#target	target_begin	target_end	hit_len	query_cov	target_cov
GCA_001515205_00229	156	376	220	0.982143	0.574413
GCA_011358735_00459	154	377	223	0.995536	0.560302
GCF_003201835_02134	156	378	222	0.991071	0.532374
GCA_014361095_00944	156	382	226	1.00893	0.590078
GCA_013154205_02036	169	387	218	0.973214	0.515366
GCA_011358085_00891	155	375	220	0.982143	0.559796
GCA_011367225_00903	156	374	218	0.973214	0.570681
GCA_011370445_00372	156	367	211	0.941964	0.555263
GCA_011042755_00637	158	376	218	0.973214	0.567708
GCA_011362965_00597	156	375	219	0.977679	0.55303
GCF_001719125_00349	155	378	223	0.995536	0.545232
GCA_011053435_00907	158	377	219	0.977679	0.539409
GCA_004347955_00034	156	375	219	0.977679	0.55303
GCA_011056255_00514	153	373	220	0.982143	0.574413
GCF_001484685_01010	147	366	219	0.977679	0.528986
GCA_005881695_01239	174	397	223	0.995536	0.494457
GCA_004347925_00566	152	370	218	0.973214	0.582888
GCA_001915065_01212	159	377	218	0.973214	0.5
GCA_014361445_00813	156	375	219	0.977679	0.55303
GCA_001919285_00080	159	377	218	0.973214	0.5
GCA_011040545_00860	163	382	219	0.977679	0.573298
GCA_005882905_01497	159	377	218	0.973214	0.5
GCF_000430485_01933	147	366	219	0.977679	0.52518
GCA_003601875_00554	152	375	223	0.995536	0.563131
GCA_003649235_00146	159	378	219	0.977679	0.539409
GCA_011372985_01318	158	377	219	0.977679	0.539409
GCA_003662645_00843	165	384	219	0.977679	0.538084
GCA_011363115_00049	158	377	219	0.977679	0.538084
GCA_005888755_02015	159	382	223	0.995536	0.511468
GCA_005888745_00830	159	382	223	0.995536	0.511468
GCF_000813245_01583	164	383	219	0.977679	0.51773
GCA_003152955_02308	170	388	218	0.973214	0.536946
GCF_002116695_02269	153	376	223	0.995536	0.533493
GCF_000019605_01573	152	372	220	0.982143	0.575916
GCA_005883075_00170	216	439	223	0.995536	0.452333
GCA_011605775_00887	149	371	222	0.991071	0.566327
GCA_003558235_00684	46	267	221	0.986607	0.827715
GCA_003096235_01252	165	384	219	0.977679	0.521429
GCF_011319465_01673	148	350	202	0.901786	0.577143
GCF_000246985_02139	147	366	219	0.977679	0.528986
GCA_003344655_00883	153	373	220	0.982143	0.578947
GCA_001918745_01233	171	394	223	0.995536	0.497768
GCA_005888695_01295	160	380	220	0.982143	0.484581
GCA_002490245_00486	159	378	219	0.977679	0.574803
GCA_005888635_00195	159	378	219	0.977679	0.502294
GCF_008326425_01033	155	377	222	0.991071	0.506849
GCA_004375695_00199	156	380	224	1	0.583333
GCF_000015945_01286	161	379	218	0.973214	0.531707
GCF_000632495_01042	155	378	223	0.995536	0.539952
GCA_005882955_00434	159	378	219	0.977679	0.502294
GCA_011380285_00270	161	383	222	0.991071	0.541463
GCF_012027555_00102	147	366	219	0.977679	0.514085
GCF_003967175_01007	155	379	224	1	0.541063
GCA_003086435_01392	152	374	222	0.991071	0.542787
GCF_009729015_00358	152	374	222	0.991071	0.542787
GCA_001775995_00180	159	381	222	0.991071	0.538835
GCA_003601835_00047	152	377	225	1.00446	0.556931
GCA_011380215_01236	158	378	220	0.982143	0.539216
GCA_001593875_00793	57	275	218	0.973214	0.754325
GCA_011053655_00398	155	374	219	0.977679	0.544776
GCA_002899805_01207	160	380	220	0.982143	0.52506
GCA_003661945_01007	159	377	218	0.973214	0.535627
GCF_902812495_01283	133	354	221	0.986607	0.586207
GCA_002507245_00932	162	380	218	0.973214	0.534314
GCA_011355215_01275	161	382	221	0.986607	0.549751
GCA_011047595_00155	158	377	219	0.977679	0.538084
GCA_002495845_00790	155	377	222	0.991071	0.509174
GCF_000092465_01161	161	379	218	0.973214	0.529126
GCA_011773785_01259	162	383	221	0.986607	0.5
GCF_003201765_01892	152	375	223	0.995536	0.534772
GCF_001647085_00478	147	366	219	0.977679	0.515294
GCF_000011205_01388	155	378	223	0.995536	0.545232
GCF_009729055_01431	155	378	223	0.995536	0.545232
GCF_002214385_01418	147	366	219	0.977679	0.51049
GCF_009729545_00209	152	374	222	0.991071	0.542787
GCA_002855745_00701	162	381	219	0.977679	0.535452
GCF_013343295_00437	155	374	219	0.977679	0.534146
GCF_000022545_00791	147	366	219	0.977679	0.528986
GCA_005888675_01532	160	380	220	0.982143	0.484581
GCA_011369595_00791	162	380	218	0.973214	0.569191
GCF_012027495_01670	147	366	219	0.977679	0.515294
GCF_001592435_00627	147	366	219	0.977679	0.514085
GCA_000565255_01211	156	379	223	0.995536	0.545232
GCF_000993805_01592	161	380	219	0.977679	0.534146
GCF_000243455_00019	145	367	222	0.991071	0.533654
GCF_000258515_01760	148	366	218	0.973214	0.512941
GCA_011355205_01416	157	376	219	0.977679	0.551637
GCF_000009965_00185	147	366	219	0.977679	0.521429
GCF_009601705_01443	155	379	224	1	0.545012
GCA_004376295_01216	160	381	221	0.986607	0.54703
GCF_000022365_00468	147	366	219	0.977679	0.518957
GCA_011333245_00139	160	380	220	0.982143	0.526316
GCA_001593865_01563	159	379	220	0.982143	0.577428
GCA_003663535_00828	147	366	219	0.977679	0.528986
GCF_000258425_01189	160	381	221	0.986607	0.521226
GCA_011364235_00999	156	379	223	0.995536	0.561713
GCA_003661465_00016	151	373	222	0.991071	0.585752
GCA_003649495_00247	155	374	219	0.977679	0.548872
GCA_003649185_00606	162	381	219	0.977679	0.536765
GCA_007280465_00974	148	361	213	0.950893	0.491917
GCA_003601695_00953	162	384	222	0.991071	0.556391
GCA_013867335_00818	149	370	221	0.986607	0.497748
GCA_012513715_01901	159	378	219	0.977679	0.492135
GCA_013288145_00516	148	371	223	0.995536	0.512644
GCF_904067545_01762	148	366	218	0.973214	0.515366
GCA_000405685_01008	153	376	223	0.995536	0.558897
GCA_011337925_01711	153	376	223	0.995536	0.558897
GCA_001593925_00985	160	381	221	0.986607	0.537713
GCA_011329225_01465	156	380	224	1	0.527059
GCF_000816105_01208	147	366	219	0.977679	0.518957
GCF_000591035_01373	164	382	218	0.973214	0.519048
GCF_900167955_00387	148	361	213	0.950893	0.489655
GCF_000769655_00116	147	366	219	0.977679	0.526442
GCF_002214545_01918	147	366	219	0.977679	0.51773
GCA_003601605_00543	159	381	222	0.991071	0.546798
GCF_000214415_01218	145	366	221	0.986607	0.528708
GCA_011369655_00918	155	376	221	0.986607	0.571059
GCF_000011125_01451	163	381	218	0.973214	0.520286
GCA_001399805_00217	160	381	221	0.986607	0.541667
GCA_011361905_00165	162	381	219	0.977679	0.571802
GCF_012027645_00343	148	366	218	0.973214	0.512941
GCF_000221185_01787	148	366	218	0.973214	0.512941
GCA_011374155_00737	162	379	217	0.96875	0.56658
GCF_000092185_00156	160	379	219	0.977679	0.542079
GCA_013152575_00756	156	377	221	0.986607	0.53253
GCA_002009975_01745	147	366	219	0.977679	0.527711
GCA_003601725_00620	164	388	224	1	0.546341
GCA_003056285_00584	157	379	222	0.991071	0.560606
GCA_011053855_00306	160	379	219	0.977679	0.542079
GCA_011364825_00136	160	379	219	0.977679	0.540741
GCA_003661975_00895	167	385	218	0.973214	0.540943
GCF_000022485_01520	155	379	224	1	0.543689
GCA_011375845_01505	153	376	223	0.995536	0.558897
GCA_013043295_00620	148	370	222	0.991071	0.518692
GCA_003663525_00628	147	366	219	0.977679	0.528986
GCA_002011075_00478	145	368	223	0.995536	0.585302
GCF_000517445_01398	147	366	219	0.977679	0.530266
GCA_011369665_00228	155	374	219	0.977679	0.544776
GCF_001484195_00753	148	366	218	0.973214	0.512941
GCA_003650925_01315	159	378	219	0.977679	0.540741
GCA_002788515_01588	148	370	222	0.991071	0.516279
GCF_000966265_01987	148	367	219	0.977679	0.522673
GCF_012222305_01696	155	378	223	0.995536	0.545232
GCA_001399795_00622	159	382	223	0.995536	0.550617
GCA_009889605_00077	159	379	220	0.982143	0.539216
GCA_005888735_00841	159	379	220	0.982143	0.502283
GCA_011364865_00250	161	385	224	1	0.561404
GCF_012027355_01641	147	366	219	0.977679	0.51773
GCA_005798405_00009	149	370	221	0.986607	0.494407
GCA_002495905_00685	152	374	222	0.991071	0.549505
GCA_004376385_01314	160	383	223	0.995536	0.538647
GCA_011375775_00913	157	376	219	0.977679	0.571802
GCA_013911135_01227	149	370	221	0.986607	0.510393
GCF_000242875_00877	148	370	222	0.991071	0.581152
GCF_002214505_00142	147	366	219	0.977679	0.516509
GCF_002214465_01442	147	366	219	0.977679	0.516509
GCF_000151105_01282	147	366	219	0.977679	0.530266
GCF_000243315_02514	155	374	219	0.977679	0.534146
GCA_011338225_01647	157	378	221	0.986607	0.568123
GCA_011380145_01129	161	380	219	0.977679	0.535452
GCA_004297665_01573	149	370	221	0.986607	0.513953
GCF_013343275_00650	48	250	202	0.901786	0.798419
GCA_003096255_00594	159	383	224	1	0.539759
GCF_900079115_00943	155	379	224	1	0.545012
GCA_003650625_00418	168	387	219	0.977679	0.534146
GCA_003650815_00465	159	378	219	0.977679	0.540741
GCA_003661825_00420	115	338	223	0.995536	0.628169
GCA_003601785_00260	56	278	222	0.991071	0.730263
GCA_011363825_01076	153	376	223	0.995536	0.554726
GCF_002214365_00913	148	366	218	0.973214	0.512941
GCA_011373965_01247	160	379	219	0.977679	0.532847
GCA_003649085_01249	159	383	224	1	0.558603
GCA_000508305_01231	155	377	222	0.991071	0.538835
GCF_000204925_00502	155	375	220	0.982143	0.539216
GCF_000223395_01809	164	385	221	0.986607	0.528708
GCF_006274605_02156	148	366	218	0.973214	0.514151
GCF_009729035_00850	155	378	223	0.995536	0.545232
GCA_011363045_01177	156	379	223	0.995536	0.561713
GCA_011373645_00609	148	371	223	0.995536	0.574742
GCA_011372935_00160	155	374	219	0.977679	0.540741
GCA_011367275_00093	157	376	219	0.977679	0.571802
GCF_013340765_01521	150	373	223	0.995536	0.550617
GCA_004376645_00230	160	380	220	0.982143	0.539216
GCA_003650865_00015	159	379	220	0.982143	0.54321
GCF_000017945_00070	172	395	223	0.995536	0.515012
GCF_000585495_01657	147	366	219	0.977679	0.52019
GCF_012027635_00546	147	366	219	0.977679	0.518957
GCF_900198835_02004	147	366	219	0.977679	0.518957
GCF_000151205_02074	147	366	219	0.977679	0.518957
GCA_003086555_00630	155	378	223	0.995536	0.543902
GCA_004376975_00318	165	386	221	0.986607	0.537713
GCA_014361085_00022	162	385	223	0.995536	0.558897
GCA_011373445_00465	158	377	219	0.977679	0.542079
GCA_902514095_00317	144	370	226	1.00893	0.602667
GCA_000746685_00570	73	294	221	0.986607	0.64058
GCA_011375785_00142	162	383	221	0.986607	0.540342
GCA_012515445_01191	159	378	219	0.977679	0.449692
GCA_013538805_00450	158	381	223	0.995536	0.547912
GCF_900065925_01572	148	358	210	0.9375	0.491803
GCA_014075315_00354	148	370	222	0.991071	0.512702
GCF_000025525_01528	142	366	224	1	0.541063
GCA_011373895_00644	158	377	219	0.977679	0.542079
GCA_004028775_00850	156	380	224	1	0.553086
GCA_011362255_01150	151	370	219	0.977679	0.558673
GCF_000263735_00129	149	368	219	0.977679	0.542079
GCF_000012285_01293	155	377	222	0.991071	0.538835
GCF_000007305_00064	147	367	220	0.982143	0.547264
GCA_007280335_00200	161	382	221	0.986607	0.488938
GCF_001317345_01575	147	366	219	0.977679	0.534146
GCA_011055445_00520	150	369	219	0.977679	0.546135
GCF_000264495_00057	160	381	221	0.986607	0.548387
GCF_000016605_01759	155	375	220	0.982143	0.537897
GCA_000746765_01118	149	370	221	0.986607	0.508046
GCA_014523685_00433	153	375	222	0.991071	0.463466
GCA_013288545_00782	148	363	215	0.959821	0.503513
GCA_013203245_00898	149	370	221	0.986607	0.484649
GCF_012027325_01975	147	366	219	0.977679	0.530266
GCA_014361455_01629	156	380	224	1	0.553086
GCF_011319475_01008	148	367	219	0.977679	0.512881
GCF_012027425_00682	147	366	219	0.977679	0.530266
GCA_003702495_00116	148	370	222	0.991071	0.515081
GCA_003649445_01003	159	378	219	0.977679	0.542079
GCA_002507085_00880	148	361	213	0.950893	0.550388
GCA_004347965_01405	159	380	221	0.986607	0.54703
GCF_900177045_01258	148	369	221	0.986607	0.524941
GCF_012027305_00785	147	366	219	0.977679	0.51773
GCA_003662205_00272	167	388	221	0.986607	0.563776
GCA_004348015_00363	156	376	220	0.982143	0.568475
GCA_000746785_00800	149	369	220	0.982143	0.564103
GCA_013867245_01177	149	370	221	0.986607	0.5
GCA_003660485_01505	55	275	220	0.982143	0.709677
GCF_002214565_01321	147	366	219	0.977679	0.51773
GCA_001543015_00579	149	370	221	0.986607	0.404022
GCA_009697485_00212	149	370	221	0.986607	0.449187
GCF_012027615_00843	147	366	219	0.977679	0.51773
GCF_002214585_01963	148	366	218	0.973214	0.508159
GCF_003116855_01669	162	385	223	0.995536	0.542579
GCA_001717015_00571	156	380	224	1	0.553086
GCA_002317795_01375	149	370	221	0.986607	0.454733
GCA_003702545_00281	149	370	221	0.986607	0.508046
GCF_000739065_01242	155	379	224	1	0.52459
GCA_013378385_00021	152	374	222	0.991071	0.550868
GCA_013306035_00576	152	374	222	0.991071	0.550868
GCA_011366735_00688	159	379	220	0.982143	0.554156
GCF_000018365_01318	147	366	219	0.977679	0.521429
GCF_002214485_00110	148	366	218	0.973214	0.509346
GCA_008974855_00365	148	368	220	0.982143	0.545906
GCA_011367965_01990	159	378	219	0.977679	0.476087
GCA_011364525_00750	162	383	221	0.986607	0.541667
GCF_000215995_01468	147	366	219	0.977679	0.544776
GCF_000023985_00107	142	365	223	0.995536	0.537349
GCF_000017165_01511	157	378	221	0.986607	0.442
GCA_013388895_01333	161	382	221	0.986607	0.539024
GCF_003201675_01994	155	375	220	0.982143	0.539216
GCF_001577775_01373	147	367	220	0.982143	0.547264
GCF_002214605_00144	147	367	220	0.982143	0.545906
GCA_007571135_01441	148	370	222	0.991071	0.508009
GCF_000725425_00937	149	367	218	0.973214	0.512941
GCF_000018465_01488	149	370	221	0.986607	0.470213
GCA_013388905_01287	160	379	219	0.977679	0.534146
GCA_000389735_00809	155	378	223	0.995536	0.529691
GCA_005877305_01126	166	388	222	0.991071	0.493333
GCF_000211475_00577	147	366	219	0.977679	0.550251
GCF_006740685_01398	149	370	221	0.986607	0.456612
GCA_003331425_00991	148	370	222	0.991071	0.529833
GCA_001723835_00123	141	356	215	0.959821	0.595568
GCA_001723855_01818	141	356	215	0.959821	0.595568
GCF_003175215_01086	148	370	222	0.991071	0.540146
GCA_011054345_00527	150	373	223	0.995536	0.5575
GCA_013154085_00154	181	405	224	1	0.507937
GCF_000299395_01567	148	370	222	0.991071	0.513889
GCA_003164815_00522	143	366	223	0.995536	0.537349
GCF_000091665_00742	142	365	223	0.995536	0.538647
GCF_001541925_00644	149	370	221	0.986607	0.496629
GCF_013407145_01507	149	370	221	0.986607	0.437624
GCA_002737445_01228	148	370	222	0.991071	0.536232
GCA_002737455_00482	148	370	222	0.991071	0.466387
GCA_002011085_00478	147	367	220	0.982143	0.552764
GCF_002945325_00385	146	366	220	0.982143	0.462185
GCF_002156965_00340	149	370	221	0.986607	0.442886
GCA_013330055_00154	149	369	220	0.982143	0.559796
GCF_000265525_01442	147	367	220	0.982143	0.518868
GCA_009889585_00119	159	378	219	0.977679	0.538084
GCA_009843815_01155	147	366	219	0.977679	0.532847
GCA_003702465_00993	149	370	221	0.986607	0.498871
GCA_011370995_00184	159	374	215	0.959821	0.574866
GCF_013390905_00622	149	370	221	0.986607	0.511574
GCA_011334935_00406	137	359	222	0.991071	0.587302
GCF_000017225_01642	146	368	222	0.991071	0.457732
GCA_011337845_00345	160	378	218	0.973214	0.542289
GCF_000299365_01555	149	370	221	0.986607	0.52
GCA_005877185_00259	142	363	221	0.986607	0.581579
GCA_003661265_00417	160	382	222	0.991071	0.57513
GCA_011333845_00224	153	376	223	0.995536	0.534772
GCA_003663695_00277	41	260	219	0.977679	0.701923
GCF_014078525_01964	149	371	222	0.991071	0.492239
GCA_001443365_00378	148	369	221	0.986607	0.54703
GCF_013407185_02126	149	370	221	0.986607	0.448276
GCA_003569705_00107	149	370	221	0.986607	0.37585
GCF_902812485_01284	140	362	222	0.991071	0.532374
GCA_005877225_01974	147	368	221	0.986607	0.558081
GCA_000484975_01149	149	370	221	0.986607	0.510393
GCF_000875775_01960	149	370	221	0.986607	0.443775
GCA_001723845_00754	144	362	218	0.973214	0.60221
GCA_009840065_00616	147	366	219	0.977679	0.534146
GCA_005877205_01792	148	369	221	0.986607	0.529976
GCF_000016125_01037	146	368	222	0.991071	0.4625
GCA_002779065_00111	46	261	215	0.959821	0.814394
GCA_002506605_00122	149	372	223	0.995536	0.576227
GCA_011367065_00914	157	379	222	0.991071	0.544118
GCF_001412615_00592	158	380	222	0.991071	0.529833
GCA_009904015_00872	160	381	221	0.986607	0.539024
GCA_002011035_01339	158	377	219	0.977679	0.542079
GCF_012027395_01425	147	366	219	0.977679	0.52019
GCA_003649145_00084	168	389	221	0.986607	0.537713
GCA_001775955_00587	159	382	223	0.995536	0.558897
GCA_011055355_00568	164	382	218	0.973214	0.535627
GCA_003056265_01203	164	386	222	0.991071	0.5311
GCA_013215285_01565	148	370	222	0.991071	0.503401
GCA_007050885_01647	159	381	222	0.991071	0.556391
GCF_012027595_02055	148	366	218	0.973214	0.506977
GCA_003660495_00229	147	366	219	0.977679	0.523923
GCA_013140415_00163	149	370	221	0.986607	0.495516
GCF_000195935_00067	147	367	220	0.982143	0.544554
GCA_002254895_00579	160	379	219	0.977679	0.544776
GCF_000015225_00375	160	379	219	0.977679	0.534146
GCF_000956175_00480	149	370	221	0.986607	0.397482
GCA_000204585_01787	1	168	167	0.745536	0.501502
GCA_013287585_01178	161	382	221	0.986607	0.488938
GCA_011389385_01048	155	374	219	0.977679	0.55303
GCA_005877365_00212	147	368	221	0.986607	0.558081
GCF_003947435_00885	158	372	214	0.955357	0.572193
GCA_009783705_00410	159	378	219	0.977679	0.44877
GCA_003554235_00657	128	352	224	1	0.634561
GCA_009781675_01030	159	378	219	0.977679	0.473002
GCA_003661965_00696	152	373	221	0.986607	0.568123
GCA_014384555_01000	148	370	222	0.991071	0.53753
GCA_003649565_00134	161	381	220	0.982143	0.540541
GCA_001515185_00085	156	380	224	1	0.583333
GCA_011331095_01860	156	376	220	0.982143	0.527578
GCA_011364715_00794	162	384	222	0.991071	0.550868
GCF_013407165_01478	149	370	221	0.986607	0.430799
GCF_900696045_02540	160	384	224	1	0.5
GCA_011363945_00370	158	380	222	0.991071	0.553616
GCA_003649205_00054	162	386	224	1	0.554455
GCF_000018485_00309	146	368	222	0.991071	0.458678
GCF_000186365_00865	160	379	219	0.977679	0.539409
GCA_003352285_01006	149	370	221	0.986607	0.436759
GCF_000376965_00444	148	368	220	0.982143	0.4814
GCF_000513855_00985	175	396	221	0.986607	0.524941
GCA_003661745_00811	160	382	222	0.991071	0.542787
GCF_000144915_01300	158	377	219	0.977679	0.528986
GCA_011332735_00641	45	261	216	0.964286	0.81203
GCF_000016385_01459	158	377	219	0.977679	0.518957
GCA_000247545_00837	158	377	219	0.977679	0.518957
GCA_003661775_00089	163	382	219	0.977679	0.532847
GCA_011375875_00028	160	379	219	0.977679	0.543424
GCA_002698885_00719	148	371	223	0.995536	0.537349
GCF_014078545_01005	149	370	221	0.986607	0.502273
GCA_011332615_02683	193	412	219	0.977679	0.444219
GCF_000723185_01245	149	367	218	0.973214	0.5
GCA_011362155_00425	159	379	220	0.982143	0.541872
GCA_002254975_00526	108	328	220	0.982143	0.635838
GCA_902566725_00402	149	371	222	0.991071	0.540146
GCA_002897955_00407	175	336	161	0.71875	0.461318
GCA_000960885_00352	156	375	219	0.977679	0.526442
GCA_001627235_00913	149	371	222	0.991071	0.540146
GCA_011364305_01145	158	377	219	0.977679	0.550251
GCA_011380095_00198	142	354	212	0.946429	0.590529
GCA_013331845_00343	26	207	181	0.808036	0.866029
GCA_011375895_00843	160	381	221	0.986607	0.539024
GCA_001593845_00596	160	379	219	0.977679	0.551637
GCA_013153105_01241	164	383	219	0.977679	0.508121
GCA_013538675_00469	159	382	223	0.995536	0.491189
GCA_004211975_01893	75	264	189	0.84375	0.707865
GCA_011334665_00899	160	382	222	0.991071	0.532374
GCF_000193375_01821	158	378	220	0.982143	0.526316
GCF_000308215_00711	142	333	191	0.852679	0.501312
GCA_002499005_00679	149	372	223	0.995536	0.571795
GCA_003661865_00362	163	382	219	0.977679	0.536765
GCF_008000775_00281	159	380	221	0.986607	0.492205
GCF_000007225_02284	158	378	220	0.982143	0.522565
GCF_008389435_01089	160	382	222	0.991071	0.492239
GCA_011369545_00278	159	379	220	0.982143	0.540541
GCA_002254745_00704	163	381	218	0.973214	0.535627
GCF_002201895_00891	157	381	224	1	0.533333
GCA_002779555_01590	109	328	219	0.977679	0.613445
GCA_001437625_01190	148	370	222	0.991071	0.515081
GCA_902606945_00618	148	370	222	0.991071	0.53753
GCF_002214525_00435	148	369	221	0.986607	0.53253
GCA_002898655_01290	98	321	223	0.995536	0.610959
GCA_014361245_00932	147	306	159	0.709821	0.516234
GCF_000011105_00047	148	367	219	0.977679	0.544776
GCF_000220175_01438	148	370	222	0.991071	0.387435
GCF_001462395_00558	159	380	221	0.986607	0.523697
GCA_009903795_01411	144	369	225	1.00446	0.601604
GCA_013153595_00225	149	366	217	0.96875	0.5
GCF_000007185_00596	157	382	225	1.00446	0.535714
GCA_012964965_00662	153	374	221	0.986607	0.54703
GCA_011056395_02193	164	387	223	0.995536	0.546569
GCF_002787055_00040	149	362	213	0.950893	0.426
GCF_000015145_00030	191	409	218	0.973214	0.489888
GCA_013540595_00525	158	380	222	0.991071	0.53753
GCA_000802205_01989	161	384	223	0.995536	0.503386
GCA_001940665_01039	114	384	270	1.20536	0.649038
GCA_011605835_00116	159	379	220	0.982143	0.545906
GCA_011364225_00182	160	379	219	0.977679	0.543424
GCF_000019805_01708	158	378	220	0.982143	0.52381
GCA_002496425_00174	154	373	219	0.977679	0.511682
GCA_011057405_00746	178	397	219	0.977679	0.514085
GCA_001717035_01554	156	381	225	1.00446	0.459184
GCA_011361755_00423	163	383	220	0.982143	0.547264
GCA_011364585_01100	159	379	220	0.982143	0.539216
GCA_011375725_00719	165	385	220	0.982143	0.527578
GCF_000253055_01602	156	375	219	0.977679	0.52518
GCA_002255065_00860	158	375	217	0.96875	0.535802
GCA_002011395_01296	145	303	158	0.705357	0.518033
GCA_013154335_00891	157	381	224	1	0.52459
GCA_011362245_00899	157	376	219	0.977679	0.55443
GCA_008080815_01022	149	370	221	0.986607	0.496629
GCF_000812185_01064	149	371	222	0.991071	0.540146
GCA_002506595_01442	159	377	218	0.973214	0.529126
GCA_011051215_00108	159	377	218	0.973214	0.525301
GCA_009903945_01372	161	380	219	0.977679	0.52019
GCA_001593855_00317	160	379	219	0.977679	0.543424
GCA_001917995_00872	148	369	221	0.986607	0.529976
GCF_900143675_01217	148	368	220	0.982143	0.520095
GCA_011362025_00637	158	377	219	0.977679	0.550251
GCF_001481685_00663	168	392	224	1	0.52093
GCA_002495025_00258	163	381	218	0.973214	0.533007
GCA_000145985_00023	164	383	219	0.977679	0.534146
GCF_900248165_00710	179	402	223	0.995536	0.503386
GCA_013154145_00411	46	268	222	0.991071	0.770833
GCA_004322465_01404	149	369	220	0.982143	0.504587
GCA_902606965_00470	155	375	220	0.982143	0.540541
GCA_011380195_00010	160	382	222	0.991071	0.548148
GCF_002077075_00758	158	377	219	0.977679	0.523923
GCF_003351865_00389	145	367	222	0.991071	0.536232
GCF_000234805_01470	158	377	219	0.977679	0.52019
GCF_000317795_00319	159	377	218	0.973214	0.529126
GCA_003601775_00807	169	388	219	0.977679	0.557252
GCA_002505645_00274	155	376	221	0.986607	0.52
GCF_000024625_00346	142	364	222	0.991071	0.528571
GCA_000402075_00684	156	370	214	0.955357	0.525799
GCA_000015805_01162	156	376	220	0.982143	0.528846
GCA_013153845_00944	142	364	222	0.991071	0.528571
GCA_003661365_01324	160	379	219	0.977679	0.571802
GCA_007050895_01404	139	359	220	0.982143	0.548628
GCA_001189275_01840	158	378	220	0.982143	0.522565
GCA_002713205_00496	152	374	222	0.991071	0.53494
GCF_013390375_01248	147	369	222	0.991071	0.556391
GCA_902384455_02499	120	351	231	1.03125	0.654391
GCA_003555465_00306	27	185	158	0.705357	0.840426
GCF_000685395_01892	149	370	221	0.986607	0.504566
GCF_013407275_01554	149	369	220	0.982143	0.502283
GCF_003431325_01525	158	379	221	0.986607	0.53125
GCA_003151735_03567	159	378	219	0.977679	0.463983
GCA_005240025_00022	142	360	218	0.973214	0.540943
GCF_001748385_01261	156	374	218	0.973214	0.533007
GCA_009778385_00722	159	377	218	0.973214	0.469828
GCA_011375585_00782	163	382	219	0.977679	0.531553
GCA_013153145_00541	159	377	218	0.973214	0.527845
GCF_013390745_00829	148	363	215	0.959821	0.538847
GCA_011364985_01243	159	382	223	0.995536	0.534772
GCA_002508315_00234	161	386	225	1.00446	0.538278
GCA_013114725_00952	152	375	223	0.995536	0.521028
GCA_003144275_01937	164	383	219	0.977679	0.501144
GCF_000015205_00426	158	378	220	0.982143	0.52381
GCA_003650785_00842	148	367	219	0.977679	0.561538
GCA_011364565_00188	162	382	220	0.982143	0.531401
GCA_011373385_00518	154	375	221	0.986607	0.568123
GCF_009831555_03249	1	141	140	0.625	0.972222
GCA_011375535_00651	152	365	213	0.950893	0.541985
GCA_002877855_00275	164	382	218	0.973214	0.522782
GCA_001774245_02178	160	377	217	0.96875	0.562176
GCA_013153895_01213	162	383	221	0.986607	0.515152
GCA_013154035_00523	42	263	221	0.986607	0.741611
GCA_001510295_00344	149	368	219	0.977679	0.531553
GCA_009787585_00813	163	385	222	0.991071	0.393617
GCA_003553905_00314	190	352	162	0.723214	0.458924
GCF_000179575_01373	151	372	221	0.986607	0.480435
GCA_013114705_00163	160	384	224	1	0.5
GCA_002506665_01489	150	372	222	0.991071	0.541463
GCA_003141855_01787	159	378	219	0.977679	0.480263
GCA_009379865_00367	161	384	223	0.995536	0.5
GCA_003660555_00860	143	351	208	0.928571	0.571429
GCA_900299125_01285	149	368	219	0.977679	0.462025
GCA_002838935_00801	173	346	173	0.772321	0.451697
GCA_013153275_01268	162	383	221	0.986607	0.516355
GCA_011375665_01171	163	382	219	0.977679	0.531553
GCF_001870125_01994	160	384	224	1	0.5
GCA_014523485_00258	152	375	223	0.995536	0.53222
GCF_007826885_00691	161	384	223	0.995536	0.501124
GCF_902158745_01613	116	298	182	0.8125	0.610738
GCA_003165195_01127	159	377	218	0.973214	0.497717
GCA_002693165_00160	154	377	223	0.995536	0.547912
GCA_013154355_01481	162	383	221	0.986607	0.516355
GCA_011366545_00081	164	385	221	0.986607	0.542998
GCA_011367155_00946	164	384	220	0.982143	0.54321
GCA_001940755_01342	155	374	219	0.977679	0.51049
GCA_002255045_00786	136	352	216	0.964286	0.610169
GCA_003663355_00553	69	250	181	0.808036	0.718254
GCA_003661385_00146	156	379	223	0.995536	0.5575
GCA_000746705_00002	144	369	225	1.00446	0.56391
GCA_000375685_00232	153	371	218	0.973214	0.557545
GCA_003650675_00752	161	381	220	0.982143	0.536585
GCA_012511995_00782	159	378	219	0.977679	0.457203
GCF_003589585_01365	164	382	218	0.973214	0.484444
GCA_001315985_00272	162	379	217	0.96875	0.514218
GCA_003663175_00468	142	348	206	0.919643	0.591954
GCA_002506645_01072	160	377	217	0.96875	0.515439
GCA_900322125_01736	180	379	199	0.888393	0.46934
GCA_001316265_01679	160	377	217	0.96875	0.516667
GCA_011366635_01708	163	382	219	0.977679	0.535452
GCA_004212085_00396	96	298	202	0.901786	0.677852
GCA_011056475_00632	141	360	219	0.977679	0.590296
GCA_013166775_03291	155	374	219	0.977679	0.512881
GCA_000494185_00250	155	374	219	0.977679	0.565891
GCA_902590655_00928	155	376	221	0.986607	0.542998
GCA_001273385_00445	158	380	222	0.991071	0.529833
GCA_002011355_00227	154	313	159	0.709821	0.501577
GCA_011367165_00781	1	134	133	0.59375	0.956835
GCA_001316285_03219	160	377	217	0.96875	0.504651
GCA_003021335_01615	82	284	202	0.901786	0.703833
GCA_009903825_01760	163	381	218	0.973214	0.530414
GCA_011332645_00359	171	388	217	0.96875	0.552163
GCF_011734195_02558	71	274	203	0.90625	0.732852
GCA_005239615_00305	46	266	220	0.982143	0.461216
GCF_000148385_00308	160	377	217	0.96875	0.515439
GCA_005191415_01503	119	342	223	0.995536	0.580729
GCA_013821245_01482	158	380	222	0.991071	0.504545
GCA_003663325_00508	167	353	186	0.830357	0.521008
GCA_011364605_00361	151	372	221	0.986607	0.563776
GCF_000092305_00942	139	362	223	0.995536	0.573265
GCA_001316245_01090	160	377	217	0.96875	0.515439
GCA_011373125_00586	152	358	206	0.919643	0.521519
GCA_002509095_00769	177	378	201	0.897321	0.478571
GCA_001717025_00373	2	225	223	0.995536	0.745819
GCA_009779045_01386	160	378	218	0.973214	0.362729
GCA_003164295_00181	159	377	218	0.973214	0.489888
GCA_013331925_00982	46	268	222	0.991071	0.742475
GCF_900110535_02976	77	273	196	0.875	0.707581
GCA_009781395_01319	161	379	218	0.973214	0.398537
GCA_902789505_01448	129	351	222	0.991071	0.579634
GCA_002499525_00287	151	365	214	0.955357	0.527094
GCA_000220355_00561	68	244	176	0.785714	0.715447
GCA_014361195_00625	149	305	156	0.696429	0.503226
GCF_004310395_00041	146	368	222	0.991071	0.536232
GCA_011052825_01242	96	313	217	0.96875	0.686709
GCA_003660975_00433	71	240	169	0.754464	0.698347
GCA_003663345_00501	166	350	184	0.821429	0.521246
GCA_903901015_01033	159	378	219	0.977679	0.465957
GCA_003661605_00014	158	377	219	0.977679	0.55303
GCA_001316005_02445	160	377	217	0.96875	0.486547
GCA_003663115_00450	143	348	205	0.915179	0.585714
GCA_010028495_00483	151	365	214	0.955357	0.29681
GCF_000012545_01426	148	366	218	0.973214	0.533007
GCA_011055275_00778	2	137	135	0.602679	0.828221
GCA_003560595_00451	132	332	200	0.892857	0.597015
GCA_000220375_01327	44	247	203	0.90625	0.808765
GCA_014361295_01475	143	333	190	0.848214	0.553936
GCA_011366425_00781	161	381	220	0.982143	0.544554
GCF_000371805_01034	141	363	222	0.991071	0.572165
GCA_013375455_00111	159	381	222	0.991071	0.527316
GCA_008297865_00444	108	316	208	0.928571	0.645963
GCA_001587715_00776	145	365	220	0.982143	0.552764
GCA_003724285_00698	184	404	220	0.982143	0.510441
GCA_002495685_00329	156	365	209	0.933036	0.509756
GCA_013154005_01025	92	261	169	0.754464	0.628253
GCA_011049295_01063	2	155	153	0.683036	0.974522
GCA_900314615_01168	143	352	209	0.933036	0.545692
GCA_002709285_00477	147	368	221	0.986607	0.553885
GCA_003663415_01100	189	382	193	0.861607	0.502604
GCA_003663585_00356	139	345	206	0.919643	0.558266
GCF_009741975_03010	2	157	155	0.691964	0.96875
GCA_013152995_00097	151	303	152	0.678571	0.48254
GCF_000190315_01374	160	376	216	0.964286	0.513064
GCF_008124605_01630	73	273	200	0.892857	0.722022
GCA_005223125_02833	159	380	221	0.986607	0.551122
GCA_003724325_00135	169	382	213	0.950893	0.512019
GCA_000270325_00287	146	368	222	0.991071	0.573643
GCA_002495315_01391	156	377	221	0.986607	0.549751
GCF_007833275_01457	109	273	164	0.732143	0.594203
GCA_902785855_00982	132	352	220	0.982143	0.577428
GCA_012962055_00696	156	313	157	0.700893	0.493711
GCA_013388835_00071	158	379	221	0.986607	0.53253
GCA_011331665_00008	149	330	181	0.808036	0.533923
GCA_009787175_01075	186	408	222	0.991071	0.438735
GCA_011373505_01354	151	370	219	0.977679	0.564433
GCF_001971705_01117	124	280	156	0.696429	0.525253
GCA_003663445_00510	124	313	189	0.84375	0.601911
GCA_000495735_00538	221	440	219	0.977679	0.449692
GCF_000303155_03424	155	377	222	0.991071	0.513889
GCA_902782595_00516	143	352	209	0.933036	0.545692
GCA_008080735_00085	159	380	221	0.986607	0.562341
GCA_900318035_00295	131	352	221	0.986607	0.577023
GCA_013139905_00433	157	351	194	0.866071	0.486216
GCA_902774605_00229	140	352	212	0.946429	0.553525
GCA_003568775_00051	152	328	176	0.785714	0.53012
GCA_014238095_00515	148	352	204	0.910714	0.571429
GCA_001761425_00432	44	248	204	0.910714	0.822581
GCA_002713325_00064	155	376	221	0.986607	0.527446
GCF_000337535_03223	95	296	201	0.897321	0.642173
GCA_000008085_00354	146	335	189	0.84375	0.554252
GCA_004524535_01826	159	377	218	0.973214	0.540943
GCA_009665115_02406	185	406	221	0.986607	0.493304
GCA_003551675_01221	139	343	204	0.910714	0.594752
GCA_011364965_02056	153	371	218	0.973214	0.520286
GCA_011364805_00326	198	416	218	0.973214	0.487696
GCF_000337595_02483	96	296	200	0.892857	0.638978
GCA_002010215_01010	104	272	168	0.75	0.613139
GCA_007122875_01739	117	277	160	0.714286	0.569395
GCF_001663375_00633	176	396	220	0.982143	0.516432
GCA_001516585_00811	162	380	218	0.973214	0.524038
GCA_000806115_00764	149	320	171	0.763393	0.53271
GCF_000018305_01309	164	384	220	0.982143	0.53528
GCA_000402355_00825	46	264	218	0.973214	0.46383
GCA_003135935_00979	166	334	168	0.75	0.466667
GCA_003550625_00423	201	351	150	0.669643	0.424929
GCF_009617975_00246	60	247	187	0.834821	0.751004
GCF_003675855_01955	128	272	144	0.642857	0.516129
GCF_003675875_02922	126	274	148	0.660714	0.530466
GCA_011362275_00898	165	386	221	0.986607	0.54703
GCA_009889515_01862	151	368	217	0.96875	0.55641
GCA_014523515_00245	158	381	223	0.995536	0.524706
GCA_011370515_00695	157	377	220	0.982143	0.551378
GCA_011605825_00342	157	377	220	0.982143	0.551378
GCA_014381835_01085	166	385	219	0.977679	0.567358
GCA_902771435_01578	132	352	220	0.982143	0.574413
GCA_011372955_00242	157	379	222	0.991071	0.556391
GCF_002177135_01581	93	284	191	0.852679	0.64094
GCF_900104065_00073	113	280	167	0.745536	0.575862
GCF_000337675_04190	136	283	147	0.65625	0.494949
GCA_003133625_01485	170	392	222	0.991071	0.501129
GCF_000337555_01894	96	296	200	0.892857	0.638978
GCA_013619005_01719	155	367	212	0.946429	0.576087
GCA_002506515_00484	164	384	220	0.982143	0.53012
GCA_011334735_01240	156	333	177	0.790179	0.516035
GCA_902772665_02252	143	352	209	0.933036	0.545692
GCA_003021085_02961	81	275	194	0.866071	0.687943
GCA_002067635_01478	152	335	183	0.816964	0.485411
GCF_900103415_01439	127	347	220	0.982143	0.583554
GCF_000328685_03771	115	278	163	0.727679	0.567944
GCA_902801725_00765	141	352	211	0.941964	0.550914
GCA_003663225_00735	159	331	172	0.767857	0.511905
GCA_003023565_00965	130	278	148	0.660714	0.522968
GCA_013331455_01376	47	261	214	0.955357	0.792593
GCA_013178285_01334	145	365	220	0.982143	0.555556
GCA_002501845_01258	155	377	222	0.991071	0.513889
GCA_008297795_00185	159	312	153	0.683036	0.490385
GCA_013375485_00533	159	382	223	0.995536	0.55611
GCA_003649225_00607	157	376	219	0.977679	0.542079
GCF_004363215_00408	147	320	173	0.772321	0.527439
GCA_012719175_02151	158	332	174	0.776786	0.461538
GCF_000970205_03294	150	313	163	0.727679	0.485119
GCA_013330975_00770	156	376	220	0.982143	0.35313
GCF_000383975_03776	124	280	156	0.696429	0.52
GCA_011334385_00312	148	354	206	0.919643	0.575419
GCF_001488575_01427	68	274	206	0.919643	0.743682
GCF_000698785_01662	147	370	223	0.995536	0.519814
GCF_013342135_03070	124	280	156	0.696429	0.516556
GCF_001477655_02074	127	347	220	0.982143	0.583554
GCF_002156705_02532	78	277	199	0.888393	0.665552
GCA_013152905_00615	157	315	158	0.705357	0.49375
GCA_902764455_01485	144	352	208	0.928571	0.543081
GCA_900320955_01383	95	313	218	0.973214	0.633721
GCF_000014945_00849	119	275	156	0.696429	0.547368
GCF_000230955_02032	350	526	176	0.785714	0.332703
GCA_001563875_00197	34	253	219	0.977679	0.862205
GCA_002496475_00670	160	377	217	0.96875	0.515439
GCA_011370395_00882	152	356	204	0.910714	0.557377
GCA_002763225_00914	44	262	218	0.973214	0.801471
GCA_005877345_02550	150	368	218	0.973214	0.530414
GCA_014523495_00366	150	369	219	0.977679	0.531553
GCA_002506595_00655	126	326	200	0.892857	0.609756
GCA_003153895_00879	166	336	170	0.758929	0.470914
GCA_900314695_00312	133	352	219	0.977679	0.571802
GCA_902384555_01129	42	257	215	0.959821	0.520581
GCA_002688315_00004	98	320	222	0.991071	0.69375
GCF_000016525_01052	137	352	215	0.959821	0.555556
GCF_009789175_01110	82	279	197	0.879464	0.698582
GCA_009776805_01896	159	380	221	0.986607	0.440239
GCA_003662305_00457	160	379	219	0.977679	0.543424
GCF_003841505_00064	113	279	166	0.741071	0.537217
GCF_000337575_00705	92	297	205	0.915179	0.638629
GCA_005877075_01977	150	370	220	0.982143	0.536585
GCF_002252585_01491	137	352	215	0.959821	0.555556
GCA_003650975_00589	153	313	160	0.714286	0.507937
GCF_000376445_00538	92	281	189	0.84375	0.660839
GCA_014523525_01364	150	367	217	0.96875	0.527981
GCA_002501855_02975	183	406	223	0.995536	0.497768
GCA_003194445_01558	108	257	149	0.665179	0.547794
GCF_008245225_03274	120	279	159	0.709821	0.514563
GCA_013375405_04064	118	341	223	0.995536	0.588391
GCF_900112175_01052	126	279	153	0.683036	0.538732
GCA_013572355_00419	131	277	146	0.651786	0.506944
GCA_002254825_00966	76	238	162	0.723214	0.661224
GCF_900112205_03353	116	283	167	0.745536	0.560403
GCF_000337695_00191	84	276	192	0.857143	0.657534
GCF_000730285_00609	157	380	223	0.995536	0.505669
GCA_001587575_00621	170	390	220	0.982143	0.522565
GCA_001940655_01812	158	383	225	1.00446	0.498891
GCA_003491285_00792	158	370	212	0.946429	0.522167
GCA_007570915_00206	149	353	204	0.910714	0.541114
GCA_002503595_01242	53	212	159	0.709821	0.726027
GCF_011043775_04085	90	283	193	0.861607	0.647651
GCA_011366705_00290	146	324	178	0.794643	0.544343
GCF_000337495_02779	124	279	155	0.691964	0.525424
GCA_902384585_00945	46	256	210	0.9375	0.780669
GCF_001485535_01497	74	273	199	0.888393	0.718412
GCF_000337115_03158	31	220	189	0.84375	0.790795
GCF_003977755_00235	125	280	155	0.691964	0.525424
GCA_004524365_01450	155	375	220	0.982143	0.572917
GCA_003584625_01206	152	356	204	0.910714	0.563536
GCA_003661505_00231	145	365	220	0.982143	0.565553
GCF_000979455_02234	151	313	162	0.723214	0.482143
GCF_000970085_00304	151	313	162	0.723214	0.482143
GCF_009806985_01168	127	288	161	0.71875	0.533113
GCF_900108095_01007	120	280	160	0.714286	0.538721
GCF_000337215_01611	61	281	220	0.982143	0.730897
GCF_000337735_03185	39	190	151	0.674107	0.747525
GCA_002508545_02281	166	334	168	0.75	0.448
GCF_001548675_01900	136	353	217	0.96875	0.56658
GCA_002255135_00163	135	297	162	0.723214	0.532895
GCF_004137855_01047	128	313	185	0.825893	0.583596
GCF_000327505_00916	111	265	154	0.6875	0.56
GCF_013402815_00880	81	276	195	0.870536	0.661017
GCF_004785955_03125	132	275	143	0.638393	0.507092
GCF_005954745_01927	118	276	158	0.705357	0.558304
GCA_000380705_00357	154	369	215	0.959821	0.558442
GCA_011361945_00158	2	197	195	0.870536	0.851528
GCA_902763935_01624	126	348	222	0.991071	0.588859
GCA_902768765_00832	126	348	222	0.991071	0.588859
GCA_003663565_00862	139	345	206	0.919643	0.559783
GCA_002496565_03026	152	312	160	0.714286	0.47619
GCF_900215215_00317	128	312	184	0.821429	0.580442
GCA_013330915_00332	183	362	179	0.799107	0.438725
GCA_013331465_00912	183	362	179	0.799107	0.438725
GCF_900188065_03121	88	280	192	0.857143	0.646465
GCA_011358415_00268	42	243	201	0.897321	0.817073
GCF_900110865_00617	117	280	163	0.727679	0.552542
GCA_002898395_00179	151	368	217	0.96875	0.55641
GCF_000970285_04096	152	314	162	0.723214	0.482143
GCA_900319535_01840	126	348	222	0.991071	0.588859
GCA_011365055_02713	158	376	218	0.973214	0.521531
GCF_002761295_01094	125	312	187	0.834821	0.591772
GCF_003814835_00184	157	352	195	0.870536	0.509138
GCA_002011125_02057	121	160	39	0.174107	0.110795
GCA_002011125_02057	166	327	161	0.71875	0.457386
GCA_003551065_01017	137	340	203	0.90625	0.595308
GCA_001800675_00701	131	329	198	0.883929	0.570605
GCF_000337195_03602	78	276	198	0.883929	0.680412
GCA_902384675_00867	153	343	190	0.848214	0.549133
GCF_000217715_00224	90	280	190	0.848214	0.633333
GCA_002867475_00289	126	309	183	0.816964	0.592233
GCA_012518185_01531	144	329	185	0.825893	0.51676
GCA_900319985_00305	144	351	207	0.924107	0.54047
GCA_001564035_00692	32	247	215	0.959821	0.866935
GCF_001729965_01049	170	366	196	0.875	0.47343
GCA_001316025_02287	162	379	217	0.96875	0.511792
GCF_001889405_00544	130	310	180	0.803571	0.567823
GCF_001861355_03130	86	291	205	0.915179	0.648734
GCF_004765785_02431	130	280	150	0.669643	0.510204
GCA_014647155_01586	124	280	156	0.696429	0.543554
GCA_004524595_01822	116	205	89	0.397321	0.211401
GCA_004524595_01822	221	380	159	0.709821	0.377672
GCA_013114715_01562	155	378	223	0.995536	0.53222
GCA_007133845_00336	138	318	180	0.803571	0.564263
GCF_003722075_00179	127	312	185	0.825893	0.583596
GCA_012961645_01190	80	263	183	0.816964	0.693182
GCA_013375355_00776	158	366	208	0.928571	0.494062
GCF_009392895_03159	130	279	149	0.665179	0.515571
GCA_013329175_00223	87	316	229	1.02232	0.722397
GCA_004193545_00154	149	315	166	0.741071	0.523659
GCF_000745485_03209	146	364	218	0.973214	0.540943
GCF_000017185_00771	148	364	216	0.964286	0.438134
GCA_902788255_00413	130	352	222	0.991071	0.579634
GCF_900100335_02771	131	280	149	0.665179	0.496667
GCF_000970265_00214	151	313	162	0.723214	0.482143
GCA_902770715_02120	129	351	222	0.991071	0.581152
GCF_000235565_00085	129	287	158	0.705357	0.504792
GCA_013153555_00022	102	324	222	0.991071	0.683077
GCA_001800815_00013	132	329	197	0.879464	0.567723
GCF_000230735_02124	82	280	198	0.883929	0.662207
GCA_900316895_01013	7	225	218	0.973214	0.851562
GCF_000337135_01700	92	294	202	0.901786	0.633229
GCA_008080765_00997	157	381	224	1	0.567089
GCA_902777885_00287	127	347	220	0.982143	0.583554
GCF_006543045_00742	146	313	167	0.745536	0.503012
GCA_003553085_01439	151	335	184	0.821429	0.547619
GCA_013538715_00894	143	359	216	0.964286	0.561039
GCF_000504205_01281	110	280	170	0.758929	0.536278
GCA_014647115_01225	125	280	155	0.691964	0.536332
GCA_003559215_02040	87	278	191	0.852679	0.65411
GCA_002506015_02312	98	264	166	0.741071	0.62406
GCA_009776675_01169	170	344	174	0.776786	0.5
GCA_002688965_00347	33	257	224	1	0.868217
GCA_003661105_00644	131	278	147	0.65625	0.503425
GCA_013388945_01973	155	375	220	0.982143	0.333839
GCF_000025865_00131	127	310	183	0.816964	0.577287
GCA_000690595_02787	88	279	191	0.852679	0.64527
GCF_000230715_00185	596	781	185	0.825893	0.233586
GCF_900620265_01343	116	326	210	0.9375	0.458515
GCF_900110465_04182	130	276	146	0.651786	0.514085
GCF_003841485_00819	146	291	145	0.647321	0.47541
GCF_000621965_00609	158	363	205	0.915179	0.50995
GCF_000026045_01024	109	277	168	0.75	0.6
GCA_002898355_00209	153	376	223	0.995536	0.571795
GCA_003023785_02335	133	286	153	0.683036	0.523973
GCF_000006175_00866	188	405	217	0.96875	0.408663
GCF_000226975_03179	120	282	162	0.723214	0.543624
GCA_002763335_00309	180	338	158	0.705357	0.463343
GCA_011357905_01349	80	259	179	0.799107	0.680608
GCA_004524445_01473	159	381	222	0.991071	0.550868
GCA_002507205_02251	108	272	164	0.732143	0.537705
GCA_002067065_01556	157	364	207	0.924107	0.5175
GCA_000496235_01967	114	277	163	0.727679	0.573944
GCA_004297575_00678	2	158	156	0.696429	0.962963
GCF_000404225_01546	173	335	162	0.723214	0.447514
GCA_001871595_00405	10	226	216	0.964286	0.935065
GCF_000013725_01658	164	328	164	0.732143	0.463277
GCF_006546655_00500	174	338	164	0.732143	0.437333
GCF_001304615_00969	151	312	161	0.71875	0.479167
GCA_011333035_00369	145	195	50	0.223214	0.141643
GCA_011333035_00369	190	351	161	0.71875	0.456091
GCA_001940645_00059	149	368	219	0.977679	0.514085
GCF_900100385_01127	79	278	199	0.888393	0.708185
GCA_001714685_02478	153	312	159	0.709821	0.473214
GCF_013456555_00081	81	276	195	0.870536	0.656566
GCA_011363135_00006	148	354	206	0.919643	0.573816
GCF_000337615_00628	114	279	165	0.736607	0.559322
GCA_003663045_00450	185	351	166	0.741071	0.464986
GCF_000025625_00686	93	294	201	0.897321	0.626168
GCA_003022905_00290	69	276	207	0.924107	0.741935
GCF_000499765_01701	155	369	214	0.955357	0.532338
GCF_000337095_00418	119	278	159	0.709821	0.559859
GCA_001512965_01341	140	329	189	0.84375	0.520661
GCA_004212095_00741	147	316	169	0.754464	0.533123
GCF_000969885_02301	151	311	160	0.714286	0.47619
GCF_002208625_01338	158	363	205	0.915179	0.513784
GCF_009176545_02446	126	281	155	0.691964	0.530822
GCA_011047985_00053	96	299	203	0.90625	0.669967
GCF_000007345_00352	152	313	161	0.71875	0.479167
GCA_011372835_00520	140	347	207	0.924107	0.570248
GCF_000731985_03651	112	276	164	0.732143	0.563574
GCA_013330825_00679	115	306	191	0.852679	0.62013
GCA_002499085_01039	164	338	174	0.776786	0.50289
GCF_003264935_01202	197	363	166	0.741071	0.446237
GCA_004347865_01354	58	255	197	0.879464	0.766537
GCA_002499405_00721	92	296	204	0.910714	0.675497
GCF_000970305_02184	151	309	158	0.705357	0.470238
GCF_900114455_04152	129	280	151	0.674107	0.517123
GCA_003154335_00968	69	270	201	0.897321	0.700348
GCA_004376265_03202	177	398	221	0.986607	0.506881
GCF_000194625_01281	56	257	201	0.897321	0.776062
GCA_002498125_00160	36	258	222	0.991071	0.853846
GCF_900100715_01733	131	300	169	0.754464	0.501484
GCA_001507955_00580	168	356	188	0.839286	0.519337
GCA_013151465_00229	193	356	163	0.727679	0.446575
GCA_013331275_03019	151	309	158	0.705357	0.470238
GCA_011772645_00869	137	334	197	0.879464	0.581121
GCA_003009815_00822	46	248	202	0.901786	0.811245
GCF_003610195_01604	120	309	189	0.84375	0.583333
GCF_004799645_03093	86	279	193	0.861607	0.665517
GCA_004212035_01065	83	304	221	0.986607	0.726974
GCA_003266075_01805	150	362	212	0.946429	0.523457
GCA_001940705_01832	155	373	218	0.973214	0.533007
GCA_900320515_01932	132	352	220	0.982143	0.574413
GCA_902783085_01469	139	350	211	0.941964	0.555263
GCA_001552015_00034	139	325	186	0.830357	0.568807
GCF_000063445_02809	122	287	165	0.736607	0.555556
GCA_000402775_01171	143	358	215	0.959821	0.593923
GCF_000025325_02104	126	280	154	0.6875	0.522034
GCA_012799835_00176	16	237	221	0.986607	0.827715
GCA_013374385_00586	138	309	171	0.763393	0.537736
GCF_002287235_01186	152	309	157	0.700893	0.467262
GCA_013329455_00552	95	293	198	0.883929	0.642857
GCA_900317865_01035	136	347	211	0.941964	0.559682
GCA_013791785_01667	131	335	204	0.910714	0.577904
GCF_000739555_00085	81	277	196	0.875	0.634304
GCF_014212355_02958	47	202	155	0.691964	0.752427
GCA_003551265_02145	123	278	155	0.691964	0.551601
GCF_001639275_01963	143	351	208	0.928571	0.543081
GCF_900156475_00201	75	279	204	0.910714	0.693878
GCA_003019535_00952	131	353	222	0.991071	0.573643
GCF_013391635_02243	127	275	148	0.660714	0.530466
GCA_013329415_00570	150	310	160	0.714286	0.473373
GCF_000195895_00845	154	310	156	0.696429	0.464286
GCF_001006045_01787	52	258	206	0.919643	0.79845
GCA_900314605_00993	157	364	207	0.924107	0.5086
GCA_013415865_00807	152	331	179	0.799107	0.495845
GCA_003663055_00588	52	248	196	0.875	0.784
GCF_002572525_03858	82	276	194	0.866071	0.653199
GCF_000970325_02190	160	325	165	0.736607	0.464789
GCA_009777005_01887	147	366	219	0.977679	0.543424
GCA_013403005_00978	157	368	211	0.941964	0.526185
GCF_002243045_02726	150	316	166	0.741071	0.475645
GCF_003430825_01327	95	275	180	0.803571	0.629371
GCA_007135435_00229	152	305	153	0.683036	0.496753
GCF_001625445_00050	87	276	189	0.84375	0.672598
GCA_013330875_00485	115	294	179	0.799107	0.608844
GCF_003111605_00624	141	359	218	0.973214	0.560411
GCA_000200715_00503	147	367	220	0.982143	0.561224
GCF_002487355_01375	144	297	153	0.683036	0.5
GCF_004099695_01609	154	310	156	0.696429	0.464286
GCA_001563995_00554	57	247	190	0.848214	0.763052
GCA_012026795_00386	89	292	203	0.90625	0.67893
GCA_003009795_00529	46	248	202	0.901786	0.801587
GCF_000969965_00277	152	313	161	0.71875	0.479167
GCF_003841465_03637	79	276	197	0.879464	0.672355
GCA_013138615_00241	160	379	219	0.977679	0.52518
GCF_000172995_01516	131	278	147	0.65625	0.517606
GCA_003166335_01307	157	365	208	0.928571	0.518703
GCA_002503845_01054	87	277	190	0.848214	0.673759
GCA_004212155_00940	140	347	207	0.924107	0.570248
GCF_900110455_04027	83	276	193	0.861607	0.660959
GCA_003162115_00756	157	371	214	0.955357	0.528395
GCF_009741925_02615	92	275	183	0.816964	0.655914
GCA_001914405_01406	64	292	228	1.01786	0.772881
GCA_009712615_00919	159	368	209	0.933036	0.507282
GCF_005576615_01948	84	276	192	0.857143	0.66436
GCA_900313645_00706	141	351	210	0.9375	0.548303
GCA_013331625_00617	47	258	211	0.941964	0.433265
GCA_004524565_00307	158	375	217	0.96875	0.515439
GCA_002067865_00398	172	334	162	0.723214	0.448753
GCF_000217995_01948	129	320	191	0.852679	0.556851
GCA_002728275_01349	138	354	216	0.964286	0.601671
GCA_003663295_00326	86	253	167	0.745536	0.660079
GCA_011373345_01047	154	376	222	0.991071	0.564885
GCA_009889685_00042	115	276	161	0.71875	0.570922
GCA_002509665_03185	161	381	220	0.982143	0.52381
GCA_003662985_01695	108	269	161	0.71875	0.566901
GCA_903832665_00764	138	289	151	0.674107	0.476341
GCA_009776495_01363	156	366	210	0.9375	0.521092
GCA_002496385_01225	163	335	172	0.767857	0.49711
GCA_012840175_00689	190	356	166	0.741071	0.459834
GCA_011045925_00197	103	289	186	0.830357	0.639175
GCF_900103505_00190	126	283	157	0.700893	0.530405
GCF_000251105_01856	88	237	149	0.665179	0.605691
GCF_008122205_02318	88	279	191	0.852679	0.64966
GCF_000970025_00531	155	309	154	0.6875	0.458333
GCA_005878515_01585	167	329	162	0.723214	0.455056
GCF_001953745_01687	83	280	197	0.879464	0.658863
GCA_011371845_00438	228	371	143	0.638393	0.380319
GCF_000337895_01968	113	278	165	0.736607	0.565068
GCA_007135505_00641	88	275	187	0.834821	0.625418
GCF_000685155_01286	82	288	206	0.919643	0.695946
GCA_003558335_00826	145	365	220	0.982143	0.555556
GCF_004297185_00171	153	279	126	0.5625	0.431507
GCA_012511245_02356	73	271	198	0.883929	0.692308
GCF_009831575_01025	122	278	156	0.696429	0.55516
GCA_002499445_00723	153	309	156	0.696429	0.464286
GCA_001563805_01875	106	275	169	0.754464	0.590909
GCF_000025665_00113	110	261	151	0.674107	0.576336
GCF_900116205_03967	124	275	151	0.674107	0.5
GCF_000334895_02592	123	282	159	0.709821	0.519608
GCA_002502855_01362	110	322	212	0.946429	0.600567
GCA_001421185_00394	166	329	163	0.727679	0.317121
GCA_002495625_01643	159	367	208	0.928571	0.52
GCA_011366665_00937	161	334	173	0.772321	0.517964
GCA_902385155_00884	35	251	216	0.964286	0.757895
GCA_003022815_01768	81	276	195	0.870536	0.698925
GCA_002839675_02078	145	302	157	0.700893	0.486068
GCF_900110215_00670	78	272	194	0.866071	0.680702
GCA_002926195_01165	154	320	166	0.741071	0.470255
GCA_012519255_01717	168	333	165	0.736607	0.444744
GCF_900107195_01943	126	276	150	0.669643	0.530035
GCA_001587675_01378	145	369	224	1	0.562814
GCA_003022725_01726	122	279	157	0.700893	0.556738
GCA_002726865_00586	166	379	213	0.950893	0.551813
GCA_003164755_01353	156	311	155	0.691964	0.455882
GCA_002067705_02181	122	286	164	0.732143	0.559727
GCF_900215575_02460	122	278	156	0.696429	0.553191
GCA_011358475_00802	56	267	211	0.941964	0.787313
GCF_900114835_02746	153	316	163	0.727679	0.457865
GCA_011355145_00473	145	330	185	0.825893	0.522599
GCA_002507545_01175	79	260	181	0.808036	0.696154
GCA_003022945_00588	132	277	145	0.647321	0.516014
GCA_902794475_00709	121	340	219	0.977679	0.590296
GCA_001742785_01224	142	356	214	0.955357	0.592798
GCF_005938085_01453	79	275	196	0.875	0.685315
GCA_002504525_00896	163	331	168	0.75	0.457766
GCA_013329495_00051	141	339	198	0.883929	0.575581
GCF_000455365_00325	133	280	147	0.65625	0.508651
GCF_003298465_01638	86	277	191	0.852679	0.682143
GCA_902796575_00746	138	347	209	0.933036	0.555851
GCA_013329135_00970	162	327	165	0.736607	0.474138
GCF_900111485_02604	82	275	193	0.861607	0.672474
GCA_014647455_00406	116	277	161	0.71875	0.562937
GCF_002287175_01608	145	364	219	0.977679	0.543424
GCF_000455345_02103	77	278	201	0.897321	0.681356
GCA_902797085_00281	168	362	194	0.866071	0.477833
GCA_011049195_00319	132	298	166	0.741071	0.482558
GCA_001766815_00025	12	204	192	0.857143	0.853333
GCF_001571385_00636	140	269	129	0.575893	0.459075
GCF_003862495_02560	131	285	154	0.6875	0.536585
GCA_011605715_01716	141	337	196	0.875	0.581602
GCA_011334515_00187	43	260	217	0.96875	0.831418
GCF_004114995_02057	125	282	157	0.700893	0.511401
GCA_007121575_01030	95	282	187	0.834821	0.65614
GCF_000337175_00363	122	280	158	0.705357	0.535593
GCF_002727125_00998	128	283	155	0.691964	0.513245
GCF_004944975_00239	129	276	147	0.65625	0.521277
GCA_003651105_00194	141	288	147	0.65625	0.505155
GCF_000789255_01210	76	258	182	0.8125	0.705426
GCA_002505765_00929	158	368	210	0.9375	0.521092
GCF_000320505_00743	158	366	208	0.928571	0.51358
GCA_003554845_00243	196	350	154	0.6875	0.436261
GCA_000496175_00216	122	286	164	0.732143	0.559727
GCF_000191585_00306	157	369	212	0.946429	0.514563
GCF_004217335_03152	82	275	193	0.861607	0.665517
GCF_002952775_02620	135	286	151	0.674107	0.510135
GCA_011331255_00640	136	329	193	0.861607	0.543662
GCA_002254405_00920	147	356	209	0.933036	0.587079
GCA_003151535_03776	158	370	212	0.946429	0.523457
GCA_003554605_02586	84	278	194	0.866071	0.646667
GCA_000830295_00381	120	316	196	0.875	0.620253
GCF_900115675_01172	80	276	196	0.875	0.659933
GCA_003164415_01685	158	370	212	0.946429	0.523457
GCA_005878985_00743	167	329	162	0.723214	0.455056
GCF_000327485_02600	75	282	207	0.924107	0.723776
GCA_000415965_02362	79	277	198	0.883929	0.692308
GCA_902386115_01147	127	289	162	0.723214	0.554795
GCA_003662765_00077	223	375	152	0.678571	0.372549
GCF_001261915_02995	125	281	156	0.696429	0.513158
GCF_000336915_00112	120	281	161	0.71875	0.543919
GCF_009690625_01124	82	274	192	0.857143	0.688172
GCA_003022005_02486	127	279	152	0.678571	0.511785
GCA_003601535_00848	91	254	163	0.727679	0.636719
GCF_900095815_01573	147	354	207	0.924107	0.553476
GCF_000337775_03282	111	273	162	0.723214	0.578571
GCF_000379085_03471	79	272	193	0.861607	0.691756
GCA_002506535_01896	133	293	160	0.714286	0.504732
GCF_000237865_01770	121	281	160	0.714286	0.561404
GCF_900107205_00510	23	190	167	0.745536	0.830846
GCF_000023965_02257	80	272	192	0.857143	0.688172
GCA_001563885_01786	84	277	193	0.861607	0.658703
GCA_002509325_00442	156	311	155	0.691964	0.46131
GCA_001564135_00718	77	277	200	0.892857	0.714286
GCA_002502785_01482	132	293	161	0.71875	0.527869
GCA_002496805_01398	158	367	209	0.933036	0.5225
GCA_012838205_00799	157	369	212	0.946429	0.527363
GCF_003268005_01745	190	372	182	0.8125	0.436451
GCF_000337475_02320	109	275	166	0.741071	0.566553
GCF_001989615_00314	116	271	155	0.691964	0.547703
GCA_003491305_01803	157	368	211	0.941964	0.524876
GCA_903884505_00742	45	257	212	0.946429	0.666667
GCA_002498285_00886	164	329	165	0.736607	0.455801
GCA_002010285_01218	87	267	180	0.803571	0.669145
GCA_002499505_00485	47	265	218	0.973214	0.567708
GCA_011361745_00895	55	254	199	0.888393	0.774319
GCA_003034855_00170	87	301	214	0.955357	0.703947
GCA_002067325_00556	158	367	209	0.933036	0.5225
GCF_004143485_02280	129	277	148	0.660714	0.488449
GCA_001563915_00450	50	245	195	0.870536	0.792683
GCA_011364975_00341	159	382	223	0.995536	0.547912
GCA_002495055_01184	69	270	201	0.897321	0.700348
GCA_002254385_00328	171	333	162	0.723214	0.428571
GCA_014297435_00235	46	248	202	0.901786	0.811245
GCA_001509375_02306	137	292	155	0.691964	0.506536
GCF_000403645_02202	129	284	155	0.691964	0.521886
GCF_900156425_01274	80	275	195	0.870536	0.69395
GCA_002501695_01225	108	274	166	0.741071	0.540717
GCF_009791395_00562	127	273	146	0.651786	0.489933
GCF_900774055_00357	163	326	163	0.727679	0.461756
GCA_902386135_01796	79	285	206	0.919643	0.693603
GCA_012026835_03425	132	289	157	0.700893	0.525084
GCF_001307315_02563	110	277	167	0.745536	0.568027
GCA_004524725_00381	159	382	223	0.995536	0.546569
GCA_003019595_01653	133	358	225	1.00446	0.608108
GCA_002067365_01675	105	303	198	0.883929	0.626582
GCA_002494725_01126	49	258	209	0.933036	0.810078
GCF_002286985_01538	126	281	155	0.691964	0.506536
GCA_014361205_01362	148	312	164	0.732143	0.479532
GCF_013391105_00228	29	188	159	0.709821	0.832461
GCF_009617995_01549	121	272	151	0.674107	0.541219
GCF_001593955_00690	107	270	163	0.727679	0.59058
GCA_003266165_00957	170	367	197	0.879464	0.481663
GCA_902385255_00207	106	288	182	0.8125	0.629758
GCA_003552585_01570	138	341	203	0.90625	0.595308
GCF_003439925_00075	101	273	172	0.767857	0.614286
GCF_000011005_01586	57	218	161	0.71875	0.688034
GCA_005222965_00404	63	238	175	0.78125	0.735294
GCF_003721435_00182	123	279	156	0.696429	0.518272
GCF_900767505_00523	179	340	161	0.71875	0.443526
GCF_004118325_04109	121	271	150	0.669643	0.528169
GCF_013415905_04471	115	274	159	0.709821	0.535354
GCA_013329105_01063	174	337	163	0.727679	0.460452
GCA_004524515_02761	160	380	220	0.982143	0.541872
GCF_003781945_03576	128	287	159	0.709821	0.509615
GCF_009834785_00600	130	280	150	0.669643	0.508475
GCA_000387965_00027	140	325	185	0.825893	0.565749
GCA_003660965_00030	43	256	213	0.950893	0.822394
GCF_000022205_01042	116	271	155	0.691964	0.54007
GCA_009889625_01019	82	272	190	0.848214	0.685921
GCA_002763025_00485	127	307	180	0.803571	0.582524
GCA_013331265_01221	152	313	161	0.71875	0.479167
GCA_011389375_00800	187	336	149	0.665179	0.43695
GCF_000970045_03357	152	310	158	0.705357	0.467456
GCF_000969905_03266	155	309	154	0.6875	0.458333
GCF_000336755_02235	122	272	150	0.669643	0.537634
GCF_004799685_02586	138	290	152	0.678571	0.517007
GCF_013839425_01764	125	274	149	0.665179	0.53405
GCF_003111625_01479	195	352	157	0.700893	0.409922
GCF_009831455_00967	125	275	150	0.669643	0.539568
GCF_010747475_02154	146	296	150	0.669643	0.465839
GCA_011335085_00179	148	354	206	0.919643	0.575419
GCA_003086415_00298	128	325	197	0.879464	0.602446
GCA_003021015_01345	120	279	159	0.709821	0.56383
GCF_000011085_00791	113	273	160	0.714286	0.571429
GCA_011372335_00668	76	247	171	0.763393	0.684
GCF_000591055_01273	78	275	197	0.879464	0.708633
GCA_011363705_00080	160	308	148	0.660714	0.478964
GCF_000337915_03081	127	282	155	0.691964	0.501618
GCA_002498315_00287	138	275	137	0.611607	0.487544
GCF_000328665_00056	149	312	163	0.727679	0.445355
GCF_001469955_00501	108	273	165	0.736607	0.589286
GCA_000830275_00030	47	264	217	0.96875	0.783394
GCA_002067045_01423	40	207	167	0.745536	0.692946
GCA_011389055_00031	75	251	176	0.785714	0.538226
GCA_003662995_01993	51	262	211	0.941964	0.799242
GCA_014523695_00691	154	378	224	1	0.498886
GCF_000302455_01793	157	373	216	0.964286	0.530713
GCA_001871495_00435	80	255	175	0.78125	0.670498
GCA_003021105_01028	118	273	155	0.691964	0.559567
GCF_004765805_02985	128	286	158	0.705357	0.539249
GCA_002839645_01943	85	270	185	0.825893	0.646853
GCA_902384525_03133	145	295	150	0.669643	0.482315
GCA_011620785_01527	116	277	161	0.71875	0.542088
GCF_001639285_00131	159	375	216	0.964286	0.514286
GCA_001316325_01579	4	159	155	0.691964	0.974843
GCF_004698125_03299	144	292	148	0.660714	0.459627
GCA_903884115_00130	38	255	217	0.96875	0.607843
GCF_000474235_01459	115	278	163	0.727679	0.562069
GCF_002494345_00952	91	281	190	0.848214	0.641892
GCA_003020965_02053	131	279	148	0.660714	0.524823
GCA_003564925_00926	117	316	199	0.888393	0.629747
GCA_002505485_02116	153	309	156	0.696429	0.464286
GCA_013331575_00846	75	290	215	0.959821	0.693548
GCF_000336615_01554	112	273	161	0.71875	0.577061
GCA_003022085_01392	87	279	192	0.857143	0.680851
GCF_004765815_03700	128	278	150	0.669643	0.498339
GCA_007128515_01086	15	177	162	0.723214	0.89011
GCF_008729015_00731	115	273	158	0.705357	0.566308
GCF_000710615_01734	94	275	181	0.808036	0.644128
GCA_001316125_01425	160	344	184	0.821429	0.534884
GCF_000765475_01268	156	326	170	0.758929	0.478873
GCF_900095295_02050	156	372	216	0.964286	0.533333
GCF_002114285_00605	138	296	158	0.705357	0.50641
GCF_900196725_00355	64	284	220	0.982143	0.740741
GCF_003665925_01025	128	278	150	0.669643	0.530035
GCA_011620845_00780	158	367	209	0.933036	0.5225
GCA_000494145_00549	4	187	183	0.816964	0.851163
GCF_900103715_02776	118	273	155	0.691964	0.551601
GCA_011364905_01097	206	372	166	0.741071	0.405868
GCF_000204415_01287	118	277	159	0.709821	0.535354
GCF_003856835_01771	115	272	157	0.700893	0.562724
GCA_013335235_01585	130	320	190	0.848214	0.59375
GCF_900115785_01034	123	278	155	0.691964	0.547703
GCA_011367145_00600	146	361	215	0.959821	0.590659
GCF_005406125_00200	114	273	159	0.709821	0.569892
GCA_001602645_00859	121	281	160	0.714286	0.529801
GCA_009786295_00006	173	334	161	0.71875	0.447222
GCA_000309865_00009	157	374	217	0.96875	0.53317
GCA_007127385_00459	148	318	170	0.758929	0.495627
GCF_005543295_00239	78	272	194	0.866071	0.692857
GCA_003157895_01908	130	270	140	0.625	0.487805
GCA_012799645_00661	13	211	198	0.883929	0.678082
GCA_011358645_00744	43	253	210	0.9375	0.739437
GCF_005239175_00178	88	272	184	0.821429	0.657143
GCF_002252755_00437	127	281	154	0.6875	0.511628
GCA_001412335_00232	123	281	158	0.705357	0.554386
GCF_000739595_03290	129	282	153	0.683036	0.488818
GCF_003670115_03926	130	279	149	0.665179	0.496667
GCA_002011235_00259	108	269	161	0.71875	0.579137
GCF_000739575_01506	135	284	149	0.665179	0.510274
GCA_012518265_00099	194	353	159	0.709821	0.439227
GCF_000336955_00982	122	272	150	0.669643	0.537634
GCA_003021755_00856	4	149	145	0.647321	0.941558
GCF_001571405_01342	142	272	130	0.580357	0.454545
GCF_000470655_00350	56	274	218	0.973214	0.781362
GCF_003382685_01503	127	280	153	0.683036	0.516892
GCA_002494495_00714	157	369	212	0.946429	0.53
GCA_003695045_00753	197	340	143	0.638393	0.420588
GCF_008831545_01269	131	279	148	0.660714	0.494983
GCF_010119195_02391	112	273	161	0.71875	0.581227
GCF_003666015_01205	30	190	160	0.714286	0.751174
GCF_007671725_02026	124	281	157	0.700893	0.514754
GCF_000336895_01112	117	273	156	0.696429	0.55914
GCA_002067275_00609	147	312	165	0.736607	0.45082
GCA_009903905_00444	158	307	149	0.665179	0.485342
GCF_000336675_01760	119	269	150	0.669643	0.541516
GCA_902386205_01500	95	290	195	0.870536	0.652174
GCA_002508705_01170	69	279	210	0.9375	0.734266
GCA_003158115_00713	157	368	211	0.941964	0.520988
GCF_004087835_00099	127	281	154	0.6875	0.522034
GCA_011041895_00220	143	360	217	0.96875	0.592896
GCA_002778455_00113	47	257	210	0.9375	0.410959
GCF_000336695_01583	118	272	154	0.6875	0.548043
GCA_007122455_01696	147	304	157	0.700893	0.50974
GCA_003023535_00631	119	278	159	0.709821	0.565836
GCA_013152685_01001	163	326	163	0.727679	0.480826
GCA_002497075_01294	132	329	197	0.879464	0.544199
GCA_008080745_01166	159	377	218	0.973214	0.527845
GCA_011373045_00577	162	320	158	0.705357	0.48318
GCA_002839545_01504	94	295	201	0.897321	0.672241
GCF_000336715_03198	113	269	156	0.696429	0.561151
GCA_002503885_01472	85	271	186	0.830357	0.65035
GCF_003990725_01072	126	281	155	0.691964	0.521886
GCA_002506905_00910	175	336	161	0.71875	0.442308
GCA_013415695_00136	173	333	160	0.714286	0.463768
GCF_009741825_02483	97	246	149	0.665179	0.598394
GCA_002498385_00795	178	386	208	0.928571	0.494062
GCF_003730195_03613	124	281	157	0.700893	0.525084
GCA_902386255_02623	139	295	156	0.696429	0.514851
GCF_001316045_00442	155	298	143	0.638393	0.478261
GCA_011523285_00288	147	371	224	1	0.480687
GCF_004681185_00804	117	276	159	0.709821	0.565836
GCF_001011115_01597	111	272	161	0.71875	0.579137
GCF_000336935_02346	122	281	159	0.709821	0.538983
GCF_000517625_01619	128	275	147	0.65625	0.486755
GCF_900766745_01654	148	358	210	0.9375	0.537084
GCF_009762275_00935	118	275	157	0.700893	0.558719
GCA_903915225_00212	145	313	168	0.75	0.528302
GCF_900102305_02443	82	272	190	0.848214	0.669014
GCA_002010305_02114	97	261	164	0.732143	0.618868
GCA_007129135_01366	115	272	157	0.700893	0.566787
GCF_013342525_02042	111	273	162	0.723214	0.578571
GCA_003104905_00883	123	289	166	0.741071	0.558923
GCF_002906575_02187	118	280	162	0.723214	0.556701
GCA_014646875_02829	134	284	150	0.669643	0.513699
GCF_007655485_00948	138	288	150	0.669643	0.513699
GCF_009900715_00782	116	269	153	0.683036	0.546429
GCA_011364925_01045	159	384	225	1.00446	0.552826
GCF_002025255_00824	83	279	196	0.875	0.655518
GCF_900095385_00131	79	270	191	0.852679	0.667832
GCA_011333475_01634	172	342	170	0.758929	0.428212
GCA_003554965_01161	139	344	205	0.915179	0.594203
GCF_000755245_00424	89	271	182	0.8125	0.654676
GCA_013331635_00620	144	305	161	0.71875	0.527869
GCF_007004735_03998	114	275	161	0.71875	0.560976
GCF_900111645_01647	149	312	163	0.727679	0.479412
GCA_013138805_00585	135	348	213	0.950893	0.610315
GCA_013202955_00661	119	299	180	0.803571	0.602007
GCA_002496065_01281	2	195	193	0.861607	0.842795
GCA_013331555_01390	119	312	193	0.861607	0.61859
GCA_003023405_01006	137	295	158	0.705357	0.490683
GCF_013402875_02404	124	271	147	0.65625	0.517606
GCF_000025505_02143	36	254	218	0.973214	0.851562
GCA_002779595_00584	55	240	185	0.825893	0.767635
GCA_903923795_00129	45	257	212	0.946429	0.560847
GCF_000336995_01103	126	281	155	0.691964	0.51495
GCA_005878915_00736	135	327	192	0.857143	0.534819
GCA_014647235_00645	121	273	152	0.678571	0.546763
GCF_005239435_04638	134	281	147	0.65625	0.498305
GCF_004116405_03884	85	274	189	0.84375	0.638514
GCA_002067035_02713	71	280	209	0.933036	0.728223
GCA_014237145_00355	143	324	181	0.808036	0.551829
GCA_902627615_00910	56	239	183	0.816964	0.76569
GCA_903825675_00468	164	322	158	0.705357	0.489164
GCA_009784005_00027	276	447	171	0.763393	0.371739
GCA_003020945_00400	131	276	145	0.647321	0.494881
GCA_002498365_00685	179	337	158	0.705357	0.437673
GCF_000008665_02144	77	256	179	0.799107	0.693798
GCF_012726115_01298	115	273	158	0.705357	0.566308
GCF_900108505_01403	82	277	195	0.870536	0.670103
GCA_002254545_00358	206	412	206	0.919643	0.495192
GCF_900102375_02780	136	299	163	0.727679	0.515823
GCA_012797575_00325	77	274	197	0.879464	0.688811
GCA_001871475_01013	62	257	195	0.870536	0.752896
GCA_003021705_00770	84	279	195	0.870536	0.689046
GCF_000336875_00108	29	191	162	0.723214	0.786408
GCA_005878665_00199	167	335	168	0.75	0.47191
GCA_003266145_00437	170	365	195	0.870536	0.474453
GCA_013415665_00420	84	282	198	0.883929	0.692308
GCA_003023485_00819	3	144	141	0.629464	0.959184
GCF_001485575_03313	116	273	157	0.700893	0.562724
GCA_003023465_00339	135	291	156	0.696429	0.495238
GCF_003665935_00596	117	277	160	0.714286	0.567376
GCA_012798365_02022	132	272	140	0.625	0.469799
GCF_000336635_02218	113	273	160	0.714286	0.571429
GCF_009911715_00251	180	336	156	0.696429	0.430939
GCA_003345555_00459	146	365	219	0.977679	0.539409
GCF_013401515_00912	127	275	148	0.660714	0.515679
GCA_011333375_01249	62	258	196	0.875	0.75969
GCA_007133925_00707	146	315	169	0.754464	0.529781
GCF_001017125_00349	77	275	198	0.883929	0.692308
GCF_002844335_01496	114	273	159	0.709821	0.567857
GCA_003661905_01146	161	310	149	0.665179	0.480645
GCF_000296615_00599	141	300	159	0.709821	0.476048
GCA_009777615_00171	175	337	162	0.723214	0.45
GCA_000415985_01130	125	278	153	0.683036	0.536842
GCA_003650935_00054	73	294	221	0.986607	0.744108
GCF_002153915_00154	97	301	204	0.910714	0.671053
GCA_005878485_00414	168	331	163	0.727679	0.457865
GCA_002067315_00442	125	276	151	0.674107	0.524306
GCF_013391085_00399	87	277	190	0.848214	0.678571
GCA_003022745_00902	128	275	147	0.65625	0.528777
GCA_002506745_00573	106	295	189	0.84375	0.638514
GCA_014647475_01098	73	275	202	0.901786	0.701389
GCF_007671685_00583	127	283	156	0.696429	0.5
GCF_002844195_03400	123	273	150	0.669643	0.46875
GCA_003021235_02792	119	279	160	0.714286	0.553633
GCA_002508425_01504	148	314	166	0.741071	0.453552
GCF_000495475_00817	106	251	145	0.647321	0.519713
GCA_002508425_02172	148	314	166	0.741071	0.453552
GCA_903832205_01082	82	251	169	0.754464	0.310092
GCF_003344565_04320	115	272	157	0.700893	0.552817
GCF_000337375_00881	127	283	156	0.696429	0.501608
GCA_002067565_01606	158	368	210	0.9375	0.523691
GCF_900107665_01952	107	270	163	0.727679	0.59058
GCF_002355635_00485	79	277	198	0.883929	0.6875
GCA_002501765_00900	114	276	162	0.723214	0.582734
GCA_003558085_01856	145	354	209	0.933036	0.55291
GCA_003551945_01374	126	277	151	0.674107	0.539286
GCA_003251955_01733	122	284	162	0.723214	0.545455
GCA_005878415_00171	129	326	197	0.879464	0.553371
GCA_001784635_00413	138	343	205	0.915179	0.592486
GCF_000337355_03416	126	281	155	0.691964	0.509868
GCA_011605725_00716	173	329	156	0.696429	0.468468
GCA_902385025_00302	115	284	169	0.754464	0.590909
GCF_001280425_00433	113	273	160	0.714286	0.571429
GCF_000021965_02712	114	282	168	0.75	0.585366
GCA_005878525_00672	166	327	161	0.71875	0.452247
GCA_002502245_02064	135	273	138	0.616071	0.474227
GCF_000023945_00410	79	274	195	0.870536	0.698925
GCA_011334955_00308	43	262	219	0.977679	0.835878
GCF_013839515_02277	88	277	189	0.84375	0.675
GCA_002509405_01149	179	337	158	0.705357	0.437673
GCF_900880625_00147	122	275	153	0.683036	0.544484
GCF_013415885_03559	117	274	157	0.700893	0.532203
GCA_003266105_00673	170	369	199	0.888393	0.480676
GCA_003022685_02404	85	273	188	0.839286	0.635135
GCF_000223905_01495	115	273	158	0.705357	0.566308
GCF_000337455_02233	115	277	162	0.723214	0.541806
GCA_002505805_01103	117	268	151	0.674107	0.526132
GCF_000337335_01942	145	300	155	0.691964	0.476923
GCF_000744455_02296	157	370	213	0.950893	0.525926
GCA_002494885_01216	146	356	210	0.9375	0.537084
GCA_013331015_00925	75	271	196	0.875	0.682927
GCF_003342675_02073	117	274	157	0.700893	0.558719
GCA_011362635_00343	148	336	188	0.839286	0.531073
GCF_003697815_02104	85	280	195	0.870536	0.681818
GCF_000746205_00120	85	274	189	0.84375	0.627907
GCF_004765795_00678	134	282	148	0.660714	0.513889
GCA_902764015_00898	136	353	217	0.96875	0.563636
GCA_003021045_00153	129	294	165	0.736607	0.494012
GCA_013425325_00970	88	263	175	0.78125	0.660377
GCA_003022865_01446	84	273	189	0.84375	0.670213
GCA_001595885_00256	129	332	203	0.90625	0.586705
GCA_012729095_00042	140	329	189	0.84375	0.522099
GCF_004799665_03189	122	277	155	0.691964	0.547703
GCA_002506425_01309	174	339	165	0.736607	0.453297
GCA_003345545_02107	158	375	217	0.96875	0.511792
GCF_900129775_02768	135	279	144	0.642857	0.484848
GCA_003021725_00103	130	280	150	0.669643	0.530035
GCF_002813695_01562	158	371	213	0.950893	0.529851
GCA_003565715_00135	169	336	167	0.745536	0.452575
GCF_003149675_00750	204	358	154	0.6875	0.378378
GCA_003561665_00009	148	336	188	0.839286	0.532578
GCA_003141335_00291	127	269	142	0.633929	0.494774
GCF_001315925_03449	8	198	190	0.848214	0.935961
GCA_001564115_00606	73	269	196	0.875	0.595745
GCF_003336245_00099	123	274	151	0.674107	0.537367
GCF_003369835_01621	130	279	149	0.665179	0.495017
GCA_001940805_01053	116	267	151	0.674107	0.517123
GCA_003020925_01404	129	277	148	0.660714	0.524823
GCA_003560545_00166	15	236	221	0.986607	0.928571
GCA_002502735_00124	134	286	152	0.678571	0.508361
GCA_003162615_02386	126	274	148	0.660714	0.510345
GCF_900113245_01922	116	279	163	0.727679	0.573944
GCA_013329565_00469	130	329	199	0.888393	0.549724
GCA_012798025_01457	92	246	154	0.6875	0.551971
GCA_003021285_00064	120	278	158	0.705357	0.562278
GCA_002504725_00253	158	366	208	0.928571	0.512315
GCF_010119205_00666	117	276	159	0.709821	0.565836
GCA_002839605_00140	81	271	190	0.848214	0.662021
GCF_000800805_01085	169	334	165	0.736607	0.458333
GCA_009377575_03350	154	378	224	1	0.503371
GCA_011335015_01005	42	255	213	0.950893	0.825581
GCA_011773475_00827	165	307	142	0.633929	0.458065
GCA_902795935_00588	155	367	212	0.946429	0.520885
GCA_002067755_01096	94	247	153	0.683036	0.548387
GCA_002067895_00173	141	271	130	0.580357	0.454545
GCA_003649915_00791	143	305	162	0.723214	0.529412
GCF_001639265_01332	193	401	208	0.928571	0.462222
GCA_013331965_00870	71	245	174	0.776786	0.701613
GCA_004377185_02215	145	331	186	0.830357	0.536023
GCF_009831625_01229	134	280	146	0.651786	0.498294
GCF_009914725_01736	67	274	207	0.924107	0.726316
GCA_013331375_01484	35	184	149	0.665179	0.792553
GCA_007116915_00664	172	330	158	0.705357	0.44507
GCA_003557905_00408	174	329	155	0.691964	0.43662
GCF_002355655_00364	141	302	161	0.71875	0.509494
GCA_003345595_00222	159	378	219	0.977679	0.523923
GCA_003021685_00012	111	272	161	0.71875	0.577061
GCA_002900555_01857	101	294	193	0.861607	0.652027
GCA_001896725_01549	149	314	165	0.736607	0.45082
GCA_002503705_00852	59	249	190	0.848214	0.756972
GCA_003555025_01400	186	343	157	0.700893	0.431319
GCA_002501775_00023	61	267	206	0.919643	0.733096
GCA_002068885_00835	42	209	167	0.745536	0.488304
GCF_000196655_02204	143	315	172	0.767857	0.525994
GCA_002825465_02378	158	376	218	0.973214	0.522782
GCA_002825535_00126	158	376	218	0.973214	0.522782
GCA_003022925_02832	125	280	155	0.691964	0.547703
GCF_011440375_00257	111	272	161	0.71875	0.553265
GCA_013202845_00176	62	244	182	0.8125	0.745902
GCF_001282785_01970	82	277	195	0.870536	0.677083
GCF_004015825_00462	119	279	160	0.714286	0.567376
GCA_902386385_00176	49	268	219	0.977679	0.771127
GCA_011358535_00225	72	271	199	0.888393	0.713262
GCA_003724275_00596	149	322	173	0.772321	0.537267
GCA_014189685_00304	160	342	182	0.8125	0.50838
GCF_013388255_02489	158	319	161	0.71875	0.468023
GCF_000025285_00699	42	261	219	0.977679	0.829545
GCA_002497965_01174	141	275	134	0.598214	0.466899
GCA_013415595_01910	112	263	151	0.674107	0.539286
GCA_011046235_01418	140	331	191	0.852679	0.541076
GCF_000304355_01665	134	269	135	0.602679	0.472028
GCF_000427685_01683	117	275	158	0.705357	0.562278
GCA_013329165_01808	138	271	133	0.59375	0.461806
GCA_001563325_00123	199	420	221	0.986607	0.488938
GCA_002501655_00814	85	276	191	0.852679	0.667832
GCF_004745425_01300	154	314	160	0.714286	0.461095
GCA_009778575_01136	161	333	172	0.767857	0.477778
GCA_902774685_01111	157	367	210	0.9375	0.512195
GCF_000828575_01121	150	351	201	0.897321	0.543243
GCF_000025685_01656	120	271	151	0.674107	0.539286
GCF_000008645_01189	150	350	200	0.892857	0.540541
GCA_013425335_00608	42	255	213	0.950893	0.828794
GCA_004524425_00293	159	380	221	0.986607	0.549751
GCA_002687795_00742	43	246	203	0.90625	0.825203
GCA_001564205_01137	129	284	155	0.691964	0.516667
GCF_900100875_01762	120	277	157	0.700893	0.556738
GCF_013377755_00982	137	265	128	0.571429	0.455516
GCA_002503825_01552	133	282	149	0.665179	0.522807
GCA_001512375_02054	139	279	140	0.625	0.48951
GCA_013152845_01159	145	297	152	0.678571	0.462006
GCF_000275865_00423	138	265	127	0.566964	0.451957
GCF_000337835_01435	120	271	151	0.674107	0.539286
GCA_001595785_00146	63	244	181	0.808036	0.741803
GCA_002763265_00956	88	299	211	0.941964	0.687296
GCA_002496395_00681	134	271	137	0.611607	0.475694
GCA_003023195_00510	161	312	151	0.674107	0.420613
GCF_001462205_03096	80	269	189	0.84375	0.658537
GCA_002506585_00595	70	269	199	0.888393	0.695804
GCA_902769175_01443	157	366	209	0.933036	0.513514
GCA_014189675_00584	158	318	160	0.714286	0.498442
GCA_002505345_00215	178	337	159	0.709821	0.440443
GCA_005879045_01396	169	335	166	0.741071	0.466292
GCA_003650585_00649	158	323	165	0.736607	0.510836
GCA_003838065_01125	137	278	141	0.629464	0.486207
GCA_013204355_01076	111	307	196	0.875	0.634304
GCA_003170075_01420	144	286	142	0.633929	0.47651
GCA_002496355_00150	112	298	186	0.830357	0.615894
GCA_007117735_00348	83	258	175	0.78125	0.675676
GCA_903907555_00857	108	318	210	0.9375	0.660377
GCA_012521035_01865	83	270	187	0.834821	0.653846
GCA_006954465_01244	1	118	117	0.522321	0.818182
GCA_013331695_00247	78	319	241	1.07589	0.748447
GCA_902784195_00822	156	366	210	0.9375	0.513447
GCA_011605865_00606	76	254	178	0.794643	0.695312
GCA_002498845_00754	110	267	157	0.700893	0.588015
GCA_004347825_00592	78	254	176	0.785714	0.6875
GCF_000337035_01704	134	298	164	0.732143	0.522293
GCA_003021785_02146	106	273	167	0.745536	0.577855
GCA_013331315_00325	161	321	160	0.714286	0.422164
GCA_002495465_00319	158	318	160	0.714286	0.498442
GCA_001564285_01829	125	266	141	0.629464	0.51087
GCA_000496215_02363	118	274	156	0.696429	0.528814
GCA_001871535_00157	43	253	210	0.9375	0.813953
GCA_011045995_00899	92	282	190	0.848214	0.662021
GCF_000145295_01552	150	354	204	0.910714	0.552846
GCA_003162175_01635	81	283	202	0.901786	0.684746
GCA_003554115_00184	94	277	183	0.816964	0.633218
GCA_003139855_01143	115	287	172	0.767857	0.571429
GCA_002839705_00322	157	366	209	0.933036	0.521197
GCA_009649835_01667	140	324	184	0.821429	0.560976
GCA_903858385_00710	36	275	239	1.06696	0.707101
GCA_003552325_01046	124	266	142	0.633929	0.522059
GCA_000416085_00908	1	116	115	0.513393	0.966387
GCF_001469875_00378	120	271	151	0.674107	0.539286
GCA_001412355_00397	91	286	195	0.870536	0.665529
GCA_001563335_00757	155	369	214	0.955357	0.52451
GCA_012329085_00336	135	282	147	0.65625	0.517606
GCA_903930505_00210	85	292	207	0.924107	0.694631
GCA_005878615_01830	154	331	177	0.790179	0.497191
GCA_007119345_02010	88	277	189	0.84375	0.627907
GCA_902531985_00477	110	233	123	0.549107	0.527897
GCA_011048195_00987	42	254	212	0.946429	0.831373
GCA_002792915_00490	111	299	188	0.839286	0.616393
GCA_011333755_00247	171	337	166	0.741071	0.492582
GCA_002498065_01138	82	275	193	0.861607	0.672474
GCA_002499905_01017	141	289	148	0.660714	0.505119
GCF_000306765_01776	118	269	151	0.674107	0.541219
GCA_001595945_01317	110	295	185	0.825893	0.622896
GCA_002825515_00225	103	204	101	0.450893	0.247549
GCA_002825515_00225	155	373	218	0.973214	0.534314
GCA_003021005_00988	141	285	144	0.642857	0.5
GCF_000385565_00229	51	263	212	0.946429	0.80303
GCA_001800825_00766	170	329	159	0.709821	0.451705
GCA_002256595_00940	119	269	150	0.669643	0.519031
GCA_004553595_01250	156	366	210	0.9375	0.513447
GCA_002503135_01102	160	293	133	0.59375	0.443333
GCF_005049285_00765	128	271	143	0.638393	0.512545
GCF_001886955_00563	124	269	145	0.647321	0.525362
GCA_004525545_00985	133	329	196	0.875	0.539945
GCA_011363915_01074	179	330	151	0.674107	0.452096
GCA_011391755_01294	119	278	159	0.709821	0.552083
GCA_003695265_00233	119	300	181	0.808036	0.601329
GCA_002762785_00570	131	287	156	0.696429	0.543554
GCF_004114375_01304	137	294	157	0.700893	0.498413
GCA_903892905_00828	44	258	214	0.955357	0.775362
GCA_002503105_01723	138	276	138	0.616071	0.475862
GCA_002504405_00246	179	335	156	0.696429	0.432133
GCF_001602375_02443	70	275	205	0.915179	0.716783
GCF_000337075_02691	136	295	159	0.709821	0.496875
GCA_013329855_01253	167	331	164	0.732143	0.464589
GCF_900113615_01189	126	276	150	0.669643	0.517241
GCA_003651045_01208	105	291	186	0.830357	0.628378
GCA_002508495_00820	70	273	203	0.90625	0.707317
GCA_002686295_00126	41	244	203	0.90625	0.831967
GCF_900111935_00008	129	286	157	0.700893	0.503205
GCA_002779235_00383	146	319	173	0.772321	0.54232
GCF_000337415_01096	136	293	157	0.700893	0.495268
GCA_003158275_02104	77	287	210	0.9375	0.697674
GCF_000337795_03209	120	272	152	0.678571	0.542857
GCA_902386085_01402	84	303	219	0.977679	0.713355
GCF_902158735_01504	129	276	147	0.65625	0.519435
GCA_003315675_00859	40	270	230	1.02679	0.830325
GCA_000235685_01436	146	292	146	0.651786	0.489933
GCA_002010195_01780	57	265	208	0.928571	0.779026
GCA_003942085_01246	106	293	187	0.834821	0.631757
GCA_002762705_00006	133	322	189	0.84375	0.586957
GCF_001368915_01294	120	271	151	0.674107	0.539286
GCA_014384455_00759	61	244	183	0.816964	0.75
GCF_001280455_03494	118	277	159	0.709821	0.53
GCA_004524545_00287	160	380	220	0.982143	0.514019
GCA_000306725_01807	127	294	167	0.745536	0.510703
GCF_000336815_01718	119	269	150	0.669643	0.535714
GCF_000336775_02909	120	268	148	0.660714	0.528571
GCA_902552015_00606	149	313	164	0.732143	0.523962
GCA_902385225_00138	19	209	190	0.848214	0.574018
GCA_002506335_00562	80	281	201	0.897321	0.636076
GCA_002494625_00260	91	265	174	0.776786	0.651685
GCA_001563795_01380	68	276	208	0.928571	0.714777
GCA_902533295_00130	87	240	153	0.683036	0.6375
GCA_003136075_00043	132	270	138	0.616071	0.469388
GCF_009742825_00491	53	208	155	0.691964	0.65678
GCA_002011215_01622	58	267	209	0.933036	0.782772
GCA_005878325_00691	170	321	151	0.674107	0.466049
GCF_005435165_01924	117	278	161	0.71875	0.531353
GCA_003021655_01396	129	284	155	0.691964	0.534483
GCA_007129655_00935	170	335	165	0.736607	0.492537
GCF_000015765_01703	58	288	230	1.02679	0.779661
GCF_000691865_01928	70	270	200	0.892857	0.699301
GCA_013331805_00386	50	258	208	0.928571	0.779026
GCF_001542905_01380	127	274	147	0.65625	0.5
GCA_002839575_00377	77	270	193	0.861607	0.674825
GCA_902386555_00809	63	277	214	0.955357	0.683706
GCF_004102725_01144	139	280	141	0.629464	0.494737
GCA_001800745_00422	167	328	161	0.71875	0.452247
GCA_011363025_00304	135	327	192	0.857143	0.583587
GCA_011362045_00345	176	329	153	0.683036	0.458084
GCA_005879015_01514	165	314	149	0.665179	0.419718
GCA_002792115_00579	111	290	179	0.799107	0.617241
GCA_003170935_01283	93	285	192	0.857143	0.650847
GCF_000015825_00533	70	275	205	0.915179	0.716783
GCF_902763685_00062	156	316	160	0.714286	0.467836
GCF_002072215_00804	217	388	171	0.763393	0.395833
GCA_003838185_00276	141	276	135	0.602679	0.467128
GCA_903893865_00371	55	260	205	0.915179	0.50995
GCA_001871415_00578	167	318	151	0.674107	0.464615
GCF_009898475_00245	1	122	121	0.540179	0.742331
GCF_000196895_01575	106	270	164	0.732143	0.594203
GCF_000214725_02146	160	369	209	0.933036	0.514778
GCA_005879065_00427	166	314	148	0.660714	0.41573
GCA_002687935_00519	164	318	154	0.6875	0.479751
GCF_006861665_02380	111	272	161	0.71875	0.547619
GCF_900182635_02441	116	274	158	0.705357	0.542955
GCF_000337815_00053	116	269	153	0.683036	0.548387
GCA_005878995_00200	169	328	159	0.709821	0.446629
GCA_002687775_00278	101	302	201	0.897321	0.663366
GCA_013331535_00759	65	281	216	0.964286	0.701299
GCA_902529885_00267	97	257	160	0.714286	0.622568
GCA_002506085_01384	42	273	231	1.03125	0.833935
GCF_000513315_00969	180	381	201	0.897321	0.480861
GCA_003600755_01679	158	365	207	0.924107	0.5175
GCF_900114435_01148	113	270	157	0.700893	0.560714
GCF_009674625_00167	119	269	150	0.669643	0.537634
GCF_003287355_00419	130	274	144	0.642857	0.473684
GCA_003695435_00548	62	239	177	0.790179	0.740586
GCA_005878375_01752	166	327	161	0.71875	0.457386
GCA_013166835_02727	155	379	224	1	0.550369
GCA_003560875_00270	176	331	155	0.691964	0.434174
GCA_903828975_00129	142	269	127	0.566964	0.445614
GCA_903851445_01118	44	259	215	0.959821	0.523114
GCF_009674585_01971	119	269	150	0.669643	0.537634
GCF_000166095_01169	110	351	241	1.07589	0.671309
GCF_000017625_00525	141	269	128	0.571429	0.442907
GCA_001563305_00184	176	335	159	0.709821	0.441667
GCF_003697845_02572	132	274	142	0.633929	0.464052
GCF_000024185_02009	180	392	212	0.946429	0.491879
GCA_002067795_00189	133	291	158	0.705357	0.511327
GCA_903930485_01027	144	353	209	0.933036	0.534527
GCF_001402945_00045	13	165	152	0.678571	0.91018
GCA_002499455_01716	85	281	196	0.875	0.685315
GCA_003649845_01517	99	288	189	0.84375	0.638514
GCF_001482285_01891	120	269	149	0.665179	0.532143
GCA_002010045_00494	101	257	156	0.696429	0.602317
GCF_003605575_02287	81	274	193	0.861607	0.652027
GCA_002083985_00639	151	365	214	0.955357	0.579946
GCF_000328525_01401	113	274	161	0.71875	0.559028
GCA_002254565_01243	146	355	209	0.933036	0.587079
GCA_012719315_01044	2	156	154	0.6875	0.810526
GCA_002254885_00585	92	294	202	0.901786	0.662295
GCA_007118975_00462	119	277	158	0.705357	0.566308
GCA_003020985_01180	131	276	145	0.647321	0.489865
GCA_002509745_01907	156	366	210	0.9375	0.523691
GCA_003162655_01611	1	145	144	0.642857	0.857143
GCA_003009755_00100	168	338	170	0.758929	0.485714
GCF_000350305_00237	178	338	160	0.714286	0.443213
GCA_013425455_00846	95	306	211	0.941964	0.649231
GCA_902386535_01031	44	258	214	0.955357	0.660494
GCA_007131205_00658	22	246	224	1	0.906883
GCF_001639295_00140	186	391	205	0.915179	0.44086
GCF_000224475_01792	80	278	198	0.883929	0.678082
GCF_006861655_02240	87	273	186	0.830357	0.628378
GCA_903877165_00743	134	294	160	0.714286	0.536913
GCA_012520845_01304	176	332	156	0.696429	0.441926
GCA_001564275_01740	76	267	191	0.852679	0.638796
GCA_902385045_00089	87	247	160	0.714286	0.632411
GCA_013331515_01022	161	348	187	0.834821	0.537356
GCA_903842985_00727	55	233	178	0.794643	0.757447
GCA_903904885_00336	149	325	176	0.785714	0.538226
GCF_000337515_00303	78	273	195	0.870536	0.677083
GCA_003694965_00388	72	256	184	0.821429	0.650177
GCA_002762845_00136	125	284	159	0.709821	0.559859
GCA_013426015_00675	43	256	213	0.950893	0.825581
GCF_003058365_00820	76	270	194	0.866071	0.705455
GCF_009674605_02427	120	269	149	0.665179	0.53405
GCA_003694385_00897	4	213	209	0.933036	0.958716
GCA_013329045_01457	136	303	167	0.745536	0.540453
GCA_002762865_00866	111	339	228	1.01786	0.670588
GCA_003660925_00358	130	274	144	0.642857	0.523636
GCA_014523665_01600	3	148	145	0.647321	0.690476
GCA_002688925_00049	181	317	136	0.607143	0.427673
GCA_903819595_02111	142	268	126	0.5625	0.442105
GCA_014240055_00041	49	243	194	0.866071	0.798354
GCA_002789635_00886	134	330	196	0.875	0.576471
GCF_002252985_00743	128	274	146	0.651786	0.503448
GCA_003021175_00934	125	272	147	0.65625	0.523132
GCA_002504495_01434	175	337	162	0.723214	0.445055
GCA_002506175_00041	176	338	162	0.723214	0.45
GCA_002687355_00859	48	233	185	0.825893	0.764463
GCF_900109065_03192	121	274	153	0.683036	0.533101
GCA_003650545_00741	59	231	172	0.767857	0.744589
GCF_900114585_00967	156	370	214	0.955357	0.52451
GCF_001469865_00253	121	269	148	0.660714	0.530466
GCF_000784355_02099	123	284	161	0.71875	0.553265
GCA_002067095_00352	132	271	139	0.620536	0.486014
GCF_000147875_00396	124	284	160	0.714286	0.549828
GCA_009776695_00250	144	309	165	0.736607	0.488166
GCA_902385515_00296	47	263	216	0.964286	0.436364
GCA_903828955_00539	84	252	168	0.75	0.624535
GCA_013203345_01555	128	317	189	0.84375	0.59434
GCA_013375475_00644	160	382	222	0.991071	0.545455
GCA_002688265_00521	91	317	226	1.00893	0.712934
GCF_000300255_00225	177	335	158	0.705357	0.431694
GCA_002688775_00210	124	314	190	0.848214	0.603175
GCA_002505945_01055	172	329	157	0.700893	0.471471
GCA_013330215_00057	40	257	217	0.96875	0.702265
GCA_003857025_02350	75	280	205	0.915179	0.702055
GCA_002498375_01239	42	274	232	1.03571	0.837545
GCF_000711905_01567	118	276	158	0.705357	0.568345
GCA_009758405_00043	95	272	177	0.790179	0.638989
GCA_903920925_00750	73	302	229	1.02232	0.736334
GCF_002287215_01644	65	274	209	0.933036	0.754513
GCA_013415575_00450	119	280	161	0.71875	0.566901
GCF_005239135_00628	121	272	151	0.674107	0.545126
GCA_009778265_00243	176	333	157	0.700893	0.436111
GCF_001950595_00238	123	272	149	0.665179	0.526502
GCA_002171315_01227	176	324	148	0.660714	0.441791
GCA_004524435_00249	200	376	176	0.785714	0.431373
GCA_002498455_00372	174	319	145	0.647321	0.443425
GCA_003023185_00549	118	272	154	0.6875	0.548043
GCF_007421925_00702	77	275	198	0.883929	0.678082
GCA_005878385_00168	166	319	153	0.683036	0.429775
GCA_902384685_01153	106	295	189	0.84375	0.636364
GCA_002731655_00789	55	233	178	0.794643	0.706349
GCA_903921825_01316	49	256	207	0.924107	0.638889
GCA_002762985_00327	184	350	166	0.741071	0.468927
GCA_003649715_00810	80	289	209	0.933036	0.703704
GCA_013425405_00358	44	255	211	0.941964	0.821012
GCA_002509495_00697	110	272	162	0.723214	0.566434
GCA_002067485_01475	127	272	145	0.647321	0.506993
GCA_002699515_00712	146	329	183	0.816964	0.546269
GCA_903900025_00210	129	268	139	0.620536	0.487719
GCF_009184545_02526	123	272	149	0.665179	0.526502
GCA_012516785_00756	135	287	152	0.678571	0.513514
GCA_006954405_00015	174	333	159	0.709821	0.446629
GCA_007118075_00378	78	271	193	0.861607	0.694245
GCA_900321995_00828	159	371	212	0.946429	0.512077
GCA_002495325_00213	172	336	164	0.732143	0.44086
GCA_002507425_00024	170	320	150	0.669643	0.447761
GCA_002722615_00661	163	326	163	0.727679	0.486567
GCA_012515075_00880	183	333	150	0.669643	0.403226
GCA_013425425_00310	62	274	212	0.946429	0.749117
GCF_001481295_01048	181	339	158	0.705357	0.429348
GCA_002501965_00182	131	271	140	0.625	0.48951
GCA_002496635_00848	178	323	145	0.647321	0.432836
GCA_002692465_00228	181	329	148	0.660714	0.441791
GCA_002506485_00660	52	247	195	0.870536	0.789474
GCA_002720095_00172	178	329	151	0.674107	0.450746
GCA_001421175_00544	167	321	154	0.6875	0.420765
GCA_012728895_02158	147	275	128	0.571429	0.449123
GCA_013178225_00180	120	279	159	0.709821	0.555944
GCA_011368255_00167	117	274	157	0.700893	0.572993
GCA_002498605_01062	179	337	158	0.705357	0.44507
GCA_013290045_01356	179	310	131	0.584821	0.370056
GCA_002506105_02141	125	280	155	0.691964	0.541958
GCA_012522645_01431	134	332	198	0.883929	0.543956
GCA_003602665_00017	178	325	147	0.65625	0.438806
GCA_009776625_00516	177	333	156	0.696429	0.433333
GCA_003561825_00489	177	335	158	0.705357	0.471642
GCA_013152815_00398	152	302	150	0.669643	0.412088
GCF_001560915_01620	178	337	159	0.709821	0.432065
GCA_900314635_00669	155	367	212	0.946429	0.517073
GCA_002503545_00557	178	331	153	0.683036	0.418033
GCA_009780575_00320	143	332	189	0.84375	0.532394
GCA_003315655_02066	4	146	142	0.633929	0.788889
GCA_013415565_00347	121	280	159	0.709821	0.559859
GCA_002502045_00491	53	245	192	0.857143	0.774194
GCA_009887135_00453	178	325	147	0.65625	0.438806
GCA_001629205_01161	140	329	189	0.84375	0.565868
GCF_000243255_00939	123	283	160	0.714286	0.531561
GCF_000691505_00298	121	246	125	0.558036	0.469925
GCA_002727515_00920	164	320	156	0.696429	0.465672
GCA_002731395_01106	193	338	145	0.647321	0.4039
GCA_002686525_00125	140	328	188	0.839286	0.564565
GCA_013425375_00080	67	279	212	0.946429	0.713805
GCA_007116295_00287	16	234	218	0.973214	0.92766
GCA_005239845_01246	41	256	215	0.959821	0.698052
GCA_902384795_00181	24	247	223	0.995536	0.888446
GCA_001873845_00099	165	378	213	0.950893	0.556136
GCA_002696315_00221	178	325	147	0.65625	0.438806
GCA_003650935_00531	110	295	185	0.825893	0.620805
GCA_003695745_00716	153	295	142	0.633929	0.440994
GCA_011362975_00385	44	255	211	0.941964	0.817829
GCA_903835325_00511	40	251	211	0.941964	0.764493
GCA_002683155_00136	188	343	155	0.691964	0.445402
GCA_001889985_00127	48	264	216	0.964286	0.722408
GCA_002457155_00674	144	328	184	0.821429	0.552553
GCA_013330925_00130	174	312	138	0.616071	0.413174
GCA_002719615_00973	127	328	201	0.897321	0.601796
GCA_002504905_00893	131	328	197	0.879464	0.591592
GCA_005878955_00084	135	326	191	0.852679	0.536517
GCA_002710015_00717	152	322	170	0.758929	0.507463
GCA_013415575_00024	140	289	149	0.665179	0.508532
GCA_011055585_01232	148	281	133	0.59375	0.47331
GCA_902573015_00401	174	327	153	0.683036	0.458084
GCF_003173355_00478	144	292	148	0.660714	0.498316
GCA_903835385_00277	47	256	209	0.933036	0.776952
GCA_002505355_01437	180	326	146	0.651786	0.433234
GCA_903871465_02003	130	278	148	0.660714	0.517483
GCA_009779205_00040	118	255	137	0.611607	0.501832
GCA_002724815_00953	179	325	146	0.651786	0.438438
GCF_003605635_02042	314	466	152	0.678571	0.316667
GCA_001595915_01169	94	293	199	0.888393	0.674576
GCA_002509165_00973	73	209	136	0.607143	0.618182
GCA_002502965_00869	164	329	165	0.736607	0.45082
GCA_001628485_00376	170	327	157	0.700893	0.47006
GCA_902625325_00916	169	327	158	0.705357	0.473054
GCF_000711215_00199	110	311	201	0.897321	0.550685
GCA_002506255_00859	168	321	153	0.683036	0.418033
GCA_014240255_00898	63	243	180	0.803571	0.740741
GCA_003559395_00057	69	249	180	0.803571	0.705882
GCA_002900535_01626	138	293	155	0.691964	0.521886
GCA_013331615_00588	123	352	229	1.02232	0.650568
GCA_013330315_01568	1	109	108	0.482143	0.818182
GCA_011364155_00776	1	123	122	0.544643	0.865248
GCA_001629235_00524	203	356	153	0.683036	0.421488
GCA_002068435_02348	135	287	152	0.678571	0.513514
GCA_002496485_00281	146	327	181	0.808036	0.541916
GCA_002503985_01446	176	293	117	0.522321	0.381107
GCF_902787415_01298	179	337	158	0.705357	0.429348
GCA_013331125_01451	129	249	120	0.535714	0.481928
GCA_002067155_01955	133	271	138	0.616071	0.482517
GCA_002718915_00450	18	236	218	0.973214	0.923729
GCA_001875345_00178	25	235	210	0.9375	0.893617
GCA_014384375_00307	59	244	185	0.825893	0.758197
GCA_002496845_00390	172	313	141	0.629464	0.422156
GCA_011334705_01398	22	176	154	0.6875	0.846154
GCA_002694585_00749	197	334	137	0.611607	0.381616
GCA_003602635_00451	172	313	141	0.629464	0.422156
GCA_002506025_00582	151	315	164	0.732143	0.503067
GCA_013138765_00996	137	347	210	0.9375	0.603448
GCA_001629255_00079	176	327	151	0.674107	0.452096
GCA_001940725_00809	143	361	218	0.973214	0.556122
GCA_002730445_00387	137	327	190	0.848214	0.570571
GCA_013329865_00754	160	327	167	0.745536	0.494083
GCA_004332335_00290	151	271	120	0.535714	0.421053
GCA_002204705_00453	43	200	157	0.700893	0.765854
GCA_002172185_00233	167	329	162	0.723214	0.486486
GCA_009784745_01051	171	335	164	0.732143	0.459384
GCA_002721085_00619	177	326	149	0.665179	0.442136
GCA_014239955_00582	171	328	157	0.700893	0.471471
GCA_011526375_01242	161	325	164	0.732143	0.486647
GCA_002697065_00682	134	315	181	0.808036	0.562112
GCA_002723045_00332	173	328	155	0.691964	0.465465
GCA_002712575_01288	127	329	202	0.901786	0.60479
GCA_002719815_00588	157	331	174	0.776786	0.519403
GCA_013330015_00565	7	148	141	0.629464	0.927632
GCA_002689565_01505	176	316	140	0.625	0.41791
GCA_002495945_00072	178	326	148	0.660714	0.439169
GCA_002503045_01305	170	316	146	0.651786	0.438438
GCA_013044425_00333	59	219	160	0.714286	0.689655
GCA_002715725_01712	175	317	142	0.633929	0.423881
GCA_002496955_01250	204	336	132	0.589286	0.380403
GCA_002878135_00687	134	275	141	0.629464	0.505376
GCA_002502135_00709	57	252	195	0.870536	0.696429
GCA_012729995_00293	138	290	152	0.678571	0.515254
GCA_002505685_00339	131	315	184	0.821429	0.566154
GCA_011367245_01146	42	251	209	0.933036	0.822835
GCA_012520015_01886	2	119	117	0.522321	0.95122
GCA_013153395_00508	79	225	146	0.651786	0.632035
GCA_002503205_00491	120	261	141	0.629464	0.5
GCA_009780795_00967	172	331	159	0.709821	0.446629
GCA_013331595_00533	97	249	152	0.678571	0.361045
GCA_002495675_00558	146	354	208	0.928571	0.579387
GCA_903891505_00258	29	253	224	1	0.88189
GCA_902605365_00424	176	318	142	0.633929	0.423881
GCA_004212075_01278	91	297	206	0.919643	0.693603
GCA_002923215_00547	137	287	150	0.669643	0.46875
GCA_902563095_01037	174	317	143	0.638393	0.426866
GCA_002710205_00452	177	316	139	0.620536	0.414925
GCA_002706065_00336	186	346	160	0.714286	0.457143
GCA_002731655_00521	79	209	130	0.580357	0.585586
GCA_011364265_00781	1	113	112	0.5	0.772414
GCA_002010075_00417	59	252	193	0.861607	0.765873
GCF_000195915_01305	48	190	142	0.633929	0.747368
GCA_003602515_00957	177	328	151	0.674107	0.453453
GCA_014361165_00663	26	239	213	0.950893	0.880165
GCA_012270265_00643	149	331	182	0.8125	0.543284
GCA_001875365_00566	24	236	212	0.946429	0.898305
GCA_003602595_00186	124	328	204	0.910714	0.610778
GCA_002506755_01038	171	327	156	0.696429	0.46988
GCA_002724775_00220	62	236	174	0.776786	0.737288
GCA_002702945_00547	180	324	144	0.642857	0.4273
GCA_002497245_00825	157	346	189	0.84375	0.538462
GCA_002503665_00213	171	307	136	0.607143	0.408408
GCA_002506875_00474	133	312	179	0.799107	0.537538
GCA_002713585_00483	173	309	136	0.607143	0.408408
GCA_002497905_01260	167	315	148	0.660714	0.444444
GCA_013044425_01316	185	317	132	0.589286	0.382609
GCA_002503985_00504	194	327	133	0.59375	0.364384
GCA_002718695_00950	168	328	160	0.714286	0.479042
GCF_002214165_00690	50	264	214	0.955357	0.638806
GCA_002688355_01080	56	224	168	0.75	0.75
GCA_011525095_01267	176	316	140	0.625	0.41791
GCA_002506705_00946	176	316	140	0.625	0.41791
GCA_002712285_00872	162	312	150	0.669643	0.45045
GCA_002501885_00524	174	316	142	0.633929	0.439628
GCA_003230355_01253	142	293	151	0.674107	0.467492
GCA_003602575_00161	180	326	146	0.651786	0.433234
GCA_002706615_00414	178	323	145	0.647321	0.434132
GCA_002692685_00292	149	329	180	0.803571	0.537313
GCA_011370275_00195	66	218	152	0.678571	0.646809
GCA_002498925_00435	163	321	158	0.705357	0.484663
GCA_002505695_00095	129	329	200	0.892857	0.598802
GCA_002727695_00289	177	316	139	0.620536	0.414925
GCA_009936765_01048	140	280	140	0.625	0.466667
GCA_003602535_00351	175	318	143	0.638393	0.426866
GCA_002495525_00023	160	346	186	0.830357	0.529915
GCA_002502215_01084	156	331	175	0.78125	0.522388
GCA_002505455_00829	161	317	156	0.696429	0.482972
GCA_002698145_00477	160	331	171	0.763393	0.510448
GCA_003602415_00463	177	315	138	0.616071	0.41194
GCA_002719635_00400	158	319	161	0.71875	0.493865
GCA_902593945_00120	163	350	187	0.834821	0.526761
GCA_002727485_00770	182	324	142	0.633929	0.421365
GCA_002504435_00663	174	329	155	0.691964	0.464072
GCA_004195615_00974	157	328	171	0.763393	0.513514
GCA_002170775_00687	156	328	172	0.767857	0.51497
GCA_002499195_01131	171	331	160	0.714286	0.477612
GCA_903916665_00358	49	240	191	0.852679	0.704797
GCA_002503285_00838	128	328	200	0.892857	0.597015
GCA_002730095_00826	175	331	156	0.696429	0.467066
GCA_002718995_00930	184	329	145	0.647321	0.434132
GCA_002685855_00766	44	204	160	0.714286	0.780488
GCA_004195715_00707	201	329	128	0.571429	0.384384
GCA_002712645_01029	192	346	154	0.6875	0.436261
GCF_900176435_01206	15	163	148	0.660714	0.891566
GCA_011620765_00993	15	193	178	0.794643	0.469657
GCA_011523055_00900	171	327	156	0.696429	0.467066
GCF_000011185_00369	36	179	143	0.638393	0.781421
GCA_002497295_00341	175	327	152	0.678571	0.45509
GCA_002720055_00770	161	328	167	0.745536	0.501502
GCA_003661905_01346	2	110	108	0.482143	0.818182
GCA_002503215_00706	74	256	182	0.8125	0.684211
GCF_003205235_01339	43	190	147	0.65625	0.773684
GCA_000405245_00047	166	328	162	0.723214	0.489426
GCA_002496725_00346	195	329	134	0.598214	0.401198
GCA_002506825_00937	191	327	136	0.607143	0.407186
GCA_002779075_00073	43	260	217	0.96875	0.758741
GCA_002501605_00831	192	331	139	0.620536	0.416168
GCA_002723635_00501	172	313	141	0.629464	0.422156
GCA_002713185_00588	171	328	157	0.700893	0.471471
GCA_002718215_00478	169	309	140	0.625	0.42042
GCA_002502095_00150	196	329	133	0.59375	0.398204
GCA_002503055_00931	116	314	198	0.883929	0.613003
GCA_002495185_01106	183	327	144	0.642857	0.413793
GCA_011522915_00995	225	364	139	0.620536	0.362924
GCA_009887195_00056	194	336	142	0.633929	0.409222
GCA_002726395_00982	183	326	143	0.638393	0.424332
GCA_002698225_00501	188	315	127	0.566964	0.393189
GCA_002507175_00943	128	328	200	0.892857	0.598802
GCA_002726845_00826	183	324	141	0.629464	0.420896
GCA_013329925_00363	190	336	146	0.651786	0.420749
GCA_002495235_00046	22	184	162	0.723214	0.448753
GCA_002502605_01166	210	334	124	0.553571	0.357349
GCA_002495185_01404	167	294	127	0.566964	0.413681
GCA_009392915_00602	93	247	154	0.6875	0.616
GCA_002498185_00820	177	316	139	0.620536	0.414925
GCA_002717835_00992	206	361	155	0.691964	0.421196
GCA_002709705_00725	177	316	139	0.620536	0.414925
GCA_002719475_00928	185	333	148	0.660714	0.426513
GCA_002505935_01063	183	333	150	0.669643	0.432277
GCA_002504845_00021	194	346	152	0.678571	0.430595
GCA_003602645_01019	200	324	124	0.553571	0.367953
GCA_003193925_01247	199	327	128	0.571429	0.383234
GCA_002697105_00668	171	315	144	0.642857	0.432432
GCA_002505775_00232	190	331	141	0.629464	0.422156
GCA_002499545_01041	194	323	129	0.575893	0.382789
GCA_002505325_00306	214	342	128	0.571429	0.366762
GCA_002687185_00445	62	228	166	0.741071	0.72807
GCA_002495735_00073	200	326	126	0.5625	0.378378
GCA_000806155_01031	27	213	186	0.830357	0.873239
GCA_902511005_00850	185	345	160	0.714286	0.45584
GCA_014240385_01296	203	327	124	0.553571	0.357349
GCA_003193815_00321	1	101	100	0.446429	0.877193
GCA_003602475_01062	177	316	139	0.620536	0.41369
GCA_002499865_00960	195	327	132	0.589286	0.39521
GCA_002716085_00922	187	328	141	0.629464	0.422156
GCA_002501805_00344	198	327	129	0.575893	0.386228
GCA_002702985_00663	143	315	172	0.767857	0.516517
GCA_007117755_00216	60	229	169	0.754464	0.725322
GCA_002715545_00342	143	320	177	0.790179	0.525223
GCA_002499325_01081	198	323	125	0.558036	0.374251
GCA_000496135_01076	131	271	140	0.625	0.514706
GCA_009937025_01180	205	325	120	0.535714	0.356083
GCA_902560445_00769	161	347	186	0.830357	0.528409
GCA_002457145_00451	140	329	189	0.84375	0.565868
GCA_003649745_00797	1	112	111	0.495536	0.973684
GCA_002708695_01317	317	456	139	0.620536	0.288981
GCA_902520595_00265	219	340	121	0.540179	0.34375
GCA_002694245_01008	174	315	141	0.629464	0.420896
GCA_002731195_00092	131	329	198	0.883929	0.592814
GCA_012959275_00601	203	331	128	0.571429	0.368876
GCA_002502365_00915	161	321	160	0.714286	0.490798
GCA_000402515_00720	17	218	201	0.897321	0.922018
GCA_002762915_00387	18	243	225	1.00446	0.925926
GCA_002499585_00137	164	329	165	0.736607	0.494012
GCA_002011165_01402	45	238	193	0.861607	0.80083
GCA_012030815_00441	149	277	128	0.571429	0.462094
GCA_002722735_00907	233	382	149	0.665179	0.385013
GCA_002505185_01183	29	187	158	0.705357	0.831579
GCA_002495405_01495	177	323	146	0.651786	0.437126
GCA_002718195_00350	177	323	146	0.651786	0.437126
GCA_002725275_01155	165	326	161	0.71875	0.480597
GCA_002722595_01012	214	370	156	0.696429	0.414894
GCA_002701145_00720	177	318	141	0.629464	0.420896
GCF_000013445_02462	128	291	163	0.727679	0.552542
GCA_003602605_00532	203	325	122	0.544643	0.362018
GCA_004195515_01347	176	314	138	0.616071	0.41194
GCA_002789275_00156	87	243	156	0.696429	0.641975
GCA_002687075_00094	261	389	128	0.571429	0.319202
GCA_012960975_00789	186	328	142	0.633929	0.426426
GCA_002502625_00639	169	315	146	0.651786	0.438438
GCA_002502295_00983	7	160	153	0.683036	0.9
GCA_002506275_00117	199	323	124	0.553571	0.367953
GCA_013330285_00955	215	338	123	0.549107	0.350427
GCA_002170315_01509	197	325	128	0.571429	0.379822
GCA_002725315_00070	184	329	145	0.647321	0.434132
GCA_002780285_00597	80	232	152	0.678571	0.655172
GCA_002495645_00246	170	323	153	0.683036	0.456716
GCA_013329905_00305	152	327	175	0.78125	0.523952
GCA_011524855_01137	196	320	124	0.553571	0.369048
GCA_013330385_00616	129	329	200	0.892857	0.598802
GCA_002499705_01613	222	343	121	0.540179	0.340845
GCF_001315945_00495	16	193	177	0.790179	0.917098
GCA_002726495_00461	186	329	143	0.638393	0.409742
GCA_013329255_00222	201	325	124	0.553571	0.367953
GCA_002704515_00896	174	325	151	0.674107	0.450746
GCA_009778275_00144	1	97	96	0.428571	0.786885
GCA_002505405_00410	173	324	151	0.674107	0.450746
GCA_013330155_00183	172	324	152	0.678571	0.453731
GCA_000246735_01438	205	324	119	0.53125	0.353116
GCA_002728035_00417	191	322	131	0.584821	0.391045
GCA_002497895_00237	142	305	163	0.727679	0.522436
GCA_011358095_00852	105	258	153	0.683036	0.581749
GCA_002502175_00045	175	347	172	0.767857	0.488636
GCA_902625885_00842	180	322	142	0.633929	0.423881
GCA_002495535_00631	214	338	124	0.553571	0.353276
GCA_002494765_00441	110	243	133	0.59375	0.547325
GCA_002457595_00799	144	321	177	0.790179	0.542945
GCA_002497025_00574	166	347	181	0.808036	0.514205
GCA_003161815_01534	10	109	99	0.441964	0.9
GCA_002496905_00030	161	329	168	0.75	0.502994
GCA_003602485_00480	140	318	178	0.794643	0.529762
GCA_014240285_00964	201	321	120	0.535714	0.36036
GCA_002457555_00561	194	347	153	0.683036	0.434659
GCA_013290045_02175	164	286	122	0.544643	0.40264
GCA_014384685_00438	162	324	162	0.723214	0.486486
GCA_013330595_00653	70	221	151	0.674107	0.659389
GCA_002498525_00266	184	339	155	0.691964	0.446686
GCA_012959845_01513	196	331	135	0.602679	0.39823
GCA_002494645_01304	142	317	175	0.78125	0.520833
GCA_013329355_00756	174	300	126	0.5625	0.42
GCA_002727275_00368	182	314	132	0.589286	0.408669
GCA_012030815_00442	1	90	89	0.397321	0.563291
GCA_011380495_00564	3	225	222	0.991071	0.956897
GCA_002499015_00545	195	331	136	0.607143	0.402367
GCA_012959435_00922	166	324	158	0.705357	0.474474
GCA_002498725_00621	156	329	173	0.772321	0.517964
GCA_002727675_00469	204	363	159	0.709821	0.436813
GCA_011605715_00033	2	70	68	0.303571	0.944444
GCA_002685895_01036	166	325	159	0.709821	0.478916
GCA_002505495_00455	147	322	175	0.78125	0.525526
GCA_004195635_00703	201	344	143	0.638393	0.393939
GCA_013331125_01027	1	88	87	0.388393	0.988636
GCF_003173335_01264	98	286	188	0.839286	0.641638
GCA_009937205_00085	196	332	136	0.607143	0.402367
GCF_900083515_01487	82	252	170	0.758929	0.646388
GCA_002725475_01152	165	329	164	0.732143	0.493976
GCA_003662515_00953	1	94	93	0.415179	0.853211
GCA_902384935_00192	260	415	155	0.691964	0.368171
GCA_013329215_00521	55	177	122	0.544643	0.689266
GCA_003021745_01293	13	118	105	0.46875	0.867769
GCA_012964335_01136	166	325	159	0.709821	0.477477
GCA_903828655_01002	96	227	131	0.584821	0.574561
GCA_012729535_02427	135	265	130	0.580357	0.485075
GCA_007117735_00751	58	200	142	0.633929	0.68932
GCA_013331225_01725	134	211	77	0.34375	0.364929
GCA_003266065_00453	188	289	101	0.450893	0.336667
GCA_007128245_01049	96	197	101	0.450893	0.502488
GCA_007116645_01043	96	198	102	0.455357	0.50495
GCA_002714305_00346	152	322	170	0.758929	0.507463
GCA_011620825_00060	175	252	77	0.34375	0.305556
GCA_003694495_00213	3	176	173	0.772321	0.982955
GCA_001856825_00300	69	264	195	0.870536	0.733083
GCA_007117065_00225	92	196	104	0.464286	0.52
GCA_001315965_03329	2	45	43	0.191964	0.236264
GCA_001315965_03329	81	113	32	0.142857	0.175824
GCA_013330625_00442	1	78	77	0.34375	0.855556
GCA_014523665_00214	154	276	122	0.544643	0.442029
GCF_900769095_00040	1	100	99	0.441964	0.755725
GCA_003649235_01818	58	197	139	0.620536	0.584034
GCA_002502705_00609	1	74	73	0.325893	0.986486
GCF_000621965_00134	135	244	109	0.486607	0.29863
GCA_011361905_00266	26	131	105	0.46875	0.347682
GCF_001316105_00086	127	211	84	0.375	0.385321
GCA_002731115_00203	379	478	99	0.441964	0.165275
GCA_012962055_00434	1	50	49	0.21875	0.960784
GCA_011389055_00511	17	125	108	0.482143	0.26799
GCA_002726395_00164	677	810	133	0.59375	0.150452
GCF_900111485_00222	2	59	57	0.254464	0.292308
GCA_002499345_00487	175	249	74	0.330357	0.297189
GCF_000015225_01109	39	93	54	0.241071	0.225
GCA_902385655_00116	425	513	88	0.392857	0.137931
GCA_000405225_00323	398	493	95	0.424107	0.153473
GCF_002214385_00593	27	127	100	0.446429	0.714286
GCA_002172375_00701	230	328	98	0.4375	0.293413
GCF_000220175_00594	105	184	79	0.352679	0.257329
GCF_000220175_00594	208	288	80	0.357143	0.260586
GCA_003569705_01163	9	97	88	0.392857	0.888889
GCA_013329505_01335	70	137	67	0.299107	0.455782
GCF_008729015_03930	15	148	133	0.59375	0.661692
GCA_002897655_00537	511	657	146	0.651786	0.201102
GCF_008124605_01831	10	90	80	0.357143	0.567376
GCA_002926195_00039	92	153	61	0.272321	0.262931
GCA_003662715_01461	159	237	78	0.348214	0.329114
GCA_013114725_01772	3	87	84	0.375	0.831683
GCA_013203245_00156	4	100	96	0.428571	0.932039
GCA_002503395_01685	213	322	109	0.486607	0.278061
GCA_903877165_01617	4	60	56	0.25	0.811594
GCA_002011215_01082	201	288	87	0.388393	0.285246
Asgard_ASG205_01912	158	382	224	1	0.546341
Asgard_ASG235_01200	158	382	224	1	0.546341
Asgard_ASG043_01560	159	381	222	0.991071	0.545455
Asgard_ASG209_02382	159	381	222	0.991071	0.545455
Asgard_ASG066_04763	21	239	218	0.973214	0.825758
Asgard_ASG042_00147	158	382	224	1	0.546341
Asgard_FWG130_00155	158	382	224	1	0.546341
Asgard_FWG136_01194	160	379	219	0.977679	0.532847
Asgard_ASG204_00269	158	382	224	1	0.543689
Asgard_ASG132_02486	94	158	64	0.285714	0.14128
Asgard_ASG132_02486	161	381	220	0.982143	0.485651
Asgard_FWG139_01453	159	383	224	1	0.53717
Asgard_FWG135_02004	156	378	222	0.991071	0.544118
Asgard_ASG052_01520	155	374	219	0.977679	0.528986
Asgard_FWG138_01119	161	381	220	0.982143	0.528846
Asgard_ASG072_05975	143	363	220	0.982143	0.53528
Asgard_ASG150_02524	158	378	220	0.982143	0.531401
Asgard_ASG101_00692	163	385	222	0.991071	0.53494
Asgard_ASG053_02513	1	216	215	0.959821	0.839844
Asgard_ASG108_02895	158	376	218	0.973214	0.522782
Asgard_ASG114_01060	157	375	218	0.973214	0.525301
Asgard_FWG001_01261	155	377	222	0.991071	0.518692
Asgard_ASG206_00028	159	385	226	1.00893	0.548544
Asgard_ASG207_00540	159	385	226	1.00893	0.548544
Asgard_ASG147_00335	158	377	219	0.977679	0.550251
Asgard_ASG243_01376	158	377	219	0.977679	0.550251
Asgard_ASG232_02282	158	378	220	0.982143	0.532688
Asgard_ASG051_00010	155	374	219	0.977679	0.51049
Asgard_ASG110_02353	157	375	218	0.973214	0.52657
Asgard_ASG113_02694	13	89	76	0.339286	0.182692
Asgard_ASG113_02694	158	376	218	0.973214	0.524038
Asgard_ASG073_01957	157	371	214	0.955357	0.519417
Asgard_ASG003_00291	159	380	221	0.986607	0.492205
Asgard_ASG158_05299	159	377	218	0.973214	0.570681
Asgard_ASG002_01087	114	384	270	1.20536	0.649038
Asgard_ASG076_00317	155	374	219	0.977679	0.51049
Asgard_ASG194_00207	159	379	220	0.982143	0.539216
Asgard_ASG195_00259	159	379	220	0.982143	0.539216
Asgard_ASG146_01494	158	377	219	0.977679	0.550251
Asgard_ASG242_00607	158	377	219	0.977679	0.550251
Asgard_ASG050_00542	86	158	72	0.321429	0.169412
Asgard_ASG050_00542	155	374	219	0.977679	0.515294
Asgard_ASG135_00375	155	376	221	0.986607	0.52
Asgard_ASG140_00342	155	376	221	0.986607	0.52
Asgard_ASG250_00285	155	376	221	0.986607	0.52
Asgard_ASG121_03810	159	378	219	0.977679	0.532847
Asgard_ASG059_00262	152	374	222	0.991071	0.536232
Asgard_ASG136_01705	164	383	219	0.977679	0.501144
Asgard_ASG315_00784	159	382	223	0.995536	0.534772
Asgard_ASG075_03271	155	376	221	0.986607	0.516355
Asgard_ASG013_02100	164	383	219	0.977679	0.501144
Asgard_ASG162_00276	159	377	218	0.973214	0.570681
Asgard_ASG149_00857	158	378	220	0.982143	0.53012
Asgard_ASG055_02165	159	381	222	0.991071	0.519906
Asgard_ASG056_00246	152	373	221	0.986607	0.533816
Asgard_FWG166_01145	155	378	223	0.995536	0.521028
Asgard_ASG071_01844	155	372	217	0.96875	0.507009
Asgard_ASG010_01369	155	374	219	0.977679	0.51049
Asgard_ASG192_00965	156	380	224	1	0.53717
Asgard_ASG046_00786	156	380	224	1	0.535885
Asgard_ASG069_01898	151	365	214	0.955357	0.52451
Asgard_ASG141_01365	155	372	217	0.96875	0.496568
Asgard_ASG298_00235	158	380	222	0.991071	0.564885
Asgard_ASG062_01588	152	369	217	0.96875	0.524155
Asgard_ASG034_01578	119	342	223	0.995536	0.580729
Asgard_ASG031_00219	159	380	221	0.986607	0.52
Asgard_ASG074_00059	155	373	218	0.973214	0.509346
Asgard_ASG077_00698	155	374	219	0.977679	0.515294
Asgard_ASG196_01842	156	380	224	1	0.538462
Asgard_ASG143_01472	122	344	222	0.991071	0.578125
Asgard_ASG160_01961	159	380	221	0.986607	0.549751
Asgard_ASG190_00409	158	382	224	1	0.53717
Asgard_ASG193_01843	158	382	224	1	0.53717
Asgard_ASG191_02518	158	382	224	1	0.534606
Asgard_ASG172_02386	60	283	223	0.995536	0.777003
Asgard_ASG130_01688	105	198	93	0.415179	0.224638
Asgard_ASG130_01688	159	380	221	0.986607	0.533816
Asgard_FWG140_01437	158	378	220	0.982143	0.522565
Asgard_ASG093_01719	160	383	223	0.995536	0.563131
Asgard_ASG198_02526	160	379	219	0.977679	0.52518
Asgard_ASG045_01685	156	380	224	1	0.539759
Asgard_ASG057_00712	152	372	220	0.982143	0.53012
Asgard_ASG058_00557	152	372	220	0.982143	0.53012
Asgard_ASG064_00848	152	372	220	0.982143	0.53012
Asgard_ASG237_00106	152	372	220	0.982143	0.53012
Asgard_ASG307_02941	159	380	221	0.986607	0.551122
Asgard_ASG067_02584	155	377	222	0.991071	0.522353
Asgard_ASG180_01134	2	145	143	0.638393	0.866667
Asgard_ASG267_02649	159	380	221	0.986607	0.551122
Asgard_ASG154_01126	159	380	221	0.986607	0.549751
Asgard_ASG168_00075	60	283	223	0.995536	0.731148
Asgard_ASG309_00087	159	380	221	0.986607	0.562341
Asgard_ASG292_01879	159	377	218	0.973214	0.540943
Asgard_ASG078_00242	153	371	218	0.973214	0.520286
Asgard_ASG004_02246	153	371	218	0.973214	0.520286
Asgard_ASG088_04247	160	380	220	0.982143	0.548628
Asgard_ASG184_01567	60	283	223	0.995536	0.731148
Asgard_ASG068_00878	155	373	218	0.973214	0.498856
Asgard_ASG308_02252	165	384	219	0.977679	0.518957
Asgard_ASG060_00461	146	369	223	0.995536	0.541262
Asgard_ASG203_02384	157	375	218	0.973214	0.525301
Asgard_ASG039_01666	159	378	219	0.977679	0.538084
Asgard_ASG090_02572	161	377	216	0.964286	0.53202
Asgard_ASG030_00881	158	378	220	0.982143	0.522565
Asgard_ASG260_00102	158	378	220	0.982143	0.522565
Asgard_ASG283_00993	159	381	222	0.991071	0.550868
Asgard_ASG070_03118	155	372	217	0.96875	0.526699
Asgard_ASG200_00250	160	380	220	0.982143	0.527578
Asgard_ASG180_02866	159	382	223	0.995536	0.55611
Asgard_ASG065_00135	152	371	219	0.977679	0.527711
Asgard_ASG085_02817	137	360	223	0.995536	0.597855
Asgard_ASG120_03551	171	390	219	0.977679	0.508121
Asgard_ASG144_01220	118	341	223	0.995536	0.588391
Asgard_ASG186_00315	159	382	223	0.995536	0.547912
Asgard_ASG164_00082	159	382	223	0.995536	0.547912
Asgard_ASG199_00617	160	380	220	0.982143	0.527578
Asgard_ASG098_03314	157	380	223	0.995536	0.579221
Asgard_ASG297_00341	156	380	224	1	0.555831
Asgard_ASG201_00156	64	283	219	0.977679	0.671779
Asgard_ASG285_01498	155	375	220	0.982143	0.572917
Asgard_ASG177_01645	123	344	221	0.986607	0.603825
Asgard_FWG016_01684	162	379	217	0.96875	0.516667
Asgard_ASG178_00613	160	381	221	0.986607	0.548387
Asgard_ASG038_00643	159	377	218	0.973214	0.551899
Asgard_ASG063_01053	152	371	219	0.977679	0.528986
Asgard_ASG142_01080	158	370	212	0.946429	0.501182
Asgard_ASG284_00886	159	381	222	0.991071	0.548148
Asgard_ASG005_00941	158	376	218	0.973214	0.521531
Asgard_ASG165_00800	21	244	223	0.995536	0.835206
Asgard_ASG208_01170	158	377	219	0.977679	0.548872
Asgard_ASG089_00855	159	377	218	0.973214	0.542289
Asgard_ASG122_03927	159	378	219	0.977679	0.528986
Asgard_ASG295_01883	116	205	89	0.397321	0.211401
Asgard_ASG295_01883	221	380	159	0.709821	0.377672
Asgard_ASG145_04727	71	167	96	0.428571	0.228029
Asgard_ASG145_04727	158	366	208	0.928571	0.494062
Asgard_ASG036_00807	157	381	224	1	0.567089
Asgard_ASG129_00899	134	339	205	0.915179	0.59593
Asgard_ASG009_02597	160	382	222	0.991071	0.545455
Asgard_ASG197_00467	176	396	220	0.982143	0.508083
Asgard_ASG289_01607	159	381	222	0.991071	0.550868
Asgard_ASG012_00062	149	368	219	0.977679	0.514085
Asgard_ASG249_01893	130	348	218	0.973214	0.567708
Asgard_ASG124_02442	155	374	219	0.977679	0.535452
Asgard_ASG264_03412	177	398	221	0.986607	0.506881
Asgard_ASG174_02209	169	391	222	0.991071	0.532374
Asgard_FWG161_00554	179	398	219	0.977679	0.5
Asgard_ASG112_02583	156	375	219	0.977679	0.534146
Asgard_ASG086_02096	160	381	221	0.986607	0.548387
Asgard_ASG151_00054	160	382	222	0.991071	0.545455
Asgard_ASG251_01369	138	354	216	0.964286	0.601671
Asgard_ASG169_02310	161	380	219	0.977679	0.542079
Asgard_ASG119_00671	179	398	219	0.977679	0.496599
Asgard_FWG137_02824	159	381	222	0.991071	0.544118
Asgard_ASG294_00325	179	396	217	0.96875	0.49095
Asgard_ASG082_01486	160	377	217	0.96875	0.531863
Asgard_ASG083_01944	160	377	217	0.96875	0.531863
Asgard_ASG310_02352	159	380	221	0.986607	0.569588
Asgard_ASG268_00665	155	333	178	0.794643	0.529762
Asgard_ASG087_03350	159	383	224	1	0.553086
Asgard_FWG038_00161	176	375	199	0.888393	0.487745
Asgard_ASG061_01234	153	373	220	0.982143	0.527578
Asgard_ASG102_00035	159	380	221	0.986607	0.529976
Asgard_ASG156_01068	160	380	220	0.982143	0.545906
Asgard_ASG210_00094	225	375	150	0.669643	0.382653
Asgard_ASG181_02872	160	380	220	0.982143	0.545906
Asgard_FWG169_01090	159	380	221	0.986607	0.510393
Asgard_ASG258_00080	223	375	152	0.678571	0.372549
Asgard_ASG259_00655	223	375	152	0.678571	0.372549
Asgard_ASG157_03261	159	383	224	1	0.550369
Asgard_ASG105_00331	156	375	219	0.977679	0.534146
Asgard_ASG170_01153	154	374	220	0.982143	0.554156
Asgard_ASG159_03529	160	380	220	0.982143	0.545906
Asgard_ASG037_01949	159	382	223	0.995536	0.547912
Asgard_ASG099_03256	159	382	223	0.995536	0.545232
Asgard_ASG167_00191	159	383	224	1	0.550369
Asgard_ASG189_00227	160	380	220	0.982143	0.545906
Asgard_ASG006_03164	159	383	224	1	0.550369
Asgard_ASG096_00888	159	381	222	0.991071	0.553616
Asgard_ASG115_03188	156	374	218	0.973214	0.531707
Asgard_ASG107_00128	179	399	220	0.982143	0.494382
Asgard_ASG302_00392	159	382	223	0.995536	0.546569
Asgard_ASG118_03143	159	376	217	0.96875	0.522892
Asgard_ASG291_02849	160	380	220	0.982143	0.541872
Asgard_ASG080_00854	160	382	222	0.991071	0.542787
Asgard_ASG109_01897	155	372	217	0.96875	0.530562
Asgard_ASG171_01112	160	380	220	0.982143	0.512821
Asgard_ASG182_00796	162	383	221	0.986607	0.539024
Asgard_ASG081_03658	160	385	225	1.00446	0.523256
Asgard_ASG084_03502	159	382	223	0.995536	0.547912
Asgard_ASG312_02368	110	204	94	0.419643	0.229829
Asgard_ASG312_02368	206	372	166	0.741071	0.405868
Asgard_ASG185_01848	159	382	223	0.995536	0.547912
Asgard_ASG155_03734	160	380	220	0.982143	0.545906
Asgard_ASG111_02076	123	374	251	1.12054	0.594787
Asgard_ASG106_01173	123	374	251	1.12054	0.594787
Asgard_ASG007_03057	159	381	222	0.991071	0.553616
Asgard_ASG125_02716	159	378	219	0.977679	0.526442
Asgard_ASG097_01539	159	382	223	0.995536	0.55611
Asgard_ASG001_01194	159	377	218	0.973214	0.527845
Asgard_ASG317_00331	155	379	224	1	0.539759
Asgard_ASG313_03631	159	384	225	1.00446	0.552826
Asgard_ASG282_01038	125	377	252	1.125	0.607229
Asgard_ASG092_00889	160	380	220	0.982143	0.511628
Asgard_ASG049_00010	155	379	224	1	0.547677
Asgard_ASG100_01670	160	383	223	0.995536	0.547912
Asgard_ASG244_05173	64	163	99	0.441964	0.246883
Asgard_ASG244_05173	159	380	221	0.986607	0.551122
Asgard_ASG256_00494	159	378	219	0.977679	0.522673
Asgard_ASG187_02280	159	382	223	0.995536	0.55611
Asgard_ASG320_01689	155	379	224	1	0.54902
Asgard_FWG129_03319	155	380	225	1.00446	0.517241
Asgard_ASG255_02247	160	377	217	0.96875	0.50939
Asgard_ASG103_00930	155	372	217	0.96875	0.530562
Asgard_ASG104_00594	158	376	218	0.973214	0.52657
Asgard_ASG126_00323	159	380	221	0.986607	0.536408
Asgard_ASG094_00851	159	376	217	0.96875	0.5425
Asgard_ASG139_01718	155	379	224	1	0.550369
Asgard_ASG266_00956	155	379	224	1	0.550369
Asgard_ASG257_00236	159	378	219	0.977679	0.523923
Asgard_ASG252_02456	158	376	218	0.973214	0.522782
Asgard_ASG254_00131	158	376	218	0.973214	0.522782
Asgard_ASG116_01911	159	380	221	0.986607	0.536408
Asgard_ASG245_00133	159	380	221	0.986607	0.536408
Asgard_ASG123_01325	119	374	255	1.13839	0.623472
Asgard_ASG014_02573	155	368	213	0.950893	0.577236
Asgard_ASG117_01185	119	372	253	1.12946	0.618582
Asgard_ASG287_00305	159	380	221	0.986607	0.549751
Asgard_ASG133_01214	155	374	219	0.977679	0.534146
Asgard_ASG091_04206	160	381	221	0.986607	0.551122
Asgard_FWG037_02535	155	375	220	0.982143	0.53528
Asgard_ASG314_02803	156	378	222	0.991071	0.533654
Asgard_ASG246_00794	155	369	214	0.955357	0.52451
Asgard_ASG247_00309	155	369	214	0.955357	0.52451
Asgard_ASG253_00242	103	204	101	0.450893	0.247549
Asgard_ASG253_00242	155	373	218	0.973214	0.534314
Asgard_ASG202_01423	4	152	148	0.660714	0.791444
Asgard_ASG008_03313	160	383	223	0.995536	0.547912
Asgard_FWG128_01969	156	379	223	0.995536	0.530952
Asgard_ASG293_00298	160	380	220	0.982143	0.514019
Asgard_ASG131_01613	155	378	223	0.995536	0.53222
Asgard_ASG134_03506	155	378	223	0.995536	0.53222
Asgard_ASG183_00103	159	383	224	1	0.550369
Asgard_ASG047_01064	155	379	224	1	0.54902
Asgard_ASG321_00608	155	379	224	1	0.54902
Asgard_ASG095_02987	160	383	223	0.995536	0.547912
Asgard_ASG319_00365	155	379	224	1	0.553086
Asgard_ASG079_01812	139	354	215	0.959821	0.598886
Asgard_ASG322_00490	155	379	224	1	0.550369
Asgard_ASG137_03128	155	379	224	1	0.550369
Asgard_ASG233_00696	1	119	118	0.526786	0.76129
Asgard_ASG288_00267	200	376	176	0.785714	0.431373
Asgard_ASG123_00040	159	339	180	0.803571	0.530973
Asgard_ASG048_00081	156	379	223	0.995536	0.529691
Asgard_ASG318_00081	156	379	223	0.995536	0.529691
Asgard_ASG011_00865	143	361	218	0.973214	0.556122
Asgard_ASG173_02279	1	99	98	0.4375	0.809917
Asgard_ASG128_01808	103	203	100	0.446429	0.374532
Asgard_ASG128_01808	159	267	108	0.482143	0.404494
Asgard_ASG233_00695	158	244	86	0.383929	0.346774
Asgard_ASG160_03308	93	178	85	0.379464	0.218509
Asgard_ASG069_02173	47	145	98	0.4375	0.464455
Asgard_ASG075_03713	180	278	98	0.4375	0.341463
Asgard_ASG080_03553	16	110	94	0.419643	0.846847
Asgard_ASG074_02337	179	281	102	0.455357	0.354167
Asgard_FWG128_01335	36	117	81	0.361607	0.452514
Asgard_ASG074_01769	157	293	136	0.607143	0.345178
Asgard_ASG185_00941	1	53	52	0.232143	0.666667
Asgard_ASG112_00054	3	101	98	0.4375	0.830508
Asgard_FWG169_02197	255	345	90	0.401786	0.211765
Asgard_ASG169_04095	340	465	125	0.558036	0.212224
GCA_005125345.1-Ani_RWIC01001494.1_i000_018354	51	274	223	0.995536	0.516204
GCA_002738545.1-Ani_NTJE010242034.1_i000_008916	29	252	223	0.995536	0.593085
GCA_007646595.3-Ani_VBQZ03000414.1_i000_020364	51	274	223	0.995536	0.501124
GCA_905332335.1-Ani_CAJOBX010013891.1_i000_018787	51	274	223	0.995536	0.505669
GCA_014176215.1-Ani_JACASE010000014.1_i000_005742	109	332	223	0.995536	0.446894
GCA_014049915.1-Ani_JABVXQ010000014.1_i000_005849	109	332	223	0.995536	0.446894
GCA_017524585.1-Ani_CM029832.1_i000_013567	109	332	223	0.995536	0.446894
GCA_000325575.1-Ani_KB030432.1_i000_002876	109	332	223	0.995536	0.446894
GCA_900661375.1-Ani_CAAGRJ010021716.1_i000_012758	109	332	223	0.995536	0.446894
GCA_905146905.1-Ani_CAJHUB010000775.1_i000_024972	109	332	223	0.995536	0.446894
GCA_014108415.1-Ani_JACASF010000021.1_i000_011568	109	332	223	0.995536	0.446894
GCA_010411085.1-Ani_CM021195.1_i000_002605	109	332	223	0.995536	0.446894
GCA_000230795.1-Ani_CM001271.1_i000_015844	109	332	223	0.995536	0.446894
GCA_002880755.3-Ani_CM009257.2_i000_016640	109	332	223	0.995536	0.446894
GCA_002880775.3-Ani_CM009281.2_i000_016494	109	332	223	0.995536	0.446894
GCF_000001405.40-Hum_NC_000019.10_i000_017570	109	332	223	0.995536	0.446894
GCA_016881025.1-Ani_JAESOR010004409.1_i000_020150	109	332	223	0.995536	0.446894
GCA_021218885.1-Ani_MU269954.1_i000_007797	109	332	223	0.995536	0.446894
GCA_020004445.1-Ani_JAATJV010454215.1_i000_022987	109	332	223	0.995536	0.446894
GCA_003521335.2-Ani_QWLN02007227.1_i000_007232	109	332	223	0.995536	0.446894
GCA_014533835.1-Ani_WJEC01000714.1_i000_004395	118	341	223	0.995536	0.438976
GCA_901343595.1-Ani_CABDUW010001168.1_i000_020195	118	341	223	0.995536	0.438976
GCA_008782695.1-Ani_CM018502.1_i000_012826	109	332	223	0.995536	0.446894
GCA_008787405.2-Ani_CM018479.1_i000_006849	109	332	223	0.995536	0.446894
GCA_000281125.4-Ani_AKHW03006584.1_i000_022793	108	331	223	0.995536	0.43301
GCA_000743615.1-Ani_KN121407.1_i000_002127	143	366	223	0.995536	0.418386
GCA_000002165.1-Ani_CM000215.2_i000_011144	109	332	223	0.995536	0.446894
GCA_000002265.1-Ani_CM000231.2_i000_000626	109	332	223	0.995536	0.446894
GCA_014108245.1-Ani_JACAGB010000184.1_i000_006443	109	332	223	0.995536	0.446894
GCA_021028975.1-Ani_CM037628.1_i000_026131	108	331	223	0.995536	0.446894
GCA_000516915.1-Ani_AZIM01000507.1_i000_003505	142	365	223	0.995536	0.446
GCA_019455555.1-Ani_JAGFMF010011562.1_i000_004604	109	332	223	0.995536	0.420755
GCA_020142125.1-Ani_CM034710.1_i000_014069	108	331	223	0.995536	0.446894
GCA_020497125.1-Ani_CM035647.1_i000_018292	95	318	223	0.995536	0.482684
GCA_014108255.1-Ani_JACAGC010000022.1_i000_009904	109	332	223	0.995536	0.446894
GCA_000004195.4-Ani_CM004449.2_i000_017887	108	331	223	0.995536	0.447791
GCA_003942145.1-Ani_QXTE01000511.1_i000_019023	107	330	223	0.995536	0.447791
GCA_018859375.1-Ani_JAHGAV010000356.1_i000_015382	106	329	223	0.995536	0.448692
GCA_000334495.1-Ani_KB320547.1_i000_003932	140	363	223	0.995536	0.436399
GCA_020004485.1-Ani_JAATJU010025451.1_i000_018084	109	332	223	0.995536	0.172601
GCA_000223135.1-Ani_JH001168.1_i000_016439	51	274	223	0.995536	0.505669
GCA_014773175.1-Ani_VXCM01002143.1_i000_013247	149	372	223	0.995536	0.416822
GCA_001270105.1-Ani_LHQP01023319.1_i000_031640	97	320	223	0.995536	0.459794
GCA_016745375.1-Ani_WIOS01000021.1_i000_010430	72	295	223	0.995536	0.484783
GCA_003186165.1-Ani_CP026243.1_i000_000834	122	345	223	0.995536	0.438976
GCA_006346445.1-Ani_VEVO01000002.1_i000_001996	122	345	223	0.995536	0.438976
GCA_007224835.1-Ani_SRMA01025987.1_i000_010482	97	320	223	0.995536	0.459794
GCA_019512145.1-Ani_CM033646.1_i000_012206	108	331	223	0.995536	0.447791
GCA_012432095.1-Ani_CM022800.1_i000_015924	121	344	223	0.995536	0.438114
GCA_003711585.2-Ani_CM011661.2_i000_012382	122	345	223	0.995536	0.438976
GCA_003845795.1-Ani_CM011687.1_i000_013444	122	345	223	0.995536	0.438976
GCA_000803125.3-Ani_CM016635.2_i000_007382	131	354	223	0.995536	0.428023
GCA_001270105.1-Ani_LHQP01001574.1_i000_002227	121	344	223	0.995536	0.468487
GCA_001005745.2-Ani_JARO02000468.1_i000_001918	123	346	223	0.995536	0.436399
GCA_019447015.1-Ani_CM033475.1_i000_013341	107	330	223	0.995536	0.448692
GCA_004120215.1-Ani_QBIY01011444.1_i000_007952	2835	3058	223	0.995536	0.0691902
GCA_014170095.1-Ani_WKFB01000117.1_i000_004826	121	344	223	0.995536	0.439842
GCA_001663975.1-Ani_CM004478.1_i000_029797	108	331	223	0.995536	0.447791
GCA_905332335.1-Ani_CAJOBX010000390.1_i000_001242	108	331	223	0.995536	0.447791
GCA_017589495.1-Ani_CM030058.1_i000_015340	122	345	223	0.995536	0.435547
GCA_013634535.1-Ani_JACDTQ010002604.1_i000_008241	109	330	221	0.986607	0.444668
GCA_019176455.1-Ani_CM032862.1_i000_011573	2864	3087	223	0.995536	0.0686154
GCA_019721115.1-Ani_CM033897.1_i000_007655	122	345	223	0.995536	0.437255
GCA_019857665.1-Ani_CM034091.1_i000_008065	108	331	223	0.995536	0.447791
GCA_019176425.1-Ani_CM032884.1_i000_011624	145	368	223	0.995536	0.418386
GCA_003999625.1-Ani_CM012452.1_i000_014133	149	372	223	0.995536	0.416822
GCA_907169785.1-Ani_CAJRST010038888.1_i000_018158	122	345	223	0.995536	0.438976
GCA_001663975.1-Ani_CM004479.1_i000_031518	108	331	223	0.995536	0.411439
GCA_013339905.1-Ani_CM023503.1_i000_007536	146	369	223	0.995536	0.419173
GCA_008369825.1-Ani_CM017916.1_i000_022950	120	343	223	0.995536	0.438976
GCA_013621035.1-Ani_QNUK01000065.1_i000_019042	2780	3003	223	0.995536	0.0712688
GCA_003731715.1-Ani_RJVU01062584.1_i000_018877	2919	3142	223	0.995536	0.0674327
GCA_004354835.1-Ani_CM014940.1_i000_005799	128	351	223	0.995536	0.433852
GCA_010015445.1-Ani_CM020915.1_i000_007676	128	351	223	0.995536	0.433852
GCA_004786185.1-Ani_CM015718.1_i000_007677	122	345	223	0.995536	0.438976
GCA_009078355.1-Ani_CM018541.1_i000_000357	2828	3051	223	0.995536	0.0693408
GCA_902810595.1-Ani_LR778280.1_i000_031557	72	295	223	0.995536	0.461698
GCA_000180735.1-Ani_CAAE01014543.1_i000_010915	121	344	223	0.995536	0.42315
GCA_018320845.1-Ani_CM031320.1_i000_000593	132	355	223	0.995536	0.428846
GCA_016984175.1-Ani_JAAWVO010073909.1_i000_013735	125	348	223	0.995536	0.434698
GCA_019097595.1-Ani_CM032594.1_i000_000123	2791	3014	223	0.995536	0.0701478
GCA_012411365.1-Ani_CM022757.1_i000_005950	122	345	223	0.995536	0.440711
GCA_004026145.2-Ani_CP034976.1_i000_010176	117	340	223	0.995536	0.44334
GCA_003711565.2-Ani_CM011078.1_i000_012948	121	344	223	0.995536	0.439842
GCA_004786185.1-Ani_CM015718.1_i000_007678	2785	3008	223	0.995536	0.0703248
GCA_008692095.1-Ani_CM018440.1_i000_004294	2850	3073	223	0.995536	0.0675962
GCA_016984135.1-Ani_JAAWVN010012555.1_i000_002478	52	275	223	0.995536	0.506818
GCA_014805685.1-Ani_CM025888.1_i000_003227	2824	3047	223	0.995536	0.0694271
GCA_000311805.2-Ani_KB016369.1_i000_000365	109	348	239	1.06696	0.464078
GCA_016835505.1-Ani_CM029072.1_i000_015838	700	923	223	0.995536	0.204963
GCA_013397825.1-Ani_VZRK01001847.1_i000_003631	30	253	223	0.995536	0.871094
GCA_013400515.1-Ani_VZTN01031880.1_i000_011140	53	276	223	0.995536	0.554726
GCA_006348945.1-Ani_SRLO01000049.1_i000_008679	122	345	223	0.995536	0.438976
GCA_011823955.1-Ani_JAAKFY010000021.1_i000_000717	122	345	223	0.995536	0.438976
GCA_011800145.1-Ani_JAAMPH010000181.1_i000_014520	90	312	222	0.991071	0.463466
GCA_016984155.1-Ani_JAAWVP010001524.1_i000_002096	131	354	223	0.995536	0.429672
GCA_013397815.1-Ani_VZTH01019439.1_i000_013180	109	333	224	1	0.448
GCA_013397635.1-Ani_VYZG01004753.1_i000_011515	2	225	223	0.995536	0.888446
GCA_000715545.1-Ani_KL596796.1_i000_009507	124	332	208	0.928571	0.232402
GCA_000715545.1-Ani_KL596796.1_i000_009507	346	463	117	0.522321	0.130726
GCA_000327345.1-Ani_KB104817.1_i000_005851	10	230	220	0.982143	0.856031
GCA_000448345.1-Ani_KE691399.1_i000_021733	109	315	206	0.919643	0.653968
GCA_013398475.1-Ani_VZSO01008122.1_i000_012049	2	213	211	0.941964	0.748227
GCA_000230445.1-Ani_JH204767.1_i000_021653	234	443	209	0.933036	0.355442
GCA_019059645.1-Ani_JAFELL010000934.1_i000_007712	122	334	212	0.946429	0.426559
GCA_000230815.1-Ani_CM001294.1_i000_014426	109	325	216	0.964286	0.475771
GCA_004119915.2-Ani_CM014091.1_i000_016203	122	341	219	0.977679	0.434524
GCA_002895965.2-Ani_PIJE02013034.1_i000_033649	122	334	212	0.946429	0.552083
GCA_002895965.2-Ani_PIJE02013249.1_i000_033714	122	334	212	0.946429	0.552083
GCA_002895965.2-Ani_PIJE02000500.1_i000_013799	40	252	212	0.946429	0.523457
GCA_927797965.1-Ani_OV696694.1_i000_014879	100	323	223	0.995536	0.447791
GCA_013399305.1-Ani_VXAI01002143.1_i000_004890	51	273	222	0.991071	0.504545
GCA_013397755.1-Ani_VZTF01000341.1_i000_000495	1	193	192	0.857143	0.537815
GCA_013389825.1-Ani_VWPW01016790.1_i000_006906	1	192	191	0.852679	0.532033
GCA_014300015.1-Ani_CM025010.1_i000_003699	122	156	34	0.151786	0.07173
GCA_014300015.1-Ani_CM025010.1_i000_003699	155	311	156	0.696429	0.329114
GCA_013358835.1-Ani_JABSTQ010010752.1_i000_020321	107	330	223	0.995536	0.522248
GCA_013339745.1-Ani_CM023474.1_i000_013053	107	330	223	0.995536	0.456033
GCA_002891405.2-Ani_NEVH01002996.1_i000_001959	111	334	223	0.995536	0.451417
GCA_000327385.1-Ani_KB203683.1_i000_022293	105	329	224	1	0.454361
GCA_019974015.1-Ani_BMAW01053855.1_i000_030364	105	328	223	0.995536	0.457906
GCA_013340265.1-Ani_BLKM01000254.1_i000_001433	111	334	223	0.995536	0.451417
GCA_019973975.1-Ani_BMAO01036591.1_i000_065011	105	328	223	0.995536	0.457906
GCA_013235015.1-Ani_BGPR01005340.1_i000_099040	105	328	223	0.995536	0.501124
GCA_000696155.1-Ani_KK852665.1_i000_005112	111	334	223	0.995536	0.451417
GCA_013339725.1-Ani_CM023468.1_i000_023812	107	333	226	1.00893	0.45935
GCA_015342795.1-Ani_CM027196.1_i000_021656	105	328	223	0.995536	0.457906
GCA_019973955.1-Ani_BMAV01024545.1_i000_044375	105	328	223	0.995536	0.457906
GCA_019649035.1-Ani_BMAT01006598.1_i000_031979	108	332	224	1	0.440079
GCA_003018175.1-Ani_PYGN01001178.1_i000_020953	111	334	223	0.995536	0.451417
GCA_000412655.1-Ani_KE164236.1_i000_015173	10	198	188	0.839286	0.734375
GCA_903813345.1-Ani_CAIIXF010000016.1_i000_025297	109	332	223	0.995536	0.446894
GCA_003073045.1-Ani_CM009758.1_i000_000922	106	330	224	1	0.457143
GCA_009733165.1-Ani_CM019155.1_i000_016526	141	324	183	0.816964	0.375
GCA_014466195.1-Ani_CM025375.1_i000_013484	107	330	223	0.995536	0.456033
GCA_001594075.1-Ani_KQ980838.1_i000_015215	107	330	223	0.995536	0.456033
GCA_014466185.1-Ani_CM025400.1_i000_012207	107	330	223	0.995536	0.456033
GCA_014905175.1-Ani_CM026522.1_i000_003479	108	331	223	0.995536	0.455102
GCA_021605095.1-Ani_BPLR01013209.1_i000_050327	105	328	223	0.995536	0.463617
GCA_021605075.1-Ani_BPLQ01011868.1_i000_040928	105	328	223	0.995536	0.457906
GCA_000147195.1-Ani_GL446678.1_i000_002760	107	330	223	0.995536	0.456033
GCA_000611955.2-Ani_KK113697.1_i000_004381	105	328	223	0.995536	0.456967
GCA_004794745.1-Ani_QBLH01003515.1_i000_007650	107	330	223	0.995536	0.456033
GCA_019049445.1-Ani_JAHFVI010000010.1_i000_004786	107	330	223	0.995536	0.456033
GCA_001594065.1-Ani_KQ976750.1_i000_000387	118	341	223	0.995536	0.446
GCA_019648995.1-Ani_BLXT01005682.1_i000_051492	108	332	224	1	0.440079
GCA_003991915.1-Ani_RQTK01000003.1_i000_000225	108	332	224	1	0.440079
GCA_014466175.1-Ani_CM025350.1_i000_014554	107	330	223	0.995536	0.456033
GCA_000204515.1-Ani_GL888742.1_i000_012975	107	330	223	0.995536	0.456033
GCA_017607455.1-Ani_JAANHZ010000809.1_i000_006738	107	330	223	0.995536	0.456033
GCA_004193795.1-Ani_QDEB01115462.1_i000_013032	114	337	223	0.995536	0.449597
GCA_013841245.2-Ani_CM034064.1_i000_002058	67	290	223	0.995536	0.496659
GCA_011392965.1-Ani_WNWW01000274.1_i000_003284	107	330	223	0.995536	0.456033
GCA_013841205.1-Ani_JACDQY010000091.1_i000_009444	106	329	223	0.995536	0.456967
GCA_017607545.1-Ani_JAANIC010003681.1_i000_004729	107	330	223	0.995536	0.424762
GCA_017607565.1-Ani_JAANIB010003379.1_i000_002106	107	330	223	0.995536	0.424762
GCA_001594045.1-Ani_KQ976507.1_i000_006649	107	330	223	0.995536	0.456033
GCA_001594055.1-Ani_KQ982701.1_i000_008863	107	330	223	0.995536	0.456033
GCA_001263275.1-Ani_KQ414748.1_i000_009533	107	330	223	0.995536	0.456033
GCA_001272555.1-Ani_KQ434842.1_i000_004380	107	330	223	0.995536	0.456967
GCA_903986555.1-Ani_CAJDYZ010007215.1_i000_004083	107	330	223	0.995536	0.456033
GCA_001045655.1-Ani_LBMM01005167.1_i000_007825	107	330	223	0.995536	0.456033
GCA_001483705.1-Ani_KQ766043.1_i000_009207	107	330	223	0.995536	0.383162
GCA_020341155.1-Ani_JAHMML010000015.1_i000_002566	107	330	223	0.995536	0.456967
GCA_009739505.2-Ani_CM019182.2_i000_011267	105	328	223	0.995536	0.457906
GCA_900618805.1-Ani_UYJE01010245.1_i000_058383	108	332	224	1	0.451613
GCA_905397895.1-Ani_CAJPWZ010000964.1_i000_018950	108	332	224	1	0.451613
GCA_001594115.1-Ani_KQ981655.1_i000_006943	107	330	223	0.995536	0.456033
GCA_905319865.3-Ani_CAJNRD030001119.1_i000_005746	107	330	223	0.995536	0.485839
GCA_000147175.1-Ani_GL439579.1_i000_008053	107	330	223	0.995536	0.456033
GCA_013202065.2-Ani_JAAOIC020000049.1_i000_006058	97	320	223	0.995536	0.440711
GCA_011752425.2-Ani_CACVKT020005076.1_i000_027620	108	332	224	1	0.451613
GCA_907166875.3-Ani_CAJRHG030000007.1_i000_011368	114	337	223	0.995536	0.449597
GCA_017607525.1-Ani_JAANIA010001783.1_i000_002370	107	330	223	0.995536	0.424762
GCA_020080835.1-Ani_CM034664.1_i000_010726	107	330	223	0.995536	0.456033
GCA_018342105.1-Ani_JAFIRS010000880.1_i000_014909	114	337	223	0.995536	0.449597
GCA_013400115.1-Ani_VXBP01005116.1_i000_006860	115	340	225	1.00446	0.451807
GCA_000002335.3-Ani_CM000284.3_i000_013184	114	337	223	0.995536	0.449597
GCA_014282415.2-Ani_JABDTM020025416.1_i000_009496	1053	1276	223	0.995536	0.155401
GCA_009761285.1-Ani_VYZN01000053.1_i000_012974	109	332	223	0.995536	0.452333
GCA_902439185.1-Ani_CABPRJ010002377.1_i000_015114	110	333	223	0.995536	0.450505
GCA_011009095.1-Ani_VTPC01090285.1_i000_022314	113	336	223	0.995536	0.450505
GCA_009835225.1-Ani_VUJU01003344.1_i000_013999	110	333	223	0.995536	0.220574
GCA_008802855.1-Ani_VVIM01000008.1_i000_012434	113	336	223	0.995536	0.451417
GCA_905250105.1-Ani_CAJNOC010002357.1_i000_012733	131	354	223	0.995536	0.430502
GCA_019364655.1-Ani_JAGXCG010010411.1_i000_010567	103	326	223	0.995536	0.458848
GCA_013368085.1-Ani_JABVZW010000323.1_i000_002297	113	336	223	0.995536	0.454175
GCA_000346045.2-Ani_KB632204.1_i000_007456	118	341	223	0.995536	0.446
GCA_000355655.1-Ani_KB741014.1_i000_007980	118	341	223	0.995536	0.446
GCA_020466585.1-Ani_JAFETG010000005.1_i000_008820	118	341	223	0.995536	0.446
GCA_020466635.1-Ani_JAFETF010000005.1_i000_009394	118	341	223	0.995536	0.446
GCA_000697945.4-Ani_ML762988.1_i000_002812	113	336	223	0.995536	0.449597
GCA_003710015.1-Ani_REGN01001524.1_i000_011117	132	355	223	0.995536	0.429672
GCA_000441895.2-Ani_KE525351.1_i000_016602	129	352	223	0.995536	0.434698
GCA_000328365.1-Ani_KB307920.1_i000_020472	106	329	223	0.995536	0.456967
GCA_905116865.2-Ani_CAJHNH020000249.1_i000_001952	110	334	224	1	0.440945
GCA_905115235.1-Ani_LR899010.1_i000_004463	117	340	223	0.995536	0.446
GCA_002249905.1-Ani_NNAY01003528.1_i000_013038	109	332	223	0.995536	0.454175
GCA_016920775.1-Ani_JAFDOW010001343.1_i000_004394	112	335	223	0.995536	0.452333
GCA_003335185.2-Ani_QKKF02028090.1_i000_013817	107	330	223	0.995536	0.455102
GCA_001718145.1-Ani_LJIJ01000126.1_i000_004623	124	347	223	0.995536	0.439842
GCA_903632075.3-Ani_CAHIKZ030001009.1_i000_016809	70	294	224	1	0.494481
GCA_002290385.1-Ani_KZ288344.1_i000_007291	106	337	231	1.03125	0.465726
GCA_001443705.1-Ani_LJIG01009468.1_i000_003921	112	335	223	0.995536	0.444223
GCA_021962125.1-Ani_JAGDYQ010000217.1_i000_009440	109	333	224	1	0.445328
GCA_900618415.1-Ani_UZAM01012679.1_i000_009376	104	328	224	1	0.443564
GCA_013368075.1-Ani_JABVZV010001312.1_i000_007769	113	336	223	0.995536	0.451417
GCA_001675575.1-Ani_LZPO01117145.1_i000_023821	119	288	169	0.754464	0.358811
GCA_001675575.1-Ani_LZPO01117145.1_i000_023821	287	304	17	0.0758929	0.0360934
GCA_905338385.1-Ani_CAJPEV010000132.1_i000_001386	122	345	223	0.995536	0.441584
GCA_001444175.2-Ani_KQ563500.1_i000_010851	126	349	223	0.995536	0.436399
GCA_001444175.2-Ani_KQ565356.1_i000_013520	126	349	223	0.995536	0.436399
GCA_000211455.3-Ani_ADMH02001525.1_i000_004468	128	351	223	0.995536	0.434698
GCA_000611835.1-Ani_KK107519.1_i000_013508	107	330	223	0.995536	0.456033
GCA_003672135.1-Ani_CM010864.1_i000_009032	107	330	223	0.995536	0.456033
GCA_002754855.1-Ani_MRZV01000269.1_i000_014220	106	329	223	0.995536	0.453252
GCA_000209225.1-Ani_DS469781.1_i000_007949	105	326	221	0.986607	0.45102
GCA_900005825.1-Ani_CVRI01000056.1_i000_014972	120	343	223	0.995536	0.441584
GCA_001194135.1-Ani_KQ419180.1_i000_014569	105	329	224	1	0.458078
GCA_001654015.2-Ani_LSRL02000075.1_i000_008010	121	344	223	0.995536	0.44334
GCA_000005175.1-Ani_CH933809.1_i000_003528	121	344	223	0.995536	0.44334
GCA_000262585.1-Ani_JH668624.1_i000_010173	112	335	223	0.995536	0.449597
GCA_005406025.1-Ani_BGZK01000061.1_i000_009209	48	271	223	0.995536	0.515012
GCA_004000445.1-Ani_RSAL01000003.1_i000_000579	114	337	223	0.995536	0.446894
GCA_003675905.2-Ani_NCKV01000645.1_i000_001944	117	340	223	0.995536	0.44511
GCA_021223965.1-Ani_JAJJHZ010003326.1_i000_008104	121	344	223	0.995536	0.428023
GCA_018290095.1-Ani_CM031379.1_i000_004997	120	343	223	0.995536	0.441584
GCA_000005245.1-Ani_CH940647.1_i000_012679	121	344	223	0.995536	0.44334
GCA_021223945.1-Ani_JAJJHW010002585.1_i000_005526	121	344	223	0.995536	0.44334
GCA_921882275.1-Ani_OV170222.1_i000_002074	114	337	223	0.995536	0.447791
GCA_021223985.1-Ani_JAJJIA010003653.1_i000_008444	121	344	223	0.995536	0.44334
GCA_021223765.1-Ani_JAJJHM010013123.1_i000_009947	117	340	223	0.995536	0.44511
GCA_021223845.1-Ani_JAJJHU010004954.1_i000_004468	117	340	223	0.995536	0.44511
GCA_000326865.1-Ani_KB095959.1_i000_003880	110	333	223	0.995536	0.450505
GCA_902806795.1-Ani_CADCXV010000795.1_i000_007527	109	332	223	0.995536	0.513825
GCA_000005195.1-Ani_CH479191.1_i000_006724	117	340	223	0.995536	0.44511
GCA_002571385.1-Ani_LSMT01000128.1_i000_008709	105	326	221	0.986607	0.454733
GCA_003704095.1-Ani_RCHS01004153.1_i000_020541	105	326	221	0.986607	0.502273
GCA_905368565.1-Ani_CAJPIZ010008922.1_i000_011246	125	348	223	0.995536	0.438976
GCA_005959815.1-Ani_QOCX01006883.1_i000_011675	118	341	223	0.995536	0.444223
GCA_021223725.1-Ani_JAJJHN010003778.1_i000_007604	139	362	223	0.995536	0.426386
GCA_021223785.1-Ani_JAJJHP010001087.1_i000_003564	121	344	223	0.995536	0.44334
GCA_021223805.1-Ani_JAJJHR010000120.1_i000_000572	139	362	223	0.995536	0.426386
GCA_001187945.1-Ani_JRES01001072.1_i000_008281	118	341	223	0.995536	0.444223
GCA_905071925.1-Ani_CAJHJT010000034.1_i000_013566	119	342	223	0.995536	0.44334
GCA_000005115.1-Ani_CH902618.1_i000_011003	117	340	223	0.995536	0.44511
GCA_020536995.1-Ani_CM035916.1_i000_024919	108	332	224	1	0.451613
GCA_000005135.1-Ani_CH954178.1_i000_010247	117	340	223	0.995536	0.44511
GCA_000005975.1-Ani_CM000159.2_i000_009573	117	340	223	0.995536	0.44511
GCA_021223865.1-Ani_JAJJHT010001359.1_i000_000690	117	340	223	0.995536	0.428846
GCA_000005155.1-Ani_CH916366.1_i000_014675	121	344	223	0.995536	0.44334
GCA_907164705.1-Ani_CAJQZP010001037.1_i000_015734	114	337	223	0.995536	0.447791
GCA_021223745.1-Ani_JAJJHO010006587.1_i000_009112	118	341	223	0.995536	0.444223
GCA_021223825.1-Ani_JAJJHQ010011965.1_i000_010928	117	340	223	0.995536	0.44511
GCA_022117675.1-Ani_JACEFF010000475.1_i000_010852	113	336	223	0.995536	0.47957
GCA_900199415.2-Ani_FZQP02006033.1_i000_012550	112	335	223	0.995536	0.512644
GCA_021223895.1-Ani_JAJJHX010004525.1_i000_004603	139	362	223	0.995536	0.426386
GCA_918697745.1-Ani_CAKKLH010000043.1_i000_002685	109	332	223	0.995536	0.44334
GCA_905116875.3-Ani_CAJHNJ030000004.1_i000_001698	114	337	223	0.995536	0.446894
GCA_019096205.1-Ani_CM032504.1_i000_006088	114	337	223	0.995536	0.446894
GCA_000005215.1-Ani_CH480815.1_i000_013659	117	340	223	0.995536	0.44511
GCA_000259055.1-Ani_CM000363.1_i000_007796	117	340	223	0.995536	0.44511
GCA_000754195.3-Ani_CM002912.1_i000_007290	117	340	223	0.995536	0.44511
GCA_001276565.1-Ani_KQ435840.1_i000_010064	101	314	213	0.950893	0.450317
GCA_019297735.1-Ani_CM033248.1_i000_014800	86	309	223	0.995536	0.511468
GCA_003675995.1-Ani_NCKU01000359.1_i000_002223	110	333	223	0.995536	0.280856
GCA_001632505.1-Ani_LRGB01000024.1_i000_000798	113	336	223	0.995536	0.439842
GCA_015832365.1-Ani_JACWZX010000141.1_i000_001763	113	336	223	0.995536	0.483731
GCA_001298345.1-Ani_KQ459302.1_i000_004333	114	337	223	0.995536	0.446894
GCA_000797535.1-Ani_KN538395.1_i000_006095	389	613	224	1	0.284625
GCA_000701005.1-Ani_KL363197.1_i000_003224	107	331	224	1	0.443564
GCA_000701025.1-Ani_KL367612.1_i000_011625	107	331	224	1	0.443564
GCA_015679615.1-Ani_JACKWZ010000028.1_i000_003051	113	336	223	0.995536	0.448692
GCA_021224005.1-Ani_JAJJHY010008789.1_i000_010927	139	362	223	0.995536	0.426386
GCA_000005925.1-Ani_CH964101.1_i000_007345	120	343	223	0.995536	0.44246
GCA_904063045.1-Ani_CAJFCJ010000007.1_i000_006327	103	325	222	0.991071	0.458678
GCA_000613005.1-Ani_HG805949.1_i000_003612	435	659	224	1	0.198582
GCA_000235995.2-Ani_KZ248694.1_i000_009321	112	335	223	0.995536	0.450505
GCA_916720795.1-Ani_CAKASE010000083.1_i000_016053	112	335	223	0.995536	0.450505
GCA_002156985.1-Ani_KZ149829.1_i000_004581	113	336	223	0.995536	0.448692
GCA_902825445.1-Ani_CADEBC010000483.1_i000_005618	112	335	223	0.995536	0.449597
GCA_902825455.1-Ani_CADEBD010000364.1_i000_013696	112	335	223	0.995536	0.449597
GCA_000344595.1-Ani_KB588327.1_i000_017163	31	161	130	0.580357	0.311751
GCA_000344595.1-Ani_KB588327.1_i000_017163	176	236	60	0.267857	0.143885
GCA_016618385.1-Ani_JABFOP010000473.1_i000_010424	109	332	223	0.995536	0.367381
GCA_021223935.1-Ani_JAJJHV010000096.1_i000_000123	117	340	223	0.995536	0.44511
GCA_905332375.1-Ani_CAJOBZ010000003.1_i000_002061	113	336	223	0.995536	0.448692
GCA_004794745.1-Ani_QBLH01002416.1_i000_010026	69	292	223	0.995536	0.494457
GCA_001298355.1-Ani_KQ461175.1_i000_013511	114	337	223	0.995536	0.428846
GCA_000006295.1-Ani_DS235860.1_i000_001442	93	308	215	0.959821	0.460385
GCA_002148645.1-Ani_LVZM01008355.1_i000_004304	102	326	224	1	0.448
GCA_003789085.1-Ani_QCYY01001067.1_i000_000453	121	344	223	0.995536	0.441584
GCA_018991925.1-Ani_JAHLQT010017232.1_i000_008962	113	336	223	0.995536	0.451417
GCA_001447595.1-Ani_JYDH01000010.1_i000_001838	398	622	224	1	0.281407
GCA_001447655.1-Ani_JYDQ01000030.1_i000_002879	205	429	224	1	0.371476
GCA_001447435.1-Ani_JYDK01000036.1_i000_003296	405	629	224	1	0.278954
GCA_001447565.1-Ani_JYDW01000001.1_i000_004291	413	637	224	1	0.276202
GCA_001447745.1-Ani_JYDM01000001.1_i000_004990	380	604	224	1	0.287918
GCA_001447455.1-Ani_JYDL01000003.1_i000_008152	398	622	224	1	0.281407
GCA_001447425.1-Ani_JYDJ01000015.1_i000_001203	400	624	224	1	0.280702
GCA_001447585.1-Ani_JYDI01000001.1_i000_000055	410	634	224	1	0.277228
GCA_001447505.1-Ani_JYDN01000055.1_i000_005000	457	681	224	1	0.261988
GCA_002113885.2-Ani_NEDP02004182.1_i000_010386	107	331	224	1	0.455285
GCA_001447755.1-Ani_JYDO01000074.1_i000_010340	388	612	224	1	0.28535
GCA_001447725.1-Ani_JYDS01000012.1_i000_001254	389	613	224	1	0.284987
GCA_001447575.1-Ani_JYDT01000001.1_i000_000099	389	613	224	1	0.284987
GCA_001447675.1-Ani_JYDR01000002.1_i000_000477	400	624	224	1	0.281054
GCA_001447665.1-Ani_JYDP01000012.1_i000_001919	434	658	224	1	0.269555
GCA_001447645.1-Ani_JYDV01000002.1_i000_000343	421	645	224	1	0.273839
GCA_001447445.1-Ani_JYDU01000030.1_i000_005963	442	666	224	1	0.266985
GCA_902829235.1-Ani_CADEPI010000281.1_i000_012163	123	346	223	0.995536	0.441584
GCA_003076615.3-Ani_NJHN03000117.1_i000_007851	232	455	223	0.995536	0.362013
GCA_905338395.1-Ani_CAJPEW010000029.1_i000_000402	119	342	223	0.995536	0.437255
GCA_002135145.1-Ani_MUJZ01056654.1_i000_011895	111	334	223	0.995536	0.449597
GCA_003344405.1-Ani_NOWV01000290.1_i000_006163	114	335	221	0.986607	0.447368
GCA_900618015.1-Ani_UZAK01039108.1_i000_016235	127	351	224	1	0.603774
GCA_905249995.1-Ani_CAJNOK010020167.1_i000_029025	94	317	223	0.995536	0.460744
GCA_905250885.1-Ani_CAJNOQ010008414.1_i000_023495	94	317	223	0.995536	0.460744
GCA_905332065.1-Ani_CAJOBC010008415.1_i000_023494	94	317	223	0.995536	0.460744
GCA_905332075.1-Ani_CAJOBA010041758.1_i000_029793	94	317	223	0.995536	0.460744
GCA_008360955.1-Ani_LUCM01008496.1_i000_008484	125	349	224	1	0.425856
GCA_900618395.1-Ani_UZAI01017338.1_i000_016896	127	351	224	1	0.424242
GCA_000150275.1-Ani_DS985242.1_i000_008893	114	332	218	0.973214	0.443992
GCA_905397405.1-Ani_CAJPVJ010012461.1_i000_013598	129	343	214	0.955357	0.623907
GCA_000699445.3-Ani_CM039143.1_i000_004273	127	351	224	1	0.424242
GCA_002763495.2-Ani_JXXN02002880.1_i000_006883	125	349	224	1	0.425856
GCA_006368765.1-Ani_SKCS01000061.1_i000_008566	127	351	224	1	0.425856
GCA_000767015.2-Ani_ASGP02000003.1_i000_008680	110	333	223	0.995536	0.450505
GCA_020809275.1-Ani_SDOV01000007.1_i000_002701	110	333	223	0.995536	0.450505
GCA_002081605.1-Ani_MNPL01002959.1_i000_002558	144	367	223	0.995536	0.419962
GCA_003604175.2-Ani_CM030371.1_i000_009764	124	348	224	1	0.42344
GCA_000209185.1-Ani_DS231841.1_i000_016781	128	344	216	0.964286	0.426877
GCA_004794785.1-Ani_SJOL01001134.1_i000_000585	124	348	224	1	0.42344
GCA_002082055.1-Ani_MTYJ01000314.1_i000_017580	103	326	223	0.995536	0.456967
GCA_016584305.1-Ani_JACEEZ010017225.1_i000_012391	113	336	223	0.995536	0.449597
GCA_001990785.1-Ani_KV892841.1_i000_003967	124	348	224	1	0.460905
GCA_004104545.1-Ani_SAUD01010417.1_i000_008491	121	344	223	0.995536	0.573265
GCA_008508345.1-Ani_QNGE01001031.1_i000_003916	128	352	224	1	0.421053
GCA_013368495.1-Ani_LUCH01001308.1_i000_003171	128	352	224	1	0.421053
GCA_014338405.1-Ani_JTDE01022163.1_i000_012448	128	352	224	1	0.421053
GCA_015252655.1-Ani_JTDF01002701.1_i000_003992	128	352	224	1	0.421053
GCA_009176605.1-Ani_SEYY01012740.1_i000_007458	121	344	223	0.995536	0.44334
GCA_009176605.1-Ani_SEYY01022761.1_i000_012909	121	344	223	0.995536	0.44334
GCA_001949185.1-Ani_BDGG01000001.1_i000_000730	105	328	223	0.995536	0.444223
GCA_013400355.1-Ani_VXBV01005915.1_i000_009516	1	156	155	0.691964	0.488959
GCA_013401155.1-Ani_VZUF01139884.1_i000_003772	1	156	155	0.691964	0.479876
GCA_000828355.1-Ani_JXLN01009656.1_i000_003006	107	330	223	0.995536	0.455102
GCA_014595675.1-Ani_WVUK01000046.1_i000_003137	107	330	223	0.995536	0.455102
GCA_905250075.1-Ani_CAJNOP010000212.1_i000_037770	114	337	223	0.995536	0.440711
GCA_905329745.1-Ani_CAJNSZ010000184.1_i000_021147	114	337	223	0.995536	0.440711
GCA_905330535.1-Ani_CAJNVN010000129.1_i000_018650	114	337	223	0.995536	0.440711
GCA_905330805.1-Ani_CAJNWK010000405.1_i000_023635	114	337	223	0.995536	0.440711
GCA_905332165.1-Ani_CAJOBK010000799.1_i000_008741	114	337	223	0.995536	0.440711
GCA_905332175.1-Ani_CAJOBL010006457.1_i000_023786	114	337	223	0.995536	0.440711
GCA_905332225.1-Ani_CAJOBN010003184.1_i000_014175	114	337	223	0.995536	0.440711
GCA_902702955.1-Ani_CACRXO010000011.1_i000_001739	100	324	224	1	0.430769
GCA_905250055.1-Ani_CAJNOF010000011.1_i000_008912	114	337	223	0.995536	0.440711
GCA_905250075.1-Ani_CAJNOP010000211.1_i000_037723	114	337	223	0.995536	0.440711
GCA_905331515.1-Ani_CAJNZC010000365.1_i000_023256	114	337	223	0.995536	0.440711
GCA_905332295.1-Ani_CAJOBT010005201.1_i000_023075	114	337	223	0.995536	0.440711
GCA_905332315.1-Ani_CAJOBV010005810.1_i000_028037	114	337	223	0.995536	0.440711
GCA_905332325.1-Ani_CAJOBW010004704.1_i000_017702	114	337	223	0.995536	0.440711
GCA_905332015.1-Ani_CAJOAZ010008441.1_i000_039931	47	270	223	0.995536	0.507973
GCA_905250065.1-Ani_CAJNON010000156.1_i000_017058	109	332	223	0.995536	0.44511
GCA_905332035.1-Ani_CAJOAY010003422.1_i000_030970	109	332	223	0.995536	0.44511
GCA_905250015.1-Ani_CAJNOM010000060.1_i000_012215	109	332	223	0.995536	0.44511
GCA_905250015.1-Ani_CAJNOM010000062.1_i000_012518	109	332	223	0.995536	0.44511
GCA_905250115.1-Ani_CAJNOI010000056.1_i000_013762	109	332	223	0.995536	0.44511
GCA_905261645.1-Ani_CAJNOV010009087.1_i000_019335	114	337	223	0.995536	0.440711
GCA_905273325.1-Ani_CAJNOW010000082.1_i000_001280	114	337	223	0.995536	0.440711
GCA_905319835.1-Ani_CAJNRE010000077.1_i000_001214	114	337	223	0.995536	0.440711
GCA_905321285.1-Ani_CAJNRF010000075.1_i000_001387	114	337	223	0.995536	0.440711
GCA_905321535.1-Ani_CAJNRG010013426.1_i000_028102	114	337	223	0.995536	0.440711
GCA_905332115.1-Ani_CAJOBH010000395.1_i000_002310	114	337	223	0.995536	0.440711
GCA_905332125.1-Ani_CAJOBJ010000245.1_i000_001477	114	337	223	0.995536	0.440711
GCA_905332135.1-Ani_CAJOBI010000527.1_i000_002767	114	337	223	0.995536	0.440711
GCA_905332145.1-Ani_CAJOBF010001246.1_i000_012125	114	337	223	0.995536	0.440711
GCA_905332155.1-Ani_CAJOBG010000971.1_i000_008357	114	337	223	0.995536	0.440711
GCA_905331015.1-Ani_CAJNXB010003641.1_i000_021018	114	337	223	0.995536	0.440711
GCA_905331295.1-Ani_CAJNYD010001075.1_i000_009402	114	337	223	0.995536	0.440711
GCA_905331475.1-Ani_CAJNYU010001540.1_i000_012996	114	337	223	0.995536	0.440711
GCA_905331485.1-Ani_CAJNYT010004795.1_i000_027697	114	337	223	0.995536	0.440711
GCA_905331495.1-Ani_CAJNYV010003694.1_i000_020669	114	337	223	0.995536	0.440711
GCA_905332235.1-Ani_CAJOBO010001521.1_i000_019091	114	337	223	0.995536	0.440711
GCA_905332245.1-Ani_CAJOBP010000868.1_i000_008249	114	337	223	0.995536	0.440711
GCA_905332265.1-Ani_CAJOBQ010001591.1_i000_021014	114	337	223	0.995536	0.440711
GCA_905332275.1-Ani_CAJOBR010000584.1_i000_006520	114	337	223	0.995536	0.440711
GCA_905332285.1-Ani_CAJOBS010001599.1_i000_019977	114	337	223	0.995536	0.440711
GCA_010799875.2-Ani_VXIV02001534.1_i000_014934	113	337	224	1	0.452525
GCA_905250035.1-Ani_CAJNOE010000200.1_i000_019681	109	332	223	0.995536	0.653959
GCA_905332045.1-Ani_CAJOBB010004522.1_i000_034045	109	332	223	0.995536	0.661721
GCA_902702965.1-Ani_CACRXP010000097.1_i000_007053	133	357	224	1	0.195976
GCA_021613535.1-Ani_CP075497.1_i000_030991	109	332	223	0.995536	0.44511
GCA_905250005.1-Ani_CAJNOH010000067.1_i000_006122	114	337	223	0.995536	0.440711
GCA_905250125.1-Ani_CAJNOL010000074.1_i000_005047	114	337	223	0.995536	0.440711
GCA_905251635.1-Ani_CAJNOT010000032.1_i000_001774	114	337	223	0.995536	0.440711
GCA_905332095.1-Ani_CAJOBD010001189.1_i000_013683	114	337	223	0.995536	0.440711
GCA_905250875.1-Ani_CAJNOO010000074.1_i000_003193	114	337	223	0.995536	0.440711
GCA_905252715.1-Ani_CAJNOU010000015.1_i000_000853	114	337	223	0.995536	0.440711
GCA_905332085.1-Ani_CAJOAX010005829.1_i000_026930	114	337	223	0.995536	0.440711
GCA_905332105.1-Ani_CAJOBE010000865.1_i000_008662	114	337	223	0.995536	0.440711
GCA_905250125.1-Ani_CAJNOL010000068.1_i000_004713	114	337	223	0.995536	0.440711
GCA_004798865.1-Ani_SJPD01000064.1_i000_013987	71	184	113	0.504464	0.365696
GCA_004798865.1-Ani_SJPD01000064.1_i000_013987	184	231	47	0.209821	0.152104
GCA_905250095.1-Ani_CAJNOR010003159.1_i000_033228	105	328	223	0.995536	0.448692
GCA_905250025.1-Ani_CAJNOJ010000145.1_i000_024896	112	335	223	0.995536	0.444223
GCA_900622495.1-Ani_UYWX01000006.1_i000_000091	138	362	224	1	0.404332
GCA_905250025.1-Ani_CAJNOJ010000145.1_i000_024889	105	328	223	0.995536	0.452333
GCA_000469725.3-Ani_LN902842.1_i000_004092	173	397	224	1	0.380306
GCA_905250025.1-Ani_CAJNOJ010000185.1_i000_028308	112	335	223	0.995536	0.44246
GCA_905250095.1-Ani_CAJNOR010000288.1_i000_006364	112	335	223	0.995536	0.44246
GCA_014773135.1-Ani_JABEBT010000050.1_i000_007117	111	334	223	0.995536	0.430502
GCA_900618005.1-Ani_UYRS01019220.1_i000_009454	138	362	224	1	0.433269
GCA_000524195.1-Ani_APAU02000089.1_i000_003450	138	362	224	1	0.404332
GCA_021556725.1-Ani_CM038614.1_i000_003771	173	397	224	1	0.380306
GCA_007210705.1-Ani_CM017377.1_i000_005661	125	348	223	0.995536	0.434698
GCA_013339695.1-Ani_CM023526.1_i000_016472	107	234	127	0.566964	0.272532
GCA_013339695.1-Ani_CM023526.1_i000_016472	231	307	76	0.339286	0.16309
GCA_903994135.1-Ani_CAJEWN010000013.1_i000_003814	111	334	223	0.995536	0.543902
GCA_903994135.1-Ani_CAJEWN010000123.1_i000_017270	111	334	223	0.995536	0.440711
GCA_900617975.1-Ani_UZAE01012716.1_i000_009603	138	362	224	1	0.402154
GCA_903994135.1-Ani_CAJEWN010000174.1_i000_020988	111	334	223	0.995536	0.440711
GCA_006783055.1-Ani_VCRD01003710.1_i000_016659	121	344	223	0.995536	0.44246
GCA_018292915.1-Ani_JACVVK010000052.1_i000_007387	194	372	178	0.794643	0.345631
GCA_018292915.1-Ani_JACVVK010000052.1_i000_007387	371	388	17	0.0758929	0.0330097
GCA_900617995.1-Ani_UZAL01028575.1_i000_007694	127	342	215	0.959821	0.626822
GCA_900618445.1-Ani_UYSG01011121.1_i000_008655	138	362	224	1	0.402154
GCA_902177915.1-Ani_CABIJS010000016.1_i000_000749	148	372	224	1	0.395062
GCA_002104905.1-Fun_MCFE01000045.1_i000_009908	93	314	221	0.986607	0.477322
GCA_900617915.1-Ani_UYRT01083638.1_i000_016333	61	285	224	1	0.497778
GCA_000507165.2-Ani_KZ500261.1_i000_016341	69	270	201	0.897321	0.493857
GCA_020875895.1-Ani_JNEY01000006.1_i000_003766	108	332	224	1	0.452525
GCA_916381525.1-Ani_CAKAEH010001276.1_i000_004039	104	328	224	1	0.454361
GCA_014220965.1-Ani_LOND01002773.1_i000_005095	204	425	221	0.986607	0.389771
GCA_900537205.1-Ani_UYRW01003173.1_i000_007834	104	328	224	1	0.454361
GCA_900537255.1-Ani_UPTC01000756.1_i000_004639	104	328	224	1	0.454361
GCA_905332015.1-Ani_CAJOAZ010003579.1_i000_030426	28	249	221	0.986607	0.528708
GCA_900537275.1-Ani_UYRX01000122.1_i000_002860	104	328	224	1	0.454361
GCA_000188695.1-Pro_GL832968.1_i000_006016	122	345	223	0.995536	0.44334
GCA_003550305.1-Fun_QKYT01000080.1_i000_019090	98	319	221	0.986607	0.470213
GCA_021730765.1-Ani_JAIZAO010000089.1_i000_006570	107	323	216	0.964286	0.446281
GCA_000764305.3-Ani_JQDR03001316.1_i000_000501	122	345	223	0.995536	0.441584
GCA_000180755.1-Ani_ADBV01002657.1_i000_006334	104	328	224	1	0.454361
GCA_900622535.1-Ani_UYWW01001087.1_i000_003277	104	328	224	1	0.454361
GCA_003549995.1-Fun_QKKE01000403.1_i000_013513	68	289	221	0.986607	0.502273
GCA_000439145.3-Fun_AUPC02000029.1_i000_012581	134	355	221	0.986607	0.436759
GCA_000597685.1-Fun_JEMT01024014.1_i000_015283	134	355	221	0.986607	0.436759
GCA_001593125.1-Fun_LLXH01000434.1_i000_009683	134	355	221	0.986607	0.436759
GCA_001593155.1-Fun_LLXL01000260.1_i000_005886	134	355	221	0.986607	0.436759
GCA_001593205.1-Fun_LLXJ01000573.1_i000_009943	134	355	221	0.986607	0.436759
GCA_002897155.2-Fun_BDIQ02000033.1_i000_012795	134	355	221	0.986607	0.436759
GCA_903189765.1-Fun_CAEVNM010000002.1_i000_002479	134	355	221	0.986607	0.436759
GCA_903231485.1-Fun_CAFBRS010000318.1_i000_012562	134	355	221	0.986607	0.436759
GCA_903470525.1-Fun_CAGKOT010000032.1_i000_013828	134	355	221	0.986607	0.436759
GCA_903470595.1-Fun_CAGKPD010000009.1_i000_004309	134	355	221	0.986607	0.436759
GCA_910592225.1-Fun_CAJVPR010000541.1_i000_007140	134	355	221	0.986607	0.436759
GCA_903189815.1-Fun_CAEVNS010000074.1_i000_021213	134	355	221	0.986607	0.436759
GCA_001593145.1-Fun_LLXI01000303.1_i000_006948	134	355	221	0.986607	0.436759
GCA_903189775.1-Fun_CAEVNN010000860.1_i000_031578	134	355	221	0.986607	0.436759
GCA_900618355.1-Ani_UZAD01000183.1_i000_001831	104	328	224	1	0.454361
GCA_000002995.5-Ani_CAAKNF010000195.1_i000_007407	104	328	224	1	0.454361
GCA_003203555.1-Fun_BEXD01000491.1_i000_004786	134	355	221	0.986607	0.436759
GCA_015698045.1-Fun_BLAL01000036.1_i000_005416	134	355	221	0.986607	0.436759
GCA_000183805.3-Ani_JH712708.1_i000_012894	104	328	224	1	0.454361
GCA_910591825.1-Fun_CAJVPQ010000149.1_i000_001221	95	316	221	0.986607	0.475269
GCA_900618365.1-Ani_UYYF01000082.1_i000_000876	105	329	224	1	0.453441
GCA_016748015.1-Fun_JAAOMT010000258.1_i000_009958	126	347	221	0.986607	0.435039
GCA_900622545.1-Ani_UYWY01020010.1_i000_008820	107	331	224	1	0.438356
GCA_905250045.1-Ani_CAJNOG010000195.1_i000_019237	28	249	221	0.986607	0.565217
GCA_003547095.1-Fun_PQFF01000210.1_i000_009883	129	350	221	0.986607	0.444668
GCA_910592015.1-Fun_CAJVPK010000036.1_i000_000990	126	347	221	0.986607	0.450102
GCA_900604375.1-Ani_UXSR01000372.1_i000_002330	138	349	211	0.941964	0.358844
GCA_000803305.1-Ani_JPKZ01000956.1_i000_004653	107	331	224	1	0.454361
GCA_910592325.1-Fun_CAJVPM010012491.1_i000_006498	126	347	221	0.986607	0.456612
GCA_910591765.1-Fun_CAJVPS010000778.1_i000_003856	124	345	221	0.986607	0.433333
GCA_021442195.1-Pla_CM038211.1_i000_023057	111	332	221	0.986607	0.457557
GCA_021904315.1-Pla_CM038924.1_i000_023791	111	332	221	0.986607	0.457557
GCA_910591835.1-Fun_CAJVPV010010037.1_i000_009791	126	347	221	0.986607	0.447368
GCA_000002865.1-Pro_CH991543.1_i000_008766	117	340	223	0.995536	0.455102
GCA_910592215.1-Fun_CAJVPN010001198.1_i000_007233	68	289	221	0.986607	0.502273
GCA_910592255.1-Fun_CAJVPO010001772.1_i000_008680	119	340	221	0.986607	0.450102
GCA_016946835.1-Fun_JACVTC010000095.1_i000_027187	138	359	221	0.986607	0.440239
GCA_000757645.3-Ani_AZBU02000002.1_i000_006670	112	336	224	1	0.443564
GCA_002104895.1-Fun_MCFG01000082.1_i000_012025	138	359	221	0.986607	0.439364
GCA_900576705.1-Ani_UXUI01008308.1_i000_005874	111	335	224	1	0.448
GCA_910591945.1-Fun_CAJVPL010000472.1_i000_004247	125	346	221	0.986607	0.434185
GCA_000002425.2-Pla_CM009320.1_i000_008168	223	444	221	0.986607	0.371429
GCA_910592245.1-Fun_CAJVQB010035210.1_i000_028042	127	348	221	0.986607	0.450102
GCA_009809945.1-Fun_WTPW01000165.1_i000_004310	127	348	221	0.986607	0.444668
GCA_905397895.1-Ani_CAJPWZ010002729.1_i000_056128	1	168	167	0.745536	0.469101
GCA_014871385.1-Pla_CM026423.1_i000_008592	114	335	221	0.986607	0.454733
GCA_003550325.1-Fun_QKWP01000184.1_i000_005831	127	348	221	0.986607	0.444668
GCA_910591965.1-Fun_CAJVPY010007023.1_i000_011404	126	347	221	0.986607	0.270171
GCA_900618345.1-Ani_UZAJ01006419.1_i000_006610	13	251	238	1.0625	0.579075
GCA_910591605.1-Ani_CAJVCH010140173.1_i000_015683	100	276	176	0.785714	0.637681
GCA_000816745.1-Ani_KN730822.1_i000_009063	108	332	224	1	0.451613
GCA_003336725.1-Ani_JOJR01000852.1_i000_019906	108	332	224	1	0.451613
GCA_900617895.1-Ani_UZAF01000288.1_i000_000408	117	341	224	1	0.444444
GCA_000507365.1-Ani_KI668993.1_i000_017090	108	332	224	1	0.451613
GCA_000402015.1-Ani_KE125413.1_i000_012324	108	332	224	1	0.451613
GCA_000688135.1-Ani_JARK01001632.1_i000_034017	108	332	224	1	0.451613
GCA_002104945.1-Fun_MCFH01000028.1_i000_004676	141	362	221	0.986607	0.437624
GCA_900625125.1-Ani_UYYG01001159.1_i000_002180	106	330	224	1	0.451613
GCA_000816705.1-Ani_KN716153.1_i000_000473	108	332	224	1	0.434951
GCA_022478865.1-Ani_JAHXPS010006279.1_i000_031730	1	168	167	0.745536	0.503012
GCA_014871385.1-Pla_CM026425.1_i000_012983	111	332	221	0.986607	0.456612
GCA_014871845.1-Pla_CM026438.1_i000_015853	111	332	221	0.986607	0.456612
GCA_003427395.1-Pla_BFEA01000824.1_i000_031094	118	339	221	0.986607	0.451943
GCA_020310875.1-Pla_CM035422.1_i000_016588	111	332	221	0.986607	0.457557
GCA_910592345.1-Fun_CAJVPI010000099.1_i000_001516	129	350	221	0.986607	0.436759
GCA_910592205.1-Fun_CAJVPJ010000122.1_i000_001585	129	350	221	0.986607	0.436759
GCA_002269645.1-Ani_NIVC01000027.1_i000_001401	122	346	224	1	0.418692
GCA_002269645.1-Ani_NIVC01003258.1_i000_042538	122	346	224	1	0.418692
GCA_900618435.1-Ani_UYSU01038653.1_i000_014073	131	355	224	1	0.586387
GCA_002269645.1-Ani_NIVC01001310.1_i000_025309	122	346	224	1	0.408759
GCA_003958945.1-Ani_QMKO01003443.1_i000_009774	127	334	207	0.924107	0.434874
GCA_900617775.1-Ani_UYRU01060661.1_i000_010689	5	212	207	0.924107	0.844898
GCA_900624975.1-Ani_UYYA01000001.1_i000_000015	108	336	228	1.01786	0.456914
GCA_003032435.1-Pla_KZ772714.1_i000_008337	111	332	221	0.986607	0.457557
GCA_009936355.2-Pla_AP019867.1_i000_004283	111	332	221	0.986607	0.457557
GCA_014281875.1-Ani_CM024804.1_i000_010607	1	121	120	0.535714	0.422535
GCA_001641455.1-Pla_LVLJ01001475.1_i000_008891	149	370	221	0.986607	0.424184
GCA_013396775.1-Ani_VZRE01009989.1_i000_008243	30	180	150	0.669643	0.549451
GCA_013396775.1-Ani_VZRE01009989.1_i000_008243	204	222	18	0.0803571	0.0659341
GCA_014180765.2-Pla_MUAA02000041.1_i000_007383	47	268	221	0.986607	0.527446
GCA_009761265.1-Ani_VOSG01000238.1_i000_005840	99	323	224	1	0.455285
GCA_003990785.1-Fun_RBNK01003938.1_i000_006187	140	361	221	0.986607	0.415414
GCA_000143415.2-Pla_GL377593.1_i000_015465	71	292	221	0.986607	0.498871
GCA_000143415.2-Pla_GL377603.1_i000_018788	71	292	221	0.986607	0.498871
GCA_004786185.1-Ani_CM015718.1_i000_007676	94	256	162	0.723214	0.558621
GCA_021235465.1-Fun_JAJSME010000001.1_i000_000985	127	348	221	0.986607	0.443775
GCA_000203795.1-Fun_GL882887.1_i000_005525	96	315	219	0.977679	0.471983
GCA_000149865.1-Fun_DS022307.1_i000_002835	138	357	219	0.977679	0.432806
GCA_900617965.1-Ani_UYRV01117491.1_i000_011507	4	114	110	0.491071	0.327381
GCA_900617965.1-Ani_UYRV01117491.1_i000_011507	108	244	136	0.607143	0.404762
GCA_016758905.1-Fun_JAEPQZ010000001.1_i000_000192	127	348	221	0.986607	0.443775
GCA_000708835.1-Pla_DF237719.1_i000_002304	113	334	221	0.986607	0.454733
GCA_910591915.1-Fun_CAJVQA010017087.1_i000_014440	128	323	195	0.870536	0.377176
GCA_910591915.1-Fun_CAJVQA010017087.1_i000_014440	331	374	43	0.191964	0.0831721
GCA_910592005.1-Fun_CAJVPP010007868.1_i000_013400	90	305	215	0.959821	0.473568
GCA_009805615.1-Ani_VIIS01000074.1_i000_001052	113	138	25	0.111607	0.0598086
GCA_009805615.1-Ani_VIIS01000074.1_i000_001052	146	309	163	0.727679	0.389952
GCA_002284615.2-Pla_MU069807.1_i000_009193	118	339	221	0.986607	0.440239
GCA_001638985.2-Fun_KV440997.1_i000_013614	81	302	221	0.986607	0.495516
GCA_900617985.1-Ani_UYRR01034891.1_i000_018007	107	296	189	0.84375	0.362069
GCA_900617985.1-Ani_UYRR01034891.1_i000_018007	288	355	67	0.299107	0.128352
GCA_002006685.1-Fun_LYON01000010.1_i000_000164	152	372	220	0.982143	0.422265
GCA_020617195.1-Fun_JAFDOU010000922.1_i000_007356	152	372	220	0.982143	0.422265
GCA_020617715.1-Fun_JAFDOV010000642.1_i000_003779	152	372	220	0.982143	0.422265
GCA_020617725.1-Fun_JAFDOT010000808.1_i000_006320	152	372	220	0.982143	0.422265
GCA_021556665.1-Fun_JAKFGG010000029.1_i000_005707	152	372	220	0.982143	0.422265
GCA_021556675.1-Fun_JAKFGI010000027.1_i000_005227	152	372	220	0.982143	0.422265
GCA_011763935.1-Fun_JAANJC010000002.1_i000_000048	128	349	221	0.986607	0.445565
GCA_011763955.1-Fun_JAANJD010000002.1_i000_000046	128	349	221	0.986607	0.445565
GCA_000149305.1-Fun_CH476745.1_i000_002642	127	348	221	0.986607	0.446465
GCA_011763585.1-Fun_JAANIP010000114.1_i000_001214	127	348	221	0.986607	0.446465
GCA_011763695.1-Fun_JAANIQ010000136.1_i000_001531	127	348	221	0.986607	0.446465
GCA_011763715.1-Fun_JAANIR010000056.1_i000_000767	127	348	221	0.986607	0.446465
GCA_011763735.1-Fun_JAANIS010000174.1_i000_001174	127	348	221	0.986607	0.446465
GCA_011763755.1-Fun_JAANIW010000229.1_i000_002983	127	348	221	0.986607	0.446465
GCA_011763775.1-Fun_JAANIT010000005.1_i000_000107	127	348	221	0.986607	0.446465
GCA_011763795.1-Fun_JAANIV010000048.1_i000_000904	127	348	221	0.986607	0.446465
GCA_011763815.1-Fun_JAANIU010000619.1_i000_004920	127	348	221	0.986607	0.446465
GCA_011763835.1-Fun_JAANIX010000056.1_i000_001029	127	348	221	0.986607	0.446465
GCA_011763875.1-Fun_JAANIZ010000605.1_i000_004887	127	348	221	0.986607	0.446465
GCA_011763895.1-Fun_JAANIY010000188.1_i000_002195	127	348	221	0.986607	0.446465
GCA_011763915.1-Fun_JAANJB010000235.1_i000_002813	127	348	221	0.986607	0.446465
GCA_011763855.1-Fun_JAANJA010000243.1_i000_003074	127	348	221	0.986607	0.446465
GCA_003614735.1-Fun_KZ992524.1_i000_001911	106	327	221	0.986607	0.451943
GCA_905338405.1-Ani_CAJPEX010000289.1_i000_002534	106	334	228	1.01786	0.270784
GCA_011951285.1-Fun_JAANRG010000100.1_i000_001859	128	349	221	0.986607	0.446465
GCA_011763645.1-Fun_JAASGZ010000009.1_i000_000202	128	349	221	0.986607	0.445565
GCA_011763975.1-Fun_JAANJF010000867.1_i000_006182	128	349	221	0.986607	0.445565
GCA_011763995.1-Fun_JAANJE010000207.1_i000_001270	128	349	221	0.986607	0.445565
GCA_011764025.1-Fun_JAANQT010000650.1_i000_005372	128	349	221	0.986607	0.445565
GCA_011764055.1-Fun_JAANQS010000030.1_i000_000506	128	349	221	0.986607	0.445565
GCA_011764125.1-Fun_JAANQV010000106.1_i000_000569	128	349	221	0.986607	0.445565
GCA_011764145.1-Fun_JAANQZ010000307.1_i000_002077	128	349	221	0.986607	0.445565
GCA_011764185.1-Fun_JAANRA010000001.1_i000_000018	128	349	221	0.986607	0.445565
GCA_011764225.1-Fun_JAANRQ010001799.1_i000_005163	128	349	221	0.986607	0.445565
GCA_011764265.1-Fun_JAANRE010000145.1_i000_000457	128	349	221	0.986607	0.445565
GCA_011800955.1-Fun_JAANRM010000009.1_i000_000217	128	349	221	0.986607	0.445565
GCA_011800985.1-Fun_JAANRL010000034.1_i000_000583	128	349	221	0.986607	0.445565
GCA_011801035.1-Fun_JAANRN010000088.1_i000_001467	128	349	221	0.986607	0.445565
GCA_011801055.1-Fun_JAANRO010000041.1_i000_000845	128	349	221	0.986607	0.445565
GCA_011801305.1-Fun_JAANRS010000053.1_i000_000930	128	349	221	0.986607	0.445565
GCA_011801335.1-Fun_JAANRP010000008.1_i000_000170	128	349	221	0.986607	0.445565
GCA_011801385.1-Fun_JAANRR010000663.1_i000_005495	128	349	221	0.986607	0.445565
GCA_011801495.1-Fun_JAANRV010000019.1_i000_000358	128	349	221	0.986607	0.445565
GCA_011801505.1-Fun_JAANRU010000057.1_i000_001063	128	349	221	0.986607	0.445565
GCA_011801555.1-Fun_JAANRX010000056.1_i000_000949	128	349	221	0.986607	0.445565
GCA_011801575.1-Fun_JAANRW010000010.1_i000_000224	128	349	221	0.986607	0.445565
GCA_011801605.1-Fun_JAANRT010000051.1_i000_000884	128	349	221	0.986607	0.445565
GCA_011801645.1-Fun_JAANRB010000052.1_i000_000825	128	349	221	0.986607	0.445565
GCA_011801675.1-Fun_JAANQW010000016.1_i000_000260	128	349	221	0.986607	0.445565
GCA_011801705.1-Fun_JAANQY010000443.1_i000_004111	128	349	221	0.986607	0.445565
GCA_011801725.1-Fun_JAANQX010000003.1_i000_000060	128	349	221	0.986607	0.445565
GCA_011801785.1-Fun_JAANQR010000025.1_i000_000395	128	349	221	0.986607	0.445565
GCA_011801815.1-Fun_JAANQU010000019.1_i000_000303	128	349	221	0.986607	0.445565
GCA_011950945.1-Fun_JAANRD010000022.1_i000_000449	128	349	221	0.986607	0.445565
GCA_011950985.1-Fun_JAANRF010000024.1_i000_000509	128	349	221	0.986607	0.445565
GCA_011951295.1-Fun_JAANRC010000683.1_i000_005577	128	349	221	0.986607	0.445565
GCA_011952045.1-Fun_JAANRH010000686.1_i000_005645	128	349	221	0.986607	0.445565
GCA_011952115.1-Fun_JAANRI010000578.1_i000_004549	128	349	221	0.986607	0.445565
GCA_011952145.1-Fun_JAANRJ010000004.1_i000_000092	128	349	221	0.986607	0.445565
GCA_011952175.1-Fun_JAANRK010000002.1_i000_000048	128	349	221	0.986607	0.445565
GCA_000236345.1-Ani_DF143277.1_i000_005241	124	157	33	0.147321	0.0990991
GCA_000236345.1-Ani_DF143277.1_i000_005241	154	304	150	0.669643	0.45045
GCA_016758935.1-Fun_JAEPRE010000071.1_i000_008587	123	344	221	0.986607	0.448276
GCA_006461475.1-Ani_SUNJ01007567.1_i000_006056	1	168	167	0.745536	0.484058
GCA_000258705.1-Pla_AGSI01000009.1_i000_005256	116	337	221	0.986607	0.448276
GCA_001417965.1-Ani_LJWW01000049.1_i000_018661	106	247	141	0.629464	0.309211
GCA_001417965.1-Ani_LJWW01000049.1_i000_018661	244	296	52	0.232143	0.114035
GCA_016758965.1-Fun_JAEPRB010000288.1_i000_010791	133	354	221	0.986607	0.441118
GCA_000512255.2-Pla_CM008455.1_i000_000650	111	332	221	0.986607	0.457557
GCA_002271885.2-Pla_CM008443.1_i000_000536	111	332	221	0.986607	0.457557
GCA_011745845.1-Pla_VYZY01002554.1_i000_012135	187	408	221	0.986607	0.395349
GCA_011745865.1-Pla_VYZZ01001890.1_i000_009644	218	439	221	0.986607	0.374576
GCA_002083745.1-Fun_KV922187.1_i000_011082	79	300	221	0.986607	0.492205
GCA_002708625.1-Fun_KZ303862.1_i000_009278	79	300	221	0.986607	0.492205
GCA_002083735.1-Fun_KV921607.1_i000_010739	79	300	221	0.986607	0.492205
GCA_000825725.1-Fun_CDGI01000241.1_i000_008893	125	346	221	0.986607	0.446465
GCA_011762625.1-Fun_JAANIL010000846.1_i000_009026	125	346	221	0.986607	0.446465
GCA_011762635.1-Fun_JAANIK010000540.1_i000_007108	125	346	221	0.986607	0.446465
GCA_011763475.1-Fun_JAANIM010000860.1_i000_009040	125	346	221	0.986607	0.446465
GCA_011763565.1-Fun_JAANIN010000600.1_i000_008060	125	346	221	0.986607	0.446465
GCA_011764045.1-Fun_JAANQQ010000604.1_i000_007544	125	346	221	0.986607	0.446465
GCA_900059795.1-Pla_HG974438.1_i000_005305	134	355	221	0.986607	0.436759
GCA_017911155.1-Fun_JAEFCI010009751.1_i000_006179	272	493	221	0.986607	0.374576
GCA_000005505.4-Pla_CM000880.3_i000_007335	160	381	221	0.986607	0.415414
GCA_000583005.2-Pla_ASHM01031468.1_i000_032221	44	265	221	0.986607	0.669697
GCA_000797555.1-Ani_KN565057.1_i000_014835	108	334	226	1.00893	0.453815
GCA_000219495.2-Pla_CM001223.2_i000_037559	112	333	221	0.986607	0.456612
GCA_003473485.2-Pla_CM010654.1_i000_034513	112	333	221	0.986607	0.456612
GCA_002271895.2-Pla_CM008431.1_i000_000605	111	332	221	0.986607	0.457557
GCA_000825725.1-Fun_CDGI01000865.1_i000_017069	127	348	221	0.986607	0.444668
GCA_001879085.1-Pla_MJEQ01002470.1_i000_026697	133	354	221	0.986607	0.437624
GCA_900000135.1-Fun_CCYT01000011.1_i000_005265	126	347	221	0.986607	0.445565
GCA_003325435.1-Fun_PJQL01002870.1_i000_013563	125	346	221	0.986607	0.446465
GCA_001742945.1-Pla_DF973129.1_i000_002158	112	333	221	0.986607	0.492205
GCA_008124465.1-Pla_CM017872.1_i000_000912	112	333	221	0.986607	0.456612
GCA_006013705.1-Pla_RXGB01026140.1_i000_024601	47	268	221	0.986607	0.527446
GCA_020169535.1-Pla_CM034995.1_i000_027052	111	332	221	0.986607	0.457557
GCA_020169555.1-Pla_CM035019.1_i000_026200	111	332	221	0.986607	0.457557
GCA_020169575.1-Pla_CM035007.1_i000_026169	111	332	221	0.986607	0.457557
GCA_020169585.1-Pla_CM034983.1_i000_026217	111	332	221	0.986607	0.457557
GCA_000005005.6-Pla_CM007648.1_i000_006698	112	333	221	0.986607	0.45567
GCA_003185045.1-Pla_CM009907.1_i000_006494	112	333	221	0.986607	0.45567
GCA_018258275.1-Pla_CM031113.1_i000_043381	128	349	221	0.986607	0.442
GCA_014058105.1-Pla_JACGCM010000665.1_i000_013011	152	373	221	0.986607	0.421756
GCA_007726485.1-Pla_CM017443.1_i000_021061	112	333	221	0.986607	0.45567
GCA_007726485.1-Pla_CM017443.1_i000_021463	112	333	221	0.986607	0.45567
GCA_902829315.1-Ani_CADEPM010000006.1_i000_009365	118	342	224	1	0.440945
GCA_015342445.1-Pla_JACEFO010001619.1_i000_015611	81	302	221	0.986607	0.486784
GCA_017311265.1-Fun_JABTEF010000005.1_i000_002770	134	355	221	0.986607	0.435897
GCA_020887355.1-Pla_AP025003.1_i000_010048	116	337	221	0.986607	0.448276
GCA_015499975.1-Fun_JAAAUD010001046.1_i000_000295	166	387	221	0.986607	0.403285
GCA_001661175.1-Pla_LSRQ01006666.1_i000_020368	113	334	221	0.986607	0.45567
GCA_003573695.1-Pla_CM010721.1_i000_026476	113	334	221	0.986607	0.454733
GCA_000003195.3-Pla_CM000765.3_i000_022854	111	332	221	0.986607	0.456612
GCA_015952705.1-Pla_CM027685.1_i000_023400	111	332	221	0.986607	0.456612
GCA_905332305.1-Ani_CAJOBU010010490.1_i000_030357	114	292	178	0.794643	0.605442
GCA_905331505.1-Ani_CAJNYZ010000537.1_i000_025078	114	292	178	0.794643	0.605442
GCA_002211085.2-Pla_CM008052.2_i000_024836	112	333	221	0.986607	0.45567
GCA_003046395.2-Pla_CM009704.2_i000_048978	112	333	221	0.986607	0.45567
GCA_003046395.2-Pla_CM009705.2_i000_051580	112	333	221	0.986607	0.45567
GCA_003061485.1-Pla_CM009755.1_i000_024442	112	333	221	0.986607	0.45567
GCA_001633215.2-Pla_KV780740.1_i000_022300	122	343	221	0.986607	0.446465
GCA_016808335.1-Pla_CM029050.1_i000_069449	122	343	221	0.986607	0.446465
GCA_022539455.1-Pla_CM039729.1_i000_016830	113	334	221	0.986607	0.45567
GCA_001605985.2-Pla_KZ502877.1_i000_016620	113	334	221	0.986607	0.45102
GCA_016758895.1-Fun_JAEPRA010000010.1_i000_009112	124	345	221	0.986607	0.446465
GCA_904845875.1-Pla_CAJGYO010000012.1_i000_046061	111	332	221	0.986607	0.456612
GCA_000346465.2-Pla_CM007655.1_i000_015860	137	358	221	0.986607	0.434185
GCA_005286985.1-Pla_CM016558.1_i000_027399	112	333	221	0.986607	0.45567
GCA_904066235.2-Ani_CAJFCV020000001.1_i000_001555	107	331	224	1	0.29435
GCA_904067135.1-Ani_CAJFDI010000001.1_i000_001555	107	331	224	1	0.29435
GCA_904845875.1-Pla_CAJGYO010000011.1_i000_043452	112	333	221	0.986607	0.45567
GCA_003573695.1-Pla_CM010724.1_i000_036385	113	334	221	0.986607	0.454733
GCA_015500005.1-Fun_JAAAUG010001177.1_i000_000873	147	368	221	0.986607	0.417769
GCA_015529795.1-Fun_JAAAUH010001148.1_i000_000761	148	369	221	0.986607	0.416981
GCA_002245835.2-Pla_LHPG02000004.1_i000_006347	115	336	221	0.986607	0.449187
GCA_019279435.1-Pla_JAAALK010000285.1_i000_011682	112	333	221	0.986607	0.456612
GCA_016758985.1-Fun_JAEPRD010000059.1_i000_006340	122	343	221	0.986607	0.449187
GCA_002287525.1-Ani_LIAE01007728.1_i000_011513	107	331	224	1	0.450704
GCA_015679515.1-Fun_JAAAVA010000148.1_i000_002737	166	387	221	0.986607	0.404762
GCA_000263155.2-Pla_CM003534.1_i000_024491	64	285	221	0.986607	0.478355
GCA_016808335.1-Pla_CM029049.1_i000_030076	112	333	221	0.986607	0.45567
GCA_020424065.1-Pla_CM035471.1_i000_022202	113	334	221	0.986607	0.45567
GCA_002245815.2-Pla_LHPF02000006.1_i000_007837	115	336	221	0.986607	0.192845
GCA_903114435.1-Pla_CAEKKB010000005.1_i000_017984	138	359	221	0.986607	0.442886
GCA_903112645.1-Pla_CAEKDK010000005.1_i000_018098	138	359	221	0.986607	0.433333
GCA_004115385.1-Pla_CM014050.1_i000_003440	113	334	221	0.986607	0.45567
GCA_008932095.1-Pla_CM018506.1_i000_002196	113	334	221	0.986607	0.45567
GCA_001185155.1-Pla_LFYR01001099.1_i000_011732	113	334	221	0.986607	0.456612
GCA_905330235.1-Ani_CAJNUA010000242.1_i000_021492	114	298	184	0.821429	0.597403
GCA_002127325.2-Pla_CM007897.2_i000_030494	113	334	221	0.986607	0.45567
GCA_004837865.1-Pla_CM017190.1_i000_005944	138	359	221	0.986607	0.433333
GCA_016098135.1-Fun_JAAAIZ010000237.1_i000_003315	134	355	221	0.986607	0.424184
GCA_016098105.1-Fun_JAAAIY010000245.1_i000_003542	134	355	221	0.986607	0.424184
GCA_905331525.1-Ani_CAJNZF010000359.1_i000_022263	114	292	178	0.794643	0.605442
GCA_905331535.1-Ani_CAJNZB010000560.1_i000_029034	114	292	178	0.794643	0.605442
GCA_002870075.2-Pla_CM022525.1_i000_033588	113	334	221	0.986607	0.45567
GCA_000331365.3-Pla_AMZH03016647.1_i000_042055	122	343	221	0.986607	0.555276
GCA_000818735.3-Pla_JTFG03008954.1_i000_043488	122	343	221	0.986607	0.555276
GCA_014462685.1-Ani_JAACXV010013921.1_i000_015187	115	246	131	0.584821	0.284165
GCA_014462685.1-Ani_JAACXV010013921.1_i000_015187	243	303	60	0.267857	0.130152
GCA_001884805.1-Pla_MKKS01014170.1_i000_042633	135	356	221	0.986607	0.537713
GCA_004320505.1-Pla_AP015044.1_i000_029900	113	334	221	0.986607	0.45567
GCA_016808095.1-Pla_CM028992.1_i000_020230	113	334	221	0.986607	0.45567
GCA_018446385.1-Pla_CM031508.1_i000_004013	112	333	221	0.986607	0.45567
GCA_018446385.1-Pla_CM031509.1_i000_005710	112	333	221	0.986607	0.45567
GCA_006381635.2-Pla_VEPZ02000209.1_i000_006464	113	334	221	0.986607	0.45567
GCA_002966975.2-Pla_PJQY01001326.1_i000_018455	200	421	221	0.986607	0.486784
GCA_020497155.1-Pla_CM035722.1_i000_044868	145	366	221	0.986607	0.427466
GCA_014282035.1-Pla_CM024848.1_i000_032836	114	335	221	0.986607	0.456612
GCA_014282095.1-Pla_CM024928.1_i000_045155	114	335	221	0.986607	0.456612
GCA_014282145.1-Pla_CM024948.1_i000_044549	114	335	221	0.986607	0.454733
GCA_000004515.5-Pla_CM000849.3_i000_041195	114	335	221	0.986607	0.454733
GCA_000722935.2-Pla_KN664134.1_i000_038289	114	335	221	0.986607	0.454733
GCA_004193775.2-Pla_CM014372.1_i000_042866	114	335	221	0.986607	0.454733
GCA_012273815.2-Pla_CM022574.2_i000_044321	114	335	221	0.986607	0.454733
GCA_014282085.1-Pla_CM024908.1_i000_017950	114	335	221	0.986607	0.454733
GCA_014282345.1-Pla_CM024983.1_i000_044383	114	335	221	0.986607	0.454733
GCA_000004515.5-Pla_CM000852.4_i000_048682	114	335	221	0.986607	0.454733
GCA_000722935.2-Pla_KN642099.1_i000_003549	114	335	221	0.986607	0.454733
GCA_004193775.2-Pla_CM014375.1_i000_050859	114	335	221	0.986607	0.454733
GCA_012273815.2-Pla_CM022577.2_i000_052416	114	335	221	0.986607	0.454733
GCA_014282035.1-Pla_CM024851.1_i000_041600	114	335	221	0.986607	0.454733
GCA_014282085.1-Pla_CM024911.1_i000_026129	114	335	221	0.986607	0.454733
GCA_014282095.1-Pla_CM024931.1_i000_053668	114	335	221	0.986607	0.454733
GCA_014282145.1-Pla_CM024951.1_i000_052810	114	335	221	0.986607	0.454733
GCA_014282345.1-Pla_CM024986.1_i000_052897	114	335	221	0.986607	0.454733
GCA_020497155.1-Pla_CM035725.1_i000_053471	114	335	221	0.986607	0.454733
GCA_000263155.2-Pla_CM003532.1_i000_019934	112	333	221	0.986607	0.45567
GCA_005286985.1-Pla_CM016556.1_i000_022237	112	333	221	0.986607	0.45567
GCA_019845555.1-Pla_CM034083.1_i000_017059	113	334	221	0.986607	0.45567
GCA_000346465.2-Pla_CM007656.1_i000_019913	113	334	221	0.986607	0.45567
GCA_902201215.1-Pla_LR694011.1_i000_019291	113	334	221	0.986607	0.45567
GCA_902201215.1-Pla_LR694010.1_i000_015291	113	334	221	0.986607	0.45567
GCA_001040885.1-Ani_LN609528.1_i000_001507	136	360	224	1	0.427481
GCA_015849295.1-Fun_JAAAHW010003494.1_i000_004330	164	385	221	0.986607	0.434185
GCA_902860255.1-Pla_LR794331.1_i000_038851	113	334	221	0.986607	0.45567
GCA_008632915.2-Pla_AP019302.1_i000_016988	171	392	221	0.986607	0.406998
GCA_905332185.1-Ani_CAJOBM010008378.1_i000_027731	114	290	176	0.785714	0.606897
GCA_019671135.1-Fun_JAHRHY010000008.1_i000_011916	151	372	221	0.986607	0.416981
GCA_002966975.2-Pla_PJQY01002118.1_i000_025710	158	379	221	0.986607	0.416981
GCA_019776745.2-Pla_CM034147.1_i000_004946	579	800	221	0.986607	0.232387
GCA_009363875.1-Pla_SZYD01000412.1_i000_042188	250	471	221	0.986607	0.355305
GCA_003546025.1-Pla_QPKB01000004.1_i000_011486	171	392	221	0.986607	0.384348
GCA_009363875.1-Pla_CM018698.1_i000_022881	259	480	221	0.986607	0.350238
GCA_022085475.1-Pla_JAIUZE010045862.1_i000_015659	113	334	221	0.986607	0.451943
GCA_903112645.1-Pla_CAEKDK010000006.1_i000_022729	259	480	221	0.986607	0.350238
GCA_903114435.1-Pla_CAEKKB010000006.1_i000_022563	259	480	221	0.986607	0.350238
GCA_003952965.2-Pla_CM025855.1_i000_022719	109	330	221	0.986607	0.459459
GCA_000403535.1-Pla_CM001880.1_i000_006518	113	334	221	0.986607	0.45567
GCA_001974825.1-Pla_AWUE01023765.1_i000_034133	110	331	221	0.986607	0.458506
GCA_904066225.2-Ani_CAJFCW020000001.1_i000_001342	107	330	223	0.995536	0.293808
GCA_904067145.1-Ani_CAJFDH010000001.1_i000_001342	107	330	223	0.995536	0.293808
GCA_000499845.1-Pla_CM002290.1_i000_006639	113	334	221	0.986607	0.45567
GCA_000511025.2-Pla_CM002326.2_i000_014781	113	334	221	0.986607	0.451943
GCA_000005425.2-Pla_AP008210.2_i000_012375	112	333	221	0.986607	0.456612
GCA_001433935.1-Pla_AP014960.1_i000_018383	112	333	221	0.986607	0.456612
GCA_004007595.1-Pla_CM012944.1_i000_014059	112	333	221	0.986607	0.456612
GCA_002870075.2-Pla_CM022518.1_i000_000327	115	336	221	0.986607	0.453799
GCA_002994745.2-Pla_CM009583.1_i000_008596	113	334	221	0.986607	0.454733
GCA_009797565.1-Pla_CM020524.1_i000_015064	112	333	221	0.986607	0.452869
GCA_009746105.1-Pla_CM019271.1_i000_014008	160	381	221	0.986607	0.415414
GCA_006547085.1-Pla_VIEB01000970.1_i000_037069	113	334	221	0.986607	0.45567
GCA_004170445.1-Pla_CM014332.1_i000_053248	113	334	221	0.986607	0.34858
GCA_006381635.2-Pla_VEPZ02000843.1_i000_019926	113	334	221	0.986607	0.416981
GCA_003990745.1-Fun_RBNI01007879.1_i000_007151	133	339	206	0.919643	0.455752
GCA_003990765.1-Fun_RBNJ01000078.1_i000_000136	134	340	206	0.919643	0.454746
GCA_002174775.1-Pla_MVGT01003557.1_i000_002124	113	334	221	0.986607	0.45567
GCA_015502485.1-Fun_JAAAUO010000306.1_i000_007821	152	373	221	0.986607	0.416196
GCA_020424065.1-Pla_CM035465.1_i000_001630	433	654	221	0.986607	0.274534
GCA_000004655.2-Pla_CM000129.1_i000_016132	133	354	221	0.986607	0.410781
GCA_007990455.1-Pla_CM017638.1_i000_011585	81	302	221	0.986607	0.487859
GCA_001477535.1-Fun_LFWA01000016.1_i000_001384	133	354	221	0.986607	0.436759
GCA_007990325.1-Pla_CM017690.1_i000_012218	113	334	221	0.986607	0.45567
GCA_007990345.1-Pla_CM017664.1_i000_006153	113	334	221	0.986607	0.45567
GCA_007990485.1-Pla_CM017612.1_i000_012285	113	334	221	0.986607	0.45567
GCA_008761655.1-Pla_CM018204.1_i000_011294	124	345	221	0.986607	0.445565
GCA_002928715.1-Pla_KZ669006.1_i000_034180	126	347	221	0.986607	0.443775
GCA_019925795.1-Pla_CM034308.1_i000_013458	131	352	221	0.986607	0.439364
GCA_003958685.2-Pla_CP039349.1_i000_018684	113	334	221	0.986607	0.45567
GCA_000209535.1-Ani_FN653019.1_i000_004095	116	337	221	0.986607	0.432485
GCA_000149285.1-Pla_CM000141.1_i000_014978	216	437	221	0.986607	0.355878
GCA_003370565.1-Pla_QJKJ01000393.1_i000_001998	147	368	221	0.986607	0.425819
GCA_002837095.1-Pla_PGOL01001822.1_i000_025655	31	252	221	0.986607	0.548387
GCA_018127125.1-Pla_CM030799.1_i000_033940	287	508	221	0.986607	0.335357
GCA_003958685.2-Pla_CP039354.1_i000_034795	155	376	221	0.986607	0.419355
GCA_005223365.2-Pla_SPHZ02000006.1_i000_019885	112	333	221	0.986607	0.456612
GCA_004170445.1-Pla_CM014330.1_i000_042452	81	302	221	0.986607	0.487859
GCA_004329165.1-Pla_CM014732.1_i000_012835	113	334	221	0.986607	0.45567
GCA_018127085.1-Fun_CM030726.1_i000_001434	132	353	221	0.986607	0.437624
GCA_017311285.1-Fun_JABTEG010000001.1_i000_000269	134	355	221	0.986607	0.436759
GCA_014282245.1-Pla_CM024964.1_i000_027237	517	738	221	0.986607	0.248594
GCA_015852335.1-Fun_JAAAID010001695.1_i000_008296	144	365	221	0.986607	0.420152
GCA_003713155.1-Pla_CP030990.1_i000_053200	113	334	221	0.986607	0.45567
GCA_004170445.1-Pla_CM014322.1_i000_052195	113	334	221	0.986607	0.45567
GCA_013467485.1-Pla_JABEZX010355876.1_i000_026017	112	333	221	0.986607	0.559494
GCA_015849335.1-Fun_JAAAIC010001061.1_i000_000396	150	371	221	0.986607	0.415414
GCA_003713155.1-Pla_CP030988.1_i000_040108	113	334	221	0.986607	0.45567
GCA_003713155.1-Pla_CP030998.1_i000_043279	113	334	221	0.986607	0.45567
GCA_003614725.1-Fun_ML005449.1_i000_003732	70	291	221	0.986607	0.502273
GCA_016098045.1-Fun_JAAAIW010001212.1_i000_001073	161	382	221	0.986607	0.409259
GCA_002201585.1-Pla_MTKT01003224.1_i000_015634	122	343	221	0.986607	0.447368
GCA_004170445.1-Pla_CM014320.1_i000_038476	128	349	221	0.986607	0.442
GCA_013677255.1-Pla_CM025223.1_i000_008320	112	333	221	0.986607	0.522459
GCA_000787975.1-Pla_KN447304.1_i000_029836	113	334	221	0.986607	0.45567
GCA_018107945.1-Pla_JACEIK010000799.1_i000_016621	111	332	221	0.986607	0.457557
GCA_000003745.2-Pla_FN597015.1_i000_000739	151	372	221	0.986607	0.422562
GCA_011799765.1-Pla_JAANDH010000587.1_i000_017026	140	361	221	0.986607	0.431641
GCA_008636185.1-Pla_VXIU01000072.1_i000_012003	111	332	221	0.986607	0.451943
GCA_900231445.1-Pla_LT934114.1_i000_013595	122	343	221	0.986607	0.559494
GCA_000696525.1-Pla_KK914893.1_i000_020502	113	334	221	0.986607	0.45567
GCA_003024255.1-Pla_CM009666.1_i000_013656	112	333	221	0.986607	0.457557
GCA_013487665.1-Pla_CM025184.1_i000_008280	97	318	221	0.986607	0.471215
GCA_020496765.1-Pla_CM035624.1_i000_015247	113	334	221	0.986607	0.45567
GCA_016098015.1-Fun_JAAAIT010002348.1_i000_004337	73	294	221	0.986607	0.485714
GCA_015502575.1-Fun_JAAAUR010000815.1_i000_010620	150	371	221	0.986607	0.415414
GCA_015679695.1-Fun_JAAAVD010001172.1_i000_000903	150	371	221	0.986607	0.415414
GCA_004114815.1-Pla_SDOW01000492.1_i000_035358	112	333	221	0.986607	0.45567
GCA_013511315.1-Pla_CM025262.1_i000_007697	112	333	221	0.986607	0.456612
GCA_013467465.1-Pla_CM025158.1_i000_008035	112	333	221	0.986607	0.456612
GCA_013467475.1-Pla_CM025171.1_i000_008061	112	333	221	0.986607	0.456612
GCA_013677235.1-Pla_CM025197.1_i000_008878	112	333	221	0.986607	0.456612
GCA_013677275.1-Pla_CM025249.1_i000_008495	112	333	221	0.986607	0.456612
GCA_000695605.1-Pla_KK784875.1_i000_002072	81	302	221	0.986607	0.487859
GCA_000327365.1-Pla_CM001744.1_i000_012320	113	334	221	0.986607	0.45567
GCA_007990455.1-Pla_CM017650.1_i000_009137	113	334	221	0.986607	0.45567
GCA_013677245.1-Pla_CM025210.1_i000_008528	112	333	221	0.986607	0.456612
GCA_001659605.2-Pla_CM004398.2_i000_021406	113	334	221	0.986607	0.45567
GCA_008638375.1-Pla_CM018044.1_i000_034090	113	334	221	0.986607	0.385689
GCA_015679495.1-Fun_JAAAUW010001594.1_i000_007490	152	373	221	0.986607	0.416196
GCA_015679425.1-Fun_JAAAUV010001485.1_i000_002559	152	373	221	0.986607	0.416196
GCA_001651415.1-Fun_KV442040.1_i000_007259	152	373	221	0.986607	0.416196
GCA_001651415.1-Fun_KV442265.1_i000_014807	152	373	221	0.986607	0.416196
GCA_020744185.1-Fun_JAGSXK010000014.1_i000_003290	152	373	221	0.986607	0.416196
GCA_015852415.1-Fun_JAAAIH010000572.1_i000_009735	152	373	221	0.986607	0.416196
GCA_000493195.1-Pla_KI536726.1_i000_012519	114	335	221	0.986607	0.454733
GCA_022201065.1-Pla_CM039173.1_i000_013306	114	335	221	0.986607	0.454733
GCA_900617915.1-Ani_UYRT01078280.1_i000_010986	140	304	164	0.732143	0.3222
GCA_900617915.1-Ani_UYRT01078280.1_i000_010986	302	344	42	0.1875	0.0825147
GCA_002220415.3-Pla_CM022230.1_i000_098174	112	333	221	0.986607	0.464286
GCA_014362265.1-Pla_BJWL01000013.1_i000_019889	174	395	221	0.986607	0.405505
GCA_016808095.1-Pla_CM028986.1_i000_005583	37	258	221	0.986607	0.540342
GCA_013677265.1-Pla_CM025236.1_i000_007276	112	333	221	0.986607	0.456612
GCA_902729315.2-Pla_LR746277.1_i000_018300	113	334	221	0.986607	0.45567
GCA_020875875.1-Pla_CM037026.1_i000_019606	113	334	221	0.986607	0.426641
GCA_001865875.1-Pla_CM007371.1_i000_017421	113	334	221	0.986607	0.45567
GCA_022201045.1-Pla_CM039164.1_i000_013045	146	367	221	0.986607	0.426641
GCA_002762385.1-Pla_NKXS01001789.1_i000_010370	113	334	221	0.986607	0.457557
GCA_002897195.1-Pla_BDQV01000004.1_i000_002190	156	377	221	0.986607	0.418561
GCA_010458925.1-Pla_CM021228.1_i000_005963	134	355	221	0.986607	0.396057
GCA_002738505.1-Pla_KZ305019.1_i000_001085	181	402	221	0.986607	0.399638
GCA_013401445.1-Pla_CM023889.1_i000_025684	113	334	221	0.986607	0.45567
GCA_001865875.1-Pla_CM007363.1_i000_005079	113	334	221	0.986607	0.45567
GCA_004320505.1-Pla_AP015037.1_i000_011977	113	334	221	0.986607	0.45567
GCA_003325415.1-Fun_PJQM01004203.1_i000_010008	44	265	221	0.986607	0.533816
GCA_001190045.1-Pla_CM003373.1_i000_007696	133	354	221	0.986607	0.437624
GCA_007990345.1-Pla_CM017676.1_i000_040785	113	334	221	0.986607	0.45567
GCA_002786265.1-Pla_KZ451980.1_i000_012065	113	334	221	0.986607	0.45567
GCA_016858145.1-Pla_JAEHOE010000012.1_i000_004123	112	333	221	0.986607	0.452869
GCA_006535965.1-Fun_QEAR01000027.1_i000_004001	113	334	221	0.986607	0.454733
GCA_011763605.1-Fun_JAANIO010000147.1_i000_000797	104	325	221	0.986607	0.466245
GCA_001411555.2-Pla_CM023853.1_i000_030253	112	333	221	0.986607	0.456612
GCA_016808215.1-Pla_CM029000.1_i000_011289	113	334	221	0.986607	0.45567
GCA_001411555.2-Pla_CM023845.1_i000_011454	113	334	221	0.986607	0.45567
GCA_018687715.1-Pla_CM031813.1_i000_011409	113	334	221	0.986607	0.45567
GCA_018688675.1-Pla_CM031829.1_i000_011254	113	334	221	0.986607	0.45567
GCA_018689175.1-Pla_CM031845.1_i000_010633	113	334	221	0.986607	0.45567
GCA_000349005.2-Fun_AFWA02000012.1_i000_000752	134	354	220	0.982143	0.434783
GCA_016097865.1-Fun_JAAAIN010004334.1_i000_012425	27	248	221	0.986607	0.544335
GCA_007990325.1-Pla_CM017702.1_i000_009582	113	334	221	0.986607	0.45567
GCA_008761655.1-Pla_CM018216.1_i000_008911	113	334	221	0.986607	0.45567
GCA_000442015.1-Fun_KE560431.1_i000_000294	70	291	221	0.986607	0.502273
GCA_015502455.1-Fun_JAAAUM010000518.1_i000_008210	146	367	221	0.986607	0.418561
GCA_002220415.3-Pla_CM022211.1_i000_003685	112	333	221	0.986607	0.45567
GCA_002220415.3-Pla_CM022213.1_i000_012958	112	333	221	0.986607	0.45567
GCA_001974805.1-Pla_AWWV01010603.1_i000_013700	110	331	221	0.986607	0.458506
GCA_007990485.1-Pla_CM017624.1_i000_009703	113	334	221	0.986607	0.45567
GCA_001659605.2-Pla_CM004399.2_i000_023075	113	334	221	0.986607	0.45567
GCA_015847195.1-Fun_JAAAHV010000333.1_i000_005323	161	382	221	0.986607	0.407749
GCA_000510995.2-Pla_KQ131592.1_i000_000671	113	334	221	0.986607	0.451943
GCA_016808215.1-Pla_CM029009.1_i000_028451	113	334	221	0.986607	0.45567
GCA_018687715.1-Pla_CM031822.1_i000_028833	113	334	221	0.986607	0.45567
GCA_018688675.1-Pla_CM031838.1_i000_028582	113	334	221	0.986607	0.45567
GCA_018689175.1-Pla_CM031854.1_i000_027229	113	334	221	0.986607	0.45567
GCA_900231445.1-Pla_LT934112.1_i000_007350	143	364	221	0.986607	0.428295
GCA_015143295.1-Pla_CM026554.1_i000_006943	214	435	221	0.986607	0.442
GCA_018691285.1-Pla_CM031898.1_i000_027634	112	333	221	0.986607	0.456612
GCA_015680625.1-Fun_JAAAXW010000004.1_i000_008068	152	373	221	0.986607	0.416196
GCA_000182565.2-Fun_KQ257468.1_i000_008261	113	334	221	0.986607	0.454733
GCA_018691285.1-Pla_CM031884.1_i000_006722	112	333	221	0.986607	0.456612
GCA_015502465.1-Fun_JAAAUP010000466.1_i000_007596	156	377	221	0.986607	0.413084
GCA_014851425.1-Pla_CM026267.1_i000_024922	81	302	221	0.986607	0.487859
GCA_003024255.1-Pla_CM009682.1_i000_032336	112	333	221	0.986607	0.457557
GCA_004115005.2-Pla_CM032152.1_i000_025381	112	333	221	0.986607	0.434185
GCA_900231445.1-Pla_LT934111.1_i000_003563	214	435	221	0.986607	0.376491
GCA_904845305.1-Ani_CAJGYM010000001.1_i000_000475	110	333	223	0.995536	0.449597
GCA_014858505.1-Pla_CM026417.1_i000_021357	46	267	221	0.986607	0.528708
GCA_016808335.1-Pla_CM029050.1_i000_069450	112	333	221	0.986607	0.45567
GCA_004115005.2-Pla_CM032138.1_i000_006268	174	395	221	0.986607	0.404762
GCA_015849275.1-Fun_JAAAIA010000064.1_i000_007378	149	370	221	0.986607	0.414634
GCA_016098025.1-Fun_JAAAIU010001650.1_i000_003171	154	375	221	0.986607	0.414634
GCA_000151685.2-Pla_EQ973961.1_i000_015237	429	650	221	0.986607	0.28553
GCA_009771035.1-Pla_CM020020.1_i000_034354	113	334	221	0.986607	0.45567
GCA_001742945.1-Pla_DF973249.1_i000_011610	113	330	217	0.96875	0.657576
GCA_014362265.1-Pla_BJWL01000029.1_i000_041062	258	479	221	0.986607	0.351351
GCA_014905375.1-Pla_BMAC01001133.1_i000_027342	79	300	221	0.986607	0.492205
GCA_000327385.1-Ani_KB203683.1_i000_022297	8	150	142	0.633929	0.806818
GCA_015847235.1-Fun_JAAAHU010000164.1_i000_002538	152	373	221	0.986607	0.415414
GCA_016097935.1-Fun_JAAAIP010000129.1_i000_001180	161	382	221	0.986607	0.408503
GCA_010261695.1-Pla_CM021005.1_i000_016150	181	402	221	0.986607	0.399638
GCA_020921065.1-Pla_CM037153.1_i000_008494	162	383	221	0.986607	0.413858
GCA_900332095.2-Pla_OOIL02003369.1_i000_029521	113	334	221	0.986607	0.45567
GCA_016097715.1-Fun_JAAZWU010000146.1_i000_002016	120	341	221	0.986607	0.45567
GCA_016097735.1-Fun_JAAZWV010000189.1_i000_002334	120	341	221	0.986607	0.45567
GCA_016097755.1-Fun_JAAZWW010000207.1_i000_003120	120	341	221	0.986607	0.45567
GCA_000347455.1-Pla_KD251540.1_i000_020757	522	743	221	0.986607	0.246927
GCA_015502505.1-Fun_JAAAUQ010000499.1_i000_008440	152	373	221	0.986607	0.416196
GCA_015499985.1-Fun_JAAAUF010000384.1_i000_006625	152	373	221	0.986607	0.416196
GCA_015502475.1-Fun_JAAAUL010001214.1_i000_001285	156	376	220	0.982143	0.413534
GCA_016098085.1-Fun_JAAAIX010000204.1_i000_003660	156	376	220	0.982143	0.413534
GCA_015502445.1-Fun_JAAAUN010000134.1_i000_001771	156	376	220	0.982143	0.413534
GCA_000471905.1-Pla_KI397501.1_i000_025870	111	332	221	0.986607	0.457557
GCA_015502565.1-Fun_JAAAUS010000054.1_i000_007006	151	372	221	0.986607	0.411546
GCA_016098155.1-Fun_JAAAJB010000435.1_i000_005962	151	372	221	0.986607	0.411546
GCA_020796205.1-Pla_JAEACU010000380.1_i000_023886	117	338	221	0.986607	0.451943
GCA_902713445.1-Pla_CACTIH010003893.1_i000_038700	112	333	221	0.986607	0.456612
GCA_021605115.1-Pla_BMAR01000001.1_i000_001948	117	338	221	0.986607	0.449187
GCA_001584585.1-Pla_LSYV01000002.1_i000_000189	115	336	221	0.986607	0.45102
GCA_002914805.1-Pla_JXTB01000141.1_i000_016067	113	334	221	0.986607	0.457557
GCA_003260385.1-Pla_NQVE01000027.1_i000_006931	113	334	221	0.986607	0.45567
GCA_900332095.2-Pla_OOIL02004817.1_i000_034938	113	334	221	0.986607	0.45567
GCA_011766145.1-Pla_BLLF01001341.1_i000_013179	30	248	218	0.973214	0.534314
GCA_015679545.1-Fun_JAAAUZ010000002.1_i000_000055	147	368	221	0.986607	0.417769
GCA_002914845.1-Pla_JXTC01000021.1_i000_005163	113	334	221	0.986607	0.435039
GCA_014851425.1-Pla_CM026266.1_i000_020849	114	335	221	0.986607	0.454733
GCA_008009225.1-Pla_CM017768.1_i000_017642	128	349	221	0.986607	0.442
GCA_013676235.1-Pla_CM025505.1_i000_021227	112	333	221	0.986607	0.462343
GCA_004153795.2-Pla_SDRB02005865.1_i000_010531	117	338	221	0.986607	0.451943
GCA_000499845.1-Pla_CM002295.1_i000_019823	121	342	221	0.986607	0.485714
GCA_007844105.2-Pla_CM017577.2_i000_025905	117	338	221	0.986607	0.451943
GCA_000612305.1-Pla_KK198760.1_i000_024455	113	334	221	0.986607	0.45567
GCA_000004075.3-Pla_CM002926.2_i000_016236	112	333	221	0.986607	0.456612
GCA_019426215.1-Pla_CM033394.1_i000_010153	152	373	221	0.986607	0.423372
GCA_016097885.1-Fun_JAAAIO010000160.1_i000_002332	161	382	221	0.986607	0.408503
GCA_007844105.2-Pla_CM017577.2_i000_025474	179	400	221	0.986607	0.393238
GCA_001531365.1-Pla_CM009744.1_i000_017672	177	398	221	0.986607	0.390459
GCA_001929475.1-Fun_LXFE01000603.1_i000_000850	131	351	220	0.982143	0.433925
GCA_005239225.1-Pla_RCHU01000113.1_i000_004280	113	334	221	0.986607	0.454733
GCA_000180635.4-Ani_CM026579.1_i000_023444	116	339	223	0.995536	0.439842
GCA_015849285.1-Fun_JAAAHZ010000247.1_i000_003954	151	372	221	0.986607	0.417769
GCA_000002775.3-Pla_CM009303.1_i000_032315	113	334	221	0.986607	0.454733
GCA_000004655.2-Pla_CM000132.1_i000_023625	112	333	221	0.986607	0.456612
GCA_000005425.2-Pla_AP008213.2_i000_018057	112	333	221	0.986607	0.456612
GCA_000149285.1-Pla_CM000144.1_i000_022061	112	333	221	0.986607	0.456612
GCA_001433935.1-Pla_AP014963.1_i000_027056	112	333	221	0.986607	0.456612
GCA_004007595.1-Pla_CM012947.1_i000_020788	112	333	221	0.986607	0.456612
GCA_009797565.1-Pla_CM020527.1_i000_022046	112	333	221	0.986607	0.456612
GCA_015852605.2-Pla_CM027583.2_i000_024444	113	334	221	0.986607	0.454733
GCA_018804465.1-Pla_CM031995.1_i000_012412	113	334	221	0.986607	0.454733
GCA_002261195.1-Fun_MVBO01000011.1_i000_000532	131	352	221	0.986607	0.441118
GCA_015852435.1-Fun_JAAAIJ010000303.1_i000_006387	144	365	221	0.986607	0.422562
GCA_015852495.1-Fun_JAAAIK010000013.1_i000_001422	144	365	221	0.986607	0.422562
GCA_016098035.1-Fun_JAAAIV010000094.1_i000_010246	147	368	221	0.986607	0.419355
GCA_018804465.1-Pla_CM031994.1_i000_011039	145	366	221	0.986607	0.426641
GCA_000938895.1-Fun_LN734054.1_i000_012747	133	354	221	0.986607	0.440239
GCA_017552425.1-Pla_CM029800.1_i000_004674	114	335	221	0.986607	0.454733
GCA_020921065.1-Pla_CM037157.1_i000_020178	114	336	222	0.991071	0.43787
GCA_020921065.1-Pla_CM037157.1_i000_020178	405	450	45	0.200893	0.0887574
GCA_020921065.1-Pla_CM037157.1_i000_020178	438	502	64	0.285714	0.126233
GCA_902713445.1-Pla_LR743779.1_i000_005120	113	334	221	0.986607	0.45567
GCA_000945115.1-Fun_LK023331.1_i000_006269	124	345	221	0.986607	0.450102
GCA_015679585.1-Fun_JAAAVF010000024.1_i000_004806	140	361	221	0.986607	0.424184
GCA_012923435.1-Pla_JAATIP010000285.1_i000_005555	114	335	221	0.986607	0.469214
GCA_013030025.1-Pla_JAATIQ010000013.1_i000_004483	114	335	221	0.986607	0.469214
GCA_000002775.3-Pla_CM009291.1_i000_006739	114	335	221	0.986607	0.454733
GCA_005239225.1-Pla_RCHU01000554.1_i000_022408	114	335	221	0.986607	0.454733
GCA_015852605.2-Pla_CM027571.2_i000_005089	114	335	221	0.986607	0.454733
GCA_001972305.1-Pla_BDDD01001859.1_i000_022220	113	334	221	0.986607	0.45567
GCA_000340665.1-Pla_CM003609.1_i000_012222	81	302	221	0.986607	0.487859
GCA_000313135.1-Pro_KB007805.1_i000_000698	120	339	219	0.977679	0.446939
GCA_014839865.1-Fun_JABAYA010000138.1_i000_001545	121	342	221	0.986607	0.454733
GCA_000504015.1-Pla_KI631803.1_i000_019716	113	334	221	0.986607	0.457557
GCA_000511025.2-Pla_CM002326.2_i000_014783	76	297	221	0.986607	0.686335
GCA_002105155.1-Fun_MCFF01000045.1_i000_007942	99	320	221	0.986607	0.458506
GCA_000763605.2-Pla_JRKL02012448.1_i000_028146	113	334	221	0.986607	0.45567
GCA_005549215.1-Pla_SSTE01020484.1_i000_033743	112	333	221	0.986607	0.456612
GCA_005549225.1-Pla_SSTD01008475.1_i000_015970	112	333	221	0.986607	0.456612
GCA_015852375.1-Fun_JAAAIF010000708.1_i000_009747	144	365	221	0.986607	0.422562
GCA_002906115.4-Pla_PKMF03022086.1_i000_077409	129	350	221	0.986607	0.441118
GCA_016618255.1-Pla_VFSX01000280.1_i000_014340	335	556	221	0.986607	0.309958
GCA_018804465.1-Pla_CM031971.1_i000_033638	114	335	221	0.986607	0.373942
GCA_015847225.1-Fun_JAAAHT010000503.1_i000_003783	141	362	221	0.986607	0.421756
GCA_018804465.1-Pla_CM031970.1_i000_031626	114	335	221	0.986607	0.368948
GCA_016834605.1-Pla_JAEHOC010000001.1_i000_000832	114	335	221	0.986607	0.452869
GCA_011763645.1-Fun_JAASGZ010006418.1_i000_018526	119	340	221	0.986607	0.518779
GCA_015680655.1-Fun_JAABKD010000001.1_i000_000070	152	373	221	0.986607	0.416981
GCA_015679415.1-Fun_JAAAUT010000013.1_i000_001439	151	372	221	0.986607	0.417769
GCA_009078335.1-Pla_CM018573.1_i000_003087	114	335	221	0.986607	0.454733
GCA_000401635.1-Fun_KE123897.1_i000_000244	129	350	221	0.986607	0.443775
GCA_015731905.1-Pla_CM027660.1_i000_003247	114	335	221	0.986607	0.423372
GCA_019788775.1-Fun_JAIFTL010000102.1_i000_000269	150	371	221	0.986607	0.418561
GCA_001477545.1-Fun_LFVZ01000011.1_i000_000540	134	354	220	0.982143	0.434783
GCA_015847185.1-Fun_JAAAHX010000141.1_i000_001509	150	371	221	0.986607	0.418561
GCA_015849325.1-Fun_JAAAIB010000073.1_i000_008970	150	371	221	0.986607	0.418561
GCA_015852385.1-Fun_JAAAIE010001009.1_i000_000143	144	365	221	0.986607	0.422562
GCA_015679405.1-Fun_JAAAUU010000032.1_i000_006068	144	365	221	0.986607	0.422562
GCA_015679485.1-Fun_JAAAUY010001037.1_i000_000281	144	365	221	0.986607	0.422562
GCA_016098005.1-Fun_JAAAIS010000120.1_i000_001168	144	365	221	0.986607	0.422562
GCA_000143925.2-Ani_GL379792.1_i000_002993	119	342	223	0.995536	0.441584
GCA_000143925.2-Ani_GL380135.1_i000_025242	119	342	223	0.995536	0.441584
GCA_004379255.2-Pla_CM031474.1_i000_007469	133	354	221	0.986607	0.440239
GCA_019650235.1-Pla_BNCP01000083.1_i000_012857	114	335	221	0.986607	0.451943
GCA_019650255.1-Pla_BNCQ01000081.1_i000_012830	114	335	221	0.986607	0.451943
GCA_004379255.2-Pla_CM031475.1_i000_010402	180	401	221	0.986607	0.40255
GCA_002158475.1-Pla_KZ155771.1_i000_000273	124	350	226	1.00893	0.447525
GCA_000214015.2-Pla_CAID01000004.2_i000_001952	124	350	226	1.00893	0.447525
GCA_016413895.1-Pla_CM028158.1_i000_018031	113	334	221	0.986607	0.456612
GCA_015849305.1-Fun_JAAAHY010000961.1_i000_010445	152	373	221	0.986607	0.416981
GCA_000004555.3-Ani_FR847112.2_i000_001290	119	342	223	0.995536	0.441584
GCA_001638945.1-Fun_AMYB01000008.1_i000_010042	84	305	221	0.986607	0.487859
GCA_015679535.1-Fun_JAAAUX010000067.1_i000_009789	145	366	221	0.986607	0.421756
GCA_000723665.1-Fun_CBTN010000036.1_i000_007242	128	349	221	0.986607	0.446465
GCA_010203745.1-Fun_JAAECE010000004.1_i000_007471	130	351	221	0.986607	0.442886
GCA_019973155.1-Fun_BPQB01000001.1_i000_001033	163	384	221	0.986607	0.406998
GCA_022376435.1-Fun_JABYQE010000039.1_i000_006874	155	376	221	0.986607	0.416196
GCA_000149515.1-Ani_DS268926.1_i000_003644	119	342	223	0.995536	0.441584
GCA_010183535.1-Ani_CM021144.1_i000_000343	119	342	223	0.995536	0.441584
GCA_000375325.1-Pla_KB870806.1_i000_004773	111	332	221	0.986607	0.456612
GCA_019722365.1-Pla_JADFUC010000345.1_i000_002686	117	338	221	0.986607	0.452869
GCA_000143455.1-Pla_GL378361.1_i000_008577	116	337	221	0.986607	0.450102
GCA_000414095.2-Pla_KE344869.1_i000_013955	150	371	221	0.986607	0.404762
GCA_016097925.1-Fun_JAAAIQ010000096.1_i000_011770	474	695	221	0.986607	0.259086
GCA_000002985.3-Ani_BX284601.5_i000_000804	118	341	223	0.995536	0.44246
GCA_015852425.1-Fun_JAAAIG010000501.1_i000_008112	153	374	221	0.986607	0.415414
GCA_000002595.3-Pla_CM008971.1_i000_010118	114	335	221	0.986607	0.452869
GCA_000950595.1-Fun_DF836314.1_i000_009313	134	355	221	0.986607	0.439364
GCA_000320605.2-Fun_KB445792.1_i000_001384	159	380	221	0.986607	0.410781
GCA_902206195.3-Pla_CABITT030000002.1_i000_004517	114	335	221	0.986607	0.454733
GCA_016758945.1-Fun_JAEPRC010000309.1_i000_006089	130	351	221	0.986607	0.442886
GCA_019202805.1-Pla_CM032906.1_i000_031030	112	333	221	0.986607	0.45567
GCA_019202795.1-Pla_CM032919.1_i000_031007	112	333	221	0.986607	0.45567
GCA_900079185.1-Fun_LT554468.1_i000_007182	150	372	222	0.991071	0.427746
GCA_004369055.1-Fun_ML210989.1_i000_002090	161	382	221	0.986607	0.409259
GCA_017301755.1-Fun_CP054542.1_i000_002280	134	354	220	0.982143	0.434783
GCA_022453885.1-Ani_CP092620.1_i000_001113	119	342	223	0.995536	0.27162
GCA_021491975.1-Ani_CP090891.1_i000_001130	119	342	223	0.995536	0.27162
GCA_002105175.1-Fun_MCGE01000004.1_i000_009901	142	364	222	0.991071	0.435294
GCA_003367725.1-Fun_KZ857388.1_i000_004659	161	382	221	0.986607	0.409259
GCA_000313525.1-Fun_HE797112.1_i000_005896	161	382	221	0.986607	0.411546
GCA_013235015.1-Ani_BGPR01046930.1_i000_193617	3	159	156	0.696429	0.981132
GCA_000092065.1-Pla_CP000584.1_i000_001890	40	266	226	1.00893	0.575064
GCA_005298045.1-Fun_SWBT01000221.1_i000_011074	171	392	221	0.986607	0.401818
GCA_001687445.1-Fun_KV722333.1_i000_000828	160	381	221	0.986607	0.410781
GCA_003813185.1-Fun_ML122044.1_i000_001467	161	382	221	0.986607	0.409259
GCA_003813205.1-Fun_ML122250.1_i000_000025	161	382	221	0.986607	0.409259
GCA_000441915.1-Pla_KE528602.1_i000_004878	112	333	221	0.986607	0.458506
GCA_020796205.1-Pla_CM036899.1_i000_018746	138	358	220	0.982143	0.588235
GCA_022160315.1-Fun_MU275167.1_i000_002183	157	378	221	0.986607	0.410781
GCA_015529505.1-Fun_JAAAUI010000015.1_i000_001567	155	376	221	0.986607	0.412313
GCA_015529515.1-Fun_JAAAUJ010000097.1_i000_009663	155	376	221	0.986607	0.412313
GCA_905216605.1-Pla_LR999452.1_i000_004321	112	333	221	0.986607	0.45567
GCA_016098165.1-Fun_JAAAJA010000819.1_i000_009206	155	376	221	0.986607	0.412313
GCA_006386115.1-Pro_VFIW01000004.1_i000_010835	154	377	223	0.995536	0.42315
GCA_000739165.1-Fun_KN042423.1_i000_008294	145	366	221	0.986607	0.420952
GCA_015679645.1-Fun_JAAAVC010001455.1_i000_002360	145	366	221	0.986607	0.420952
GCA_002742825.1-Ani_CM008509.1_i000_001619	136	359	223	0.995536	0.265476
GCA_015679595.1-Fun_JAAAVB010000396.1_i000_007304	146	367	221	0.986607	0.420152
GCA_004307905.1-Fun_ML145087.1_i000_002281	162	383	221	0.986607	0.382353
GCA_004307915.1-Fun_ML144183.1_i000_011792	162	383	221	0.986607	0.382353
GCA_000264995.1-Fun_JH687541.1_i000_004103	156	377	221	0.986607	0.413858
GCA_008636005.1-Pla_BKCP01006737.1_i000_019301	311	533	222	0.991071	0.342065
GCA_020891255.1-Fun_BQFW01000008.1_i000_006580	150	371	221	0.986607	0.416981
GCA_002117355.1-Fun_KZ110602.1_i000_008751	159	380	221	0.986607	0.412313
GCA_013389845.1-Ani_VWPX01004300.1_i000_002872	30	158	128	0.571429	0.3026
GCA_013389845.1-Ani_VWPX01004300.1_i000_002872	234	256	22	0.0982143	0.0520095
GCA_000004255.1-Pla_GL348714.1_i000_005959	107	328	221	0.986607	0.460417
GCA_022376455.1-Fun_JACBKO010000034.1_i000_007095	155	376	221	0.986607	0.415414
GCA_001683725.1-Fun_LUGH01000071.1_i000_010020	121	342	221	0.986607	0.450102
GCA_001876935.1-Pla_CM007383.1_i000_006714	115	337	222	0.991071	0.454918
GCA_015500155.1-Fun_JAAAUE010003163.1_i000_004980	420	641	221	0.986607	0.27625
GCA_001632435.1-Fun_KV423947.1_i000_004214	105	326	221	0.986607	0.45567
GCA_015956445.1-Fun_WIUZ02000011.1_i000_002375	159	380	221	0.986607	0.412313
GCA_016771965.1-Pla_CM028696.1_i000_048155	112	333	221	0.986607	0.45567
GCA_020379485.1-Pla_CM035459.1_i000_060049	112	333	221	0.986607	0.45567
GCA_015832375.1-Fun_JADOXO010000069.1_i000_009498	159	380	221	0.986607	0.412313
GCA_004307925.1-Fun_ML143396.1_i000_003814	162	383	221	0.986607	0.406998
GCA_015178975.1-Fun_WHVD01000003.1_i000_007872	151	372	221	0.986607	0.415414
GCA_905216605.1-Pla_LR999458.1_i000_020840	102	325	223	0.995536	0.477516
GCA_022376465.1-Fun_JACDTU010000008.1_i000_011659	164	385	221	0.986607	0.406998
GCA_000275845.1-Fun_JH719404.1_i000_004480	162	383	221	0.986607	0.382353
GCA_019202795.1-Pla_CM032925.1_i000_052433	102	325	223	0.995536	0.473461
GCA_015039355.1-Fun_MU134298.1_i000_001269	152	373	221	0.986607	0.414634
GCA_001632425.1-Fun_KV425615.1_i000_010204	163	384	221	0.986607	0.408503
GCA_000300595.1-Fun_JH930469.1_i000_002420	164	385	221	0.986607	0.40625
GCA_022264815.1-Fun_JADCUA010000001.1_i000_000497	160	381	221	0.986607	0.411546
GCA_000004255.1-Pla_GL348720.1_i000_029155	97	320	223	0.995536	0.49011
GCA_002760635.1-Fun_AYKW01000001.1_i000_000554	147	368	221	0.986607	0.389771
GCA_002966975.2-Pla_PJQY01002919.1_i000_032049	113	332	219	0.977679	0.459119
GCA_000292625.1-Fun_JH795876.1_i000_009117	120	341	221	0.986607	0.442
GCA_014905635.1-Pla_JABVCE010000015.1_i000_002226	380	601	221	0.986607	0.0880478
GCA_002105135.1-Fun_MCGN01000008.1_i000_009943	122	342	220	0.982143	0.448065
GCA_000143185.1-Fun_GL377302.1_i000_000880	159	380	221	0.986607	0.406998
GCA_012274485.2-Pla_MU106574.1_i000_037257	112	333	221	0.986607	0.45567
GCA_003260675.2-Pla_QGKX02000004.1_i000_047373	112	333	221	0.986607	0.45567
GCA_016771965.1-Pla_CM028690.1_i000_020252	113	334	221	0.986607	0.454733
GCA_001683735.1-Fun_LUGG01000003.1_i000_003681	156	377	221	0.986607	0.415414
GCA_001895945.1-Fun_MNAD01000413.1_i000_010105	164	385	221	0.986607	0.40625
GCA_011114355.1-Pla_CM022090.1_i000_010183	111	331	220	0.982143	0.455487
GCA_015680635.1-Fun_JAABOA010001013.1_i000_004232	100	321	221	0.986607	0.457557
GCA_016771965.1-Pla_CM028700.1_i000_069276	112	333	221	0.986607	0.45567
GCA_020884735.1-Fun_BPWL01000002.1_i000_001700	154	375	221	0.986607	0.413858
GCA_003203535.1-Pla_BDRX01000148.1_i000_011892	115	336	221	0.986607	0.437624
GCA_001632365.1-Fun_KV427605.1_i000_000444	158	379	221	0.986607	0.413858
GCA_003260655.2-Pla_QGKV02001507.1_i000_054504	112	333	221	0.986607	0.45567
GCA_004802725.1-Fun_SGPM01000004.1_i000_005989	165	386	221	0.986607	0.408503
GCA_006535975.1-Fun_QEAP01000093.1_i000_003603	130	354	224	1	0.446215
GCA_017639395.1-Pla_CM029879.1_i000_005213	113	334	221	0.986607	0.454733
GCA_016771965.1-Pla_CM028703.1_i000_086890	113	334	221	0.986607	0.454733
GCA_020379485.1-Pla_CM035456.1_i000_043067	113	334	221	0.986607	0.454733
GCA_000697665.1-Fun_KL197709.1_i000_000814	167	388	221	0.986607	0.404762
GCA_003260695.2-Pla_QGKY02000246.1_i000_043372	148	369	221	0.986607	0.424184
GCA_012274485.2-Pla_MU105696.1_i000_012162	112	333	221	0.986607	0.45567
GCA_021029105.1-Fun_JAEVFJ010000003.1_i000_005918	197	418	221	0.986607	0.384348
GCA_000765035.1-Fun_CCBP010000183.1_i000_006495	167	388	221	0.986607	0.404762
GCA_003434825.1-Pla_CM010628.1_i000_002461	113	334	221	0.986607	0.454733
GCA_900412535.3-Pla_LS974617.2_i000_003106	116	337	221	0.986607	0.451943
GCA_004332605.1-Fun_RWJN01000120.1_i000_000897	520	741	221	0.986607	0.245829
GCA_014904855.1-Fun_MU117999.1_i000_005109	158	379	221	0.986607	0.413084
GCA_020379485.1-Pla_CM035446.1_i000_002548	136	357	221	0.986607	0.434185
GCA_019343175.1-Ani_CM033270.1_i000_001107	1	140	139	0.620536	0.579167
GCA_004355085.1-Fun_ML170156.1_i000_000625	147	368	221	0.986607	0.424184
GCA_001651475.1-Pla_CM004359.1_i000_004838	112	333	221	0.986607	0.45567
GCA_019202795.1-Pla_CM032913.1_i000_004772	112	333	221	0.986607	0.45567
GCA_902651935.1-Pla_CACRSJ010000104.1_i000_004993	112	333	221	0.986607	0.45567
GCA_902705455.1-Pla_CACSHJ010000087.1_i000_004874	112	333	221	0.986607	0.45567
GCA_904420315.1-Pla_LR881466.1_i000_004046	112	333	221	0.986607	0.45567
GCA_019202805.1-Pla_CM032900.1_i000_004650	112	333	221	0.986607	0.45567
GCA_007026445.1-Fun_VDMD01000002.1_i000_005804	159	380	221	0.986607	0.407749
GCA_022160335.1-Fun_MU274903.1_i000_002434	164	385	221	0.986607	0.407749
GCA_009905375.1-Pla_WRXP01001143.1_i000_000533	65	286	221	0.986607	0.506881
GCA_000827215.1-Fun_KN837076.1_i000_000262	151	372	221	0.986607	0.422562
GCA_000151265.1-Pla_GG663738.1_i000_006911	114	340	226	1.00893	0.454728
GCA_000448345.1-Ani_KE682364.1_i000_018817	132	257	125	0.558036	0.486381
GCA_001625215.1-Pla_CM004284.1_i000_025182	75	297	222	0.991071	0.487912
GCA_000271585.1-Fun_JH711785.1_i000_003633	164	385	221	0.986607	0.40625
GCA_002104975.1-Fun_MCOG01000251.1_i000_008915	138	343	205	0.915179	0.421811
GCA_015179125.1-Fun_WHVA01000085.1_i000_019279	152	373	221	0.986607	0.413858
GCA_004369045.1-Fun_ML213504.1_i000_001920	161	382	221	0.986607	0.408503
GCA_016097945.1-Fun_JAAAIR010000287.1_i000_004267	1	218	217	0.96875	0.569554
GCA_002705745.1-Fun_KZ303501.1_i000_003626	64	285	221	0.986607	0.511574
GCA_000344655.2-Fun_KE504133.1_i000_003475	159	380	221	0.986607	0.410781
GCA_001563735.1-Fun_KQ962369.1_i000_006390	112	333	221	0.986607	0.452869
GCA_004679265.1-Fun_SEKV01000009.1_i000_010618	160	385	225	1.00446	0.425331
GCA_002092935.1-Fun_KZ084135.1_i000_010101	167	388	221	0.986607	0.404762
GCA_000344685.1-Fun_KB469297.1_i000_002123	117	338	221	0.986607	0.444668
GCA_000827485.1-Fun_KN818229.1_i000_003642	144	365	221	0.986607	0.422562
GCA_000478725.1-Pla_KI517881.1_i000_024509	112	333	221	0.986607	0.456612
GCA_000218685.1-Fun_GL945431.1_i000_003591	164	385	221	0.986607	0.40625
GCA_000218725.1-Fun_GL945477.1_i000_003479	164	385	221	0.986607	0.40625
GCA_003851025.1-Fun_BFAD01000002.1_i000_002247	161	382	221	0.986607	0.411546
GCA_020736565.1-Fun_JAHBOF010000004.1_i000_016971	167	388	221	0.986607	0.406998
GCA_902728155.2-Pla_CACVBM020001373.1_i000_034441	112	333	221	0.986607	0.451943
GCA_905250055.1-Ani_CAJNOF010001039.1_i000_031596	760	937	177	0.790179	0.188699
GCA_905250075.1-Ani_CAJNOP010001602.1_i000_056186	760	937	177	0.790179	0.188699
GCA_018127125.1-Pla_CM030789.1_i000_004478	79	300	221	0.986607	0.669697
GCA_000090985.2-Pla_CP001575.1_i000_005744	123	349	226	1.00893	0.444008
GCA_003713155.1-Pla_CP031000.1_i000_056578	113	323	210	0.9375	0.33871
GCA_022160275.1-Fun_MU275842.1_i000_001257	156	377	221	0.986607	0.414634
GCA_019202805.1-Pla_CM032912.1_i000_052730	205	428	223	0.995536	0.388502
GCA_015179035.1-Fun_WHUY01000026.1_i000_004211	157	384	227	1.01339	0.380235
GCA_015039365.1-Fun_WION01000002.1_i000_005528	152	373	221	0.986607	0.416196
GCA_001913855.2-Fun_MLYV02001242.1_i000_012313	157	378	221	0.986607	0.413084
GCA_004802665.1-Fun_SGPJ01000015.1_i000_001470	157	378	221	0.986607	0.413084
GCA_001630345.1-Fun_KV417361.1_i000_011845	109	329	220	0.982143	0.45082
GCA_020921065.1-Pla_CM037153.1_i000_007818	86	307	221	0.986607	0.52619
GCA_022264855.1-Fun_JABYQU010000035.1_i000_006943	109	332	223	0.995536	0.455102
GCA_001642005.1-Ani_LWCA01000051.1_i000_004799	111	334	223	0.995536	0.449597
GCA_000697705.1-Fun_KL198117.1_i000_014952	158	379	221	0.986607	0.408503
GCA_001691785.2-Fun_JNHV02000011.1_i000_000730	149	370	221	0.986607	0.418561
GCA_005966545.1-Pro_SPLM01000108.1_i000_000598	155	378	223	0.995536	0.422348
GCA_001632345.1-Fun_KV429040.1_i000_002688	159	370	211	0.941964	0.380866
GCA_916048055.1-Pla_CAJZHL010000016.1_i000_004644	119	339	220	0.982143	0.439122
GCA_020796205.1-Pla_CM036896.1_i000_013081	120	341	221	0.986607	0.444668
GCA_015179025.1-Fun_WHUX01000002.1_i000_004188	110	337	227	1.01339	0.412727
GCA_000263375.1-Fun_JH668235.1_i000_003349	104	325	221	0.986607	0.447368
GCA_004918905.1-Fun_SPRC01000006.1_i000_003079	157	378	221	0.986607	0.404022
GCA_022160305.1-Fun_MU277187.1_i000_000431	155	376	221	0.986607	0.416196
GCA_001691755.2-Fun_JNHY02000003.1_i000_002612	150	371	221	0.986607	0.417769
GCA_004918025.1-Fun_SPRV01000005.1_i000_002654	157	378	221	0.986607	0.404022
GCA_004918155.1-Fun_SPRG01000010.1_i000_004219	157	378	221	0.986607	0.404022
GCA_004918605.1-Fun_SPRK01000005.1_i000_002491	157	378	221	0.986607	0.404022
GCA_004918635.1-Fun_SPRD01000001.1_i000_000075	157	378	221	0.986607	0.404022
GCA_004918645.1-Fun_SPRE01000001.1_i000_000076	157	378	221	0.986607	0.404022
GCA_004918725.1-Fun_SPRT01000004.1_i000_001970	157	378	221	0.986607	0.404022
GCA_004918795.1-Fun_SPRH01000004.1_i000_001962	157	378	221	0.986607	0.404022
GCA_004918805.1-Fun_SPRR01000001.1_i000_000076	157	378	221	0.986607	0.404022
GCA_004918985.1-Fun_SPRS01000001.1_i000_000076	157	378	221	0.986607	0.404022
GCA_004917925.1-Fun_SPRI01000003.1_i000_001263	160	381	221	0.986607	0.401818
GCA_004917935.1-Fun_SPRJ01000007.1_i000_003396	160	381	221	0.986607	0.401818
GCA_004917965.1-Fun_SPRO01000003.1_i000_001272	160	381	221	0.986607	0.401818
GCA_004917975.1-Fun_SPRM01000006.1_i000_003099	160	381	221	0.986607	0.401818
GCA_004918005.1-Fun_SPRU01000006.1_i000_002985	160	381	221	0.986607	0.401818
GCA_004918075.1-Fun_SPRL01000008.1_i000_003879	160	381	221	0.986607	0.401818
GCA_004918485.1-Fun_SPRQ01000004.1_i000_002137	160	381	221	0.986607	0.401818
GCA_004918525.1-Fun_SPRF01000009.1_i000_003995	160	381	221	0.986607	0.401818
GCA_004918665.1-Fun_SPRB01000007.1_i000_003356	160	381	221	0.986607	0.401818
GCA_004918835.1-Fun_SPRW01000004.1_i000_002028	160	381	221	0.986607	0.401818
GCA_004918915.1-Fun_SPRN01000008.1_i000_003762	160	381	221	0.986607	0.401818
GCA_004918925.1-Fun_SPRP01000002.1_i000_000352	160	381	221	0.986607	0.401818
GCA_004918995.1-Fun_SPRY01000003.1_i000_001318	160	381	221	0.986607	0.401818
GCA_004919005.1-Fun_SPRX01000008.1_i000_003669	160	381	221	0.986607	0.401818
GCA_018127125.1-Pla_CM030800.1_i000_035064	108	329	221	0.986607	0.227133
GCA_001974825.1-Pla_AWUE01021140.1_i000_029993	69	291	222	0.991071	0.524823
GCA_015679605.1-Fun_JAAAVE010000431.1_i000_007071	140	361	221	0.986607	0.426641
GCA_021029095.1-Fun_JAJOHG010000017.1_i000_003816	160	381	221	0.986607	0.409259
GCA_017499595.2-Fun_CM039001.1_i000_004891	163	384	221	0.986607	0.408503
GCA_003086735.1-Fun_MBFR01000221.1_i000_004254	121	341	220	0.982143	0.446247
GCA_000151315.2-Pro_KE346376.1_i000_008354	189	412	223	0.995536	0.37479
GCA_003788615.2-Fun_ML121529.1_i000_001395	159	386	227	1.01339	0.378965
GCA_016834595.1-Pla_JAEHOD010000038.1_i000_010315	114	317	203	0.90625	0.317188
GCA_015342445.1-Pla_JACEFO010002050.1_i000_038736	46	250	204	0.910714	0.563536
GCA_000300555.1-Fun_JH971389.1_i000_004403	111	332	221	0.986607	0.453799
GCA_016800925.1-Fun_JABCPU010000002.1_i000_006076	157	378	221	0.986607	0.410781
GCA_015584085.1-Fun_MU151076.1_i000_003132	170	391	221	0.986607	0.404762
GCA_002287475.2-Fun_CM008253.1_i000_003424	157	378	221	0.986607	0.411546
GCA_004918515.1-Fun_SPRA01000005.1_i000_002697	157	378	221	0.986607	0.404022
GCA_000448345.1-Ani_KE664658.1_i000_002237	61	186	125	0.558036	0.672043
GCA_001605315.2-Fun_LUEZ02000049.1_i000_010374	210	431	221	0.986607	0.374576
GCA_014872705.1-Fun_CM026496.1_i000_004576	170	391	221	0.986607	0.404762
GCA_016695475.1-Fun_MU172920.1_i000_001939	157	378	221	0.986607	0.410781
GCA_000832265.1-Fun_KN840469.1_i000_003738	158	379	221	0.986607	0.415414
GCA_000264905.1-Fun_JH687383.1_i000_004750	167	388	221	0.986607	0.406998
GCA_014871845.1-Pla_CM026436.1_i000_011531	114	295	181	0.808036	0.587662
GCA_002554575.1-Fun_KZ301978.1_i000_002196	154	375	221	0.986607	0.413858
GCA_004369125.1-Fun_ML178835.1_i000_008744	169	390	221	0.986607	0.403285
GCA_006535955.1-Fun_QEAN01000008.1_i000_000406	140	361	221	0.986607	0.423372
GCA_006536045.1-Fun_QEAM01000073.1_i000_002558	144	365	221	0.986607	0.420152
GCA_011066575.1-Fun_WIQW01000085.1_i000_011107	153	376	223	0.995536	0.382504
GCA_011066585.1-Fun_WIQY01000048.1_i000_007941	153	376	223	0.995536	0.382504
GCA_011066595.1-Fun_WIQZ01000094.1_i000_010999	153	376	223	0.995536	0.382504
GCA_011066605.1-Fun_WIQX01000084.1_i000_011139	153	376	223	0.995536	0.382504
GCA_015584075.1-Fun_MU150231.1_i000_001176	158	379	221	0.986607	0.412313
GCA_019364595.1-Fun_JAHRGV010000022.1_i000_002922	162	383	221	0.986607	0.406998
GCA_016647625.1-Fun_JABBWH010000004.1_i000_011223	157	378	221	0.986607	0.410781
GCA_020746845.1-Fun_JAGPNJ010000001.1_i000_000637	150	373	223	0.995536	0.414498
GCA_905219625.1-Fun_CAJMWX010001036.1_i000_003639	150	373	223	0.995536	0.414498
GCA_902705455.1-Pla_CACSHJ010000089.1_i000_016324	95	317	222	0.991071	0.473348
GCA_905219635.1-Fun_CAJMWY010000060.1_i000_000269	150	373	223	0.995536	0.388502
GCA_018924745.1-Fun_CM032182.1_i000_002942	162	383	221	0.986607	0.411546
GCA_000271605.1-Fun_JH717974.1_i000_007108	97	321	224	1	0.465696
GCA_013398345.1-Ani_WBNA01001137.1_i000_012914	1	100	99	0.441964	0.370787
GCA_013398735.1-Ani_VZSV01000902.1_i000_012661	1	100	99	0.441964	0.370787
GCA_016758785.1-Fun_JABBWO010000003.1_i000_006071	157	378	221	0.986607	0.410781
GCA_905232135.1-Fun_CAJNJQ010003406.1_i000_007236	150	373	223	0.995536	0.414498
GCA_001286725.1-Fun_CYGV01001733.1_i000_010022	150	373	223	0.995536	0.414498
GCA_001029375.1-Pro_BBXB01000381.1_i000_012955	766	989	223	0.995536	0.136391
GCA_002938355.1-Fun_NHTK01006035.1_i000_011019	162	383	221	0.986607	0.411546
GCA_000934385.1-Fun_KN880439.1_i000_001517	151	372	221	0.986607	0.424184
GCA_007859695.1-Pla_CP031034.1_i000_000075	109	330	221	0.986607	0.456612
GCA_000827195.1-Fun_KN838542.1_i000_001872	150	371	221	0.986607	0.420152
GCA_000827495.1-Fun_KN817518.1_i000_000605	169	390	221	0.986607	0.403285
GCA_001574975.1-Fun_KQ965734.1_i000_001705	107	328	221	0.986607	0.441118
GCA_013053245.1-Fun_JAACJL010000016.1_i000_006619	170	391	221	0.986607	0.404762
GCA_015484485.1-Fun_MU156557.1_i000_009184	170	391	221	0.986607	0.404762
GCA_000695385.1-Fun_KK764652.1_i000_001550	155	378	223	0.995536	0.410681
GCA_014904975.1-Fun_MU127806.1_i000_007270	159	380	221	0.986607	0.413858
GCA_015342405.1-Fun_JACYCF010000001.1_i000_000643	109	332	223	0.995536	0.448692
GCA_015852395.1-Fun_JAAAII010002613.1_i000_010785	152	356	204	0.910714	0.396887
GCA_016758775.1-Fun_JABBWN010000015.1_i000_003704	161	382	221	0.986607	0.407749
GCA_000350255.1-Fun_CAOJ01001134.1_i000_000859	147	370	223	0.995536	0.416822
GCA_000832345.2-Fun_LN679102.1_i000_004453	147	370	223	0.995536	0.416822
GCA_905219545.1-Fun_CAJMWQ010000981.1_i000_004212	147	370	223	0.995536	0.416822
GCA_013398375.1-Ani_VZSI01000512.1_i000_010343	1	102	101	0.450893	0.375465
GCA_004000055.1-Fun_SAEB01000007.1_i000_009534	153	376	223	0.995536	0.382504
GCA_011066845.1-Fun_JAABOJ010000060.1_i000_009798	153	376	223	0.995536	0.382504
GCA_015179045.1-Fun_WHUZ01000013.1_i000_003049	158	385	227	1.01339	0.377704
GCA_015341985.1-Fun_JACYCC010000037.1_i000_000526	150	373	223	0.995536	0.414498
GCA_905219565.1-Fun_CAJMWR010004313.1_i000_008317	150	373	223	0.995536	0.414498
GCA_015342415.1-Fun_JACYCE010000056.1_i000_000484	150	373	223	0.995536	0.414498
GCA_015342435.1-Fun_JACYCD010000049.1_i000_000483	150	373	223	0.995536	0.414498
GCA_016906535.1-Fun_CP059661.1_i000_003835	150	373	223	0.995536	0.414498
GCA_011066875.1-Fun_JAABOE010000008.1_i000_010434	76	299	223	0.995536	0.440711
GCA_011066885.1-Fun_WIWS01000056.1_i000_008737	76	299	223	0.995536	0.440711
GCA_011066985.1-Fun_WIPG01000113.1_i000_001151	76	299	223	0.995536	0.440711
GCA_018127125.1-Pla_CM030799.1_i000_034267	97	318	221	0.986607	0.594086
GCA_015484465.1-Fun_MU155148.1_i000_002663	169	390	221	0.986607	0.403285
GCA_016647635.1-Fun_JABBWG010000008.1_i000_014837	157	378	221	0.986607	0.410781
GCA_905219585.1-Fun_CAJMWS010000310.1_i000_003369	150	373	223	0.995536	0.414498
GCA_011066745.1-Fun_JAABOH010000116.1_i000_001378	131	354	223	0.995536	0.397504
GCA_011067015.1-Fun_JAABLO010000091.1_i000_011683	131	354	223	0.995536	0.397504
GCA_905219575.1-Fun_CAJMWT010001717.1_i000_002708	150	373	223	0.995536	0.414498
GCA_003709365.1-Pla_QOKY01000206.1_i000_005505	76	297	221	0.986607	0.229253
GCA_000827265.1-Fun_KN834749.1_i000_000092	107	328	221	0.986607	0.456612
GCA_014925785.1-Fun_WIQG01000010.1_i000_001169	108	329	221	0.986607	0.448276
GCA_004768765.1-Fun_SOZJ01000002.1_i000_003721	153	376	223	0.995536	0.382504
GCA_011066715.1-Fun_WIWQ01000031.1_i000_006279	153	376	223	0.995536	0.382504
GCA_011066735.1-Fun_JAABOI010000093.1_i000_011734	153	376	223	0.995536	0.382504
GCA_011066795.1-Fun_WIWR01000014.1_i000_002231	153	376	223	0.995536	0.382504
GCA_000225545.1-Fun_JH119005.1_i000_000723	153	376	223	0.995536	0.382504
GCA_011068445.1-Fun_JAAGKP010000056.1_i000_008403	153	376	223	0.995536	0.382504
GCA_011066905.1-Fun_WIWT01000044.1_i000_007437	153	376	223	0.995536	0.382504
GCA_011066925.1-Fun_WIPF01000001.1_i000_000014	153	376	223	0.995536	0.382504
GCA_016628565.1-Fun_JABBWD010000009.1_i000_014394	160	381	221	0.986607	0.408503
GCA_001029375.1-Pro_BBXB01000006.1_i000_000856	808	1031	223	0.995536	0.135727
GCA_000417875.1-Fun_KE361633.1_i000_003622	207	433	226	1.00893	0.36748
GCA_900322975.1-Fun_OOIP01000014.1_i000_004890	207	433	226	1.00893	0.36748
GCA_009746105.1-Pla_CM019267.1_i000_007620	118	339	221	0.986607	0.600543
GCA_016628075.1-Fun_JABBWC010000003.1_i000_008445	160	381	221	0.986607	0.408503
GCA_009078325.1-Fun_SSOP01000067.1_i000_007862	150	373	223	0.995536	0.414498
GCA_000520075.1-Pro_KI913162.1_i000_013333	127	347	220	0.982143	0.442656
GCA_002197585.2-Pro_MZMZ02002061.1_i000_004022	127	347	220	0.982143	0.442656
GCA_003546545.1-Pro_QUTB01004490.1_i000_004909	127	347	220	0.982143	0.442656
GCA_004379715.1-Fun_ML213591.1_i000_001508	168	389	221	0.986607	0.40625
GCA_001658105.1-Fun_KV448147.1_i000_002031	156	377	221	0.986607	0.411546
GCA_003546565.1-Pro_QUSZ01007044.1_i000_010014	127	347	220	0.982143	0.442656
GCA_003546585.1-Pro_QUTD01011700.1_i000_013789	127	347	220	0.982143	0.442656
GCA_003546605.1-Pro_QUTA01001869.1_i000_001161	127	347	220	0.982143	0.442656
GCA_003546625.1-Pro_QUTC01008450.1_i000_011538	127	347	220	0.982143	0.442656
GCA_003546765.1-Pro_QUTG01007137.1_i000_013199	127	347	220	0.982143	0.442656
GCA_003546785.1-Pro_QUTF01002875.1_i000_000926	127	347	220	0.982143	0.442656
GCA_003546805.1-Pro_QUTE01009019.1_i000_005120	127	347	220	0.982143	0.442656
GCA_003546825.1-Pro_QUTH01001263.1_i000_001654	127	347	220	0.982143	0.442656
GCA_001630475.1-Fun_KV419405.1_i000_005244	152	373	221	0.986607	0.396057
GCA_001632355.1-Fun_KV428239.1_i000_011175	152	373	221	0.986607	0.396057
GCA_015484515.1-Fun_MU154537.1_i000_004120	159	380	221	0.986607	0.412313
GCA_012979565.1-Fun_SJDA01000003.1_i000_006060	159	380	221	0.986607	0.412313
GCA_012980525.1-Fun_SJKE01000003.1_i000_005382	159	380	221	0.986607	0.412313
GCA_014925795.1-Fun_WIQF01000003.1_i000_008738	112	333	221	0.986607	0.448276
GCA_900624965.1-Ani_UYYB01100476.1_i000_012793	5	193	188	0.839286	0.723077
GCA_905219655.1-Fun_CAJMXA010002472.1_i000_004602	149	372	223	0.995536	0.41527
GCA_019616325.1-Fun_WSTG01001775.1_i000_009581	144	367	223	0.995536	0.418386
GCA_015179015.1-Fun_WHUW01000002.1_i000_006475	129	350	221	0.986607	0.433333
GCA_011800875.2-Fun_JRHT02000038.1_i000_013198	160	381	221	0.986607	0.408503
GCA_015039435.1-Fun_MU130753.1_i000_001300	162	383	221	0.986607	0.407749
GCA_011066565.1-Fun_WIRA01000065.1_i000_009333	153	376	223	0.995536	0.382504
GCA_011066695.1-Fun_WIRB01000007.1_i000_009913	153	376	223	0.995536	0.382504
GCA_021014945.1-Fun_MU266327.1_i000_000243	161	382	221	0.986607	0.407749
GCA_002286715.1-Fun_NSJX01000001.1_i000_000387	156	377	221	0.986607	0.413084
GCA_013398715.1-Ani_VZSU01004026.1_i000_013358	1	102	101	0.450893	0.375465
GCA_016628065.1-Fun_JABBWA010000002.1_i000_007033	105	326	221	0.986607	0.454733
GCA_019616345.1-Fun_WSTH01002672.1_i000_012628	149	372	223	0.995536	0.489035
GCA_019616345.1-Fun_WSTH01003175.1_i000_013758	149	372	223	0.995536	0.489035
GCA_000520115.1-Pro_KI913962.1_i000_006366	126	346	220	0.982143	0.444444
GCA_003546525.1-Pro_QUSY01000077.1_i000_001852	126	346	220	0.982143	0.444444
GCA_016695465.1-Fun_MU177896.1_i000_002354	158	379	221	0.986607	0.410019
GCA_019616915.1-Fun_WSTI01011645.1_i000_012018	149	372	223	0.995536	0.41527
GCA_001566745.1-Fun_KQ964437.1_i000_001693	126	346	220	0.982143	0.441767
GCA_002104935.1-Fun_MCGT01000004.1_i000_007324	118	340	222	0.991071	0.455852
GCA_004802705.1-Fun_SGPL01000028.1_i000_004227	135	356	221	0.986607	0.424184
GCA_019623705.1-Fun_WSTJ01001913.1_i000_012427	149	372	223	0.995536	0.454175
GCA_014462675.1-Fun_JACAZH010000011.1_i000_013614	159	380	221	0.986607	0.40625
GCA_015039395.1-Fun_MU132141.1_i000_001582	90	313	223	0.995536	0.465553
GCA_001633215.2-Pla_KV770768.1_i000_003216	68	289	221	0.986607	0.638728
GCA_001691835.3-Fun_JNHZ02000001.1_i000_000221	157	378	221	0.986607	0.413858
GCA_905219615.1-Fun_CAJMWW010000280.1_i000_006079	150	373	223	0.995536	0.414498
GCA_001078535.1-Pro_CAIX01000086.1_i000_005828	129	352	223	0.995536	0.44511
GCA_016767475.1-Fun_MU179299.1_i000_001788	110	331	221	0.986607	0.450102
GCA_015039315.1-Fun_WIDE01000151.1_i000_003292	156	377	221	0.986607	0.400362
GCA_022496185.1-Fun_WTXG01000002.1_i000_003582	154	374	220	0.982143	0.423892
GCA_003144115.1-Fun_KZ819301.1_i000_005393	147	368	221	0.986607	0.396768
GCA_002938375.1-Fun_NHYD01003440.1_i000_015050	172	393	221	0.986607	0.401818
GCA_000827355.1-Fun_KN831771.1_i000_003583	160	381	221	0.986607	0.411546
GCA_021018615.1-Fun_JAEVFL010000004.1_i000_005234	162	383	221	0.986607	0.389085
GCA_013397935.1-Ani_VZRN01003028.1_i000_006536	1	100	99	0.441964	0.375
GCA_019787685.1-Fun_JAHNUO010000002.1_i000_001295	161	382	221	0.986607	0.409259
GCA_001882365.1-Fun_LVVM01000339.1_i000_000800	636	857	221	0.986607	0.217306
GCA_900000165.1-Fun_CCYA01000269.1_i000_005190	155	376	221	0.986607	0.386364
GCA_013368445.1-Fun_JAACJO010000001.1_i000_000540	160	381	221	0.986607	0.410781
GCA_000827275.1-Fun_KN833686.1_i000_000554	162	388	226	1.00893	0.415441
GCA_016758765.1-Fun_JABBWL010000001.1_i000_000371	157	378	221	0.986607	0.410781
GCA_900618405.1-Ani_UYSL01002647.1_i000_002365	8	191	183	0.816964	0.563077
GCA_006535985.1-Fun_QEAO01000003.1_i000_000854	134	355	221	0.986607	0.429961
GCA_900000015.1-Pro_CCYD01000523.1_i000_005820	150	374	224	1	0.425856
GCA_022264835.1-Fun_JAIFHY010000018.1_i000_004301	156	385	229	1.02232	0.414855
GCA_003788565.2-Fun_ML119649.1_i000_001725	159	386	227	1.01339	0.380235
GCA_012184355.1-Fun_LDUC01000151.1_i000_008130	155	378	223	0.995536	0.381849
GCA_001268165.1-Fun_CVQI01035050.1_i000_017636	154	367	213	0.950893	0.321752
GCA_001268165.1-Fun_CVQI01035050.1_i000_017636	364	439	75	0.334821	0.113293
GCA_000310025.1-Pro_FN648498.1_i000_015900	165	386	221	0.986607	0.413084
GCA_022496225.1-Fun_WTXE01000013.1_i000_002208	155	375	220	0.982143	0.417457
GCA_000478725.1-Pla_KI517609.1_i000_017524	89	311	222	0.991071	0.484716
GCA_003788595.2-Fun_ML120375.1_i000_005150	166	393	227	1.01339	0.372742
GCA_000934395.1-Fun_KN881724.1_i000_004807	122	342	220	0.982143	0.442656
GCA_019677325.2-Fun_CM033830.1_i000_008886	159	380	221	0.986607	0.397482
GCA_015657495.1-Fun_MU157825.1_i000_001198	167	388	221	0.986607	0.405505
GCA_001020605.1-Fun_KQ086034.1_i000_010627	152	373	221	0.986607	0.417769
GCA_018282005.1-Fun_JABCKV010000096.1_i000_005017	167	388	221	0.986607	0.429961
GCA_000524645.1-Fun_JATN01000308.1_i000_001096	110	333	223	0.995536	0.447791
GCA_002938385.1-Fun_NHYE01005657.1_i000_015634	173	394	221	0.986607	0.403285
GCA_000365505.1-Pro_ANIZ01002880.1_i000_016380	101	325	224	1	0.469602
GCA_000509525.1-Pro_KI695036.1_i000_015764	101	325	224	1	0.469602
GCA_003144125.1-Fun_KZ819188.1_i000_000220	193	417	224	1	0.369637
GCA_000182895.1-Fun_AACS02000005.1_i000_006610	177	398	221	0.986607	0.398198
GCA_016906575.1-Fun_CP059613.1_i000_004537	203	426	223	0.995536	0.376689
GCA_016906575.1-Fun_CP059629.1_i000_019377	203	426	223	0.995536	0.376689
GCA_016906555.1-Fun_CP059645.1_i000_004422	203	426	223	0.995536	0.376689
GCA_021461655.1-Ani_CM038282.1_i000_000085	127	285	158	0.705357	0.345733
GCA_021461655.1-Ani_CM038282.1_i000_000085	283	305	22	0.0982143	0.04814
GCA_000715385.1-Fun_AZST01000042.1_i000_001864	150	373	223	0.995536	0.414498
GCA_905219595.1-Fun_CAJMWU010006726.1_i000_008838	150	373	223	0.995536	0.414498
GCA_905219605.1-Fun_CAJMWV010003117.1_i000_004962	150	373	223	0.995536	0.414498
GCA_016584345.1-Fun_JABCPV010000024.1_i000_007016	160	381	221	0.986607	0.408503
GCA_014108235.1-Ani_JABWUV010000018.1_i000_008190	110	245	135	0.602679	0.55102
GCA_016772295.1-Fun_JAAGWA010000005.1_i000_006905	207	428	221	0.986607	0.377778
GCA_001483015.1-Pro_LNFO01001429.1_i000_004084	151	375	224	1	0.425047
GCA_003144195.1-Fun_KZ819375.1_i000_003563	155	376	221	0.986607	0.386364
GCA_016628085.1-Fun_JABBWB010000083.1_i000_014916	160	381	221	0.986607	0.408503
GCA_000509465.1-Pro_KI688317.1_i000_015941	151	375	224	1	0.425047
GCA_000509485.1-Pro_KI675081.1_i000_015842	151	375	224	1	0.425047
GCA_000247585.2-Pro_KI669613.1_i000_017874	151	375	224	1	0.425047
GCA_000365525.1-Pro_ANJA01003037.1_i000_016331	151	375	224	1	0.425047
GCA_000365545.1-Pro_ANIX01003266.1_i000_016223	151	375	224	1	0.425047
GCA_000367145.1-Pro_ANIY01003431.1_i000_016214	151	375	224	1	0.425047
GCA_014461135.1-Fun_JACAZF010000006.1_i000_006790	151	372	221	0.986607	0.416196
GCA_000827255.1-Fun_KN835136.1_i000_000967	160	381	221	0.986607	0.408503
GCA_001712635.2-Pro_MBAC02007296.1_i000_016628	159	383	224	1	0.41791
GCA_004126415.1-Fun_SDEE01000001.1_i000_000099	162	383	221	0.986607	0.408503
GCA_000320585.2-Fun_KI925456.1_i000_003921	106	327	221	0.986607	0.457557
GCA_016618375.1-Pro_JADEVP010000019.1_i000_007469	150	374	224	1	0.425856
GCA_001712635.2-Pro_MBAC02008046.1_i000_018273	159	383	224	1	0.41791
GCA_000400465.1-Fun_KE007227.1_i000_001160	171	392	221	0.986607	0.393939
GCA_021399455.1-Fun_JAJTUO010000005.1_i000_015146	153	374	221	0.986607	0.410781
GCA_004918755.1-Fun_SPOI01000182.1_i000_001218	174	395	221	0.986607	0.391844
GCA_004917865.1-Fun_SPOD01000017.1_i000_000948	174	395	221	0.986607	0.391844
GCA_004918415.1-Fun_SPOL01000015.1_i000_000750	174	395	221	0.986607	0.391844
GCA_004918235.1-Fun_SPOE01000016.1_i000_000905	178	399	221	0.986607	0.389085
GCA_004918305.1-Fun_SPOM01000017.1_i000_001004	178	399	221	0.986607	0.389085
GCA_004918335.1-Fun_SPNZ01000007.1_i000_003310	178	399	221	0.986607	0.389085
GCA_004918405.1-Fun_SPOO01000017.1_i000_001005	178	399	221	0.986607	0.389085
GCA_004918655.1-Fun_SPOP01000017.1_i000_001009	178	399	221	0.986607	0.389085
GCA_004918735.1-Fun_SPON01000017.1_i000_001004	178	399	221	0.986607	0.389085
GCA_004918745.1-Fun_SPOJ01000014.1_i000_000674	178	399	221	0.986607	0.389085
GCA_004918885.1-Fun_SPNY01000017.1_i000_001003	178	399	221	0.986607	0.389085
GCA_004917845.1-Fun_SPOB01000014.1_i000_000744	178	399	221	0.986607	0.389085
GCA_004917895.1-Fun_SPOH01000016.1_i000_000906	178	399	221	0.986607	0.389085
GCA_004918015.1-Fun_SPOC01000014.1_i000_000695	178	399	221	0.986607	0.389085
GCA_004918345.1-Fun_SPOA01000014.1_i000_000746	178	399	221	0.986607	0.389085
GCA_004918445.1-Fun_SPOG01000013.1_i000_000585	178	399	221	0.986607	0.389085
GCA_004918455.1-Fun_SPOF01000016.1_i000_000934	178	399	221	0.986607	0.389085
GCA_004918065.1-Fun_SPOQ01000015.1_i000_000796	178	399	221	0.986607	0.389085
GCA_004918315.1-Fun_SPNX01000015.1_i000_000771	178	399	221	0.986607	0.389085
GCA_004918625.1-Fun_SPOK01000016.1_i000_000876	178	399	221	0.986607	0.389085
GCA_004918895.1-Fun_SPOR01000014.1_i000_000684	178	399	221	0.986607	0.389085
GCA_004918325.1-Fun_SPNW01000011.1_i000_000308	169	390	221	0.986607	0.395349
GCA_016647785.1-Fun_JABBWK010000003.1_i000_009074	160	381	221	0.986607	0.408503
GCA_001482985.1-Pro_LNFP01000126.1_i000_002481	151	375	224	1	0.425047
GCA_022160365.1-Fun_MU273512.1_i000_003500	156	377	221	0.986607	0.413084
GCA_002271895.2-Pla_CM008431.1_i000_000608	47	262	215	0.959821	0.581081
GCA_016647645.1-Fun_JABBWF010000008.1_i000_015214	160	381	221	0.986607	0.408503
GCA_016647745.1-Fun_JABBWE010000043.1_i000_009912	160	381	221	0.986607	0.408503
GCA_016758755.1-Fun_JABBWM010000003.1_i000_007471	160	381	221	0.986607	0.408503
GCA_016647685.1-Fun_JABBWJ010000025.1_i000_007192	160	381	221	0.986607	0.408503
GCA_015501075.1-Fun_JADNYJ010000001.1_i000_000370	155	378	223	0.995536	0.419173
GCA_000204055.1-Fun_GL883170.1_i000_014558	91	317	226	1.00893	0.466942
GCA_003144295.1-Fun_KZ819634.1_i000_000276	182	404	222	0.991071	0.364532
GCA_000469055.2-Fun_AVOT02031570.1_i000_064842	155	384	229	1.02232	0.414105
GCA_015501055.1-Fun_JADNYV010000017.1_i000_005120	146	367	221	0.986607	0.427466
GCA_000827185.1-Fun_KN839835.1_i000_000585	162	383	221	0.986607	0.406998
GCA_015501595.1-Fun_JADNRX010000919.1_i000_026763	146	367	221	0.986607	0.427466
GCA_015501065.1-Fun_JADNYI010000002.1_i000_006566	162	383	221	0.986607	0.409259
GCA_015178925.1-Fun_WHVC01000002.1_i000_004324	155	375	220	0.982143	0.428016
GCA_000509505.1-Pro_KI681774.1_i000_015624	151	375	224	1	0.425047
GCA_001481415.2-Fun_LNZH02000215.1_i000_000446	136	357	221	0.986607	0.426641
GCA_015178965.1-Fun_WHVB01000003.1_i000_005784	155	375	220	0.982143	0.415094
GCA_007726485.1-Pla_CM017443.1_i000_021461	109	315	206	0.919643	0.385047
GCA_001191645.1-Fun_AJIL01000309.1_i000_016320	154	383	229	1.02232	0.412613
GCA_021901655.1-Fun_CM038902.1_i000_014620	154	383	229	1.02232	0.412613
GCA_021901695.1-Fun_CM038884.1_i000_014883	154	383	229	1.02232	0.412613
GCA_000385595.1-Fun_KB916411.1_i000_006492	164	399	235	1.04911	0.38715
GCA_019616325.1-Fun_WSTG01003053.1_i000_012525	146	369	223	0.995536	0.416822
GCA_014898675.1-Fun_JACXVL010000027.1_i000_009177	164	385	221	0.986607	0.405505
GCA_014898675.1-Fun_JACXVL010000053.1_i000_016298	164	385	221	0.986607	0.405505
GCA_003086725.1-Fun_MBFT01000679.1_i000_005658	112	331	219	0.977679	0.451546
GCA_003097675.1-Fun_MBFU01000069.1_i000_001218	112	331	219	0.977679	0.451546
GCA_003097675.1-Fun_MBFU01000772.1_i000_006201	112	331	219	0.977679	0.451546
GCA_015499995.1-Fun_JADNRV010000001.1_i000_000259	50	271	221	0.986607	0.523697
GCA_015501605.1-Fun_JADNRZ010000001.1_i000_000765	160	381	221	0.986607	0.413084
GCA_003182015.1-Fun_PYWC01000033.1_i000_004550	165	392	227	1.01339	0.373355
GCA_020800215.1-Pro_JAICDV010000005.1_i000_005842	146	370	224	1	0.429119
GCA_020800235.1-Pro_JAICDX010000004.1_i000_005223	146	370	224	1	0.429119
GCA_000827315.1-Fun_KN832972.1_i000_001555	105	326	221	0.986607	0.454733
GCA_015951145.1-Fun_MU167255.1_i000_005788	149	378	229	1.02232	0.418647
GCA_022496205.1-Fun_WTXD01000019.1_i000_003658	162	382	220	0.982143	0.409683
GCA_022496215.1-Fun_WTXF01000046.1_i000_008940	154	374	220	0.982143	0.415094
GCA_009735665.1-Ani_MQTX01002515.1_i000_009743	1	181	180	0.803571	0.942408
GCA_001636715.1-Fun_AZGZ01000028.1_i000_003446	154	387	233	1.04018	0.378862
GCA_000142945.1-Pro_DS028121.1_i000_014147	154	378	224	1	0.42344
GCA_012295175.1-Pro_WSZM01000007.1_i000_000368	154	378	224	1	0.42344
GCA_012552325.1-Pro_JAACNO010001556.1_i000_011375	154	378	224	1	0.42344
GCA_000149845.2-Fun_KE651168.1_i000_003800	115	337	222	0.991071	0.44668
GCA_021527785.1-Pro_JAJATU010003778.1_i000_009148	121	341	220	0.982143	0.44898
GCA_021527665.1-Pro_JAJNMJ010005134.1_i000_012647	121	341	220	0.982143	0.44898
GCA_021527805.1-Pro_JAJNMK010000827.1_i000_008891	121	341	220	0.982143	0.44898
GCA_009835175.1-Pro_VJMJ01000087.1_i000_002642	121	341	220	0.982143	0.44898
GCA_021527745.1-Pro_JAJNML010006782.1_i000_020562	121	341	220	0.982143	0.44898
GCA_021527685.1-Pro_JAJGMV010000187.1_i000_017241	121	341	220	0.982143	0.44898
GCA_019828595.1-Pro_JAHQRK010000002.1_i000_007772	121	341	220	0.982143	0.44898
GCA_019677335.1-Fun_WSLM01000406.1_i000_004074	184	407	223	0.995536	0.38918
GCA_000478725.1-Pla_KI517683.1_i000_019398	74	294	220	0.982143	0.491071
GCA_019155685.1-Pro_JAGDFL010000010.1_i000_000139	163	387	224	1	0.417132
GCA_014065215.1-Fun_JACCEH010000258.1_i000_005315	165	392	227	1.01339	0.373355
GCA_000488995.1-Fun_AWSO01000024.1_i000_000978	159	380	221	0.986607	0.412313
GCA_010093815.1-Fun_ML996566.1_i000_001390	124	357	233	1.04018	0.410935
GCA_015039465.1-Fun_MU130533.1_i000_013740	156	377	221	0.986607	0.411546
GCA_000827335.1-Fun_KN831947.1_i000_002673	161	388	227	1.01339	0.417279
GCA_019616945.1-Fun_WSTK01000054.1_i000_009146	203	426	223	0.995536	0.376689
GCA_014905825.1-Fun_JACGCN010000002.1_i000_005926	162	383	221	0.986607	0.410019
GCA_019155715.1-Pro_JAGDFM010000003.1_i000_007345	154	378	224	1	0.422642
GCA_000151645.1-Fun_FN430363.1_i000_006780	165	392	227	1.01339	0.373355
GCA_019112545.1-Fun_MU250535.1_i000_007123	156	377	221	0.986607	0.416196
GCA_000149755.2-Pro_JH159151.1_i000_001658	165	389	224	1	0.414048
GCA_002104995.1-Fun_MCFD01000001.1_i000_000466	104	324	220	0.982143	0.45929
GCA_014065205.1-Fun_JACCEG010000002.1_i000_003204	166	393	227	1.01339	0.373355
GCA_003112345.1-Pla_PKPP01000776.1_i000_010297	100	325	225	1.00446	0.566751
GCA_014461115.1-Fun_JACAZE010000006.1_i000_004968	150	371	221	0.986607	0.409259
GCA_905216605.1-Pla_LR999453.1_i000_008241	103	324	221	0.986607	0.470213
GCA_009835185.1-Pro_VJMH01005730.1_i000_015673	121	341	220	0.982143	0.44898
GCA_900708865.1-Pro_CAADRA010005751.1_i000_012619	121	341	220	0.982143	0.44898
GCA_021524915.1-Fun_JAKELL010000041.1_i000_008241	154	374	220	0.982143	0.415094
GCA_021527775.1-Fun_JAKEYF010000028.1_i000_008682	154	374	220	0.982143	0.415094
GCA_021527035.1-Fun_JAKELG010000016.1_i000_002634	153	373	220	0.982143	0.415879
GCA_022496195.1-Fun_WTXC01000062.1_i000_010324	156	376	220	0.982143	0.413534
GCA_004369175.1-Fun_QPFP01000007.1_i000_020013	103	324	221	0.986607	0.458506
GCA_015680905.1-Pla_CM027383.1_i000_030609	88	309	221	0.986607	0.486784
GCA_000697645.1-Fun_KL142368.1_i000_001749	171	392	221	0.986607	0.40255
GCA_004369085.1-Fun_ML210150.1_i000_001607	176	397	221	0.986607	0.397482
GCA_012184315.1-Fun_LDDX01000232.1_i000_004489	154	377	223	0.995536	0.382504
GCA_004369135.1-Fun_ML179035.1_i000_000628	158	379	221	0.986607	0.414634
GCA_014080715.1-Pla_JACERP010000122.1_i000_002020	122	360	238	1.0625	0.446529
GCA_000149925.1-Fun_DS178304.1_i000_005358	159	388	229	1.02232	0.4082
GCA_000149925.1-Fun_DS178368.1_i000_001179	159	388	229	1.02232	0.4082
GCA_008520325.1-Fun_VDEP01000236.1_i000_016418	159	388	229	1.02232	0.4082
GCA_008522505.1-Fun_VSWC01000158.1_i000_030362	159	388	229	1.02232	0.4082
GCA_008520325.1-Fun_VDEP01000170.1_i000_012080	159	388	229	1.02232	0.4082
GCA_008522505.1-Fun_VSWC01000145.1_i000_028534	159	388	229	1.02232	0.4082
GCA_001630335.1-Fun_KV417525.1_i000_010043	159	380	221	0.986607	0.409259
GCA_019202795.1-Pla_CM032920.1_i000_036147	106	327	221	0.986607	0.46723
GCA_905237095.1-Pro_CAJNNW010000395.1_i000_000581	56	276	220	0.982143	0.510441
GCA_019202805.1-Pla_CM032907.1_i000_036421	106	327	221	0.986607	0.46723
GCA_010194725.1-Pro_WXXK01002579.1_i000_011886	146	370	224	1	0.429119
GCA_905237085.1-Pro_CAJNNV010028222.1_i000_040942	76	296	220	0.982143	0.487805
GCA_009746105.1-Pla_CM019271.1_i000_014213	97	318	221	0.986607	0.594086
GCA_001632445.1-Fun_KV424669.1_i000_013928	108	329	221	0.986607	0.45567
GCA_000751015.1-Pla_LK051726.1_i000_061020	79	284	205	0.915179	0.488095
GCA_016864775.1-Pro_RCMO01000018.1_i000_001572	160	384	224	1	0.41791
GCA_016864795.1-Pro_RCMN01000008.1_i000_000728	160	384	224	1	0.41791
GCA_016865085.1-Pro_RCMU01000019.1_i000_008082	160	384	224	1	0.41791
GCA_016906365.1-Pro_RCMQ01000011.1_i000_001073	160	384	224	1	0.41791
GCA_018873755.1-Pro_JAENGZ010000002.1_i000_006084	160	384	224	1	0.41791
GCA_000827395.1-Fun_KN825062.1_i000_005934	164	385	221	0.986607	0.405505
GCA_018873745.1-Pro_JAENGY010000003.1_i000_009098	157	381	224	1	0.420263
GCA_000697685.1-Fun_KL198007.1_i000_004975	110	331	221	0.986607	0.453799
GCA_003070745.1-Fun_NESQ01000035.1_i000_007272	166	393	227	1.01339	0.372742
GCA_905216605.1-Pla_LR999453.1_i000_008365	104	325	221	0.986607	0.476293
GCA_000143565.1-Fun_DS547094.1_i000_014896	110	331	221	0.986607	0.454733
GCA_002215365.1-Pro_NBNE01000056.1_i000_001298	141	365	224	1	0.433269
GCA_004369065.1-Fun_ML208261.1_i000_001691	113	334	221	0.986607	0.45102
GCA_004679275.1-Fun_SEOQ01000132.1_i000_001700	138	358	220	0.982143	0.426357
GCA_019202805.1-Pla_CM032907.1_i000_036429	106	327	221	0.986607	0.46723
GCA_019202795.1-Pla_CM032920.1_i000_036142	106	327	221	0.986607	0.46723
GCA_019202795.1-Pla_CM032920.1_i000_036145	106	327	221	0.986607	0.46723
GCA_019202805.1-Pla_CM032907.1_i000_036435	105	326	221	0.986607	0.46822
GCA_002873125.1-Fun_PGCI01000064.1_i000_005966	153	382	229	1.02232	0.413357
GCA_002873275.1-Fun_PGCJ01000043.1_i000_004269	153	382	229	1.02232	0.413357
GCA_002081595.1-Pro_JNBR01001584.1_i000_003908	123	343	220	0.982143	0.446247
GCA_009732905.1-Pro_QXFV01000060.1_i000_001848	162	386	224	1	0.416357
GCA_009732945.1-Pro_QXFU01000060.1_i000_001918	162	386	224	1	0.416357
GCA_009733145.1-Pro_QXFT01000088.1_i000_002729	162	386	224	1	0.416357
GCA_009729455.1-Pro_QWGH01000006.1_i000_029640	162	386	224	1	0.416357
GCA_009732925.1-Pro_QXFW01000265.1_i000_006325	162	386	224	1	0.416357
GCA_009732985.1-Pro_QXGB01000185.1_i000_005353	162	386	224	1	0.416357
GCA_009733005.1-Pro_QXFX01000267.1_i000_006590	162	386	224	1	0.416357
GCA_009733025.1-Pro_QXGA01000057.1_i000_002102	162	386	224	1	0.416357
GCA_009733045.1-Pro_QXGC01000153.1_i000_004431	162	386	224	1	0.416357
GCA_009733065.1-Pro_QXFZ01000184.1_i000_005319	162	386	224	1	0.416357
GCA_009733085.1-Pro_QXGD01000204.1_i000_006014	162	386	224	1	0.416357
GCA_009733105.1-Pro_QXGE01000272.1_i000_006708	162	386	224	1	0.416357
GCA_014925845.1-Fun_JACGCL010000002.1_i000_005877	164	385	221	0.986607	0.409259
GCA_009733125.1-Pro_QXFY01000272.1_i000_006757	164	388	224	1	0.414815
GCA_000302655.1-Fun_AHHD01000233.1_i000_005100	164	399	235	1.04911	0.391667
GCA_020744275.1-Fun_JAGTJR010000043.1_i000_009911	164	399	235	1.04911	0.391667
GCA_014466165.1-Fun_JACETU010000003.1_i000_005099	221	442	221	0.986607	0.369565
GCA_905219645.1-Fun_CAJMWZ010003131.1_i000_003772	150	375	225	1.00446	0.415896
GCA_019202795.1-Pla_CM032920.1_i000_036136	106	327	221	0.986607	0.46723
GCA_002573605.1-Fun_PDNA01000038.1_i000_006291	154	387	233	1.04018	0.380098
GCA_012980535.1-Fun_SJKF01000003.1_i000_005370	189	410	221	0.986607	0.390459
GCA_019632295.1-Fun_WSTZ01000102.1_i000_000261	149	369	220	0.982143	0.405157
GCA_003287315.1-Pro_MJFZ01000023.1_i000_008276	160	384	224	1	0.41791
GCA_016864635.1-Pro_RCME01000007.1_i000_000627	160	384	224	1	0.41791
GCA_016864655.1-Pro_NHQK01000086.1_i000_027639	160	384	224	1	0.41791
GCA_016864665.1-Pro_RCMF01000013.1_i000_001212	160	384	224	1	0.41791
GCA_016864695.1-Pro_RCMG01000012.1_i000_001180	160	384	224	1	0.41791
GCA_016864715.1-Pro_RCMK01000012.1_i000_001119	160	384	224	1	0.41791
GCA_016864735.1-Pro_RCMI01000010.1_i000_000894	160	384	224	1	0.41791
GCA_016864755.1-Pro_RCMH01000014.1_i000_001515	160	384	224	1	0.41791
GCA_016864815.1-Pro_RCML01000009.1_i000_000871	160	384	224	1	0.41791
GCA_016864835.1-Pro_RCMM01000007.1_i000_000699	160	384	224	1	0.41791
GCA_016864855.1-Pro_RCMP01000011.1_i000_001135	160	384	224	1	0.41791
GCA_016865055.1-Pro_RCMV01000004.1_i000_000306	160	384	224	1	0.41791
GCA_016865075.1-Pro_RCMT01000008.1_i000_025270	160	384	224	1	0.41791
GCA_017309695.1-Pro_RCMJ01000030.1_i000_003025	160	384	224	1	0.41791
GCA_014904835.1-Fun_MU120898.1_i000_000608	163	384	221	0.986607	0.40625
GCA_000785735.3-Pro_JPWV03000017.1_i000_002241	163	387	224	1	0.420263
GCA_001707905.2-Pro_MAYM02000342.1_i000_007353	163	387	224	1	0.420263
GCA_001712715.2-Pro_MBDN02000009.1_i000_009500	163	387	224	1	0.420263
GCA_019044685.2-Pla_JAGTXX020000014.1_i000_007730	117	338	221	0.986607	0.435039
GCA_000333075.3-Pro_AOFI03000009.1_i000_011278	163	387	224	1	0.420263
GCA_000785725.3-Pro_JPWU03000007.1_i000_008496	163	387	224	1	0.420263
GCA_000315625.1-Pro_JH992970.1_i000_002151	110	333	223	0.995536	0.452333
GCA_010015785.1-Fun_ML978715.1_i000_003373	163	396	233	1.04018	0.379479
GCA_014188975.1-Fun_JACGCI010000007.1_i000_022068	172	393	221	0.986607	0.399638
GCA_013368325.1-Fun_JAACJK010000109.1_i000_011102	172	393	221	0.986607	0.399638
GCA_019202925.1-Pla_JAHPZM010000001.1_i000_000381	117	338	221	0.986607	0.435039
GCA_000151525.2-Fun_ADAS02000163.1_i000_010914	159	388	229	1.02232	0.408929
GCA_019633455.1-Fun_WSUA01000099.1_i000_012858	139	359	220	0.982143	0.412758
GCA_003260675.2-Pla_QGKX02000996.1_i000_003015	112	317	205	0.915179	0.443723
GCA_012184295.1-Fun_LDUD01000118.1_i000_005602	149	372	223	0.995536	0.383821
GCA_900536885.1-Fun_UWZB01000024.1_i000_001967	150	371	221	0.986607	0.419355
GCA_002738505.1-Pla_KZ305019.1_i000_000903	98	252	154	0.6875	0.342984
GCA_002738505.1-Pla_KZ305019.1_i000_000903	251	301	50	0.223214	0.111359
GCA_004681135.1-Fun_SFCI01000284.1_i000_005775	161	382	221	0.986607	0.423372
GCA_017788925.1-Fun_JACEFK010000014.1_i000_000792	134	341	207	0.924107	0.419878
GCA_014462655.1-Fun_JACAZI010000009.1_i000_011829	160	381	221	0.986607	0.424184
GCA_003073295.1-Fun_KZ803304.1_i000_005181	153	374	221	0.986607	0.417769
GCA_012184305.1-Fun_LDUB01000081.1_i000_003713	62	284	222	0.991071	0.450304
GCA_019202795.1-Pla_CM032920.1_i000_036122	105	326	221	0.986607	0.475269
GCA_003260635.2-Pla_QGKW02001911.1_i000_008632	112	317	205	0.915179	0.445652
GCA_903819665.1-Fun_CAIJEO010000008.1_i000_006155	183	416	233	1.04018	0.368088
GCA_014461125.1-Fun_JACAZG010000001.1_i000_000724	151	373	222	0.991071	0.412639
GCA_016695485.1-Fun_MU172282.1_i000_003623	52	276	224	1	0.518519
GCA_022376545.1-Fun_WTXJ01000025.1_i000_004870	152	372	220	0.982143	0.415094
GCA_021491655.1-Pro_CP090811.1_i000_005998	149	373	224	1	0.427481
GCA_019924775.1-Fun_JAHFYC010007391.1_i000_013370	74	307	233	1.04018	0.568293
GCA_021015755.1-Fun_JABWDW010000001.1_i000_000411	157	378	221	0.986607	0.414634
GCA_000271625.1-Fun_JH711577.1_i000_005497	167	388	221	0.986607	0.405505
GCA_018446385.1-Pla_CM031517.1_i000_036336	61	274	213	0.950893	0.771739
GCA_000827475.1-Fun_KN819325.1_i000_001859	164	385	221	0.986607	0.405505
GCA_001243155.1-Fun_LM651872.1_i000_007545	189	413	224	1	0.417132
GCA_016865095.1-Pro_RCMR01000007.1_i000_000620	160	384	224	1	0.41791
GCA_016880175.1-Pro_RCMS01000004.1_i000_000318	160	384	224	1	0.41791
GCA_016880985.1-Pro_QOKR01000001.1_i000_000060	160	384	224	1	0.41791
GCA_022376445.1-Fun_JACBKP010000001.1_i000_000497	159	369	210	0.9375	0.390335
GCA_004359215.2-Pro_CM033812.1_i000_005611	162	386	224	1	0.416357
GCA_014904945.1-Fun_MU127426.1_i000_005188	164	385	221	0.986607	0.405505
GCA_003260655.2-Pla_QGKV02000832.1_i000_049475	239	463	224	1	0.228338
GCA_003260655.2-Pla_QGKV02000832.1_i000_049475	648	872	224	1	0.228338
GCA_902602495.3-Pro_CACKRE030005206.1_i000_024746	178	402	224	1	0.406534
GCA_002946385.1-Fun_NJPR01000092.1_i000_010576	158	393	235	1.04911	0.385878
GCA_019924025.1-Fun_JAHFWX010005546.1_i000_018753	16	249	233	1.04018	0.502155
GCA_019924875.1-Fun_JAHFYK010005354.1_i000_019372	16	249	233	1.04018	0.502155
GCA_000441935.1-Fun_KE525480.1_i000_002019	151	374	223	0.995536	0.383162
GCA_019924755.1-Fun_JAHFYB010004826.1_i000_014644	183	416	233	1.04018	0.494692
GCA_000751015.1-Pla_LK033282.1_i000_046848	144	349	205	0.915179	0.41498
GCA_015501585.1-Fun_JADNRY010000022.1_i000_008630	162	383	221	0.986607	0.396768
GCA_000151065.3-Fun_HF943549.1_i000_005177	154	389	235	1.04911	0.390365
GCA_900002365.1-Fun_LK056664.1_i000_004179	189	413	224	1	0.370861
GCA_019924775.1-Fun_JAHFYC010006348.1_i000_012511	103	336	233	1.04018	0.455969
GCA_019924535.1-Fun_JAHFXS010000130.1_i000_002377	70	303	233	1.04018	0.449807
GCA_900237765.1-Fun_UNSH01000001.1_i000_003166	154	389	235	1.04911	0.390365
GCA_000341285.1-Pro_KB454534.1_i000_005118	85	306	221	0.986607	0.476293
GCA_020744175.1-Fun_JAGTJP010000031.1_i000_007225	152	372	220	0.982143	0.411985
GCA_005498985.1-Fun_CM016669.1_i000_000589	191	415	224	1	0.371476
GCA_000418435.1-Fun_KE374161.1_i000_000932	154	389	235	1.04911	0.390365
GCA_900519115.1-Fun_LR026992.1_i000_006342	154	389	235	1.04911	0.390365
GCA_905067625.1-Fun_LR898476.1_i000_005980	154	389	235	1.04911	0.390365
GCA_011503125.2-Fun_WWBZ02000016.1_i000_005720	164	399	235	1.04911	0.387789
GCA_000265015.1-Fun_JH687735.1_i000_001893	114	334	220	0.982143	0.444444
GCA_019924295.1-Fun_JAHFXI010000751.1_i000_004063	183	416	233	1.04018	0.420578
GCA_019924675.1-Fun_JAHFXY010002528.1_i000_010038	119	352	233	1.04018	0.410935
GCA_019924695.1-Fun_JAHFYA010002771.1_i000_010568	119	352	233	1.04018	0.410935
GCA_019924755.1-Fun_JAHFYB010000209.1_i000_001891	128	361	233	1.04018	0.404514
GCA_019924115.1-Fun_JAHFXA010002784.1_i000_010123	132	365	233	1.04018	0.401724
GCA_019924135.1-Fun_JAHFXB010000230.1_i000_002111	133	366	233	1.04018	0.401033
GCA_019925775.1-Fun_JAHFYE010002872.1_i000_014233	137	370	233	1.04018	0.398291
GCA_019924395.1-Fun_JAHFXN010000208.1_i000_001949	152	385	233	1.04018	0.388333
GCA_019924175.1-Fun_JAHFXG010000029.1_i000_004405	154	387	233	1.04018	0.387043
GCA_019924715.1-Fun_JAHFYG010000055.1_i000_007474	154	387	233	1.04018	0.387043
GCA_019924815.1-Fun_JAHFYJ010000074.1_i000_009156	154	387	233	1.04018	0.387043
GCA_019923975.1-Fun_JAHFWY010000060.1_i000_007981	154	387	233	1.04018	0.387043
GCA_000721775.1-Fun_KL584828.1_i000_003178	154	387	233	1.04018	0.386401
GCA_019925005.1-Fun_JAHFYP010000046.1_i000_007116	154	387	233	1.04018	0.386401
GCA_019924195.1-Fun_JAHFXF010000546.1_i000_014804	154	387	233	1.04018	0.386401
GCA_019924255.1-Fun_JAHFXK010000594.1_i000_015440	154	387	233	1.04018	0.386401
GCA_019924895.1-Fun_JAHFYM010000086.1_i000_017728	154	387	233	1.04018	0.386401
GCA_019924995.1-Fun_JAHFYO010000611.1_i000_015371	154	387	233	1.04018	0.386401
GCA_019924425.1-Fun_JAHFXT010000068.1_i000_008720	154	387	233	1.04018	0.386401
GCA_019924555.1-Fun_JAHFXU010000341.1_i000_003919	183	416	233	1.04018	0.369255
GCA_019925085.1-Fun_JAHFYT010000031.1_i000_005011	183	416	233	1.04018	0.369255
GCA_019924355.1-Fun_JAHFXO010000113.1_i000_002402	183	416	233	1.04018	0.369255
GCA_019924465.1-Fun_JAHFXQ010002220.1_i000_012332	183	416	233	1.04018	0.369255
GCA_019924485.1-Fun_JAHFXR010000080.1_i000_001779	183	416	233	1.04018	0.369255
GCA_019924185.1-Fun_JAHFXE010001706.1_i000_011075	183	416	233	1.04018	0.369255
GCA_019924195.1-Fun_JAHFXF010000124.1_i000_002194	183	416	233	1.04018	0.369255
GCA_019924255.1-Fun_JAHFXK010000084.1_i000_018537	183	416	233	1.04018	0.369255
GCA_019924995.1-Fun_JAHFYO010000023.1_i000_007566	183	416	233	1.04018	0.369255
GCA_019924355.1-Fun_JAHFXO010000410.1_i000_004954	183	416	233	1.04018	0.369255
GCA_019924465.1-Fun_JAHFXQ010000398.1_i000_004622	183	416	233	1.04018	0.369255
GCA_019924485.1-Fun_JAHFXR010000078.1_i000_001754	183	416	233	1.04018	0.369255
GCA_019924535.1-Fun_JAHFXS010000101.1_i000_002094	183	416	233	1.04018	0.369255
GCA_019924725.1-Fun_JAHFYF010000071.1_i000_009064	183	416	233	1.04018	0.369255
GCA_019924825.1-Fun_JAHFYH010000075.1_i000_009099	183	416	233	1.04018	0.369255
GCA_019924835.1-Fun_JAHFYI010000069.1_i000_008866	183	416	233	1.04018	0.369255
GCA_019924415.1-Fun_JAHFXV010000050.1_i000_007067	183	416	233	1.04018	0.368671
GCA_019924155.1-Fun_JAHFXD010000170.1_i000_001734	183	416	233	1.04018	0.369255
GCA_019924215.1-Fun_JAHFXC010000165.1_i000_001568	183	416	233	1.04018	0.369255
GCA_019924275.1-Fun_JAHFXJ010000169.1_i000_001647	183	416	233	1.04018	0.369255
GCA_019924315.1-Fun_JAHFXH010000153.1_i000_001745	183	416	233	1.04018	0.369255
GCA_019924375.1-Fun_JAHFXM010001456.1_i000_006992	183	416	233	1.04018	0.369255
GCA_019924435.1-Fun_JAHFXP010000169.1_i000_001619	183	416	233	1.04018	0.369255
GCA_019924575.1-Fun_JAHFXX010000180.1_i000_001755	183	416	233	1.04018	0.369255
GCA_019924615.1-Fun_JAHFXW010000170.1_i000_001693	183	416	233	1.04018	0.369255
GCA_019924655.1-Fun_JAHFXZ010000177.1_i000_001741	183	416	233	1.04018	0.369255
GCA_019924735.1-Fun_JAHFYD010000184.1_i000_001802	183	416	233	1.04018	0.369255
GCA_019924905.1-Fun_JAHFYL010000170.1_i000_001685	183	416	233	1.04018	0.369255
GCA_019924015.1-Fun_JAHFWZ010000057.1_i000_007783	183	416	233	1.04018	0.369255
GCA_019925035.1-Fun_JAHFYQ010000033.1_i000_005273	183	416	233	1.04018	0.368671
GCA_019924185.1-Fun_JAHFXE010000140.1_i000_002388	183	416	233	1.04018	0.368671
GCA_019924895.1-Fun_JAHFYM010000131.1_i000_002706	183	416	233	1.04018	0.368671
GCA_019924115.1-Fun_JAHFXA010001569.1_i000_007013	183	416	233	1.04018	0.368671
GCA_019924135.1-Fun_JAHFXB010000295.1_i000_002561	183	416	233	1.04018	0.368671
GCA_019924155.1-Fun_JAHFXD010000270.1_i000_002413	183	416	233	1.04018	0.368671
GCA_019924215.1-Fun_JAHFXC010000281.1_i000_002322	183	416	233	1.04018	0.368671
GCA_019924275.1-Fun_JAHFXJ010000288.1_i000_002457	183	416	233	1.04018	0.368671
GCA_019924315.1-Fun_JAHFXH010000255.1_i000_002434	183	416	233	1.04018	0.368671
GCA_019924375.1-Fun_JAHFXM010003337.1_i000_011605	183	416	233	1.04018	0.368671
GCA_019924395.1-Fun_JAHFXN010000263.1_i000_002331	183	416	233	1.04018	0.368671
GCA_019924435.1-Fun_JAHFXP010000275.1_i000_002311	183	416	233	1.04018	0.368671
GCA_019924575.1-Fun_JAHFXX010000365.1_i000_002904	183	416	233	1.04018	0.368671
GCA_019924615.1-Fun_JAHFXW010000291.1_i000_002510	183	416	233	1.04018	0.368671
GCA_019924655.1-Fun_JAHFXZ010000287.1_i000_002484	183	416	233	1.04018	0.368671
GCA_019924675.1-Fun_JAHFXY010001607.1_i000_007601	183	416	233	1.04018	0.368671
GCA_019924695.1-Fun_JAHFYA010001600.1_i000_007485	183	416	233	1.04018	0.368671
GCA_019924735.1-Fun_JAHFYD010000293.1_i000_002544	183	416	233	1.04018	0.368671
GCA_019925775.1-Fun_JAHFYE010001759.1_i000_011400	183	416	233	1.04018	0.368671
GCA_019924555.1-Fun_JAHFXU010000461.1_i000_004777	183	416	233	1.04018	0.369255
GCA_002003045.1-Fun_BDGU01000627.1_i000_009721	157	378	221	0.986607	0.194885
GCA_019925055.1-Fun_JAHFYR010000039.1_i000_005531	183	416	233	1.04018	0.368088
GCA_019677355.1-Fun_WSLN01000294.1_i000_003048	146	358	212	0.946429	0.456897
GCA_020091625.1-Fun_JAGYZC010000003.1_i000_005997	159	380	221	0.986607	0.399638
GCA_000507465.3-Fun_KV700055.1_i000_007911	184	407	223	0.995536	0.391228
GCA_000507485.3-Fun_KI669556.1_i000_007445	184	407	223	0.995536	0.391228
GCA_000507885.2-Fun_KI669465.1_i000_006641	184	407	223	0.995536	0.391228
GCA_019924025.1-Fun_JAHFWX010005558.1_i000_018771	17	249	232	1.03571	0.497854
GCA_019924875.1-Fun_JAHFYK010005364.1_i000_019389	17	249	232	1.03571	0.497854
GCA_000751015.1-Pla_LK032160.1_i000_017236	136	341	205	0.915179	0.421811
GCA_000981605.1-Fun_HF935702.1_i000_008210	160	387	227	1.01339	0.376451
GCA_009746105.1-Pla_CM019272.1_i000_015480	79	299	220	0.982143	0.441767
GCA_910591925.1-Fun_CAJVPW010025700.1_i000_011749	2	158	156	0.696429	0.443182
GCA_910591925.1-Fun_CAJVPW010025700.1_i000_011749	167	209	42	0.1875	0.119318
GCA_001712645.2-Pro_MBAD02002145.1_i000_004615	163	387	224	1	0.420263
GCA_001712705.2-Pro_MBDO02000013.1_i000_001217	163	387	224	1	0.420263
GCA_001006345.1-Fun_LCWF01000067.1_i000_005535	155	388	233	1.04018	0.380098
GCA_021525775.1-Fun_JAKELK010000013.1_i000_003129	150	370	220	0.982143	0.418251
GCA_000403515.1-Fun_DF238795.1_i000_003083	195	419	224	1	0.374582
GCA_021307315.1-Fun_JAJSPD010000037.1_i000_010204	152	387	235	1.04911	0.389718
GCA_018296085.1-Fun_JACKQM010011832.1_i000_013426	159	380	221	0.986607	0.411546
GCA_018296165.1-Fun_JACKQL010012037.1_i000_011317	159	380	221	0.986607	0.411546
GCA_014904895.1-Fun_MU125221.1_i000_018411	158	379	221	0.986607	0.410019
GCA_911649665.1-Fun_CAJVRL010000038.1_i000_002264	155	390	235	1.04911	0.386513
GCA_018856295.1-Fun_JAFLHD010008879.1_i000_004079	153	374	221	0.986607	0.409259
GCA_021525015.1-Fun_JAKELH010000001.1_i000_000028	159	380	221	0.986607	0.412313
GCA_003843895.1-Pro_QKXF01000081.1_i000_000731	149	373	224	1	0.427481
GCA_003704535.1-Pro_QLLG01000204.1_i000_002288	149	373	224	1	0.427481
GCA_021525005.1-Fun_JAKEYE010000012.1_i000_002253	90	310	220	0.982143	0.472103
GCA_000827205.1-Fun_KN832554.1_i000_000881	154	375	221	0.986607	0.414634
GCA_018127125.1-Pla_CM030799.1_i000_034236	11	233	222	0.991071	0.69375
GCA_911693285.1-Fun_CAJVRM010000049.1_i000_001990	155	390	235	1.04911	0.386513
GCA_001466705.1-Fun_LATX01002123.1_i000_013397	156	377	221	0.986607	0.414634
GCA_021525025.1-Fun_JAKELI010000010.1_i000_000262	151	371	220	0.982143	0.419048
GCA_003444635.2-Fun_QOKS01000035.1_i000_009203	157	384	227	1.01339	0.377704
GCA_003790465.1-Fun_ML119182.1_i000_010389	157	384	227	1.01339	0.377704
GCA_020137385.1-Fun_JACLAE010000011.1_i000_001743	157	384	227	1.01339	0.377704
GCA_000241205.2-Fun_BABT02000028.1_i000_005887	152	378	226	1.00893	0.15178
GCA_000708205.1-Fun_KL411544.1_i000_002375	152	378	226	1.00893	0.15178
GCA_018691715.1-Pro_JAFJYM010000054.1_i000_013818	164	388	224	1	0.414815
GCA_000334475.1-Fun_DF196775.1_i000_002484	186	410	224	1	0.382906
GCA_900323505.1-Fun_OOIN01000001.1_i000_000410	187	411	224	1	0.376471
GCA_018282025.1-Fun_JABCKI010006025.1_i000_009966	171	392	221	0.986607	0.40255
GCA_000711695.1-Fun_JMSN01000090.1_i000_005060	175	399	224	1	0.371476
GCA_001008285.1-Fun_LCZI01000301.1_i000_001678	158	391	233	1.04018	0.377634
GCA_000328475.2-Fun_CM003140.1_i000_000386	189	413	224	1	0.373957
GCA_016771965.1-Pla_CM028690.1_i000_016919	188	412	224	1	0.209346
GCA_016771965.1-Pla_CM028690.1_i000_016919	538	762	224	1	0.209346
GCA_002572855.1-Fun_PDND01000065.1_i000_007483	159	392	233	1.04018	0.380719
GCA_000298775.1-Fun_JH921440.1_i000_005920	156	391	235	1.04911	0.382114
GCA_903853725.1-Fun_CAINUL010000016.1_i000_007529	138	371	233	1.04018	0.397611
GCA_010093945.1-Fun_ML994047.1_i000_006175	129	361	232	1.03571	0.40208
GCA_009835185.1-Pro_VJMH01005579.1_i000_014761	10	211	201	0.897321	0.948113
GCA_900162835.1-Fun_LT795054.1_i000_000808	190	414	224	1	0.375209
GCA_017607575.1-Fun_JABAJY010007606.1_i000_007205	677	898	221	0.986607	0.209479
GCA_000230245.1-Fun_FQ311430.1_i000_000404	190	414	224	1	0.375209
GCA_010093705.1-Fun_MU006090.1_i000_001785	158	391	233	1.04018	0.392256
GCA_020921065.1-Pla_CM037157.1_i000_020180	125	347	222	0.991071	0.555
GCA_010094025.1-Fun_ML991826.1_i000_008656	163	396	233	1.04018	0.383224
GCA_020080795.1-Fun_JAGHQM010000006.1_i000_007159	200	433	233	1.04018	0.346726
GCA_003369635.1-Fun_PDLN01000001.1_i000_000293	186	421	235	1.04911	0.367762
GCA_000721765.1-Fun_KL584708.1_i000_004589	153	386	233	1.04018	0.387687
GCA_019924955.1-Fun_JAHFYN010000029.1_i000_004228	153	386	233	1.04018	0.387687
GCA_001006355.1-Fun_LAQI01000195.1_i000_003400	163	398	235	1.04911	0.387789
GCA_001975905.1-Fun_MSZU01000075.1_i000_001332	163	398	235	1.04911	0.387789
GCA_020080175.1-Fun_JAGHQL010000047.1_i000_005361	166	399	233	1.04018	0.367508
GCA_009982845.1-Fun_JAADKB010000001.1_i000_000977	162	395	233	1.04018	0.384488
GCA_021604985.1-Pla_BQKI01000001.1_i000_002388	66	285	219	0.977679	0.241189
GCA_015342445.1-Pla_JACEFO010000268.1_i000_003625	45	265	220	0.982143	0.609418
GCA_006912115.1-Fun_VCMJ01003489.1_i000_004402	158	392	234	1.04464	0.373206
GCA_010093515.1-Fun_MU001710.1_i000_010058	159	391	232	1.03571	0.369427
GCA_003144235.1-Fun_KZ819688.1_i000_000172	169	392	223	0.995536	0.383162
GCA_020726505.1-Fun_JAHLEZ010000004.1_i000_015450	144	379	235	1.04911	0.392321
GCA_002111425.1-Fun_KZ107832.1_i000_009904	162	397	235	1.04911	0.38843
GCA_008931885.1-Fun_VCHE01000163.1_i000_003340	162	397	235	1.04911	0.38843
GCA_012971845.1-Fun_QCYV01000285.1_i000_012331	162	397	235	1.04911	0.38843
GCA_000504015.1-Pla_KI631274.1_i000_016868	124	343	219	0.977679	0.446939
GCA_021432625.1-Fun_MU270362.1_i000_008265	156	391	235	1.04911	0.384615
GCA_000002945.2-Fun_CU329671.1_i000_002611	136	356	220	0.982143	0.42471
GCA_018857285.1-Fun_JABAKA010008023.1_i000_004303	159	380	221	0.986607	0.411546
GCA_013387185.1-Ani_CP045890.1_i000_000976	105	303	198	0.883929	0.43326
GCA_900242695.1-Fun_OHJM01000027.1_i000_004852	197	421	224	1	0.370861
GCA_000517465.1-Fun_AWNI01000008.1_i000_001773	186	410	224	1	0.382906
GCA_001625215.1-Pla_CM004286.1_i000_030707	171	314	143	0.638393	0.273423
GCA_001625215.1-Pla_CM004286.1_i000_030707	312	373	61	0.272321	0.116635
GCA_004786125.1-Fun_PQXH01000097.1_i000_007415	158	393	235	1.04911	0.383361
GCA_902206195.3-Pla_CABITT030000001.1_i000_001864	41	263	222	0.991071	0.53753
GCA_004786245.1-Fun_PQXK01000157.1_i000_008045	158	393	235	1.04911	0.383361
GCA_014898295.1-Fun_RCSW01000004.1_i000_002296	158	393	235	1.04911	0.383361
GCA_004786205.1-Fun_PQXM01000138.1_i000_003969	158	393	235	1.04911	0.383987
GCA_014898435.1-Fun_RCTB01000007.1_i000_005034	158	393	235	1.04911	0.383987
GCA_014898485.1-Fun_RCTC01000017.1_i000_009988	158	393	235	1.04911	0.383987
GCA_014898555.1-Fun_RCSY01000010.1_i000_003831	158	393	235	1.04911	0.383987
GCA_004786275.1-Fun_PQXN01000227.1_i000_009261	158	393	235	1.04911	0.383361
GCA_013461495.1-Fun_JABFCT010000028.1_i000_012162	158	393	235	1.04911	0.383361
GCA_002573585.1-Fun_PDNB01000024.1_i000_004690	158	391	233	1.04018	0.377634
GCA_004916875.1-Fun_PQXL01000167.1_i000_006005	158	393	235	1.04911	0.383361
GCA_014898465.1-Fun_RCTA01000002.1_i000_001582	158	393	235	1.04911	0.383361
GCA_021432655.1-Fun_MU271202.1_i000_001887	105	332	227	1.01339	0.469008
GCA_014898285.1-Fun_RCSV01000009.1_i000_007068	158	393	235	1.04911	0.383361
GCA_001632375.1-Fun_KV425882.1_i000_000309	154	374	220	0.982143	0.411985
GCA_004786065.1-Fun_ML220112.1_i000_000574	119	344	225	1.00446	0.405405
GCA_004379285.1-Fun_PHWZ01000193.1_i000_006454	158	393	235	1.04911	0.383361
GCA_003369665.1-Fun_PDLM01000001.1_i000_000929	186	421	235	1.04911	0.367188
GCA_904845875.1-Pla_CAJGYO010000007.1_i000_027979	82	306	224	1	0.494481
GCA_000146945.2-Fun_CH476628.1_i000_008006	121	356	235	1.04911	0.407986
GCA_001619985.1-Fun_KV407454.1_i000_000548	163	396	233	1.04018	0.373997
GCA_014898535.1-Fun_RCSX01000004.1_i000_002540	158	393	235	1.04911	0.383987
GCA_009613015.1-Fun_VXCB01000133.1_i000_002391	186	421	235	1.04911	0.367188
GCA_000227075.1-Fun_FQ790287.1_i000_005885	158	393	235	1.04911	0.383361
GCA_000349525.1-Fun_KB707857.1_i000_004895	158	393	235	1.04911	0.383361
GCA_000151335.1-Fun_ACFW01000001.1_i000_007220	155	387	232	1.03571	0.381579
GCA_004786145.1-Fun_PQXI01000038.1_i000_003685	158	393	235	1.04911	0.383361
GCA_000150055.1-Fun_DS268113.1_i000_001753	155	387	232	1.03571	0.381579
GCA_000170175.2-Fun_GL636491.1_i000_004741	155	387	232	1.03571	0.381579
GCA_018416015.1-Fun_CP075071.1_i000_007259	155	387	232	1.03571	0.381579
GCA_000149335.2-Fun_GG704915.1_i000_001724	155	387	232	1.03571	0.380952
GCA_000149895.1-Fun_DS028099.1_i000_001462	155	387	232	1.03571	0.380952
GCA_000150085.1-Fun_DS268200.1_i000_001366	155	387	232	1.03571	0.380952
GCA_004115165.2-Fun_RHJW02000005.1_i000_006247	155	387	232	1.03571	0.380952
GCA_000286035.1-Fun_CAGI01000188.1_i000_000925	197	421	224	1	0.369028
GCA_900519145.1-Fun_ULHA01000001.1_i000_000488	197	421	224	1	0.369028
GCA_001857865.1-Fun_CP017826.1_i000_009547	158	393	235	1.04911	0.383361
GCA_002865625.1-Fun_KZ613499.1_i000_011267	158	393	235	1.04911	0.384615
GCA_014898425.1-Fun_RCSZ01000008.1_i000_006037	158	393	235	1.04911	0.383361
GCA_002317995.1-Fun_MVNX01000013.1_i000_002204	156	391	235	1.04911	0.385246
GCA_900157425.1-Fun_FUEG01000003.1_i000_014278	150	373	223	0.995536	0.42315
GCA_004917165.1-Fun_QZAK01000457.1_i000_007781	184	417	233	1.04018	0.368088
GCA_000503235.1-Fun_KI628568.1_i000_002561	158	393	235	1.04911	0.383361
GCA_014898415.1-Fun_RCTD01000021.1_i000_008236	158	393	235	1.04911	0.382736
GCA_001883845.1-Fun_MNUE01000004.1_i000_006274	163	398	235	1.04911	0.387789
GCA_000409485.1-Fun_KE145354.1_i000_001830	155	390	235	1.04911	0.38715
GCA_000190715.1-Pro_GL871204.1_i000_008387	164	387	223	0.995536	0.420755
GCA_019632275.1-Fun_WSTT01000012.1_i000_001164	150	365	215	0.959821	0.399628
GCA_900080155.1-Fun_LT558118.1_i000_001401	197	421	224	1	0.371476
GCA_900519155.1-Fun_ULHB01000048.1_i000_002865	197	421	224	1	0.371476
GCA_019632285.1-Fun_WSTV01000310.1_i000_005102	150	365	215	0.959821	0.399628
GCA_000313545.1-Fun_CAFZ01000056.1_i000_008583	154	375	221	0.986607	0.416981
GCA_910890315.1-Fun_CAJVGD010000006.1_i000_003432	154	375	221	0.986607	0.416981
GCA_001713695.1-Fun_LYUC01000024.1_i000_003398	159	392	233	1.04018	0.377634
GCA_000747765.1-Fun_DF830068.1_i000_006379	186	410	224	1	0.382906
GCA_900322835.1-Fun_OOIQ01000001.1_i000_000530	186	410	224	1	0.382906
GCA_002204255.1-Fun_MZNU01000258.1_i000_003174	156	391	235	1.04911	0.382736
GCA_900242705.1-Fun_OEYX01000115.1_i000_007195	197	421	224	1	0.370861
GCA_019632265.1-Fun_WSTU01000210.1_i000_003301	150	365	215	0.959821	0.399628
GCA_000721755.1-Fun_KL584762.1_i000_006374	154	387	233	1.04018	0.385124
GCA_019623675.1-Fun_WSTN01000441.1_i000_008464	150	371	221	0.986607	0.466245
GCA_019627745.1-Fun_WSTR01000358.1_i000_007572	150	371	221	0.986607	0.466245
GCA_001179505.1-Pro_CDMY01000270.1_i000_005119	136	357	221	0.986607	0.425
GCA_005059845.1-Fun_NAJN01001811.1_i000_004234	164	397	233	1.04018	0.384488
GCA_012274485.2-Pla_MU112966.1_i000_049472	106	326	220	0.982143	0.455487
GCA_019627725.1-Fun_WSTQ01000142.1_i000_001954	150	371	221	0.986607	0.420152
GCA_019633565.1-Fun_WSUH01000148.1_i000_001896	150	371	221	0.986607	0.420152
GCA_019623665.1-Fun_WSTM01000346.1_i000_007277	150	371	221	0.986607	0.420152
GCA_017366145.1-Fun_JAFJYG010000019.1_i000_000932	156	391	235	1.04911	0.384615
GCA_004917145.1-Fun_QZAE01000935.1_i000_010311	184	417	233	1.04018	0.368088
GCA_004918105.1-Fun_QZBS01000687.1_i000_009045	184	417	233	1.04018	0.368088
GCA_019632305.1-Fun_WSTW01000721.1_i000_007904	148	371	223	0.995536	0.409926
GCA_002865645.1-Fun_KZ613854.1_i000_012097	69	304	235	1.04911	0.450192
GCA_004917225.1-Fun_QZAH01000974.1_i000_010254	184	417	233	1.04018	0.366929
GCA_004917305.1-Fun_QZAP01000215.1_i000_004153	184	417	233	1.04018	0.366929
GCA_020746875.1-Fun_JAGTJL010000012.1_i000_002754	156	391	235	1.04911	0.384615
GCA_004917595.1-Fun_QZAQ01002523.1_i000_005025	155	388	233	1.04018	0.405217
GCA_014607435.1-Fun_JAACFV010000050.1_i000_008949	160	393	233	1.04018	0.370429
GCA_900074885.1-Fun_FJUW01000004.1_i000_005478	158	393	235	1.04911	0.383361
GCA_900074895.1-Fun_FJVC01000058.1_i000_006883	158	393	235	1.04911	0.383361
GCA_002317995.1-Fun_MVNX01000071.1_i000_006921	108	343	235	1.04911	0.401024
GCA_903819635.1-Fun_CAIJEN010000017.1_i000_009379	138	371	233	1.04018	0.397611
GCA_019669835.1-Fun_MU251566.1_i000_007694	156	391	235	1.04911	0.385878
GCA_003357145.1-Fun_NPIC01000001.1_i000_002079	155	390	235	1.04911	0.384615
GCA_004917255.1-Fun_QZAM01000338.1_i000_006300	155	388	233	1.04018	0.386401
GCA_004917355.1-Fun_QZAS01000050.1_i000_007441	155	388	233	1.04018	0.386401
GCA_004917615.1-Fun_QZAY01000459.1_i000_007492	155	388	233	1.04018	0.386401
GCA_000721785.1-Fun_KL585003.1_i000_010393	155	388	233	1.04018	0.385762
GCA_014904845.1-Fun_MU119259.1_i000_009324	2	237	235	1.04911	0.5131
GCA_001883825.1-Fun_LGRN01000323.1_i000_004393	159	392	233	1.04018	0.377634
GCA_004917685.1-Fun_QZBI01001960.1_i000_003633	155	388	233	1.04018	0.386401
GCA_004917525.1-Fun_QZBG01001000.1_i000_010734	184	417	233	1.04018	0.368671
GCA_004917385.1-Fun_QZAV01000312.1_i000_005592	184	417	233	1.04018	0.368671
GCA_004917415.1-Fun_QZAX01001634.1_i000_002715	184	417	233	1.04018	0.368671
GCA_004918245.1-Fun_QZBX01000183.1_i000_003447	184	417	233	1.04018	0.368671
GCA_004917335.1-Fun_QZAR01000252.1_i000_004982	184	417	233	1.04018	0.368671
GCA_004917425.1-Fun_QZAZ01000420.1_i000_006679	184	417	233	1.04018	0.368671
GCA_004917745.1-Fun_QZBN01000401.1_i000_006336	184	417	233	1.04018	0.368671
GCA_015251385.1-Fun_JADGIM010000031.1_i000_006136	184	417	233	1.04018	0.368671
GCA_004917495.1-Fun_QZBE01000033.1_i000_005659	184	417	233	1.04018	0.368088
GCA_001500285.1-Fun_KQ947409.1_i000_003863	158	393	235	1.04911	0.384615
GCA_004917375.1-Fun_QZAT01000342.1_i000_006590	184	417	233	1.04018	0.368088
GCA_004917435.1-Fun_QZBA01000463.1_i000_008046	184	417	233	1.04018	0.368088
GCA_004917605.1-Fun_QZAU01000933.1_i000_010295	184	417	233	1.04018	0.368088
GCA_004917665.1-Fun_QZBH01000453.1_i000_007013	184	417	233	1.04018	0.368088
GCA_004917155.1-Fun_QZAG01002437.1_i000_004775	184	417	233	1.04018	0.368088
GCA_000827415.1-Fun_KN824278.1_i000_001089	157	377	220	0.982143	0.411985
GCA_004918535.1-Fun_QZBU01002401.1_i000_006411	184	417	233	1.04018	0.368088
GCA_001678115.1-Fun_LVWM01000282.1_i000_002798	184	417	233	1.04018	0.368088
GCA_004918575.1-Fun_QZBY01000919.1_i000_010178	184	417	233	1.04018	0.368671
GCA_004917625.1-Fun_QZBC01000186.1_i000_002659	184	417	233	1.04018	0.368671
GCA_004917505.1-Fun_QZBF01000913.1_i000_010050	184	417	233	1.04018	0.368088
GCA_004917825.1-Fun_QZBZ01000377.1_i000_006742	184	417	233	1.04018	0.368671
GCA_004917205.1-Fun_QZAN01000175.1_i000_003137	184	417	233	1.04018	0.368088
GCA_004917115.1-Fun_QZAI01002787.1_i000_006451	184	417	233	1.04018	0.368088
GCA_004917445.1-Fun_QZBB01000198.1_i000_003771	184	417	233	1.04018	0.368088
GCA_004918195.1-Fun_QZCA01000216.1_i000_003778	184	417	233	1.04018	0.368671
GCA_004917705.1-Fun_QZBK01001681.1_i000_002933	184	417	233	1.04018	0.368088
GCA_004917185.1-Fun_QZAL01000391.1_i000_007102	184	417	233	1.04018	0.368088
GCA_004917135.1-Fun_QZAJ01000745.1_i000_009270	184	417	233	1.04018	0.368088
GCA_004917555.1-Fun_QZBJ01000065.1_i000_008652	184	417	233	1.04018	0.368088
GCA_004917815.1-Fun_QZBQ01000455.1_i000_007866	184	417	233	1.04018	0.368088
GCA_004918215.1-Fun_QZBP01000905.1_i000_009923	184	417	233	1.04018	0.368088
GCA_004918275.1-Fun_QZBR01000148.1_i000_002551	184	417	233	1.04018	0.368088
GCA_004918505.1-Fun_QZCB01000847.1_i000_009784	184	417	233	1.04018	0.368088
GCA_004917105.1-Fun_QZAF01000781.1_i000_009310	184	417	233	1.04018	0.368088
GCA_004917275.1-Fun_QZAO01000690.1_i000_008978	184	417	233	1.04018	0.368088
GCA_004917795.1-Fun_QZBL01000942.1_i000_010259	184	417	233	1.04018	0.368088
GCA_903819465.1-Fun_CAIJDR010000005.1_i000_004019	184	417	233	1.04018	0.366929
GCA_004917755.1-Fun_QZBO01000327.1_i000_006076	184	417	233	1.04018	0.366929
GCA_004918145.1-Fun_QZBV01000423.1_i000_007247	184	417	233	1.04018	0.366929
GCA_000143535.4-Fun_CP009815.1_i000_008275	158	393	235	1.04911	0.383361
GCA_020921065.1-Pla_CM037153.1_i000_008873	125	347	222	0.991071	0.555
GCA_001640025.2-Fun_CP014500.1_i000_004417	132	356	224	1	0.395062
GCA_000787575.2-Pro_DF837582.1_i000_007224	145	368	223	0.995536	0.433852
GCA_018127125.1-Pla_CM030799.1_i000_034241	119	341	222	0.991071	0.542787
GCA_000150705.2-Fun_KN293997.1_i000_002831	159	392	233	1.04018	0.378862
GCA_000150475.2-Fun_KN305534.1_i000_003567	159	392	233	1.04018	0.377634
GCA_001713645.1-Fun_LZYO01000018.1_i000_001868	159	392	233	1.04018	0.377634
GCA_000150735.2-Fun_KN275958.1_i000_001829	159	392	233	1.04018	0.377634
GCA_003019875.1-Fun_KZ679010.1_i000_004222	107	342	235	1.04911	0.416667
GCA_001883805.1-Fun_LGTZ01000203.1_i000_003513	159	392	233	1.04018	0.377634
GCA_004917485.1-Fun_QZBD01000738.1_i000_008986	184	417	233	1.04018	0.368088
GCA_001014755.1-Fun_LDEV01002545.1_i000_005183	159	392	233	1.04018	0.377634
GCA_000333975.2-Fun_CAKM01000248.1_i000_001246	105	329	224	1	0.193604
GCA_000003855.2-Fun_GG657459.1_i000_006023	159	392	233	1.04018	0.377634
GCA_000003525.2-Fun_EQ999977.1_i000_005594	159	392	233	1.04018	0.377634
GCA_000166155.1-Fun_GL538444.1_i000_006893	159	392	233	1.04018	0.377634
GCA_000151595.1-Fun_GG749422.1_i000_006786	159	392	233	1.04018	0.377634
GCA_000512605.2-Fun_KI894008.1_i000_001876	183	406	223	0.995536	0.391916
GCA_004917725.1-Fun_QZBM01000405.1_i000_005752	184	417	233	1.04018	0.368088
GCA_903819495.1-Fun_CAIJDT010000008.1_i000_006755	184	417	233	1.04018	0.368088
GCA_003611235.1-Fun_MCBS01024610.1_i000_005323	158	392	234	1.04464	0.373206
GCA_003611215.1-Fun_MCBR01018864.1_i000_005187	158	392	234	1.04464	0.373206
GCA_003611195.1-Fun_MCBQ01001246.1_i000_000489	158	392	234	1.04464	0.373206
GCA_002102565.1-Fun_NBSH01000017.1_i000_002826	155	378	223	0.995536	0.410681
GCA_018857265.1-Fun_JABAJZ010013610.1_i000_008824	162	383	221	0.986607	0.413858
GCA_905337325.1-Fun_CAJPDR010000632.1_i000_009397	177	410	233	1.04018	0.374598
GCA_019616975.1-Fun_WSTL01000333.1_i000_004192	150	371	221	0.986607	0.466245
GCA_002572885.1-Fun_PDNC01000058.1_i000_006120	159	392	233	1.04018	0.377634
GCA_001660665.1-Fun_LGUA01000148.1_i000_001596	159	392	233	1.04018	0.378247
GCA_017365405.1-Fun_JAFJYH010000157.1_i000_009511	156	391	235	1.04911	0.384615
GCA_020726485.1-Fun_JAHEWH010000006.1_i000_015348	155	390	235	1.04911	0.38715
GCA_905337345.1-Fun_CAJPDS010000087.1_i000_008672	156	389	233	1.04018	0.375201
GCA_900073065.1-Fun_FJOG01000017.1_i000_010792	153	388	235	1.04911	0.385246
GCA_009732865.1-Fun_ML769333.1_i000_005439	157	392	235	1.04911	0.385246
GCA_019627755.1-Fun_WSTS01000002.1_i000_003683	150	371	221	0.986607	0.420152
GCA_019627735.1-Fun_WSTP01000215.1_i000_004290	150	371	221	0.986607	0.420152
GCA_004918115.1-Fun_QZBT01000139.1_i000_001906	184	417	233	1.04018	0.368088
GCA_013054445.1-Fun_JAAMPI010000248.1_i000_007301	155	390	235	1.04911	0.386513
GCA_015476405.1-Fun_CM027205.1_i000_009032	154	375	221	0.986607	0.200727
GCA_004918165.1-Fun_QZBW01000418.1_i000_006789	184	417	233	1.04018	0.368671
GCA_007821495.1-Fun_QGMH01000234.1_i000_008490	158	393	235	1.04911	0.384615
GCA_003073865.1-Fun_KZ804255.1_i000_017059	156	390	234	1.04464	0.382979
GCA_002918395.1-Fun_PEDP01000009.1_i000_000142	152	386	234	1.04464	0.39196
GCA_019669825.1-Fun_MU253869.1_i000_004320	157	392	235	1.04911	0.38715
GCA_000512585.2-Fun_KV700382.1_i000_009077	177	400	223	0.995536	0.396092
GCA_007825325.1-Fun_QGMG01000518.1_i000_005653	190	425	235	1.04911	0.365474
GCA_002865655.1-Fun_KZ613937.1_i000_000646	69	304	235	1.04911	0.450192
GCA_905337355.1-Fun_CAJPDT010000144.1_i000_010298	190	423	233	1.04018	0.366352
GCA_000497045.1-Fun_KI545851.1_i000_000380	185	408	223	0.995536	0.383162
GCA_004786265.1-Fun_PQXO01000357.1_i000_006736	158	393	235	1.04911	0.383361
GCA_004786225.1-Fun_PQXJ01000308.1_i000_008458	158	393	235	1.04911	0.383361
GCA_020536535.1-Pro_JAHLWZ010000849.1_i000_012480	158	383	225	1.00446	0.409836
GCA_900323505.1-Fun_OOIN01000002.1_i000_001327	187	411	224	1	0.376471
GCA_007821545.1-Fun_QGMJ01000186.1_i000_003199	158	391	233	1.04018	0.392917
GCA_007825345.1-Fun_QGMK01000198.1_i000_002207	189	423	234	1.04464	0.365055
GCA_021399465.1-Fun_JAJTUS010000060.1_i000_013820	158	393	235	1.04911	0.384615
GCA_021399475.1-Fun_JAJTUR010000021.1_i000_006750	158	393	235	1.04911	0.384615
GCA_900074905.1-Fun_FJUX01000055.1_i000_008793	158	393	235	1.04911	0.383361
GCA_010093925.1-Fun_ML994620.1_i000_006185	126	359	233	1.04018	0.406632
GCA_905066765.1-Fun_CAJHIA010000021.1_i000_006344	158	393	235	1.04911	0.382736
GCA_014066315.1-Fun_JACCJB010000015.1_i000_002540	158	391	233	1.04018	0.385762
GCA_017357885.1-Fun_CP063405.1_i000_000870	158	393	235	1.04911	0.383361
GCA_918797485.1-Pro_CAKKNE010000002.1_i000_006140	128	350	222	0.991071	0.43787
GCA_002916505.1-Fun_PKSG01000315.1_i000_004088	145	379	234	1.04464	0.388704
GCA_002922495.1-Fun_PJQD01000019.1_i000_001632	157	379	222	0.991071	0.402904
GCA_010093885.1-Fun_ML995512.1_i000_010795	110	343	233	1.04018	0.411661
GCA_020747065.1-Fun_JAGMVK010000008.1_i000_015936	156	391	235	1.04911	0.384615
GCA_000203815.1-Pro_GL883021.1_i000_008638	170	391	221	0.986607	0.389771
GCA_021365295.1-Fun_JAJTIW010000015.1_i000_002830	155	390	235	1.04911	0.38715
GCA_010015735.1-Fun_ML978067.1_i000_002269	131	364	233	1.04018	0.405217
GCA_013368555.1-Fun_JAACJN010000005.1_i000_001431	162	401	239	1.06696	0.429084
GCA_000186865.1-Pro_GL833459.1_i000_010693	102	324	222	0.991071	0.634286
GCA_017607445.1-Fun_JAEVHH010000003.1_i000_004835	159	392	233	1.04018	0.378247
GCA_000151005.2-Fun_DS990637.2_i000_000364	159	392	233	1.04018	0.378247
GCA_017310615.1-Fun_CP069102.1_i000_000561	159	392	233	1.04018	0.378247
GCA_008704605.1-Fun_SWFS01000317.1_i000_005592	109	329	220	0.982143	0.43222
GCA_003610855.1-Fun_MCFK01003576.1_i000_002453	158	392	234	1.04464	0.389351
GCA_000464535.1-Fun_KE720951.1_i000_003805	160	393	233	1.04018	0.375201
GCA_000512565.2-Fun_KI894030.1_i000_003340	187	410	223	0.995536	0.38918
GCA_003144245.1-Fun_KZ819681.1_i000_006781	169	395	226	1.00893	0.380471
GCA_012274485.2-Pla_MU106159.1_i000_030267	106	326	220	0.982143	0.455487
GCA_007821475.1-Fun_QGMF01000320.1_i000_005222	158	393	235	1.04911	0.385878
GCA_007825375.1-Fun_QGML01000839.1_i000_004062	158	393	235	1.04911	0.385878
GCA_018858115.1-Fun_JABCKT010006433.1_i000_008618	158	379	221	0.986607	0.412313
GCA_000151545.2-Pro_KK583226.1_i000_009598	122	342	220	0.982143	0.447154
GCA_002906115.4-Pla_PKMF03021703.1_i000_076671	150	384	234	1.04464	0.387417
GCA_003024175.1-Pro_MDYQ01000122.1_i000_003461	113	334	221	0.986607	0.460417
GCA_019633425.1-Fun_WSUB01000101.1_i000_000563	148	368	220	0.982143	0.410448
GCA_019633485.1-Fun_WSUC01000130.1_i000_001872	148	368	220	0.982143	0.410448
GCA_903819115.1-Fun_CAIJCR010000004.1_i000_004202	184	417	233	1.04018	0.368088
GCA_003709865.1-Fun_QRBJ01000024.1_i000_001661	167	400	233	1.04018	0.407343
GCA_003614675.1-Fun_ML002298.1_i000_001377	21	242	221	0.986607	0.667674
GCA_003693665.1-Fun_QQSL01000061.1_i000_004505	158	391	233	1.04018	0.387043
GCA_002276475.2-Fun_NCSK02000070.1_i000_007525	184	419	235	1.04911	0.369497
GCA_000281045.1-Pro_JH767148.1_i000_006378	122	342	220	0.982143	0.44898
GCA_000150115.1-Fun_GG663366.1_i000_005449	141	374	233	1.04018	0.440454
GCA_021365335.1-Fun_JAJTIZ010000014.1_i000_003019	124	357	233	1.04018	0.414591
GCA_020169535.1-Pla_CM034988.1_i000_002751	88	312	224	1	0.491228
GCA_020169555.1-Pla_CM035012.1_i000_002921	88	312	224	1	0.491228
GCA_020169585.1-Pla_CM034976.1_i000_002788	88	312	224	1	0.491228
GCA_003112345.1-Pla_PKPP01002282.1_i000_021940	165	377	212	0.946429	0.560847
GCA_003112345.1-Pla_PKPP01006970.1_i000_042106	165	377	212	0.946429	0.560847
GCA_000827325.1-Fun_KN832875.1_i000_007072	107	342	235	1.04911	0.423423
GCA_009428345.1-Fun_RDSI01000852.1_i000_008800	222	450	228	1.01786	0.357367
GCA_000003515.2-Fun_CH476616.1_i000_003272	111	344	233	1.04018	0.413854
GCA_000151505.1-Fun_ACYE01000083.1_i000_006482	129	362	233	1.04018	0.427523
GCA_003704585.1-Fun_QWIP01000981.1_i000_016058	162	396	234	1.04464	0.380488
GCA_018446385.1-Pla_CM031522.1_i000_052731	1	168	167	0.745536	0.605072
GCA_003704615.1-Fun_QWIQ01000162.1_i000_003036	162	396	234	1.04464	0.376812
GCA_003704595.1-Fun_QWIO01000809.1_i000_007438	162	396	234	1.04464	0.376206
GCA_003704675.1-Fun_QWIS01000052.1_i000_006505	162	396	234	1.04464	0.375602
GCA_003704615.1-Fun_QWIQ01001065.1_i000_000641	162	396	234	1.04464	0.376206
GCA_000750795.1-Fun_JPJX01001773.1_i000_005225	152	386	234	1.04464	0.423913
GCA_000150975.2-Fun_DS989827.1_i000_001660	129	362	233	1.04018	0.400344
GCA_001662645.1-Fun_KV459369.1_i000_001753	182	416	234	1.04464	0.379254
GCA_000750815.1-Fun_JPJZ01001561.1_i000_008805	152	386	234	1.04464	0.417112
GCA_014066305.1-Fun_JACCJC010000017.1_i000_005062	190	423	233	1.04018	0.366352
GCA_007821535.1-Fun_QGMI01000053.1_i000_001654	158	393	235	1.04911	0.383361
GCA_006013705.1-Pla_RXGB01005996.1_i000_018928	87	310	223	0.995536	0.494457
GCA_903819455.1-Fun_CAIJDQ010000009.1_i000_003813	184	418	234	1.04464	0.369085
GCA_010094045.1-Fun_ML986595.1_i000_004381	128	361	233	1.04018	0.408772
GCA_019633555.1-Fun_WSUG01000014.1_i000_002164	146	363	217	0.96875	0.389587
GCA_000750875.1-Fun_JPKA01000047.1_i000_000257	162	396	234	1.04464	0.39196
GCA_000798715.1-Fun_JNVN01000894.1_i000_002077	32	266	234	1.04464	0.488518
GCA_021399445.1-Fun_JAJTUQ010000004.1_i000_011047	155	390	235	1.04911	0.384615
GCA_001618945.2-Fun_CM038150.1_i000_005765	186	420	234	1.04464	0.365625
GCA_001625195.1-Fun_CM004176.1_i000_007895	186	420	234	1.04464	0.365625
GCA_001651435.1-Fun_LHPN01000013.1_i000_001965	129	362	233	1.04018	0.400344
GCA_000151425.1-Fun_GG700661.1_i000_000302	129	362	233	1.04018	0.400344
GCA_000616765.1-Fun_KK203767.1_i000_000302	129	362	233	1.04018	0.400344
GCA_000616805.1-Fun_KK207123.1_i000_000301	129	362	233	1.04018	0.400344
GCA_000616825.1-Fun_KK207687.1_i000_000300	129	362	233	1.04018	0.400344
GCA_000616845.1-Fun_KK208225.1_i000_000300	129	362	233	1.04018	0.400344
GCA_000616865.1-Fun_KK208718.1_i000_000295	129	362	233	1.04018	0.400344
GCA_000616905.1-Fun_KK209163.1_i000_000304	129	362	233	1.04018	0.400344
GCA_000616945.1-Fun_KK209731.1_i000_000304	129	362	233	1.04018	0.400344
GCA_000616965.1-Fun_KK210202.1_i000_000191	129	362	233	1.04018	0.400344
GCA_000616985.1-Fun_KK210552.1_i000_000337	129	362	233	1.04018	0.400344
GCA_000622995.1-Fun_AOLB01000061.1_i000_000301	129	362	233	1.04018	0.400344
GCA_000812105.1-Fun_JPGR01000068.1_i000_006417	129	362	233	1.04018	0.400344
GCA_001651445.1-Fun_LHPM01000016.1_i000_004998	129	362	233	1.04018	0.400344
GCA_015501535.1-Fun_JADNRW010000010.1_i000_001106	161	374	213	0.950893	0.400376
GCA_905250015.1-Ani_CAJNOM010000308.1_i000_033436	28	81	53	0.236607	0.146814
GCA_905250015.1-Ani_CAJNOM010000308.1_i000_033436	78	204	126	0.5625	0.34903
GCA_905250115.1-Ani_CAJNOI010000149.1_i000_022924	28	81	53	0.236607	0.146814
GCA_905250115.1-Ani_CAJNOI010000149.1_i000_022924	78	204	126	0.5625	0.34903
GCA_009428365.1-Fun_RDSJ01002307.1_i000_003727	222	450	228	1.01786	0.357367
GCA_000750935.1-Fun_JPKD01003300.1_i000_010137	182	416	234	1.04464	0.397959
GCA_018258275.1-Pla_CM031107.1_i000_011978	88	312	224	1	0.492308
GCA_000743665.3-Fun_JMRO03000007.1_i000_003671	158	393	235	1.04911	0.385246
GCA_001645055.2-Fun_LWDG02000511.1_i000_005821	222	450	228	1.01786	0.357367
GCA_009428295.1-Fun_RDSH01000069.1_i000_006661	222	450	228	1.01786	0.357367
GCA_001645015.2-Fun_LWDF02000192.1_i000_002875	222	450	228	1.01786	0.357367
GCA_905071775.1-Fun_CAJHJJ010002745.1_i000_003592	205	433	228	1.01786	0.409336
GCA_902141235.2-Fun_CABFOC020000034.1_i000_006313	145	379	234	1.04464	0.393277
GCA_000312925.2-Fun_HE965078.1_i000_002067	120	340	220	0.982143	0.433925
GCA_001653205.1-Fun_LSBH01000003.1_i000_004074	146	380	234	1.04464	0.391304
GCA_001653265.1-Fun_LSBI01000003.1_i000_003285	146	380	234	1.04464	0.391304
GCA_003144605.1-Fun_LCWV01000018.1_i000_003922	146	380	234	1.04464	0.391304
GCA_021029045.1-Pro_JAFCAI010000050.1_i000_010714	525	747	222	0.991071	0.245304
GCA_009299455.1-Fun_VIGI01000015.1_i000_009759	158	393	235	1.04911	0.383361
GCA_903819485.1-Fun_CAIJDU010000006.1_i000_005105	184	418	234	1.04464	0.369085
GCA_000004825.1-Pro_GL290984.1_i000_001155	142	365	223	0.995536	0.437255
GCA_006013705.1-Pla_RXGB01001096.1_i000_005633	86	301	215	0.959821	0.477778
GCA_902077795.2-Fun_CABFNQ020000555.1_i000_005087	145	379	234	1.04464	0.392617
GCA_002127715.1-Fun_MUNK01000022.1_i000_005232	162	396	234	1.04464	0.375602
GCA_003704685.1-Fun_QWIT01000512.1_i000_011624	162	396	234	1.04464	0.375602
GCA_002105105.1-Fun_MCFI01000008.1_i000_006280	103	324	221	0.986607	0.476293
GCA_001662585.1-Fun_KV454732.1_i000_010033	182	416	234	1.04464	0.379254
GCA_001645045.2-Fun_LWDE02000141.1_i000_001579	205	433	228	1.01786	0.36953
GCA_009428265.1-Fun_RDSE01000117.1_i000_000710	205	433	228	1.01786	0.36953
GCA_905071705.1-Fun_CAJHJC010007634.1_i000_009124	205	433	228	1.01786	0.36953
GCA_905071725.1-Fun_CAJHJD010002512.1_i000_003733	205	433	228	1.01786	0.36953
GCA_905071765.1-Fun_CAJHJB010000556.1_i000_008404	205	433	228	1.01786	0.36953
GCA_905071785.1-Fun_CAJHJI010002236.1_i000_003490	205	433	228	1.01786	0.36953
GCA_000184105.1-Fun_GL573181.1_i000_001126	225	459	234	1.04464	0.354545
GCA_001641265.1-Fun_KV441390.1_i000_002654	225	459	234	1.04464	0.354545
GCA_001645005.2-Fun_LWDD02000682.1_i000_008503	207	435	228	1.01786	0.368336
GCA_009428275.1-Fun_RDSF01000474.1_i000_006979	207	435	228	1.01786	0.368336
GCA_009428285.1-Fun_RDSG01000030.1_i000_004851	207	435	228	1.01786	0.368336
GCA_905068135.1-Fun_CAJHJA010003014.1_i000_004360	207	435	228	1.01786	0.368336
GCA_905071715.1-Fun_CAJHJH010001462.1_i000_002565	207	435	228	1.01786	0.368336
GCA_905071735.1-Fun_CAJHJE010003002.1_i000_004275	207	435	228	1.01786	0.368336
GCA_905071745.1-Fun_CAJHJG010003188.1_i000_004442	207	435	228	1.01786	0.368336
GCA_905071755.1-Fun_CAJHJF010002924.1_i000_004506	207	435	228	1.01786	0.368336
GCA_905072865.1-Fun_CAJHJV010003851.1_i000_005719	207	435	228	1.01786	0.368336
GCA_000338955.1-Fun_KB445550.1_i000_000685	69	303	234	1.04464	0.440678
GCA_000616785.1-Fun_KK204356.1_i000_001946	129	362	233	1.04018	0.400344
GCA_000622975.1-Fun_AOKY01000019.1_i000_000219	129	362	233	1.04018	0.400344
GCA_012182645.1-Fun_JAATJQ010000058.1_i000_006187	129	362	233	1.04018	0.400344
GCA_012182655.1-Fun_JAAQVJ010000062.1_i000_006372	129	362	233	1.04018	0.400344
GCA_019359935.1-Fun_JAADCK010000058.1_i000_006159	129	362	233	1.04018	0.400344
GCA_000151175.1-Fun_DS995747.1_i000_003270	129	362	233	1.04018	0.400344
GCA_000151455.1-Fun_GG698539.1_i000_000518	129	362	233	1.04018	0.400344
GCA_003704355.1-Fun_QWIL01001146.1_i000_009334	69	303	234	1.04464	0.442344
GCA_003704385.1-Fun_QWIM01002491.1_i000_014070	69	303	234	1.04464	0.442344
GCA_022376555.1-Fun_WTXH01000035.1_i000_006285	155	360	205	0.915179	0.372727
GCA_003704355.1-Fun_QWIL01004000.1_i000_016030	69	303	234	1.04464	0.442344
GCA_003704385.1-Fun_QWIM01000966.1_i000_008562	69	303	234	1.04464	0.442344
GCA_008692225.1-Fun_VICG01000011.1_i000_008933	158	393	235	1.04911	0.40378
GCA_000732125.1-Fun_JOWA01000107.1_i000_005196	143	378	235	1.04911	0.390365
GCA_000835495.1-Fun_KN847041.1_i000_002929	155	388	233	1.04018	0.385762
GCA_000785585.1-Fun_JSEJ01000081.1_i000_010133	155	388	233	1.04018	0.385762
GCA_019633535.1-Fun_WSUE01000024.1_i000_005914	146	363	217	0.96875	0.407129
GCA_014904905.1-Fun_MU122107.1_i000_003107	162	389	227	1.01339	0.375828
GCA_009733575.1-Fun_ML769388.1_i000_002462	111	333	222	0.991071	0.454918
GCA_019448385.1-Pro_JAGTXO010000007.1_i000_000824	114	338	224	1	0.455285
GCA_016906325.1-Fun_RKRL01000007.1_i000_003153	158	393	235	1.04911	0.383361
GCA_001662605.1-Fun_KV458831.1_i000_005787	182	416	234	1.04464	0.379254
GCA_022376525.1-Fun_WTXL01000008.1_i000_011566	155	371	216	0.964286	0.409867
GCA_902085965.1-Fun_CABFNS010000926.1_i000_016172	182	416	234	1.04464	0.370253
GCA_020379485.1-Pla_CM035460.1_i000_064942	107	148	41	0.183036	0.0800781
GCA_020379485.1-Pla_CM035460.1_i000_064942	146	356	210	0.9375	0.410156
GCA_000151125.2-Fun_ABSU01000014.1_i000_003436	129	362	233	1.04018	0.400344
GCA_000750805.1-Fun_JPJY01000093.1_i000_000584	152	386	234	1.04464	0.398637
GCA_000835395.1-Fun_KN846953.1_i000_006590	161	394	233	1.04018	0.383855
GCA_003260565.1-Fun_QKRW01000092.1_i000_010272	158	393	235	1.04911	0.39629
GCA_000507405.3-Fun_KI669495.1_i000_001587	185	408	223	0.995536	0.390543
GCA_001662655.1-Fun_KV460236.1_i000_006586	152	386	234	1.04464	0.398637
GCA_000750895.1-Fun_JPKB01001043.1_i000_006271	152	386	234	1.04464	0.398637
GCA_001662595.1-Fun_KV456259.1_i000_004976	152	374	222	0.991071	0.397138
GCA_904859935.1-Fun_CAJHEQ010000917.1_i000_005834	161	384	223	0.995536	0.207635
GCA_001692895.1-Fun_KV748184.1_i000_003449	129	362	233	1.04018	0.399657
GCA_003704575.1-Fun_QWIN01001309.1_i000_002205	162	396	234	1.04464	0.376206
GCA_003704585.1-Fun_QWIP01000907.1_i000_015477	162	396	234	1.04464	0.376206
GCA_008629635.1-Fun_NQVO01000014.1_i000_003402	168	391	223	0.995536	0.402527
GCA_001692735.1-Fun_KV744870.1_i000_003404	128	361	233	1.04018	0.400344
GCA_003704375.1-Fun_QWIK01001034.1_i000_000382	162	396	234	1.04464	0.376812
GCA_002105025.1-Fun_MCFA01000041.1_i000_010555	127	360	233	1.04018	0.407343
GCA_002127715.1-Fun_MUNK01000195.1_i000_004050	162	396	234	1.04464	0.376812
GCA_003704685.1-Fun_QWIT01000003.1_i000_004506	162	396	234	1.04464	0.376812
GCA_003704345.1-Fun_QWIJ01003010.1_i000_009058	162	396	234	1.04464	0.376206
GCA_003704645.1-Fun_QWIR01000031.1_i000_004807	162	396	234	1.04464	0.376812
GCA_002276285.1-Fun_NLAX01000701.1_i000_006484	142	377	235	1.04911	0.391015
GCA_902006505.2-Fun_CABFNO020001560.1_i000_016202	145	379	234	1.04464	0.392617
GCA_018902385.1-Fun_JABSSW010000013.1_i000_003508	614	847	233	1.04018	0.219191
GCA_003144205.1-Fun_KZ819611.1_i000_007302	161	382	221	0.986607	0.409259
GCA_000956045.1-Fun_KQ030501.1_i000_001273	197	431	234	1.04464	0.362791
GCA_900169345.1-Fun_FWEW01000060.1_i000_006126	164	397	233	1.04018	0.453307
GCA_002812745.2-Fun_NCSJ02000111.1_i000_000512	155	390	235	1.04911	0.384615
GCA_002906115.4-Pla_PKMF03003070.1_i000_011169	150	384	234	1.04464	0.389351
GCA_010015655.1-Fun_ML976672.1_i000_005492	133	366	233	1.04018	0.406632
GCA_905332035.1-Ani_CAJOAY010022454.1_i000_049143	1	139	138	0.616071	0.779661
GCA_000507425.3-Fun_KV700221.1_i000_005479	185	408	223	0.995536	0.390543
GCA_003260655.2-Pla_QGKV02000649.1_i000_025132	111	270	159	0.709821	0.323171
GCA_003260655.2-Pla_QGKV02000649.1_i000_025132	298	349	51	0.227679	0.103659
GCA_001720245.1-Fun_AWGL01000010.1_i000_000837	169	392	223	0.995536	0.402527
GCA_001720195.1-Fun_AWGK01000034.1_i000_004506	169	392	223	0.995536	0.402527
GCA_001662575.1-Fun_KV455065.1_i000_009035	181	415	234	1.04464	0.37987
GCA_018855915.1-Fun_JABCKO010015849.1_i000_006388	179	403	224	1	0.4
GCA_001646985.1-Fun_LVCI01000099.1_i000_011754	148	381	233	1.04018	0.39094
GCA_008636195.1-Fun_VXIT01000018.1_i000_003888	164	397	233	1.04018	0.367508
GCA_000836435.1-Fun_KN848083.1_i000_009041	154	387	233	1.04018	0.387043
GCA_003016335.1-Fun_KZ678129.1_i000_002309	128	361	233	1.04018	0.411661
GCA_000151145.1-Fun_DS995706.1_i000_001723	129	362	233	1.04018	0.401033
GCA_001642475.1-Fun_LVKK01000121.1_i000_001660	159	392	233	1.04018	0.383855
GCA_020310725.1-Fun_LGJB01000016.1_i000_006155	159	392	233	1.04018	0.383855
GCA_000750995.1-Fun_JPKE01002398.1_i000_006488	180	414	234	1.04464	0.450867
GCA_000835505.1-Fun_KN847321.1_i000_007872	153	386	233	1.04018	0.387687
GCA_000150505.2-Fun_KE503206.1_i000_001783	138	358	220	0.982143	0.423077
GCA_000835455.1-Fun_KN846971.1_i000_005679	159	392	233	1.04018	0.383855
GCA_001646965.1-Fun_LVCJ01000068.1_i000_009553	157	390	233	1.04018	0.385124
GCA_003426235.1-Fun_NQIM01000070.1_i000_010810	190	425	235	1.04911	0.51087
GCA_001572075.1-Fun_JOOL01000017.1_i000_000170	154	388	234	1.04464	0.38806
GCA_001592465.1-Fun_JPDO01000036.1_i000_006374	154	388	234	1.04464	0.38806
GCA_020744415.1-Fun_JAGMWT010000017.1_i000_005204	129	362	233	1.04018	0.407343
GCA_000750925.1-Fun_JPKC01003610.1_i000_010962	180	414	234	1.04464	0.405546
GCA_000733195.1-Pla_CM002869.1_i000_001202	81	300	219	0.977679	0.491031
GCA_002220235.1-Pla_FO082261.1_i000_007605	148	375	227	1.01339	0.424299
GCA_001651985.1-Fun_LVYI01000013.1_i000_002984	156	389	233	1.04018	0.386401
GCA_002081575.1-Pro_JNBS01005268.1_i000_013151	120	340	220	0.982143	0.621469
GCA_010093895.1-Fun_ML996087.1_i000_006516	156	391	235	1.04911	0.390365
GCA_005059885.1-Fun_NAJL01000017.1_i000_001867	162	396	234	1.04464	0.37987
GCA_001278385.1-Fun_LGAV01000001.1_i000_000676	147	372	225	1.00446	0.409091
GCA_001644535.1-Fun_KV441644.1_i000_006850	124	357	233	1.04018	0.429098
GCA_000836115.1-Fun_KN847493.1_i000_002839	151	384	233	1.04018	0.39094
GCA_002335675.1-Pla_BEGY01000013.1_i000_003014	5	185	180	0.803571	0.524781
GCA_010093825.1-Fun_ML995818.1_i000_002898	85	319	234	1.04464	0.441509
GCA_002914845.1-Pla_JXTC01000260.1_i000_024665	87	311	224	1	0.478632
GCA_004009835.2-Fun_RIBY02002556.1_i000_010046	160	394	234	1.04464	0.382979
GCA_001692915.1-Fun_KV751158.1_i000_014184	129	362	233	1.04018	0.399657
GCA_001189435.1-Fun_LFRF01000013.1_i000_001820	145	379	234	1.04464	0.389351
GCA_005382405.1-Fun_PTQR01000050.1_i000_005526	162	397	235	1.04911	0.389718
GCA_000585565.1-Fun_AMGY01000010.1_i000_009538	153	386	233	1.04018	0.388333
GCA_003709825.1-Fun_QQXN01000015.1_i000_000903	158	391	233	1.04018	0.387043
GCA_001630375.1-Fun_JYNV01000209.1_i000_005279	125	358	233	1.04018	0.417563
GCA_004011695.1-Fun_RYYQ01000003.1_i000_001461	125	358	233	1.04018	0.417563
GCA_001272575.2-Fun_LAZP02000117.1_i000_000631	68	301	233	1.04018	0.456863
GCA_003013795.1-Fun_NHZQ01000412.1_i000_001292	161	396	235	1.04911	0.391015
GCA_011058865.1-Fun_SWKW01000104.1_i000_000562	125	358	233	1.04018	0.416816
GCA_000835515.1-Fun_KN847333.1_i000_002002	154	387	233	1.04018	0.388982
GCA_008704415.1-Fun_VXIS01000237.1_i000_004917	162	389	227	1.01339	0.375207
GCA_000511025.2-Pla_CM002322.2_i000_003329	87	314	227	1.01339	0.616848
GCA_019924265.1-Fun_JAHFXL010000009.1_i000_006797	158	391	233	1.04018	0.384488
GCA_000230625.1-Fun_JH226132.1_i000_004241	158	391	233	1.04018	0.384488
GCA_000988875.2-Fun_LCTV02000012.1_i000_001795	157	379	222	0.991071	0.408088
GCA_000320785.2-Fun_KB722646.1_i000_002451	157	379	222	0.991071	0.408088
GCA_003234015.1-Fun_LK052940.1_i000_005236	157	379	222	0.991071	0.408088
GCA_000349385.1-Fun_KB705695.1_i000_001803	161	395	234	1.04464	0.380488
GCA_003573695.1-Pla_CM010724.1_i000_038528	73	294	221	0.986607	0.5
GCA_001642045.1-Fun_KV441548.1_i000_001984	131	364	233	1.04018	0.408056
GCA_019633465.1-Fun_WSTY01007969.1_i000_013532	152	372	220	0.982143	0.482456
GCA_001969505.1-Fun_LSSK01001527.1_i000_005151	148	370	222	0.991071	0.411874
GCA_001720155.1-Fun_AWGH01000025.1_i000_004055	178	401	223	0.995536	0.396797
GCA_012980515.1-Fun_JAACLJ010000001.1_i000_000156	137	370	233	1.04018	0.408772
GCA_016771965.1-Pla_CM028699.1_i000_062925	107	148	41	0.183036	0.0802348
GCA_016771965.1-Pla_CM028699.1_i000_062925	147	355	208	0.928571	0.407045
GCA_017639395.1-Pla_CM029884.1_i000_025272	107	328	221	0.986607	0.456612
GCA_008632915.2-Pla_AP019301.1_i000_014173	130	343	213	0.950893	0.429435
GCA_020746835.1-Fun_JAGPNK010000002.1_i000_007068	140	374	234	1.04464	0.394604
GCA_020746995.1-Fun_JAGPXD010000002.1_i000_005264	145	381	236	1.05357	0.391376
GCA_000827425.1-Fun_KN822008.1_i000_002120	160	373	213	0.950893	0.400376
GCA_010093485.1-Fun_MU001496.1_i000_004325	131	364	233	1.04018	0.408056
GCA_011692745.1-Fun_JAACJD010000003.1_i000_004247	129	362	233	1.04018	0.397611
GCA_001541205.1-Fun_KQ954465.1_i000_000665	96	318	222	0.991071	0.454918
GCA_010085335.1-Ani_VULH01051089.1_i000_017061	1	74	73	0.325893	0.228125
GCA_010085335.1-Ani_VULH01051089.1_i000_017061	101	153	52	0.232143	0.1625
GCA_014595645.1-Fun_JACTAD010000003.1_i000_008151	189	424	235	1.04911	0.366615
GCA_019633595.1-Fun_WSUI01000077.1_i000_011711	149	369	220	0.982143	0.216323
GCA_900412535.3-Pla_LS974622.2_i000_027724	107	328	221	0.986607	0.456612
GCA_003260655.2-Pla_QGKV02000297.1_i000_007827	107	149	42	0.1875	0.0821918
GCA_003260655.2-Pla_QGKV02000297.1_i000_007827	146	355	209	0.933036	0.409002
GCA_015832175.1-Fun_WJXW01000001.1_i000_000066	131	364	233	1.04018	0.40949
GCA_019627685.1-Fun_WSTO01000057.1_i000_001001	151	372	221	0.986607	0.419355
GCA_005059875.1-Fun_MXAQ01000002.1_i000_001914	159	381	222	0.991071	0.404372
GCA_016584205.1-Fun_PUHQ01000013.1_i000_001207	159	381	222	0.991071	0.404372
GCA_001720205.1-Fun_AWGJ01000010.1_i000_000962	176	399	223	0.995536	0.398214
GCA_019633495.1-Fun_WSUD01000476.1_i000_003792	54	274	220	0.982143	0.243902
GCA_001720235.1-Fun_MEKH01000009.1_i000_007750	183	406	223	0.995536	0.393298
GCA_020169575.1-Pla_CM035000.1_i000_002579	88	312	224	1	0.492308
GCA_004011705.1-Fun_RZGK01000010.1_i000_006003	125	358	233	1.04018	0.417563
GCA_019609905.1-Fun_CM033785.1_i000_001381	144	378	234	1.04464	0.393277
GCA_001675295.1-Fun_LYXU01000001.1_i000_001342	144	378	234	1.04464	0.393277
GCA_002901185.1-Fun_NRSZ01000441.1_i000_006412	145	379	234	1.04464	0.389351
GCA_007990605.1-Fun_BJWK01000009.1_i000_003861	157	379	222	0.991071	0.408088
GCA_007182795.1-Fun_VFLP01000001.1_i000_000234	155	390	235	1.04911	0.383987
GCA_001263195.1-Fun_KQ412721.1_i000_008562	166	262	96	0.428571	0.171429
GCA_001263195.1-Fun_KQ412721.1_i000_008562	263	403	140	0.625	0.25
GCA_000827465.1-Fun_KN822989.1_i000_005946	151	371	220	0.982143	0.410448
GCA_001275005.1-Pro_JWZX01001013.1_i000_002535	127	348	221	0.986607	0.450102
GCA_000835475.1-Fun_KN846991.1_i000_007930	158	391	233	1.04018	0.383855
GCA_011075155.1-Fun_JAAJBS010000008.1_i000_008744	152	388	236	1.05357	0.388158
GCA_018906675.1-Fun_JAESDO010000001.1_i000_001562	152	388	236	1.05357	0.388158
GCA_018906765.1-Fun_JAESDN010000001.1_i000_001568	152	388	236	1.05357	0.388158
GCA_018907675.1-Fun_JAESDM010000001.1_i000_001573	152	388	236	1.05357	0.388158
GCA_000836275.1-Fun_KN847525.1_i000_007960	153	386	233	1.04018	0.387043
GCA_022376515.1-Fun_WTXI01000019.1_i000_004626	154	394	240	1.07143	0.437158
GCA_001563135.1-Fun_JFBX01000267.1_i000_004373	185	421	236	1.05357	0.368175
GCA_001831195.1-Fun_MJBS01000022.1_i000_005887	152	388	236	1.05357	0.388158
GCA_001563115.1-Fun_JEMN01001685.1_i000_013061	185	421	236	1.05357	0.368175
GCA_003709845.1-Fun_QQXO01000155.1_i000_001267	162	395	233	1.04018	0.384488
GCA_000835555.1-Fun_KN847485.1_i000_011037	159	392	233	1.04018	0.383855
GCA_010094145.1-Fun_ML978962.1_i000_003529	125	358	233	1.04018	0.417563
GCA_003434825.1-Pla_CM010633.1_i000_020224	107	328	221	0.986607	0.456612
GCA_021399435.1-Fun_JAJTUP010000001.1_i000_000866	156	391	235	1.04911	0.386513
GCA_000334115.1-Fun_KB317705.1_i000_004320	154	375	221	0.986607	0.409259
GCA_020169555.1-Pla_CM035018.1_i000_024009	93	308	215	0.959821	0.466377
GCA_020169575.1-Pla_CM035006.1_i000_023906	93	308	215	0.959821	0.466377
GCA_020169585.1-Pla_CM034982.1_i000_023857	93	308	215	0.959821	0.466377
GCA_000582985.1-Fun_JARH01000541.1_i000_007024	185	421	236	1.05357	0.368175
GCA_020744425.1-Fun_JAGMUV010000013.1_i000_003924	181	415	234	1.04464	0.375
GCA_011057905.1-Fun_WUBL01000003.1_i000_005809	155	390	235	1.04911	0.382736
GCA_010093715.1-Fun_MU005775.1_i000_009088	130	363	233	1.04018	0.411661
GCA_015178995.1-Fun_WHVE01000001.1_i000_000142	114	341	227	1.01339	0.40754
GCA_020379485.1-Pla_CM035451.1_i000_021582	107	328	221	0.986607	0.456612
GCA_002591395.1-Fun_NJES01000862.1_i000_007158	129	362	233	1.04018	0.412389
GCA_017506865.1-Pro_JAFCMP010000047.1_i000_003581	134	354	220	0.982143	0.437376
GCA_002895985.1-Fun_NKHZ01000029.1_i000_004698	166	401	235	1.04911	0.387789
GCA_002220415.3-Pla_CM022215.1_i000_022243	128	268	140	0.625	0.299145
GCA_002220415.3-Pla_CM022215.1_i000_022243	266	329	63	0.28125	0.134615
GCA_014621405.1-Fun_JAANBC010000252.1_i000_003584	181	415	234	1.04464	0.370253
GCA_004011775.1-Fun_NAJM01000009.1_i000_010204	153	386	233	1.04018	0.387043
GCA_011947395.2-Fun_JAATWM020000064.1_i000_011701	153	388	235	1.04911	0.386513
GCA_018258275.1-Pla_CM031112.1_i000_039019	93	308	215	0.959821	0.135305
GCA_002307695.1-Fun_KZ293645.1_i000_002307	156	371	215	0.959821	0.409524
GCA_000709125.1-Fun_AMGV01000006.1_i000_007523	152	385	233	1.04018	0.388982
GCA_013365045.1-Fun_QQZM01000015.1_i000_001003	152	373	221	0.986607	0.365894
GCA_001633055.2-Fun_LKCN02000010.1_i000_007834	144	377	233	1.04018	0.385762
GCA_016647755.1-Fun_JABBWI010000001.1_i000_000701	154	380	226	1.00893	0.418519
GCA_002077065.1-Fun_NAJO01000005.1_i000_014037	160	394	234	1.04464	0.382979
GCA_000583005.2-Pla_ASHM01005820.1_i000_009511	40	201	161	0.71875	0.407595
GCA_000583005.2-Pla_ASHM01005820.1_i000_009511	196	234	38	0.169643	0.0962025
GCA_002077065.1-Fun_NAJO01000020.1_i000_006185	172	406	234	1.04464	0.375602
GCA_013390195.1-Fun_QPNA01000006.1_i000_009455	186	422	236	1.05357	0.368175
GCA_008065275.1-Fun_QKWK01000002.1_i000_000996	152	376	224	1	0.415584
GCA_000313795.2-Fun_CACQ02001458.1_i000_003521	153	389	236	1.05357	0.385621
GCA_004920355.1-Fun_MWPZ01000007.1_i000_011413	153	389	236	1.05357	0.385621
GCA_002738505.1-Pla_KZ305094.1_i000_022974	105	328	223	0.995536	0.4869
GCA_002307675.1-Fun_KZ293421.1_i000_006064	153	368	215	0.959821	0.423228
GCA_000446055.1-Fun_AMYD01003649.1_i000_013802	186	422	236	1.05357	0.368175
GCA_001672515.1-Fun_CM004461.1_i000_011843	186	422	236	1.05357	0.365891
GCA_011947485.2-Fun_JAATWK020000156.1_i000_003217	186	422	236	1.05357	0.368175
GCA_005350895.1-Fun_PJEX01000003.1_i000_000292	140	376	236	1.05357	0.414763
GCA_001563125.1-Fun_JFFI01001517.1_i000_007554	185	421	236	1.05357	0.368175
GCA_002105095.1-Fun_MCFJ01000005.1_i000_009579	157	392	235	1.04911	0.385878
GCA_011058905.1-Fun_SWKU01000030.1_i000_006707	125	358	233	1.04018	0.416816
GCA_006783085.1-Fun_PUHP01000047.1_i000_001176	186	422	236	1.05357	0.365891
GCA_013339685.1-Ani_CM023490.1_i000_024795	99	225	126	0.5625	0.555066
GCA_000149035.1-Fun_GG697342.1_i000_003866	153	389	236	1.05357	0.386252
GCA_019425555.1-Fun_MXQG01000031.1_i000_007148	180	414	234	1.04464	0.372019
GCA_020744135.1-Fun_JAGMVI010000001.1_i000_002540	180	414	234	1.04464	0.372019
GCA_900007375.1-Fun_LN649229.1_i000_004462	180	414	234	1.04464	0.372019
GCA_021432615.1-Fun_MU270215.1_i000_008131	153	389	236	1.05357	0.388158
GCA_000585535.1-Fun_AMGX01000007.1_i000_005052	153	386	233	1.04018	0.387043
GCA_002215705.1-Fun_AMKS01000010.1_i000_000847	165	388	223	0.995536	0.403986
GCA_002215745.1-Fun_NKHX01000022.1_i000_002808	165	388	223	0.995536	0.403986
GCA_002215755.1-Fun_NKHW01000065.1_i000_005730	165	388	223	0.995536	0.403986
GCA_002220045.1-Fun_NKHY01000065.1_i000_005887	165	388	223	0.995536	0.403986
GCA_013201765.1-Fun_QPMQ01000009.1_i000_001212	186	422	236	1.05357	0.368175
GCA_000319635.2-Fun_ANPB02000008.1_i000_013802	132	368	236	1.05357	0.373418
GCA_009771025.1-Fun_SSNE01000046.1_i000_012344	132	368	236	1.05357	0.373418
GCA_013201785.1-Fun_QPMP01000019.1_i000_006621	186	422	236	1.05357	0.368175
GCA_013201905.1-Fun_QPMW01000097.1_i000_012604	186	422	236	1.05357	0.368175
GCA_013201925.1-Fun_QPMY01000082.1_i000_011299	186	422	236	1.05357	0.368175
GCA_013201745.1-Fun_QPMT01000059.1_i000_012717	186	422	236	1.05357	0.368175
GCA_013201755.1-Fun_QPMR01000028.1_i000_008106	186	422	236	1.05357	0.368175
GCA_013201795.1-Fun_QPMS01000066.1_i000_013805	186	422	236	1.05357	0.368175
GCA_013201865.1-Fun_QPMU01000054.1_i000_012813	186	422	236	1.05357	0.368175
GCA_013390185.1-Fun_QPNB01000007.1_i000_010683	186	422	236	1.05357	0.368175
GCA_013201875.1-Fun_QPMV01000124.1_i000_012664	186	422	236	1.05357	0.368175
GCA_002222155.1-Fun_APKL01000080.1_i000_006556	179	402	223	0.995536	0.393993
GCA_002222385.1-Fun_AMKN01000033.1_i000_002754	179	402	223	0.995536	0.393993
GCA_002215835.1-Fun_AMKP01000006.1_i000_006204	179	402	223	0.995536	0.393993
GCA_002222475.1-Fun_AMKO01000009.1_i000_006832	179	402	223	0.995536	0.393993
GCA_002234625.1-Fun_AMKQ01000010.1_i000_000639	179	402	223	0.995536	0.393993
GCA_000585585.1-Fun_AMWN01000007.1_i000_008132	159	392	233	1.04018	0.383855
GCA_020169535.1-Pla_CM034994.1_i000_024753	92	307	215	0.959821	0.467391
GCA_019202795.1-Pla_CM032915.1_i000_016146	102	178	76	0.339286	0.168889
GCA_019202795.1-Pla_CM032915.1_i000_016146	173	303	130	0.580357	0.288889
GCA_001006365.1-Fun_LCUC01000331.1_i000_005460	150	385	235	1.04911	0.390365
GCA_010094035.1-Fun_ML987189.1_i000_000062	141	374	233	1.04018	0.403114
GCA_010093535.1-Fun_MU003503.1_i000_006227	127	360	233	1.04018	0.406632
GCA_020744375.1-Fun_JAGMUU010000002.1_i000_007011	146	380	234	1.04464	0.391304
GCA_019321695.1-Fun_JAHWGW010000005.1_i000_005184	151	386	235	1.04911	0.389718
GCA_013390205.1-Fun_QPMX01000006.1_i000_009701	178	414	236	1.05357	0.34757
GCA_020921065.1-Pla_CM037157.1_i000_020183	79	301	222	0.991071	0.641618
GCA_022432385.1-Fun_JAJJXC010000009.1_i000_013024	155	390	235	1.04911	0.389073
GCA_012932255.1-Fun_QLYQ01000591.1_i000_008638	202	438	236	1.05357	0.336182
GCA_013365075.1-Fun_QQZL01000072.1_i000_004652	152	373	221	0.986607	0.365894
GCA_013365125.1-Fun_QQZK01000007.1_i000_004307	152	373	221	0.986607	0.365894
GCA_013305595.1-Fun_QQZN01000012.1_i000_000597	152	373	221	0.986607	0.365894
GCA_001402995.1-Fun_CCBN010000023.1_i000_006342	152	373	221	0.986607	0.365894
GCA_014596635.1-Fun_QQZJ01000030.1_i000_002605	152	373	221	0.986607	0.365894
GCA_013365065.1-Fun_QQZO01000214.1_i000_002097	152	373	221	0.986607	0.365894
GCA_010405375.1-Fun_MU004414.1_i000_011165	129	362	233	1.04018	0.403114
GCA_004802695.1-Fun_SGPK01000001.1_i000_000027	670	908	238	1.0625	0.223055
GCA_001636675.1-Fun_AZGY01000010.1_i000_001402	146	380	234	1.04464	0.387417
GCA_001278495.1-Fun_LGSR01000013.1_i000_004257	155	389	234	1.04464	0.379254
GCA_013364965.1-Fun_JAAMOD010000148.1_i000_005676	179	413	234	1.04464	0.371429
GCA_905332055.1-Fun_CAJOAW010000095.1_i000_009388	102	336	234	1.04464	0.423146
GCA_000091045.1-Fun_AE017342.1_i000_001396	166	389	223	0.995536	0.403255
GCA_000149385.1-Fun_CM000041.1_i000_000845	166	389	223	0.995536	0.403255
GCA_008355005.1-Fun_NIDF01000063.1_i000_006614	180	403	223	0.995536	0.39539
GCA_019201745.1-Fun_JABELV010000005.1_i000_005139	167	388	221	0.986607	0.393939
GCA_021052385.1-Fun_JAIFAB010000026.1_i000_005019	167	388	221	0.986607	0.393939
GCA_008271595.1-Pro_SMMQ01002160.1_i000_006929	151	375	224	1	0.428298
GCA_022376275.1-Fun_JAJNOH010000003.1_i000_007325	154	389	235	1.04911	0.384615
GCA_002352725.1-Fun_NQOC01000023.1_i000_008080	179	413	234	1.04464	0.371429
GCA_010093625.1-Fun_MU006703.1_i000_001837	125	358	233	1.04018	0.417563
GCA_000365165.2-Fun_KB822706.1_i000_006788	152	385	233	1.04018	0.390285
GCA_003614145.1-Fun_KZ988116.1_i000_002441	95	314	219	0.977679	0.458159
GCA_021604985.1-Pla_BQKI01000009.1_i000_017768	112	224	112	0.5	0.276543
GCA_021604985.1-Pla_BQKI01000009.1_i000_017768	221	305	84	0.375	0.207407
GCA_010015815.1-Fun_ML977502.1_i000_003551	123	356	233	1.04018	0.418312
GCA_904845875.1-Pla_CAJGYO010000012.1_i000_046053	111	296	185	0.825893	0.51105
GCA_001702395.2-Fun_MAVT02001095.1_i000_009547	151	386	235	1.04911	0.389718
GCA_015473125.1-Pla_BNJQ01000006.1_i000_002789	169	395	226	1.00893	0.412409
GCA_003033665.1-Fun_PVEM01000001.1_i000_001245	143	377	234	1.04464	0.393939
GCA_016952355.1-Fun_CP064750.1_i000_009285	143	377	234	1.04464	0.393939
GCA_000240135.3-Fun_CM000574.1_i000_001523	143	377	234	1.04464	0.393939
GCA_900044135.1-Fun_HG970332.2_i000_001609	143	377	234	1.04464	0.393939
GCA_900073075.1-Fun_LT222053.1_i000_001625	143	377	234	1.04464	0.393939
GCA_009982855.1-Fun_JAADKA010000003.1_i000_006468	125	358	233	1.04018	0.417563
GCA_022376655.1-Fun_JAJJKE010000003.1_i000_005381	157	392	235	1.04911	0.382736
GCA_011800055.1-Fun_WVTB01000057.1_i000_009518	186	422	236	1.05357	0.368175
GCA_002215885.1-Fun_AMKM01000010.1_i000_000699	165	388	223	0.995536	0.403986
GCA_000149245.3-Fun_CP003821.1_i000_001440	165	388	223	0.995536	0.403986
GCA_002215765.1-Fun_AMLA01000088.1_i000_006419	165	388	223	0.995536	0.403986
GCA_002215775.1-Fun_AMLG01000037.1_i000_003142	165	388	223	0.995536	0.403986
GCA_002215825.1-Fun_AMLK01000019.1_i000_000960	165	388	223	0.995536	0.403986
GCA_002216725.1-Fun_CP022322.1_i000_001440	165	388	223	0.995536	0.403986
GCA_002220445.1-Fun_AMLJ01000068.1_i000_005858	165	388	223	0.995536	0.403986
GCA_002221985.1-Fun_APKI01000054.1_i000_005758	165	388	223	0.995536	0.403986
GCA_002222015.1-Fun_APKO01000086.1_i000_006596	165	388	223	0.995536	0.403986
GCA_002222025.1-Fun_APKS01000087.1_i000_006561	165	388	223	0.995536	0.403986
GCA_002222095.1-Fun_APKP01000086.1_i000_006729	165	388	223	0.995536	0.403986
GCA_002222115.1-Fun_APKR01000077.1_i000_006464	165	388	223	0.995536	0.403986
GCA_002222135.1-Fun_APKK01000071.1_i000_006249	165	388	223	0.995536	0.403986
GCA_002222145.1-Fun_APKQ01000063.1_i000_006084	165	388	223	0.995536	0.403986
GCA_002222165.1-Fun_APKT01000066.1_i000_006158	165	388	223	0.995536	0.403986
GCA_002222215.1-Fun_APKH01000051.1_i000_005681	165	388	223	0.995536	0.403986
GCA_002222225.1-Fun_AMLE01000204.1_i000_000706	165	388	223	0.995536	0.403986
GCA_002222245.1-Fun_APKJ01000064.1_i000_005899	165	388	223	0.995536	0.403986
GCA_002222255.1-Fun_AMLH01000123.1_i000_000516	165	388	223	0.995536	0.403986
GCA_002222295.1-Fun_AMLB01000113.1_i000_000372	165	388	223	0.995536	0.403986
GCA_002222315.1-Fun_AMKY01000012.1_i000_000724	165	388	223	0.995536	0.403986
GCA_002222325.1-Fun_AMKT01000025.1_i000_001464	165	388	223	0.995536	0.403986
GCA_002222375.1-Fun_AMLI01000006.1_i000_006375	165	388	223	0.995536	0.403986
GCA_002222395.1-Fun_AMLD01000099.1_i000_006882	165	388	223	0.995536	0.403986
GCA_002222405.1-Fun_AMLC01000026.1_i000_002680	165	388	223	0.995536	0.403986
GCA_002222455.1-Fun_AMKZ01000089.1_i000_006405	165	388	223	0.995536	0.403986
GCA_002224005.1-Fun_AMLF01000007.1_i000_006433	165	388	223	0.995536	0.403986
GCA_002222335.1-Fun_AMKU01000008.1_i000_006445	165	388	223	0.995536	0.403986
GCA_002215855.1-Fun_AMKX01000077.1_i000_006375	165	388	223	0.995536	0.403986
GCA_002217545.1-Fun_APKM01000091.1_i000_006704	165	388	223	0.995536	0.403986
GCA_002220035.1-Fun_AMKW01000094.1_i000_006889	165	388	223	0.995536	0.403986
GCA_003339415.1-Fun_PDHQ01000047.1_i000_004565	145	378	233	1.04018	0.384488
GCA_000696135.1-Fun_JMSE01000014.1_i000_000176	153	389	236	1.05357	0.386252
GCA_000599445.1-Fun_CM002651.1_i000_001489	179	413	234	1.04464	0.371429
GCA_900492705.2-Fun_UIHA02000070.1_i000_008082	179	413	234	1.04464	0.371429
GCA_901446245.1-Fun_CABDWO010000099.1_i000_010735	179	413	234	1.04464	0.371429
GCA_905332025.1-Fun_CAJOAV010000127.1_i000_010537	179	413	234	1.04464	0.371429
GCA_905359455.1-Fun_CAJPII010000062.1_i000_005390	179	413	234	1.04464	0.371429
GCA_905359465.1-Fun_CAJPIH010000295.1_i000_002347	179	413	234	1.04464	0.371429
GCA_905359475.1-Fun_CAJPIG010000111.1_i000_002396	179	413	234	1.04464	0.371429
GCA_905359485.1-Fun_CAJPIJ010000191.1_i000_012386	179	413	234	1.04464	0.371429
GCA_010093595.1-Fun_MU003693.1_i000_001576	123	356	233	1.04018	0.404514
GCA_022179045.1-Fun_BPPX01000024.1_i000_009726	140	376	236	1.05357	0.39399
GCA_001625215.1-Pla_CM004285.1_i000_027836	78	298	220	0.982143	0.53012
GCA_013368315.1-Fun_JAACJM010000012.1_i000_003135	153	387	234	1.04464	0.431734
GCA_000835435.1-Fun_KN846959.1_i000_007041	152	385	233	1.04018	0.389632
GCA_002116315.1-Fun_KZ107853.1_i000_009622	126	359	233	1.04018	0.416071
GCA_005059865.1-Fun_NAJQ01000039.1_i000_008252	162	396	234	1.04464	0.376812
GCA_020360975.1-Fun_JAIZPD010000021.1_i000_011460	145	363	218	0.973214	0.388592
GCA_001700775.1-Fun_LGRB01000009.1_i000_004546	146	379	233	1.04018	0.394247
GCA_013266165.1-Fun_JAAGWP010000105.1_i000_003385	185	419	234	1.04464	0.367925
GCA_020726555.1-Fun_JAHBNH010000012.1_i000_003103	125	358	233	1.04018	0.416816
GCA_016952305.1-Fun_CP064755.1_i000_006550	143	377	234	1.04464	0.393939
GCA_006352295.1-Fun_SOZI01000001.1_i000_000039	157	379	222	0.991071	0.404372
GCA_011745865.1-Pla_VYZZ01003009.1_i000_014276	103	318	215	0.959821	0.634218
GCA_002980475.2-Fun_PVQB02000320.1_i000_007179	179	413	234	1.04464	0.369668
GCA_001855235.1-Fun_KV842086.1_i000_008455	153	389	236	1.05357	0.385621
GCA_005059855.1-Fun_NAJP01000040.1_i000_010601	162	396	234	1.04464	0.376812
GCA_013423385.1-Fun_BLZA01000007.1_i000_000865	189	409	220	0.982143	0.379965
GCA_011058895.1-Fun_SWKV01000013.1_i000_001658	125	358	233	1.04018	0.416816
GCA_012977835.1-Fun_SDJM01000021.1_i000_004888	188	423	235	1.04911	0.374801
GCA_008692325.1-Fun_NMPR01000009.1_i000_009385	157	392	235	1.04911	0.385878
GCA_020800285.1-Fun_JAGTJO010000011.1_i000_002612	157	392	235	1.04911	0.385878
GCA_902728155.2-Pla_CACVBM020001071.1_i000_015814	87	314	227	1.01339	0.486081
GCA_000303195.2-Fun_CM003198.1_i000_001360	142	376	234	1.04464	0.394604
GCA_001703955.2-Fun_CM004556.1_i000_001272	142	376	234	1.04464	0.394604
GCA_013305805.1-Fun_QVQA01000429.1_i000_003292	152	373	221	0.986607	0.366501
GCA_001625285.1-Fun_LFIW01001556.1_i000_002915	235	471	236	1.05357	0.340058
GCA_003025115.1-Fun_KZ680570.1_i000_009625	81	315	234	1.04464	0.619048
GCA_004014815.1-Fun_RYZI01000511.1_i000_008457	162	397	235	1.04911	0.379032
GCA_002003505.1-Fun_BDMC01000033.1_i000_009544	162	397	235	1.04911	0.378422
GCA_001373355.1-Fun_CENE01000003.1_i000_001131	152	374	222	0.991071	0.410351
GCA_002222465.1-Fun_AMKV01000006.1_i000_006201	165	388	223	0.995536	0.403986
GCA_004768795.1-Fun_SKBN01000345.1_i000_006571	155	390	235	1.04911	0.382114
GCA_010015585.1-Fun_ML975166.1_i000_007199	151	385	234	1.04464	0.398637
GCA_002742065.1-Fun_CM008499.1_i000_001340	153	387	234	1.04464	0.384236
GCA_002933655.1-Fun_PNEN01000531.1_i000_009323	153	387	234	1.04464	0.384236
GCA_000151355.1-Fun_GG698896.1_i000_000512	142	376	234	1.04464	0.393277
GCA_003339455.1-Fun_PDHP01000054.1_i000_005223	145	378	233	1.04018	0.383224
GCA_003711515.1-Fun_ML119058.1_i000_007130	149	385	236	1.05357	0.389439
GCA_014235925.1-Fun_VUJX01000018.1_i000_006501	153	389	236	1.05357	0.388158
GCA_001625265.1-Fun_LFIV01000044.1_i000_008652	186	422	236	1.05357	0.365891
GCA_020310465.1-Fun_JAHSQE010000001.1_i000_000310	162	417	255	1.13839	0.427852
GCA_013363075.1-Fun_JAAFOW010001448.1_i000_008505	179	413	234	1.04464	0.371429
GCA_020726575.1-Fun_JAGSXJ010000015.1_i000_002672	145	381	236	1.05357	0.390728
GCA_000512255.2-Pla_CM008461.1_i000_020753	103	318	215	0.959821	0.482063
GCA_000149555.1-Fun_CM000578.1_i000_000659	142	376	234	1.04464	0.394604
GCA_002591385.1-Fun_NJEV01001567.1_i000_002371	146	379	233	1.04018	0.387687
GCA_004155935.1-Fun_QJNV01000337.1_i000_006750	121	355	234	1.04464	0.406957
GCA_008694065.1-Fun_VYXO01000003.1_i000_005599	151	386	235	1.04911	0.386513
GCA_016771965.1-Pla_CM028699.1_i000_062929	102	143	41	0.183036	0.113889
GCA_016771965.1-Pla_CM028699.1_i000_062929	141	352	211	0.941964	0.586111
GCA_019915245.1-Fun_CM034114.1_i000_000576	180	414	234	1.04464	0.37084
GCA_003316975.2-Fun_CM010967.1_i000_001828	180	414	234	1.04464	0.37084
GCA_013395995.1-Fun_JAAOAR010000277.1_i000_005644	180	414	234	1.04464	0.37084
GCA_013396035.1-Fun_JAAOAS010000226.1_i000_008619	180	414	234	1.04464	0.37084
GCA_013396175.1-Fun_JAAOAK010000219.1_i000_007633	180	414	234	1.04464	0.37084
GCA_013781345.1-Fun_JAAOAJ010000045.1_i000_001254	180	414	234	1.04464	0.37084
GCA_013396195.1-Fun_JAAQRI010000039.1_i000_002120	180	414	234	1.04464	0.37084
GCA_010261695.1-Pla_JAAEJY010002831.1_i000_047192	180	414	234	1.04464	0.37084
GCA_013396005.1-Fun_JAAOAO010000382.1_i000_009309	180	414	234	1.04464	0.37084
GCA_019721275.1-Fun_JAASLF010000004.1_i000_006252	126	359	233	1.04018	0.416071
GCA_003025105.1-Fun_KZ679256.1_i000_001235	143	377	234	1.04464	0.39196
GCA_020647865.1-Fun_CP084944.1_i000_003384	143	377	234	1.04464	0.39196
GCA_009806415.1-Fun_WOWK01000105.1_i000_008889	186	422	236	1.05357	0.368175
GCA_003942215.1-Fun_RSCD01000003.1_i000_006425	202	426	224	1	0.378378
GCA_001292635.1-Fun_JXCE01000054.1_i000_008725	142	376	234	1.04464	0.394604
GCA_003012315.1-Fun_PXOF01000002.1_i000_000041	142	376	234	1.04464	0.394604
GCA_001600855.1-Fun_BCLC01000006.1_i000_003605	202	426	224	1	0.378378
GCA_000835765.1-Fun_KN848832.1_i000_000837	166	389	223	0.995536	0.403255
GCA_000835815.1-Fun_KN848527.1_i000_002305	166	389	223	0.995536	0.403255
GCA_000836315.1-Fun_KN848136.1_i000_002158	166	389	223	0.995536	0.403255
GCA_000836375.1-Fun_KN847907.1_i000_004622	166	389	223	0.995536	0.403255
GCA_000836455.1-Fun_KN848958.1_i000_003077	166	389	223	0.995536	0.403255
GCA_000875795.1-Fun_KN848514.1_i000_005066	166	389	223	0.995536	0.403255
GCA_002954075.1-Fun_CP025761.1_i000_002326	166	389	223	0.995536	0.403255
GCA_010093505.1-Fun_MU001634.1_i000_003914	160	393	233	1.04018	0.379479
GCA_019650295.1-Fun_BOLY01000002.1_i000_003041	153	387	234	1.04464	0.384236
GCA_014839935.1-Fun_QTSX01010029.1_i000_006015	104	324	220	0.982143	0.45929
GCA_013423425.1-Fun_BLZH01000001.1_i000_000895	142	376	234	1.04464	0.392617
GCA_021066465.1-Fun_JAJKFY010000300.1_i000_007706	142	376	234	1.04464	0.392617
GCA_012934285.1-Fun_JAAVMX010000004.1_i000_003900	145	378	233	1.04018	0.390285
GCA_004155925.1-Fun_QJNX01000497.1_i000_009083	158	392	234	1.04464	0.382353
GCA_004155915.1-Fun_QJOA01000049.1_i000_008259	158	392	234	1.04464	0.382353
GCA_003795275.1-Fun_LJZO01000016.1_i000_004409	151	386	235	1.04911	0.38843
GCA_022432525.1-Fun_JAJKLB010000008.1_i000_009499	153	388	235	1.04911	0.384615
GCA_001263375.1-Fun_LAVV01002344.1_i000_001834	172	334	162	0.723214	0.272269
GCA_001263375.1-Fun_LAVV01002344.1_i000_001834	330	423	93	0.415179	0.156303
GCA_003260635.2-Pla_QGKW02000276.1_i000_034233	7	230	223	0.995536	0.906504
GCA_002105055.1-Fun_MCGR01000022.1_i000_003504	87	311	224	1	0.476596
GCA_000448365.1-Fun_KE656087.1_i000_006358	174	407	233	1.04018	0.372204
GCA_000226095.1-Fun_CP003002.1_i000_001197	158	393	235	1.04911	0.383987
GCA_017309875.1-Fun_PKMG01000001.1_i000_001365	179	413	234	1.04464	0.371429
GCA_003942205.1-Fun_RSCE01000006.1_i000_007497	178	401	223	0.995536	0.401802
GCA_003615215.1-Fun_MRDB01000018.1_i000_004136	179	413	234	1.04464	0.371429
GCA_017309865.1-Fun_PKMH01000002.1_i000_000830	179	413	234	1.04464	0.371429
GCA_000350345.1-Fun_KB731261.1_i000_014269	135	369	234	1.04464	0.401372
GCA_000875855.1-Fun_KN848931.1_i000_004779	166	389	223	0.995536	0.403255
GCA_000260175.2-Fun_JH657927.1_i000_005742	141	375	234	1.04464	0.39527
GCA_000149955.2-Fun_CM000589.1_i000_000689	141	375	234	1.04464	0.39527
GCA_000259975.2-Fun_JH650834.1_i000_008352	141	375	234	1.04464	0.39527
GCA_000260075.2-Fun_JH650968.1_i000_001505	141	375	234	1.04464	0.39527
GCA_000260155.3-Fun_JH651392.1_i000_009323	141	375	234	1.04464	0.39527
GCA_000260215.2-Fun_JH658828.1_i000_005754	141	375	234	1.04464	0.39527
GCA_000260235.2-Fun_JH658378.1_i000_007720	141	375	234	1.04464	0.39527
GCA_000260495.2-Fun_JH659329.1_i000_000711	141	375	234	1.04464	0.39527
GCA_000271705.2-Fun_JH717896.1_i000_000707	141	375	234	1.04464	0.39527
GCA_019157275.1-Fun_JAELUR010000001.1_i000_001405	141	375	234	1.04464	0.39527
GCA_900096695.1-Fun_FMJY01000002.1_i000_001596	141	375	234	1.04464	0.39527
GCA_004155945.1-Fun_QJNY01000226.1_i000_004104	158	392	234	1.04464	0.382353
GCA_005059855.1-Fun_NAJP01000022.1_i000_006425	162	396	234	1.04464	0.376812
GCA_002894145.1-Fun_MTYI01000023.1_i000_005065	147	381	234	1.04464	0.39
GCA_013396025.1-Fun_JAAOAQ010000686.1_i000_012634	179	413	234	1.04464	0.371429
GCA_002120325.1-Fun_KZ112928.1_i000_000752	153	388	235	1.04911	0.383987
GCA_000260195.2-Fun_JH658272.1_i000_000530	141	375	234	1.04464	0.39527
GCA_000350365.1-Fun_KB726987.1_i000_007959	141	375	234	1.04464	0.39527
GCA_020744335.1-Fun_JAHBOG010000001.1_i000_001448	141	375	234	1.04464	0.39527
GCA_001329695.1-Fun_KQ474079.1_i000_003925	139	361	222	0.991071	0.422053
GCA_018296245.1-Fun_JADFTV010000984.1_i000_013880	115	349	234	1.04464	0.413428
GCA_018296265.1-Fun_JADFTU010000981.1_i000_014043	115	349	234	1.04464	0.413428
GCA_018296285.1-Fun_JADFTT010000699.1_i000_012654	115	349	234	1.04464	0.413428
GCA_018296305.1-Fun_JADFTW010000998.1_i000_013178	115	349	234	1.04464	0.413428
GCA_018296325.1-Fun_JADFTY010000805.1_i000_013586	115	349	234	1.04464	0.413428
GCA_018296345.1-Fun_JADFTX010001207.1_i000_013891	115	349	234	1.04464	0.413428
GCA_004155035.1-Fun_QJOB01000227.1_i000_005220	158	392	234	1.04464	0.382353
GCA_002844615.1-Fun_MVDW01000006.1_i000_001255	153	387	234	1.04464	0.384236
GCA_005930515.1-Fun_SRMI01000005.1_i000_000640	179	413	234	1.04464	0.371429
GCA_003025115.1-Fun_KZ680217.1_i000_006607	151	385	234	1.04464	0.406957
GCA_000525045.1-Fun_KI966469.1_i000_005587	151	341	190	0.848214	0.557185
GCA_003615075.1-Fun_MRCW01000210.1_i000_006661	179	413	234	1.04464	0.371429
GCA_003615085.1-Fun_CM010800.1_i000_000656	179	413	234	1.04464	0.371429
GCA_003615095.1-Fun_MRCV01000215.1_i000_006923	179	413	234	1.04464	0.371429
GCA_003615185.1-Fun_MRDA01000203.1_i000_006317	179	413	234	1.04464	0.371429
GCA_004141715.1-Fun_MQTW01000053.1_i000_015230	179	413	234	1.04464	0.371429
GCA_013085055.1-Fun_CP052038.1_i000_001542	179	413	234	1.04464	0.371429
GCA_020796175.1-Fun_JAJGYP010000001.1_i000_000649	179	413	234	1.04464	0.371429
GCA_003615115.1-Fun_MRCX01000287.1_i000_009219	179	413	234	1.04464	0.371429
GCA_020744455.1-Fun_JAHEWL010000007.1_i000_015669	179	413	234	1.04464	0.371429
GCA_000222805.1-Fun_AFQF01000085.1_i000_000229	179	413	234	1.04464	0.371429
GCA_014154955.1-Fun_CM024360.1_i000_000503	179	413	234	1.04464	0.371429
GCA_018894095.1-Fun_RSAI01000007.1_i000_019102	179	413	234	1.04464	0.371429
GCA_013396295.1-Fun_JAAGWQ010000085.1_i000_005045	149	383	234	1.04464	0.39
GCA_014764975.1-Fun_JACYFE010005807.1_i000_007639	141	375	234	1.04464	0.394604
GCA_013396075.1-Fun_JAAOAV010000247.1_i000_012016	141	375	234	1.04464	0.39527
GCA_000277445.1-Pro_AJWJ01000045.1_i000_001794	148	371	223	0.995536	0.440711
GCA_019157295.1-Fun_JAELUQ010000001.1_i000_001376	179	413	234	1.04464	0.371429
GCA_007994515.1-Fun_VMNF01000007.1_i000_013667	179	413	234	1.04464	0.371429
GCA_000167675.2-Fun_GL985059.1_i000_002208	151	385	234	1.04464	0.383607
GCA_000513815.1-Fun_KI911147.1_i000_004624	151	385	234	1.04464	0.383607
GCA_020744355.1-Fun_JAHEVI010000001.1_i000_000629	179	413	234	1.04464	0.371429
GCA_013368375.1-Fun_JAACJP010000001.1_i000_000237	176	410	234	1.04464	0.412698
GCA_003795315.1-Fun_LKEA01000002.1_i000_001045	149	384	235	1.04911	0.389718
GCA_003012295.1-Fun_PXXK01000243.1_i000_008117	145	379	234	1.04464	0.392617
GCA_022432375.1-Fun_JAJKKK010000056.1_i000_009502	156	391	235	1.04911	0.381494
GCA_011745845.1-Pla_VYZY01003022.1_i000_014087	103	318	215	0.959821	0.634218
GCA_010015805.1-Fun_ML978133.1_i000_010164	125	359	234	1.04464	0.400685
GCA_020002365.1-Fun_JAINEY010000001.1_i000_001082	151	385	234	1.04464	0.385502
GCA_000271745.2-Fun_JH717842.1_i000_007186	179	413	234	1.04464	0.371429
GCA_002105065.1-Fun_MCFC01000091.1_i000_007765	156	379	223	0.995536	0.409926
GCA_013396205.1-Fun_JAAOAN010000272.1_i000_008064	179	413	234	1.04464	0.371429
GCA_013364935.1-Fun_JABEVY010000341.1_i000_011405	179	413	234	1.04464	0.371429
GCA_013758895.1-Fun_JAAOAI010000471.1_i000_008442	179	413	234	1.04464	0.371429
GCA_013396185.1-Fun_JAAQPE010000522.1_i000_012129	179	413	234	1.04464	0.371429
GCA_000855695.1-Fun_KN848899.1_i000_004081	166	389	223	0.995536	0.403255
GCA_009650685.1-Fun_CM018866.1_i000_002207	166	389	223	0.995536	0.403255
GCA_020744385.1-Fun_JAHBOO010000001.1_i000_001350	182	416	234	1.04464	0.369668
GCA_000271645.1-Fun_JH711542.1_i000_007381	110	333	223	0.995536	0.446894
GCA_001702695.2-Fun_CM008287.1_i000_001228	179	413	234	1.04464	0.371429
GCA_003615155.1-Fun_MRCY01000032.1_i000_009398	179	413	234	1.04464	0.371429
GCA_003615165.1-Fun_MRCZ01000127.1_i000_002429	179	413	234	1.04464	0.371429
GCA_000185945.1-Fun_CP000286.1_i000_000030	166	389	223	0.995536	0.403255
GCA_000835745.1-Fun_KN848659.1_i000_002777	166	389	223	0.995536	0.403255
GCA_000836355.1-Fun_KN847928.1_i000_003087	166	389	223	0.995536	0.403255
GCA_000875815.1-Fun_KN849060.1_i000_003198	166	389	223	0.995536	0.403255
GCA_000935105.1-Fun_KN905586.1_i000_000833	166	389	223	0.995536	0.403255
GCA_019565615.1-Fun_CP075866.1_i000_006260	8	242	234	1.04464	0.506494
GCA_018855395.1-Fun_JABAJW010008958.1_i000_005477	728	941	213	0.950893	0.194521
GCA_001937105.1-Fun_MPGH01000058.1_i000_007601	152	388	236	1.05357	0.387521
GCA_000230375.1-Fun_FP929094.1_i000_002791	117	350	233	1.04018	0.419065
GCA_022343315.1-Fun_JACTNS010000014.1_i000_005711	117	350	233	1.04018	0.419065
GCA_002120305.1-Fun_KZ112637.1_i000_010643	90	325	235	1.04911	0.428051
GCA_010093785.1-Fun_MU003780.1_i000_003643	151	385	234	1.04464	0.386139
GCA_010093985.1-Fun_ML992687.1_i000_008757	153	387	234	1.04464	0.384236
GCA_002894225.1-Fun_MTQA01000078.1_i000_014378	179	413	234	1.04464	0.371429
GCA_001661325.1-Fun_KV454290.1_i000_001408	105	329	224	1	0.580311
GCA_000170995.2-Fun_ABDF02000090.1_i000_001311	147	381	234	1.04464	0.39
GCA_020647635.1-Fun_CP071109.1_i000_005859	147	381	234	1.04464	0.39
GCA_000836335.1-Fun_KN847983.1_i000_004140	166	389	223	0.995536	0.403255
GCA_020647705.1-Fun_CP071117.1_i000_005638	147	381	234	1.04464	0.39
GCA_000835755.1-Fun_KN848865.1_i000_003979	166	389	223	0.995536	0.403255
GCA_900096645.1-Fun_FMJU01000001.1_i000_011356	141	375	234	1.04464	0.39527
GCA_900096505.1-Fun_FMSL01000010.1_i000_013158	141	375	234	1.04464	0.39527
GCA_900096605.1-Fun_FMJS01000022.1_i000_001806	141	375	234	1.04464	0.39527
GCA_900096615.1-Fun_FMJV01000001.1_i000_012162	141	375	234	1.04464	0.39527
GCA_900096625.1-Fun_FMJX01000001.1_i000_004712	141	375	234	1.04464	0.39527
GCA_900096635.1-Fun_FMJW01000001.1_i000_011145	141	375	234	1.04464	0.39527
GCA_900096685.1-Fun_FMSM01000001.1_i000_009340	141	375	234	1.04464	0.39527
GCA_900096705.1-Fun_FMJT01000001.1_i000_009550	141	375	234	1.04464	0.39527
GCA_900067095.1-Fun_FJOF01000001.1_i000_013844	141	375	234	1.04464	0.39527
GCA_900029915.1-Fun_FCQG01000036.1_i000_009753	141	375	234	1.04464	0.39527
GCA_004117975.1-Fun_SDIL01000084.1_i000_007426	180	403	223	0.995536	0.391916
GCA_001481775.2-Fun_JPDN02000004.1_i000_006919	144	378	234	1.04464	0.391304
GCA_010093585.1-Fun_MU001836.1_i000_005005	129	362	233	1.04018	0.411661
GCA_001299255.1-Fun_LFJN01000008.1_i000_011050	182	416	234	1.04464	0.371429
GCA_013396015.1-Fun_JAAOAM010000078.1_i000_003722	179	413	234	1.04464	0.371429
GCA_013266175.1-Fun_JABFAI010000293.1_i000_010467	141	375	234	1.04464	0.39527
GCA_022432515.1-Fun_JAJKLA010000001.1_i000_000062	154	389	235	1.04911	0.383361
GCA_000743755.1-Pro_JPUL02000132.1_i000_002993	99	318	219	0.977679	0.2661
GCA_011066345.1-Fun_QLNT01000003.1_i000_005732	147	381	234	1.04464	0.389351
GCA_002894205.1-Fun_MTYH01000050.1_i000_007104	144	378	234	1.04464	0.391304
GCA_001266575.1-Ani_JTDY01000091.1_i000_000612	61	161	100	0.446429	0.218341
GCA_001266575.1-Ani_JTDY01000091.1_i000_000612	160	193	33	0.147321	0.0720524
GCA_001266575.1-Ani_JTDY01000091.1_i000_000612	194	234	40	0.178571	0.0873362
GCA_000813385.1-Fun_KN714671.1_i000_001418	152	387	235	1.04911	0.387789
GCA_001023045.1-Fun_JRVF01000194.1_i000_002242	179	413	234	1.04464	0.371429
GCA_001023035.1-Fun_JRVG01000040.1_i000_009343	179	413	234	1.04464	0.371429
GCA_001023065.1-Fun_JRVH01002170.1_i000_006907	179	413	234	1.04464	0.371429
GCA_009663055.1-Fun_CP023077.1_i000_000557	179	413	234	1.04464	0.371429
GCA_009663095.1-Fun_CP023089.1_i000_000557	179	413	234	1.04464	0.371429
GCA_900079805.1-Fun_HF679023.1_i000_000596	179	413	234	1.04464	0.371429
GCA_901677955.1-Fun_CABFJX010000190.1_i000_005943	179	413	234	1.04464	0.371429
GCA_901677965.1-Fun_CABFJW010000036.1_i000_002152	179	413	234	1.04464	0.371429
GCA_003290285.1-Fun_PKMI01000050.1_i000_011681	179	413	234	1.04464	0.371429
GCA_013396165.1-Fun_JAAQPF010000188.1_i000_004834	179	413	234	1.04464	0.371429
GCA_017309895.1-Fun_PKMJ01000001.1_i000_001360	179	413	234	1.04464	0.371429
GCA_012932015.1-Fun_JAADJF010000408.1_i000_011776	179	413	234	1.04464	0.371429
GCA_000585515.1-Fun_AMGW01000004.1_i000_006638	152	385	233	1.04018	0.390285
GCA_000340215.1-Fun_KB446555.1_i000_002115	155	389	234	1.04464	0.382979
GCA_003316985.1-Fun_QKXC01000359.1_i000_007514	145	379	234	1.04464	0.392617
GCA_000818155.1-Fun_CM003099.1_i000_001745	152	387	235	1.04911	0.387789
GCA_010094085.1-Fun_ML986486.1_i000_002094	138	371	233	1.04018	0.39094
GCA_002120335.1-Fun_KZ111278.1_i000_011015	154	389	235	1.04911	0.383361
GCA_009194965.1-Fun_VSMA01000021.1_i000_009954	148	383	235	1.04911	0.392321
GCA_900343105.1-Fun_OUUZ01000001.1_i000_002913	156	391	235	1.04911	0.386513
GCA_000226115.1-Fun_CP003010.1_i000_003569	156	391	235	1.04911	0.386513
GCA_002838845.1-Fun_NQLC01000571.1_i000_010189	147	381	234	1.04464	0.389351
GCA_003025095.1-Fun_KZ679676.1_i000_002758	147	381	234	1.04464	0.389351
GCA_000988865.1-Fun_JOKZ01000877.1_i000_011372	147	381	234	1.04464	0.389351
GCA_003012105.1-Fun_PXOA01000870.1_i000_009823	137	371	234	1.04464	0.39661
GCA_002022785.1-Fun_LVVK01000019.1_i000_005266	147	381	234	1.04464	0.389351
GCA_000213195.1-Fun_GL890999.1_i000_001688	159	394	235	1.04911	0.384615
GCA_000182925.2-Fun_CM002236.1_i000_000826	159	394	235	1.04911	0.384615
GCA_000786625.1-Fun_KN389625.1_i000_000272	159	394	235	1.04911	0.384615
GCA_000825705.1-Fun_CDHN01000001.1_i000_002379	135	369	234	1.04464	0.395939
GCA_003957675.1-Fun_MIKF01000178.1_i000_004142	174	408	234	1.04464	0.373206
GCA_020631695.1-Fun_CM036087.1_i000_000928	143	377	234	1.04464	0.391304
GCA_004154915.1-Fun_QJNU01000043.1_i000_007174	158	392	234	1.04464	0.382353
GCA_000171015.2-Fun_ABDG02000027.1_i000_001273	144	378	234	1.04464	0.391304
GCA_020647795.1-Fun_CP084936.1_i000_003879	144	378	234	1.04464	0.391304
GCA_000150675.2-Fun_DS572716.1_i000_001451	154	390	236	1.05357	0.395973
GCA_020045945.2-Fun_CM034696.1_i000_004648	147	381	234	1.04464	0.389351
GCA_013266195.1-Fun_JABEYC010000982.1_i000_009732	162	396	234	1.04464	0.37987
GCA_001268145.1-Fun_CVQH01011112.1_i000_006352	154	390	236	1.05357	0.384365
GCA_002892985.1-Fun_MPSH01000005.1_i000_008198	154	390	236	1.05357	0.384365
GCA_002892995.1-Fun_PHNU01000224.1_i000_003724	154	390	236	1.05357	0.384365
GCA_002893025.1-Fun_PHNV01000465.1_i000_007150	154	390	236	1.05357	0.384365
GCA_002893035.1-Fun_PHNW01000498.1_i000_007081	154	390	236	1.05357	0.384365
GCA_002893045.1-Fun_PHNX01000222.1_i000_003571	154	390	236	1.05357	0.384365
GCA_004109745.1-Fun_CM014041.1_i000_000183	154	390	236	1.05357	0.384365
GCA_020726535.1-Fun_JAHEWJ010000022.1_i000_005932	154	390	236	1.05357	0.384365
GCA_003320035.1-Fun_CM010347.1_i000_000678	154	390	236	1.05357	0.384365
GCA_010093795.1-Fun_MU006573.1_i000_005022	130	363	233	1.04018	0.402418
GCA_010093995.1-Fun_ML992507.1_i000_005292	157	392	235	1.04911	0.394958
GCA_020744475.1-Fun_JAGMUX010000001.1_i000_001463	179	413	234	1.04464	0.371429
GCA_000213175.1-Fun_GL891382.1_i000_009492	159	394	235	1.04911	0.384615
GCA_010015565.1-Fun_ML975944.1_i000_001832	155	389	234	1.04464	0.388704
GCA_009194965.1-Fun_VSMA01000003.1_i000_013426	148	383	235	1.04911	0.392321
GCA_910393935.1-Fun_CAJSTJ010000111.1_i000_002451	145	379	234	1.04464	0.392617
GCA_013397325.1-Ani_VZTC01009318.1_i000_012115	1	109	108	0.482143	0.402985
GCA_013266205.1-Fun_JAAGWO010001008.1_i000_011446	183	417	234	1.04464	0.367925
GCA_001606155.1-Pro_LODT01000035.1_i000_006308	164	387	223	0.995536	0.413729
GCA_000836255.1-Fun_DF938588.1_i000_003346	182	417	235	1.04911	0.374204
GCA_020747015.1-Fun_JAGTJM010000014.1_i000_002451	122	355	233	1.04018	0.416816
GCA_004154925.1-Fun_QJNS01000746.1_i000_010224	159	393	234	1.04464	0.381729
GCA_004154975.1-Fun_QJNW01001437.1_i000_002425	159	393	234	1.04464	0.381729
GCA_004155895.1-Fun_QJNT01000050.1_i000_008717	159	393	234	1.04464	0.381729
GCA_013266265.1-Fun_JABFAK010000664.1_i000_009145	177	411	234	1.04464	0.3744
GCA_012931995.1-Fun_JAADYS010003216.1_i000_016408	181	415	234	1.04464	0.369085
GCA_001654555.2-Fun_LUFC02001146.1_i000_011639	179	413	234	1.04464	0.371429
GCA_020509005.2-Fun_CP090163.1_i000_001519	162	396	234	1.04464	0.378029
GCA_020744495.1-Fun_JAGTJS010000002.1_i000_007438	142	376	234	1.04464	0.393277
GCA_012932025.1-Fun_JAADJG010000009.1_i000_000299	179	413	234	1.04464	0.371429
GCA_021365365.1-Fun_JAJTIX010000002.1_i000_006786	147	381	234	1.04464	0.390651
GCA_003946985.1-Fun_NKCI01000009.1_i000_015665	174	408	234	1.04464	0.373206
GCA_003947015.1-Fun_NKCJ01000661.1_i000_012837	174	408	234	1.04464	0.373206
GCA_003698175.1-Fun_NKUJ01000133.1_i000_002229	174	408	234	1.04464	0.373206
GCA_003947005.1-Fun_NKCL01000239.1_i000_005987	174	408	234	1.04464	0.373206
GCA_003946995.1-Fun_NKCK01000019.1_i000_005606	174	408	234	1.04464	0.373206
GCA_003947045.1-Fun_NIZV01000020.1_i000_005329	174	408	234	1.04464	0.373206
GCA_017309325.2-Fun_JAESVG020000007.1_i000_006352	157	392	235	1.04911	0.394958
GCA_000732775.1-Fun_KL660726.1_i000_006953	176	410	234	1.04464	0.37084
GCA_020740775.1-Fun_JAHEWK010000003.1_i000_013758	147	381	234	1.04464	0.390651
GCA_011745865.1-Pla_VYZZ01000476.1_i000_002612	38	262	224	1	0.455285
GCA_000350065.2-Fun_AMCV02000011.1_i000_005192	153	388	235	1.04911	0.385246
GCA_004367935.1-Fun_QAPF01000106.1_i000_005934	153	388	235	1.04911	0.385246
GCA_000512255.2-Pla_CM008462.1_i000_021779	38	262	224	1	0.455285
GCA_013396095.1-Fun_JAAQRM010000494.1_i000_012582	179	413	234	1.04464	0.371429
GCA_000511025.2-Pla_CM002323.2_i000_006009	78	310	232	1.03571	0.537037
GCA_010093605.1-Fun_MU004194.1_i000_011329	123	356	233	1.04018	0.403114
GCA_900044065.1-Fun_FCQH01000001.1_i000_002228	141	375	234	1.04464	0.39527
GCA_900074925.1-Fun_FJUY01000021.1_i000_000325	164	398	234	1.04464	0.376206
GCA_001306435.1-Fun_LKCW01000143.1_i000_002287	180	414	234	1.04464	0.370253
GCA_004366825.1-Fun_QAPG01000022.1_i000_002243	186	421	235	1.04911	0.365474
GCA_000591435.1-Fun_JELW01000009.1_i000_005734	129	363	234	1.04464	0.401372
GCA_000732565.1-Fun_KL651596.1_i000_009095	176	410	234	1.04464	0.37084
GCA_000187425.2-Fun_ADNJ02000012.1_i000_002839	141	375	234	1.04464	0.393277
GCA_000730325.1-Fun_KL648614.1_i000_007801	176	410	234	1.04464	0.370253
GCA_000732765.1-Fun_KL657809.1_i000_006616	176	410	234	1.04464	0.37084
GCA_004155055.1-Fun_QJNZ01000419.1_i000_006755	158	392	234	1.04464	0.382353
GCA_002591415.1-Fun_NJET01000183.1_i000_002593	138	372	234	1.04464	0.40625
GCA_002120315.1-Fun_KZ111562.1_i000_006583	154	389	235	1.04911	0.383987
GCA_020744155.1-Fun_JAGPNQ010000002.1_i000_008942	178	412	234	1.04464	0.371429
GCA_020744515.1-Fun_JAGPXF010000002.1_i000_003780	183	417	234	1.04464	0.369085
GCA_001268145.1-Fun_CVQH01011112.1_i000_006361	154	390	236	1.05357	0.384992
GCA_018994095.1-Fun_JAEMWZ010000005.1_i000_013782	154	365	211	0.941964	0.335453
GCA_018994095.1-Fun_JAEMWZ010000005.1_i000_013782	361	406	45	0.200893	0.0715421
GCA_013396255.1-Fun_JAAOAY010000483.1_i000_012436	179	413	234	1.04464	0.371429
GCA_011032825.1-Fun_JAADJZ010000015.1_i000_003459	131	364	233	1.04018	0.410211
GCA_020744255.1-Fun_JAGTJQ010000008.1_i000_014626	156	390	234	1.04464	0.381729
GCA_000392275.1-Fun_KB933309.1_i000_007569	181	416	235	1.04911	0.373016
GCA_022376535.1-Fun_JAJJKD010000050.1_i000_008694	154	389	235	1.04911	0.38715
GCA_000426965.1-Fun_KE384720.1_i000_000909	141	375	234	1.04464	0.393277
GCA_000814965.1-Fun_AZNG01000007.1_i000_009854	141	375	234	1.04464	0.393277
GCA_013426205.1-Fun_CP058938.1_i000_010927	141	375	234	1.04464	0.393277
GCA_000739145.1-Fun_JNNZ01000014.1_i000_001637	141	375	234	1.04464	0.393277
GCA_000814975.1-Fun_AZNF01000011.1_i000_002416	141	375	234	1.04464	0.393277
GCA_001879275.1-Fun_KV875093.1_i000_000800	148	383	235	1.04911	0.393635
GCA_010194725.1-Pro_WXXK01000255.1_i000_001865	119	334	215	0.959821	0.453586
GCA_001275765.2-Fun_LCTW02000403.1_i000_009528	191	426	235	1.04911	0.367762
GCA_020736575.1-Fun_JAGPYM010000004.1_i000_010428	143	377	234	1.04464	0.397284
GCA_013266185.1-Fun_JABEXW010001117.1_i000_013863	179	413	234	1.04464	0.370253
GCA_000814945.1-Fun_AZNE01000017.1_i000_003263	141	375	234	1.04464	0.393277
GCA_000814955.1-Fun_AZNH01000022.1_i000_004791	182	416	234	1.04464	0.367925
GCA_013305495.1-Fun_JABUBV010000007.1_i000_012378	172	406	234	1.04464	0.373802
GCA_001653235.2-Fun_CM008059.1_i000_008624	179	413	234	1.04464	0.369668
GCA_000968615.1-Fun_LAEV01000350.1_i000_001254	131	366	235	1.04911	0.398305
GCA_014621425.1-Fun_JAANBB010000610.1_i000_011005	181	414	233	1.04018	0.549528
GCA_001578225.1-Fun_LFZO01000179.1_i000_002515	156	390	234	1.04464	0.382353
GCA_014904935.1-Fun_MU123695.1_i000_000097	169	380	211	0.941964	0.389299
GCA_003019895.1-Fun_KZ678419.1_i000_004353	156	391	235	1.04911	0.383361
GCA_001566295.1-Fun_KQ964256.1_i000_008760	156	390	234	1.04464	0.382353
GCA_000340195.1-Fun_KB446535.1_i000_000828	162	396	234	1.04464	0.37987
GCA_010093695.1-Fun_MU006289.1_i000_000953	117	350	233	1.04018	0.420578
GCA_000389695.3-Fun_APWK03000049.1_i000_004943	156	391	235	1.04911	0.384615
GCA_000978885.1-Fun_LBBL01000029.1_i000_000898	157	392	235	1.04911	0.383361
GCA_905216605.1-Pla_LR999453.1_i000_008242	103	132	29	0.129464	0.0659091
GCA_905216605.1-Pla_LR999453.1_i000_008242	130	294	164	0.732143	0.372727
GCA_001636735.1-Fun_AZHA01000013.1_i000_001752	124	358	234	1.04464	0.403448
GCA_001636795.1-Fun_AZHF01000002.1_i000_004507	127	361	234	1.04464	0.4
GCA_000293215.1-Fun_JH977535.1_i000_000232	156	379	223	0.995536	0.411439
GCA_000299215.2-Fun_JH925092.1_i000_003423	156	379	223	0.995536	0.411439
GCA_002591405.1-Fun_NJEU01001240.1_i000_000917	143	377	234	1.04464	0.403448
GCA_003724135.2-Fun_RBVV01000044.1_i000_006206	154	390	236	1.05357	0.384992
GCA_000166175.1-Fun_GL541645.1_i000_000519	164	387	223	0.995536	0.405455
GCA_007866325.1-Fun_SBHS01000007.1_i000_007918	122	356	234	1.04464	0.40625
GCA_900096595.1-Fun_FMSP01000008.1_i000_006077	165	388	223	0.995536	0.404719
GCA_001636745.1-Fun_AZHC01000021.1_i000_003453	141	375	234	1.04464	0.393277
GCA_020726465.1-Fun_JAGIZQ010000003.1_i000_005046	154	389	235	1.04911	0.38715
GCA_000365145.2-Fun_KB822725.1_i000_010530	154	387	233	1.04018	0.392917
GCA_010583015.1-Fun_MU007052.1_i000_008394	152	384	232	1.03571	0.385382
GCA_000426985.1-Fun_KE385327.1_i000_001688	141	375	234	1.04464	0.393277
GCA_003144135.1-Fun_KZ819336.1_i000_005869	175	410	235	1.04911	0.370079
GCA_014058105.1-Pla_JACGCM010002660.1_i000_006094	181	398	217	0.96875	0.545226
GCA_000146915.2-Fun_CH445334.1_i000_009119	123	356	233	1.04018	0.416071
GCA_016801405.1-Fun_CP069032.1_i000_009893	123	356	233	1.04018	0.416071
GCA_020557385.1-Fun_JAIRDT010000004.1_i000_002610	123	356	233	1.04018	0.416071
GCA_020567955.1-Fun_JAIRGA010000007.1_i000_004539	123	356	233	1.04018	0.416071
GCA_020568055.1-Fun_JAIRGC010000009.1_i000_003786	123	356	233	1.04018	0.416071
GCA_020568205.1-Fun_JAIRGE010000010.1_i000_005943	123	356	233	1.04018	0.416071
GCA_020568415.1-Fun_JAIRDV010000002.1_i000_001296	123	356	233	1.04018	0.416071
GCA_020568465.1-Fun_JAIRDW010000016.1_i000_009680	123	356	233	1.04018	0.416071
GCA_020568635.1-Fun_JAIRDX010000002.1_i000_001416	123	356	233	1.04018	0.416071
GCA_020568765.1-Fun_JAIRDY010000002.1_i000_001899	123	356	233	1.04018	0.416071
GCA_020568935.1-Fun_JAIRGH010000005.1_i000_003188	123	356	233	1.04018	0.416071
GCA_020568945.1-Fun_JAIRDZ010000001.1_i000_000293	123	356	233	1.04018	0.416071
GCA_020569145.1-Fun_JAIREA010000001.1_i000_000318	123	356	233	1.04018	0.416071
GCA_020570015.1-Fun_JAIREG010000030.1_i000_012552	123	356	233	1.04018	0.416071
GCA_020570345.1-Fun_JAIRGM010000029.1_i000_011903	123	356	233	1.04018	0.416071
GCA_020570355.1-Fun_JAIREH010000026.1_i000_010583	123	356	233	1.04018	0.416071
GCA_020570395.1-Fun_JAIRGN010000005.1_i000_004343	123	356	233	1.04018	0.416071
GCA_020570405.1-Fun_JAIREJ010000003.1_i000_002761	123	356	233	1.04018	0.416071
GCA_020570415.1-Fun_JAIRGO010000006.1_i000_005317	123	356	233	1.04018	0.416071
GCA_020570635.1-Fun_JAIRGP010000004.1_i000_002796	123	356	233	1.04018	0.416071
GCA_020570935.1-Fun_JAIREL010000002.1_i000_001742	123	356	233	1.04018	0.416071
GCA_020570965.1-Fun_JAIRGS010000004.1_i000_002934	123	356	233	1.04018	0.416071
GCA_020570975.1-Fun_JAIRGT010000007.1_i000_004739	123	356	233	1.04018	0.416071
GCA_020571295.1-Fun_JAIRGU010000006.1_i000_004191	123	356	233	1.04018	0.416071
GCA_020571325.1-Fun_JAIREN010000004.1_i000_002509	123	356	233	1.04018	0.416071
GCA_020571545.1-Fun_JAIREO010000002.1_i000_000939	123	356	233	1.04018	0.416071
GCA_020571815.1-Fun_JAIRGX010000012.1_i000_005447	123	356	233	1.04018	0.416071
GCA_020571885.1-Fun_JAIRGY010000011.1_i000_006296	123	356	233	1.04018	0.416071
GCA_020572205.1-Fun_JAIREQ010000019.1_i000_010402	123	356	233	1.04018	0.416071
GCA_020572315.1-Fun_JAIRHB010000007.1_i000_005376	123	356	233	1.04018	0.416071
GCA_020572395.1-Fun_JAIRHG010000004.1_i000_002691	123	356	233	1.04018	0.416071
GCA_020572635.1-Fun_JAIRHE010000003.1_i000_002933	123	356	233	1.04018	0.416071
GCA_020572645.1-Fun_JAIRHF010000014.1_i000_006566	123	356	233	1.04018	0.416071
GCA_020572945.1-Fun_JAIRHJ010000015.1_i000_007560	123	356	233	1.04018	0.416071
GCA_020573315.1-Fun_JAIRHM010000006.1_i000_003501	123	356	233	1.04018	0.416071
GCA_020573595.1-Fun_JAIRHO010000001.1_i000_000495	123	356	233	1.04018	0.416071
GCA_020573915.1-Fun_JAIRHR010000010.1_i000_004726	123	356	233	1.04018	0.416071
GCA_020574085.1-Fun_JAIRHT010000006.1_i000_004253	123	356	233	1.04018	0.416071
GCA_020574295.1-Fun_JAIRHV010000003.1_i000_002152	123	356	233	1.04018	0.416071
GCA_020574365.1-Fun_JAIRHW010000004.1_i000_002736	123	356	233	1.04018	0.416071
GCA_020574385.1-Fun_JAIRFB010000006.1_i000_003690	123	356	233	1.04018	0.416071
GCA_020574825.1-Fun_JAIRIB010000002.1_i000_001590	123	356	233	1.04018	0.416071
GCA_020575445.1-Fun_JAIRIJ010000001.1_i000_000486	123	356	233	1.04018	0.416071
GCA_020575485.1-Fun_JAIRIK010000006.1_i000_003906	123	356	233	1.04018	0.416071
GCA_020578265.1-Fun_JAIRIR010000019.1_i000_009241	123	356	233	1.04018	0.416071
GCA_020578295.1-Fun_JAIRIT010000001.1_i000_000484	123	356	233	1.04018	0.416071
GCA_020579825.1-Fun_JAIRIY010000007.1_i000_002932	123	356	233	1.04018	0.416071
GCA_020579845.1-Fun_JAIRJB010000010.1_i000_005856	123	356	233	1.04018	0.416071
GCA_020580415.1-Fun_JAIRFW010000008.1_i000_004731	123	356	233	1.04018	0.416071
GCA_020580425.1-Fun_JAIRJH010000007.1_i000_004429	123	356	233	1.04018	0.416071
GCA_020580485.1-Fun_JAIRJI010000004.1_i000_003282	123	356	233	1.04018	0.416071
GCA_020580725.1-Fun_JAIRJJ010000012.1_i000_007634	123	356	233	1.04018	0.416071
GCA_020581165.1-Fun_JAIRJO010000006.1_i000_003055	123	356	233	1.04018	0.416071
GCA_014298035.1-Fun_JABCIY010000158.1_i000_007332	156	390	234	1.04464	0.382353
GCA_006981975.1-Fun_SPUL01000007.1_i000_005246	126	360	234	1.04464	0.4
GCA_006981985.1-Fun_SPUK01000007.1_i000_005767	126	360	234	1.04464	0.4
GCA_020102295.1-Fun_JACEFI010000009.1_i000_005490	129	363	234	1.04464	0.401372
GCA_001578235.1-Fun_LFZN01000431.1_i000_007703	295	529	234	1.04464	0.311585
GCA_003635345.1-Fun_QVQW01000070.1_i000_008103	180	415	235	1.04911	0.373609
GCA_000187405.1-Fun_GL698538.1_i000_007135	141	375	234	1.04464	0.393277
GCA_019434395.1-Fun_JAGRQL010000409.1_i000_007119	141	375	234	1.04464	0.393277
GCA_019434415.1-Fun_JAGRQK010000021.1_i000_008373	141	375	234	1.04464	0.393277
GCA_000281105.1-Fun_JH767555.1_i000_000582	196	428	232	1.03571	0.360248
GCA_011745365.1-Fun_MU032348.1_i000_006908	156	391	235	1.04911	0.387789
GCA_017639365.1-Fun_JAAQQX010000002.1_i000_001708	120	342	222	0.991071	0.425287
GCA_017639385.1-Fun_JAAQQW010000001.1_i000_000408	120	342	222	0.991071	0.425287
GCA_004367215.1-Fun_RYZW01000026.1_i000_003934	153	388	235	1.04911	0.383361
GCA_019456465.1-Fun_JAHXPR010000024.1_i000_009138	179	413	234	1.04464	0.372611
GCA_019669845.1-Fun_MU251252.1_i000_004298	145	379	234	1.04464	0.39
GCA_010093935.1-Fun_ML993614.1_i000_011897	162	396	234	1.04464	0.380488
GCA_020568095.1-Fun_JAIRGD010000011.1_i000_006702	123	356	233	1.04018	0.416071
GCA_020568775.1-Fun_JAIRGG010000008.1_i000_003571	123	356	233	1.04018	0.416071
GCA_020569235.1-Fun_JAIREB010000003.1_i000_001964	123	356	233	1.04018	0.416071
GCA_020574375.1-Fun_JAIRFA010000002.1_i000_001187	123	356	233	1.04018	0.416071
GCA_020574615.1-Fun_JAIRHZ010000061.1_i000_013295	123	356	233	1.04018	0.416071
GCA_020574755.1-Fun_JAIRIA010000002.1_i000_001309	123	356	233	1.04018	0.416071
GCA_020575405.1-Fun_JAIRII010000015.1_i000_008524	123	356	233	1.04018	0.416071
GCA_020575775.1-Fun_JAIRIN010000009.1_i000_005718	123	356	233	1.04018	0.416071
GCA_020575975.1-Fun_JAIRFF010000003.1_i000_001697	123	356	233	1.04018	0.416071
GCA_020578205.1-Fun_JAIRFS010000004.1_i000_002693	123	356	233	1.04018	0.416071
GCA_020578585.1-Fun_JAIRIW010000006.1_i000_004164	123	356	233	1.04018	0.416071
GCA_020580665.1-Fun_JAIRFY010000010.1_i000_006639	123	356	233	1.04018	0.416071
GCA_020580775.1-Fun_JAIRJL010000002.1_i000_001096	123	356	233	1.04018	0.416071
GCA_020580905.1-Fun_JAIRFZ010000024.1_i000_011232	123	356	233	1.04018	0.416071
GCA_020581275.1-Fun_JAIRJP010000033.1_i000_011355	123	356	233	1.04018	0.416071
GCA_020568045.1-Fun_JAIRGB010000006.1_i000_003424	123	356	233	1.04018	0.416071
GCA_020568325.1-Fun_JAIRDU010000004.1_i000_002705	123	356	233	1.04018	0.416071
GCA_020568705.1-Fun_JAIRGF010000005.1_i000_003138	123	356	233	1.04018	0.416071
GCA_020569285.1-Fun_JAIREC010000009.1_i000_006147	123	356	233	1.04018	0.416071
GCA_020569485.1-Fun_JAIRGI010000001.1_i000_000482	123	356	233	1.04018	0.416071
GCA_020569495.1-Fun_JAIRED010000009.1_i000_005993	123	356	233	1.04018	0.416071
GCA_020569505.1-Fun_JAIREE010000005.1_i000_003706	123	356	233	1.04018	0.416071
GCA_020569515.1-Fun_JAIRGJ010000013.1_i000_007869	123	356	233	1.04018	0.416071
GCA_020569685.1-Fun_JAIRGK010000020.1_i000_009473	123	356	233	1.04018	0.416071
GCA_020569895.1-Fun_JAIRGL010000006.1_i000_003868	123	356	233	1.04018	0.416071
GCA_020569945.1-Fun_JAIREF010000002.1_i000_001167	123	356	233	1.04018	0.416071
GCA_020570045.1-Fun_JAIREI010000006.1_i000_004304	123	356	233	1.04018	0.416071
GCA_020570525.1-Fun_JAIREK010000006.1_i000_003955	123	356	233	1.04018	0.416071
GCA_020570685.1-Fun_JAIRGQ010000002.1_i000_001281	123	356	233	1.04018	0.416071
GCA_020570735.1-Fun_JAIRGR010000005.1_i000_003382	123	356	233	1.04018	0.416071
GCA_020571265.1-Fun_JAIREM010000005.1_i000_003042	123	356	233	1.04018	0.416071
GCA_020571575.1-Fun_JAIRGV010000003.1_i000_002076	123	356	233	1.04018	0.416071
GCA_020571605.1-Fun_JAIRGW010000005.1_i000_003143	123	356	233	1.04018	0.416071
GCA_020571895.1-Fun_JAIREP010000014.1_i000_009133	123	356	233	1.04018	0.416071
GCA_020571965.1-Fun_JAIRGZ010000006.1_i000_004201	123	356	233	1.04018	0.416071
GCA_020572075.1-Fun_JAIRHA010000003.1_i000_001890	123	356	233	1.04018	0.416071
GCA_020572305.1-Fun_JAIRHC010000007.1_i000_004406	123	356	233	1.04018	0.416071
GCA_020572345.1-Fun_JAIRHD010000012.1_i000_008085	123	356	233	1.04018	0.416071
GCA_020572675.1-Fun_JAIRHH010000005.1_i000_002513	123	356	233	1.04018	0.416071
GCA_020572955.1-Fun_JAIRHI010000003.1_i000_002187	123	356	233	1.04018	0.416071
GCA_020572985.1-Fun_JAIRER010000005.1_i000_003169	123	356	233	1.04018	0.416071
GCA_020572995.1-Fun_JAIRES010000016.1_i000_008615	123	356	233	1.04018	0.416071
GCA_020573275.1-Fun_JAIRHK010000028.1_i000_012172	123	356	233	1.04018	0.416071
GCA_020573285.1-Fun_JAIRHL010000027.1_i000_013256	123	356	233	1.04018	0.416071
GCA_020573325.1-Fun_JAIRET010000016.1_i000_010784	123	356	233	1.04018	0.416071
GCA_020573495.1-Fun_JAIRHN010000021.1_i000_009339	123	356	233	1.04018	0.416071
GCA_020573605.1-Fun_JAIRHP010000026.1_i000_010569	123	356	233	1.04018	0.416071
GCA_020573625.1-Fun_JAIRHQ010000020.1_i000_010027	123	356	233	1.04018	0.416071
GCA_020573725.1-Fun_JAIREU010000002.1_i000_001384	123	356	233	1.04018	0.416071
GCA_020573765.1-Fun_JAIREV010000031.1_i000_012979	123	356	233	1.04018	0.416071
GCA_020574055.1-Fun_JAIRHS010000010.1_i000_006062	123	356	233	1.04018	0.416071
GCA_020574115.1-Fun_JAIRHU010000008.1_i000_005459	123	356	233	1.04018	0.416071
GCA_020574145.1-Fun_JAIREW010000003.1_i000_003225	123	356	233	1.04018	0.416071
GCA_020574155.1-Fun_JAIREX010000001.1_i000_000321	123	356	233	1.04018	0.416071
GCA_020574265.1-Fun_JAIREY010000001.1_i000_000484	123	356	233	1.04018	0.416071
GCA_020574345.1-Fun_JAIREZ010000002.1_i000_002058	123	356	233	1.04018	0.416071
GCA_020574405.1-Fun_JAIRHY010000012.1_i000_006361	123	356	233	1.04018	0.416071
GCA_020574595.1-Fun_JAIRHX010000001.1_i000_000638	123	356	233	1.04018	0.416071
GCA_020574715.1-Fun_JAIRFC010000020.1_i000_010511	123	356	233	1.04018	0.416071
GCA_020574725.1-Fun_JAIRFD010000002.1_i000_001605	123	356	233	1.04018	0.416071
GCA_020574875.1-Fun_JAIRIC010000010.1_i000_006098	123	356	233	1.04018	0.416071
GCA_020575035.1-Fun_JAIRFE010000011.1_i000_007440	123	356	233	1.04018	0.416071
GCA_020575105.1-Fun_JAIRID010000014.1_i000_007831	123	356	233	1.04018	0.416071
GCA_020575195.1-Fun_JAIRIE010000032.1_i000_012307	123	356	233	1.04018	0.416071
GCA_020575285.1-Fun_JAIRIF010000004.1_i000_002514	123	356	233	1.04018	0.416071
GCA_020575355.1-Fun_JAIRIH010000001.1_i000_000318	123	356	233	1.04018	0.416071
GCA_020575375.1-Fun_JAIRIG010000015.1_i000_008174	123	356	233	1.04018	0.416071
GCA_020575615.1-Fun_JAIRIL010000013.1_i000_005641	123	356	233	1.04018	0.416071
GCA_020575645.1-Fun_JAIRIM010000002.1_i000_001369	123	356	233	1.04018	0.416071
GCA_020575955.1-Fun_JAIRIO010000014.1_i000_005503	123	356	233	1.04018	0.416071
GCA_020575995.1-Fun_JAIRIP010000023.1_i000_010885	123	356	233	1.04018	0.416071
GCA_020576185.1-Fun_JAIRIQ010000012.1_i000_007101	123	356	233	1.04018	0.416071
GCA_020576195.1-Fun_JAIRFG010000003.1_i000_001984	123	356	233	1.04018	0.416071
GCA_020576365.1-Fun_JAIRFI010000006.1_i000_003702	123	356	233	1.04018	0.416071
GCA_020577795.1-Fun_JAIRFH010000008.1_i000_004842	123	356	233	1.04018	0.416071
GCA_020577805.1-Fun_JAIRFJ010000010.1_i000_006221	123	356	233	1.04018	0.416071
GCA_020577855.1-Fun_JAIRFK010000002.1_i000_001039	123	356	233	1.04018	0.416071
GCA_020577905.1-Fun_JAIRFL010000017.1_i000_008518	123	356	233	1.04018	0.416071
GCA_020577915.1-Fun_JAIRFM010000019.1_i000_008953	123	356	233	1.04018	0.416071
GCA_020578075.1-Fun_JAIRFO010000010.1_i000_005696	123	356	233	1.04018	0.416071
GCA_020578085.1-Fun_JAIRFN010000015.1_i000_007914	123	356	233	1.04018	0.416071
GCA_020578095.1-Fun_JAIRFP010000009.1_i000_004926	123	356	233	1.04018	0.416071
GCA_020578105.1-Fun_JAIRFQ010000020.1_i000_008797	123	356	233	1.04018	0.416071
GCA_020578115.1-Fun_JAIRFR010000008.1_i000_003892	123	356	233	1.04018	0.416071
GCA_020578315.1-Fun_JAIRIS010000018.1_i000_008920	123	356	233	1.04018	0.416071
GCA_020578375.1-Fun_JAIRFT010000008.1_i000_005860	123	356	233	1.04018	0.416071
GCA_020578445.1-Fun_JAIRIU010000018.1_i000_008173	123	356	233	1.04018	0.416071
GCA_020578515.1-Fun_JAIRIV010000010.1_i000_005605	123	356	233	1.04018	0.416071
GCA_020578615.1-Fun_JAIRIX010000002.1_i000_001344	123	356	233	1.04018	0.416071
GCA_020579815.1-Fun_JAIRIZ010000009.1_i000_007148	123	356	233	1.04018	0.416071
GCA_020579835.1-Fun_JAIRJA010000005.1_i000_002380	123	356	233	1.04018	0.416071
GCA_020579855.1-Fun_JAIRFU010000061.1_i000_016689	123	356	233	1.04018	0.416071
GCA_020580075.1-Fun_JAIRJC010000005.1_i000_003253	123	356	233	1.04018	0.416071
GCA_020580085.1-Fun_JAIRJD010000004.1_i000_002807	123	356	233	1.04018	0.416071
GCA_020580115.1-Fun_JAIRFV010000021.1_i000_010488	123	356	233	1.04018	0.416071
GCA_020580145.1-Fun_JAIRJE010000012.1_i000_005986	123	356	233	1.04018	0.416071
GCA_020580155.1-Fun_JAIRJF010000005.1_i000_003379	123	356	233	1.04018	0.416071
GCA_020580305.1-Fun_JAIRJG010000010.1_i000_006332	123	356	233	1.04018	0.416071
GCA_020580655.1-Fun_JAIRFX010000007.1_i000_004912	123	356	233	1.04018	0.416071
GCA_020580695.1-Fun_JAIRJK010000009.1_i000_004671	123	356	233	1.04018	0.416071
GCA_020581045.1-Fun_JAIRJM010000020.1_i000_009851	123	356	233	1.04018	0.416071
GCA_020581155.1-Fun_JAIRJN010000005.1_i000_001764	123	356	233	1.04018	0.416071
GCA_022343325.1-Fun_JACTNT010000039.1_i000_009340	117	350	233	1.04018	0.420578
GCA_019633545.1-Fun_WSUF01000180.1_i000_003615	146	382	236	1.05357	0.427536
GCA_018857305.1-Fun_JABCKQ010017452.1_i000_006790	159	413	254	1.13393	0.451155
GCA_020726525.1-Fun_JAGPXC010000001.1_i000_001031	183	418	235	1.04911	0.393635
GCA_010093745.1-Fun_MU005994.1_i000_005252	126	360	234	1.04464	0.411972
GCA_000770705.1-Fun_ANFO01001292.1_i000_011008	124	358	234	1.04464	0.403448
GCA_021193595.1-Fun_JAJJMK010000532.1_i000_011769	183	418	235	1.04911	0.373016
GCA_003795295.1-Fun_LKEB01000006.1_i000_001983	157	392	235	1.04911	0.385878
GCA_000804445.1-Fun_AZHE01000007.1_i000_007682	143	377	234	1.04464	0.39
GCA_020736525.1-Fun_JAHBOE010000001.1_i000_001341	190	425	235	1.04911	0.366044
GCA_000349305.2-Fun_HE999552.1_i000_000799	118	343	225	1.00446	0.431862
GCA_900149145.1-Fun_LT671821.1_i000_000113	118	343	225	1.00446	0.431862
GCA_000769215.1-Fun_JPYM01000002.1_i000_005314	183	417	234	1.04464	0.369085
GCA_000004155.2-Fun_KE546995.1_i000_004613	142	354	212	0.946429	0.410853
GCA_018282135.1-Fun_JAGPUO010000018.1_i000_004171	183	417	234	1.04464	0.369085
GCA_022432365.1-Fun_JAJJXE010000007.1_i000_009356	154	389	235	1.04911	0.382736
GCA_020744115.1-Fun_JAGMVH010000003.1_i000_006856	183	417	234	1.04464	0.369085
GCA_004353045.1-Fun_SKBQ01000013.1_i000_001676	189	425	236	1.05357	0.363077
GCA_017635955.1-Fun_JAAQQV010000003.1_i000_003199	120	342	222	0.991071	0.425287
GCA_010099065.1-Fun_PPTI01000008.1_i000_009569	118	352	234	1.04464	0.407666
GCA_000143365.1-Fun_CH408030.1_i000_007971	154	389	235	1.04911	0.387789
GCA_022432505.1-Fun_JAJKKH010000001.1_i000_000127	157	392	235	1.04911	0.385878
GCA_000280675.1-Fun_JH725179.1_i000_008075	124	358	234	1.04464	0.403448
GCA_001682635.1-Fun_JRHA01000001.1_i000_001484	124	358	234	1.04464	0.403448
GCA_021365345.1-Fun_JAAZTN010000007.1_i000_009976	124	358	234	1.04464	0.403448
GCA_018360365.1-Fun_SRQA01001197.1_i000_000713	143	377	234	1.04464	0.386777
GCA_008080495.1-Fun_CP023324.1_i000_008293	128	362	234	1.04464	0.4
GCA_021432605.1-Fun_MU271150.1_i000_008210	148	383	235	1.04911	0.393635
GCA_010015825.1-Fun_ML977313.1_i000_002622	131	362	231	1.03125	0.403141
GCA_003814445.1-Fun_CP031387.1_i000_003678	142	376	234	1.04464	0.387417
GCA_000221225.1-Fun_GL988037.1_i000_000968	148	383	235	1.04911	0.38715
GCA_000225605.1-Fun_JH126399.1_i000_001106	128	362	234	1.04464	0.4
GCA_019096155.1-Fun_JAHCVI010000001.1_i000_002268	191	426	235	1.04911	0.365474
GCA_010093635.1-Fun_MU006786.1_i000_007382	134	370	236	1.05357	0.411867
GCA_010405425.1-Fun_MU005576.1_i000_005424	130	363	233	1.04018	0.408772
GCA_000227095.3-Fun_BACD03000002.1_i000_006714	119	340	221	0.986607	0.440239
GCA_001661265.1-Fun_KV454255.1_i000_000754	119	340	221	0.986607	0.440239
GCA_018994095.1-Fun_JAEMWZ010000566.1_i000_014903	154	386	232	1.03571	0.539535
GCA_000208925.2-Pro_DS571303.1_i000_002548	96	319	223	0.995536	0.492274
GCA_000338855.1-Pro_KB444337.1_i000_002472	96	319	223	0.995536	0.492274
GCA_000344925.1-Pro_KB610214.1_i000_001490	96	319	223	0.995536	0.492274
GCA_000346345.1-Pro_KB638864.1_i000_007081	96	319	223	0.995536	0.492274
GCA_000365475.1-Pro_KB824335.1_i000_004847	96	319	223	0.995536	0.492274
GCA_001662325.1-Pro_BDEQ01000001.1_i000_005776	96	319	223	0.995536	0.492274
GCA_000149985.1-Fun_DS231615.1_i000_010534	114	342	228	1.01786	0.416058
GCA_003171515.3-Fun_CM025795.1_i000_001004	114	342	228	1.01786	0.416058
GCA_003171545.1-Fun_NQWZ01000101.1_i000_004594	114	342	228	1.01786	0.416058
GCA_003231325.2-Fun_MVBF02000001.1_i000_000330	114	342	228	1.01786	0.416058
GCA_003231345.1-Fun_MVBI01000238.1_i000_007470	114	342	228	1.01786	0.416058
GCA_003231355.1-Fun_MVBG01000121.1_i000_005612	114	342	228	1.01786	0.416058
GCA_003231365.1-Fun_MVBH01000163.1_i000_006246	114	342	228	1.01786	0.416058
GCA_003231415.2-Fun_MUXC02000001.1_i000_000934	114	342	228	1.01786	0.416058
GCA_003231425.1-Fun_NRDI01000088.1_i000_004301	114	342	228	1.01786	0.416058
GCA_008692205.1-Fun_SAXQ01000001.1_i000_000957	114	342	228	1.01786	0.416058
GCA_000350225.2-Pro_HG001756.1_i000_006007	114	335	221	0.986607	0.445565
GCA_018360145.1-Fun_SRPY01000034.1_i000_003896	151	385	234	1.04464	0.381107
GCA_004154745.1-Fun_PDXA01000015.1_i000_002616	114	342	228	1.01786	0.415301
GCA_001642055.1-Fun_KV441503.1_i000_012575	114	342	228	1.01786	0.415301
GCA_020726445.1-Fun_JAGJXA010000003.1_i000_004036	159	394	235	1.04911	0.376
GCA_000687475.2-Fun_CP072753.1_i000_001246	143	377	234	1.04464	0.391304
GCA_000965225.2-Fun_BBTG02000019.1_i000_003713	143	377	234	1.04464	0.391304
GCA_004154815.1-Fun_PEJP01000022.1_i000_004288	114	342	228	1.01786	0.416819
GCA_004154755.1-Fun_PDXD01000042.1_i000_009542	114	342	228	1.01786	0.416819
GCA_004154835.1-Fun_PDUP01000019.1_i000_003863	114	342	228	1.01786	0.416819
GCA_004154845.1-Fun_PDXH01000047.1_i000_009548	114	342	228	1.01786	0.416819
GCA_004156025.2-Fun_PDWZ02000011.1_i000_003640	114	342	228	1.01786	0.416819
GCA_004156035.1-Fun_PDXC01000002.1_i000_004974	114	342	228	1.01786	0.416819
GCA_004168565.1-Fun_PDXF01000055.1_i000_010093	114	342	228	1.01786	0.416819
GCA_020736535.1-Fun_JAHBNJ010000011.1_i000_003322	114	342	228	1.01786	0.416819
GCA_001970855.1-Fun_LSSN01003788.1_i000_008665	130	356	226	1.00893	0.431298
GCA_001970855.1-Fun_LSSN01004955.1_i000_010013	130	356	226	1.00893	0.431298
GCA_001691775.3-Fun_JNHW02000002.1_i000_001223	209	396	187	0.834821	0.337545
GCA_001266575.1-Ani_JTDY01002389.1_i000_008033	109	210	101	0.450893	0.282123
GCA_001266575.1-Ani_JTDY01002389.1_i000_008033	207	271	64	0.285714	0.178771
GCA_003012285.1-Fun_PXOG01000131.1_i000_006060	140	374	234	1.04464	0.395939
GCA_907166805.1-Fun_CAJRGZ010000017.1_i000_004945	115	343	228	1.01786	0.416058
GCA_000187875.1-Ani_GL733634.1_i000_028062	1	113	112	0.5	0.391608
GCA_018360135.1-Fun_SRPV01002324.1_i000_003515	149	383	234	1.04464	0.383607
GCA_000583005.2-Pla_ASHM01016385.1_i000_020967	1	166	165	0.736607	0.595668
GCA_000583005.2-Pla_ASHM01031757.1_i000_032393	1	166	165	0.736607	0.595668
GCA_016618355.2-Fun_JADGIP010000027.1_i000_001238	156	365	209	0.933036	0.399618
GCA_000516985.1-Fun_KI912109.1_i000_001533	157	392	235	1.04911	0.389073
GCA_014621435.1-Fun_JAANBA010000326.1_i000_008585	150	385	235	1.04911	0.393635
GCA_010093805.1-Fun_ML996201.1_i000_010413	128	360	232	1.03571	0.404181
GCA_011058875.1-Fun_SWKT01000156.1_i000_003630	156	391	235	1.04911	0.389718
GCA_018360085.1-Fun_SRPR01000245.1_i000_003203	144	378	234	1.04464	0.382353
GCA_018360175.1-Fun_SRPS01000104.1_i000_000322	144	378	234	1.04464	0.382353
GCA_002871155.1-Fun_MRVG01000008.1_i000_009778	124	358	234	1.04464	0.403448
GCA_018360345.1-Fun_SRQH01000646.1_i000_006402	144	378	234	1.04464	0.382979
GCA_018360375.1-Fun_SRQE01000482.1_i000_005164	144	378	234	1.04464	0.382979
GCA_018360385.1-Fun_SRQF01000498.1_i000_005284	144	378	234	1.04464	0.382979
GCA_018360275.1-Fun_SRQB01000236.1_i000_002616	144	378	234	1.04464	0.382979
GCA_018360355.1-Fun_SRQC01000029.1_i000_003536	144	378	234	1.04464	0.382979
GCA_018360525.1-Fun_SRQD01000021.1_i000_002485	144	378	234	1.04464	0.382979
GCA_016771965.1-Pla_CM028694.1_i000_034294	42	258	216	0.964286	0.791209
GCA_018360075.1-Fun_SRPQ01000476.1_i000_004900	144	378	234	1.04464	0.382979
GCA_000359705.1-Fun_KB908855.1_i000_010559	115	343	228	1.01786	0.416819
GCA_018360465.1-Fun_SRQM01000001.1_i000_000055	144	378	234	1.04464	0.382353
GCA_000166005.1-Fun_GL533847.1_i000_003196	114	342	228	1.01786	0.424581
GCA_009728635.1-Fun_WJSK01000002.1_i000_001672	114	342	228	1.01786	0.424581
GCA_009728645.1-Fun_WJSL01000002.1_i000_001700	114	342	228	1.01786	0.424581
GCA_009728655.1-Fun_WJSN01000001.1_i000_000430	114	342	228	1.01786	0.424581
GCA_009728665.1-Fun_WJSO01000001.1_i000_000420	114	342	228	1.01786	0.424581
GCA_009728675.1-Fun_WJSM01000001.1_i000_000978	114	342	228	1.01786	0.424581
GCA_900231935.2-Fun_OCTF02000002.1_i000_001834	114	342	228	1.01786	0.424581
GCA_010015675.1-Fun_ML977004.1_i000_010412	132	365	233	1.04018	0.410935
GCA_900232045.3-Fun_HG992978.1_i000_001925	114	342	228	1.01786	0.416058
GCA_018360565.1-Fun_SRQP01000537.1_i000_005936	144	378	234	1.04464	0.382979
GCA_000347355.1-Fun_CAGA01000051.1_i000_002291	144	378	234	1.04464	0.382979
GCA_018360475.1-Fun_SRQQ01000078.1_i000_007456	144	378	234	1.04464	0.382979
GCA_018360585.1-Fun_SRQN01000257.1_i000_003124	144	378	234	1.04464	0.382979
GCA_018360605.1-Fun_SRQO01000040.1_i000_004844	144	378	234	1.04464	0.382979
GCA_018360655.1-Fun_SRQS01000012.1_i000_000678	144	378	234	1.04464	0.382979
GCA_018360675.1-Fun_SRQZ01000152.1_i000_001321	144	378	234	1.04464	0.382979
GCA_018360725.1-Fun_SRQU01000295.1_i000_003576	144	378	234	1.04464	0.382979
GCA_018360735.1-Fun_SRQX01000503.1_i000_005753	144	378	234	1.04464	0.382979
GCA_018360745.1-Fun_SRQT01000409.1_i000_005047	144	378	234	1.04464	0.382979
GCA_018360755.1-Fun_SRQW01000054.1_i000_006043	144	378	234	1.04464	0.382979
GCA_018360765.1-Fun_SRQV01000148.1_i000_001246	144	378	234	1.04464	0.382979
GCA_018360825.1-Fun_SRRA01000057.1_i000_006333	144	378	234	1.04464	0.382979
GCA_018360835.1-Fun_SRRB01000460.1_i000_005506	144	378	234	1.04464	0.382979
GCA_018360905.1-Fun_SRRI01000073.1_i000_007346	144	378	234	1.04464	0.382979
GCA_018360925.1-Fun_SRRJ01000004.1_i000_005075	144	378	234	1.04464	0.382979
GCA_018360955.1-Fun_SRQY01000184.1_i000_001925	144	378	234	1.04464	0.382979
GCA_018361025.1-Fun_SRRH01000111.1_i000_000465	144	378	234	1.04464	0.382979
GCA_018360065.1-Fun_SRPO01000167.1_i000_001570	144	378	234	1.04464	0.382979
GCA_018360865.1-Fun_SRRG01000003.1_i000_003656	144	378	234	1.04464	0.382979
GCA_018360045.1-Fun_SRPN01000035.1_i000_004295	144	378	234	1.04464	0.382979
GCA_018360685.1-Fun_SRRD01000009.1_i000_007940	144	378	234	1.04464	0.382979
GCA_018360845.1-Fun_SRRE01000085.1_i000_007842	144	378	234	1.04464	0.382979
GCA_018360855.1-Fun_SRRF01000075.1_i000_007368	144	378	234	1.04464	0.382979
GCA_018360935.1-Fun_SRRK01000715.1_i000_007344	144	378	234	1.04464	0.382979
GCA_018360975.1-Fun_SRRC01000012.1_i000_000668	144	378	234	1.04464	0.382979
GCA_018360535.1-Fun_SRQR01000008.1_i000_007750	144	378	234	1.04464	0.382979
GCA_001651475.1-Pla_CM004361.1_i000_016059	102	177	75	0.334821	0.169683
GCA_001651475.1-Pla_CM004361.1_i000_016059	172	295	123	0.549107	0.278281
GCA_019202805.1-Pla_CM032902.1_i000_015547	102	177	75	0.334821	0.169683
GCA_019202805.1-Pla_CM032902.1_i000_015547	172	295	123	0.549107	0.278281
GCA_001636725.1-Fun_AZHB01000010.1_i000_001358	127	361	234	1.04464	0.401372
GCA_001661245.1-Fun_KV454015.1_i000_003919	93	321	228	1.01786	0.465306
GCA_000002525.1-Fun_CR382128.1_i000_001216	120	342	222	0.991071	0.425287
GCA_001761485.1-Fun_CP017554.1_i000_001587	120	342	222	0.991071	0.425287
GCA_003367845.1-Fun_KZ859275.1_i000_000904	120	342	222	0.991071	0.425287
GCA_003367865.1-Fun_KZ858973.1_i000_002446	120	342	222	0.991071	0.425287
GCA_003367925.1-Fun_KZ858295.1_i000_002918	120	342	222	0.991071	0.425287
GCA_003367945.1-Fun_KZ858018.1_i000_000783	120	342	222	0.991071	0.425287
GCA_003367965.1-Fun_KZ858608.1_i000_001673	120	342	222	0.991071	0.425287
GCA_003698155.1-Fun_PKSB01000001.1_i000_000577	120	342	222	0.991071	0.425287
GCA_009194645.1-Fun_ML736603.1_i000_001536	120	342	222	0.991071	0.425287
GCA_009372015.1-Fun_ML755978.1_i000_000468	120	342	222	0.991071	0.425287
GCA_014490615.1-Fun_CP061014.1_i000_002143	120	342	222	0.991071	0.425287
GCA_900087985.1-Fun_LT576315.1_i000_000800	120	342	222	0.991071	0.425287
GCA_900537225.1-Fun_UTQH01000003.1_i000_000871	120	342	222	0.991071	0.425287
GCA_016097525.1-Fun_JADAKD010000009.1_i000_024222	114	342	228	1.01786	0.415301
GCA_000257125.1-Pro_JH926792.1_i000_002775	96	319	223	0.995536	0.492274
GCA_021176775.1-Fun_JAJEVK010000002.1_i000_002643	143	377	234	1.04464	0.399317
GCA_900091695.1-Fun_LT853692.1_i000_001818	156	390	234	1.04464	0.379254
GCA_900099495.1-Fun_LT882676.1_i000_001799	156	390	234	1.04464	0.379254
GCA_900184105.1-Fun_LT854273.1_i000_001780	156	390	234	1.04464	0.379254
GCA_000219625.1-Fun_CM001196.1_i000_001635	156	390	234	1.04464	0.379254
GCA_900184115.1-Fun_LT854253.1_i000_001808	156	390	234	1.04464	0.379254
GCA_018360055.1-Fun_SRPP01000039.1_i000_004363	144	378	234	1.04464	0.382979
GCA_018360325.1-Fun_SRQG01000081.1_i000_007602	144	377	233	1.04018	0.380719
GCA_018360435.1-Fun_SRQI01000051.1_i000_005993	144	377	233	1.04018	0.380719
GCA_018360595.1-Fun_SRQJ01000040.1_i000_004903	144	377	233	1.04018	0.380719
GCA_018360445.1-Fun_SRQK01000152.1_i000_001375	144	377	233	1.04018	0.380719
GCA_018360575.1-Fun_SRQL01000081.1_i000_007752	144	377	233	1.04018	0.380719
GCA_016771965.1-Pla_CM028697.1_i000_052305	105	322	217	0.96875	0.671827
GCA_000313485.1-Fun_CAIF01000043.1_i000_004782	130	351	221	0.986607	0.460417
GCA_003574525.1-Fun_QPFE01000110.1_i000_007521	114	342	228	1.01786	0.415301
GCA_013036055.1-Fun_JAAABM010000006.1_i000_007185	114	342	228	1.01786	0.415301
GCA_000966595.1-Fun_LAFY01000586.1_i000_005677	156	390	234	1.04464	0.379254
GCA_018360225.1-Fun_SRPW01001064.1_i000_003729	152	386	234	1.04464	0.379254
GCA_001027345.1-Fun_KQ087270.1_i000_007459	151	374	223	0.995536	0.408425
GCA_008065305.1-Fun_QKWL01000003.1_i000_004373	151	374	223	0.995536	0.408425
GCA_001572055.1-Fun_LPVP01000012.1_i000_007091	114	342	228	1.01786	0.415301
GCA_018360215.1-Fun_SRPX01000094.1_i000_008156	144	378	234	1.04464	0.382353
GCA_904420315.1-Pla_LR881468.1_i000_013486	216	291	75	0.334821	0.134892
GCA_904420315.1-Pla_LR881468.1_i000_013486	286	409	123	0.549107	0.221223
GCA_000209125.2-Pro_DS548389.1_i000_007191	94	317	223	0.995536	0.494457
GCA_020736505.1-Fun_JAHBNI010000010.1_i000_002205	118	346	228	1.01786	0.413793
GCA_018360255.1-Fun_SRPZ01000025.1_i000_003461	153	387	234	1.04464	0.380488
GCA_001970865.1-Fun_LSSM01001056.1_i000_003107	130	356	226	1.00893	0.430476
GCA_001661255.1-Fun_KV454212.1_i000_004591	85	306	221	0.986607	0.506881
GCA_018854895.1-Fun_JABAJV010000001.1_i000_000077	24	234	210	0.9375	0.539846
GCA_022432395.1-Fun_JAJKLJ010000016.1_i000_004286	155	390	235	1.04911	0.392321
GCA_001661315.1-Fun_KV454410.1_i000_003370	39	269	230	1.02679	0.489362
GCA_000523455.1-Fun_KI964001.1_i000_006839	116	344	228	1.01786	0.416819
GCA_002818225.1-Fun_KZ454987.1_i000_000622	117	342	225	1.00446	0.427757
GCA_018360205.1-Fun_SRPT01000021.1_i000_002467	153	387	234	1.04464	0.382979
GCA_003290485.1-Fun_CP030252.1_i000_001550	142	367	225	1.00446	0.413603
GCA_004154765.1-Fun_PDXG01000005.1_i000_010499	114	342	228	1.01786	0.416819
GCA_018360185.1-Fun_SRPU01001665.1_i000_005457	150	384	234	1.04464	0.380488
GCA_004154735.1-Fun_PDXE01000010.1_i000_000832	114	342	228	1.01786	0.416819
GCA_000143105.2-Fun_GL629765.1_i000_001892	144	380	236	1.05357	0.39531
GCA_022453515.1-Fun_JAJNNY010000006.1_i000_009714	161	396	235	1.04911	0.380259
GCA_010015705.1-Fun_ML977145.1_i000_003272	69	297	228	1.01786	0.460606
GCA_900290415.1-Fun_LR026964.1_i000_001446	146	381	235	1.04911	0.391015
GCA_002271885.2-Pla_CM008450.1_i000_019418	1	225	224	1	0.656891
GCA_000523435.1-Fun_KI964693.1_i000_008804	116	344	228	1.01786	0.416819
GCA_000338975.1-Fun_KB445576.1_i000_006686	116	344	228	1.01786	0.416819
GCA_000354255.1-Fun_KB733447.1_i000_002228	116	344	228	1.01786	0.416819
GCA_019454015.1-Fun_JAHUAA010000005.1_i000_008789	116	344	228	1.01786	0.416819
GCA_900120095.1-Fun_FQNC01000018.1_i000_003723	177	399	222	0.991071	0.395018
GCA_003691605.1-Fun_CP033149.1_i000_000837	142	367	225	1.00446	0.413603
GCA_004155955.1-Fun_PDWY01000021.1_i000_004593	114	342	228	1.01786	0.416819
GCA_000338995.1-Fun_KB445648.1_i000_008524	116	344	228	1.01786	0.416819
GCA_013416765.1-Fun_WNKQ01000005.1_i000_003068	116	344	228	1.01786	0.416819
GCA_003426265.1-Fun_NQIL01000086.1_i000_011902	154	373	219	0.977679	0.373083
GCA_019702505.1-Fun_JAANER010000008.1_i000_011044	118	346	228	1.01786	0.411552
GCA_021432635.1-Fun_MU270073.1_i000_017854	150	385	235	1.04911	0.389718
GCA_021365275.1-Fun_JAJTIY010000003.1_i000_010510	156	391	235	1.04911	0.38843
GCA_000733215.1-Pla_KL662148.1_i000_005089	86	254	168	0.75	0.379233
GCA_000733215.1-Pla_KL662148.1_i000_005089	250	288	38	0.169643	0.0857788
GCA_001890705.1-Fun_KV878582.1_i000_000172	63	296	233	1.04018	0.445507
GCA_000474925.1-Fun_KI440843.1_i000_002472	146	382	236	1.05357	0.390728
GCA_002946415.1-Fun_NJPS01000048.1_i000_005523	111	318	207	0.924107	0.38764
GCA_000145635.1-Fun_GL385395.1_i000_001319	151	387	236	1.05357	0.387521
GCA_000226545.1-Fun_CU633867.1_i000_001138	146	381	235	1.04911	0.391015
GCA_000961545.1-Fun_AXCR01000004.1_i000_001850	200	436	236	1.05357	0.358663
GCA_020617735.1-Fun_JAFCIX010000030.1_i000_000693	152	280	128	0.571429	0.267782
GCA_020617735.1-Fun_JAFCIX010000030.1_i000_000693	278	329	51	0.227679	0.106695
GCA_001653215.1-Fun_LUKN01004083.1_i000_001415	94	310	216	0.964286	0.696774
GCA_016861865.1-Fun_AP024447.1_i000_008592	116	349	233	1.04018	0.404514
GCA_015844325.1-Fun_VCAU01000060.1_i000_010008	120	353	233	1.04018	0.398291
GCA_015025155.1-Fun_WITN01000175.1_i000_004520	155	361	206	0.919643	0.392381
GCA_002271895.2-Pla_CM008437.1_i000_019992	103	318	215	0.959821	0.131418
GCA_001191545.1-Fun_LGLR01000178.1_i000_003052	116	344	228	1.01786	0.411552
GCA_003268315.1-Fun_QGDG01000089.1_i000_008492	116	344	228	1.01786	0.411552
GCA_003268335.1-Fun_QGDH01000076.1_i000_007922	116	344	228	1.01786	0.411552
GCA_000320565.2-Fun_KB456260.1_i000_001167	156	390	234	1.04464	0.382353
GCA_007735645.1-Fun_CP042195.1_i000_007186	185	417	232	1.03571	0.365931
GCA_019925215.1-Fun_JAHFYS010001878.1_i000_006321	154	348	194	0.866071	0.557471
GCA_000820605.1-Fun_AWTV01000006.1_i000_002794	145	381	236	1.05357	0.391376
GCA_004346965.1-Fun_CP034209.1_i000_010609	144	380	236	1.05357	0.395973
GCA_000292585.1-Fun_JH793087.1_i000_002448	138	374	236	1.05357	0.4
GCA_000002495.2-Fun_CM001231.1_i000_001909	144	380	236	1.05357	0.395973
GCA_021442365.1-Fun_PHFK01000002.1_i000_002542	144	380	236	1.05357	0.395973
GCA_021845515.1-Fun_VIDS01000007.1_i000_011028	144	380	236	1.05357	0.395973
GCA_003351075.1-Fun_QFBF01000010.1_i000_001166	185	417	232	1.03571	0.365931
GCA_009769405.1-Fun_WNWR01000390.1_i000_008335	185	417	232	1.03571	0.365931
GCA_009769425.1-Fun_WNWS01000093.1_i000_003950	185	417	232	1.03571	0.365931
GCA_009769445.1-Fun_WNWQ01000067.1_i000_001728	185	417	232	1.03571	0.365931
GCA_000292605.1-Fun_JH794549.1_i000_003803	182	418	236	1.05357	0.37224
GCA_000410735.1-Fun_KE148147.1_i000_001331	142	378	236	1.05357	0.396639
GCA_004337985.1-Fun_CM014989.1_i000_009261	157	393	236	1.05357	0.387521
GCA_002271895.2-Pla_CM008438.1_i000_021471	38	262	224	1	0.586387
GCA_004522655.2-Fun_SNSC02000009.1_i000_005494	156	388	232	1.03571	0.383471
GCA_004522665.1-Fun_SNSD01000009.1_i000_005367	156	388	232	1.03571	0.383471
GCA_001592805.2-Fun_CP051143.1_i000_007578	160	394	234	1.04464	0.383607
GCA_004337975.1-Fun_RRCJ01000010.1_i000_008636	144	380	236	1.05357	0.395973
GCA_004156015.1-Fun_PDXB01000048.1_i000_009207	114	342	228	1.01786	0.416819
GCA_020744215.1-Fun_JAGMVJ010000001.1_i000_001721	117	350	233	1.04018	0.420578
GCA_001890125.1-Fun_KV878125.1_i000_001777	66	299	233	1.04018	0.442966
GCA_020921065.1-Pla_CM037157.1_i000_020182	777	989	212	0.946429	0.203455
GCA_014235945.1-Fun_WIGO01000272.1_i000_012770	178	414	236	1.05357	0.372828
GCA_002920205.1-Fun_PKSM01000162.1_i000_009280	138	319	181	0.808036	0.367886
GCA_020744225.1-Fun_JAGMWG010000004.1_i000_011445	117	350	233	1.04018	0.420578
GCA_010015635.1-Fun_ML976042.1_i000_006256	115	353	238	1.0625	0.426523
GCA_018127125.1-Pla_CM030799.1_i000_034242	108	323	215	0.959821	0.581081
GCA_001661475.1-Fun_KV453842.1_i000_003006	86	307	221	0.986607	0.575521
GCA_014235955.1-Fun_WIGN01000090.1_i000_006466	178	414	236	1.05357	0.372828
GCA_001511075.1-Fun_CDMC01000007.1_i000_008885	59	292	233	1.04018	0.44636
GCA_004355905.1-Fun_RRCK01000002.1_i000_007895	144	380	236	1.05357	0.395973
GCA_010015615.1-Fun_ML976619.1_i000_011391	122	355	233	1.04018	0.416816
GCA_000004255.1-Pla_GL348715.1_i000_011552	106	131	25	0.111607	0.0563063
GCA_000004255.1-Pla_GL348715.1_i000_011552	128	298	170	0.758929	0.382883
GCA_010015745.1-Fun_ML978176.1_i000_004883	115	348	233	1.04018	0.422101
GCA_011066485.2-Fun_MU009886.1_i000_002991	154	382	228	1.01786	0.41989
GCA_003260695.2-Pla_QGKY02000089.1_i000_006832	188	355	167	0.745536	0.191954
GCA_003260695.2-Pla_QGKY02000089.1_i000_006832	537	761	224	1	0.257471
GCA_012550715.1-Fun_JAANYQ010000008.1_i000_006904	170	404	234	1.04464	0.373802
GCA_003260675.2-Pla_QGKX02000088.1_i000_051223	14	220	206	0.919643	0.547872
GCA_000003125.1-Fun_EQ962652.1_i000_007289	61	294	233	1.04018	0.453307
GCA_014925825.1-Fun_JACGCK010000001.1_i000_000612	170	372	202	0.901786	0.381132
GCA_020747045.1-Fun_JAGTJN010000001.1_i000_000638	124	357	233	1.04018	0.414591
GCA_000769265.1-Fun_JPKY01000027.1_i000_004159	147	380	233	1.04018	0.387043
GCA_015476325.1-Pro_JADAQX010000747.1_i000_000390	108	335	227	1.01339	0.468041
GCA_015952705.1-Pla_CM027683.1_i000_017807	57	102	45	0.200893	0.14377
GCA_015952705.1-Pla_CM027683.1_i000_017807	95	245	150	0.669643	0.479233
GCA_000003195.3-Pla_CM000763.3_i000_017440	88	292	204	0.910714	0.466819
GCA_003704575.1-Fun_QWIN01001423.1_i000_002894	162	363	201	0.897321	0.553719
GCA_014235935.1-Fun_WIGM01000023.1_i000_001369	175	411	236	1.05357	0.374603
GCA_001636815.1-Fun_AZHD01000027.1_i000_005411	144	380	236	1.05357	0.359209
GCA_014905375.1-Pla_BMAC01001247.1_i000_027889	1	168	167	0.745536	0.518634
GCA_000968595.1-Fun_LASV01000732.1_i000_009081	64	297	233	1.04018	0.445507
GCA_003073855.1-Fun_KZ805305.1_i000_001581	136	370	234	1.04464	0.404844
GCA_001651215.1-Pro_LXWW01000168.1_i000_003113	130	349	219	0.977679	0.293566
GCA_000691945.2-Pro_FO082872.1_i000_001209	120	340	220	0.982143	0.449898
GCA_001907595.1-Fun_LFMY01000006.1_i000_007103	66	299	233	1.04018	0.450677
GCA_019650175.1-Pla_BNCO01000105.1_i000_012162	376	552	176	0.785714	0.249292
GCA_019968985.1-Pro_JAHYSF010000259.1_i000_001027	104	325	221	0.986607	0.568123
GCA_000165395.2-Pro_CM031753.1_i000_001225	111	323	212	0.946429	0.449153
GCA_019804575.1-Fun_JAHQZX010000299.1_i000_002661	57	290	233	1.04018	0.452427
GCA_014282245.1-Pla_CM024954.1_i000_004031	53	200	147	0.65625	0.436202
GCA_014282245.1-Pla_CM024954.1_i000_004031	197	238	41	0.183036	0.121662
GCA_001644525.1-Fun_KV441715.1_i000_008810	124	357	233	1.04018	0.414591
GCA_002794465.1-Fun_MTSL01000178.1_i000_000107	24	245	221	0.986607	0.231899
GCA_003615045.1-Fun_ML014254.1_i000_004540	8	230	222	0.991071	0.727869
GCA_014281905.1-Fun_JACBAD010002087.1_i000_006614	55	288	233	1.04018	0.450677
GCA_014281935.1-Fun_JACBAF010002273.1_i000_006892	55	288	233	1.04018	0.450677
GCA_014281915.1-Fun_JACBAG010001676.1_i000_004625	55	288	233	1.04018	0.452427
GCA_001953115.1-Fun_LSSL01000428.1_i000_001167	126	357	231	1.03125	0.445946
GCA_001953115.1-Fun_LSSL01003426.1_i000_005302	126	357	231	1.03125	0.445946
GCA_000751175.1-Pro_CCKQ01007046.1_i000_007245	116	338	222	0.991071	0.427746
GCA_014281895.1-Fun_JACBAE010001143.1_i000_004576	55	288	233	1.04018	0.452427
GCA_006937295.1-Pla_VIBQ01000056.1_i000_025471	153	387	234	1.04464	0.394604
GCA_000330505.1-Pro_KB206474.1_i000_004115	98	317	219	0.977679	0.494357
GCA_004565275.1-Pro_SDOX01000006.1_i000_007239	166	412	246	1.09821	0.421955
GCA_000143415.2-Pla_GL377675.1_i000_030590	7	232	225	1.00446	0.773196
GCA_003698115.1-Fun_RAQS01000545.1_i000_007900	53	286	233	1.04018	0.455078
GCA_010724255.1-Fun_BLKF01000167.1_i000_009975	55	288	233	1.04018	0.44894
GCA_008932095.1-Pla_CM018519.1_i000_034299	105	286	181	0.808036	0.416092
GCA_010405405.1-Fun_MU004237.1_i000_007880	109	331	222	0.991071	0.410351
GCA_010723975.1-Fun_BLKD01000021.1_i000_004399	55	288	233	1.04018	0.44894
GCA_010724455.1-Fun_BLKH01000076.1_i000_008695	55	288	233	1.04018	0.44894
GCA_010724575.1-Fun_BLKI01000016.1_i000_003694	55	288	233	1.04018	0.44894
GCA_010724635.1-Fun_BLKJ01000024.1_i000_005187	55	288	233	1.04018	0.44894
GCA_010724915.1-Fun_BLKL01000010.1_i000_002204	55	288	233	1.04018	0.44894
GCA_012656335.1-Fun_JAAAPU010000062.1_i000_007676	55	288	233	1.04018	0.44894
GCA_012656375.1-Fun_JAAAPT010000073.1_i000_008344	55	288	233	1.04018	0.44894
GCA_012656395.1-Fun_JAAAPS010000069.1_i000_008109	55	288	233	1.04018	0.44894
GCA_012656435.1-Fun_JAAAPP010000052.1_i000_007050	55	288	233	1.04018	0.44894
GCA_012656445.1-Fun_JAAAPR010000071.1_i000_008146	55	288	233	1.04018	0.44894
GCA_012656455.1-Fun_JAAAPQ010000058.1_i000_007403	55	288	233	1.04018	0.44894
GCA_001445615.2-Fun_BCLY01000016.1_i000_008211	55	288	233	1.04018	0.44894
GCA_001078395.2-Fun_BBXM02000006.1_i000_007892	55	288	233	1.04018	0.44894
GCA_010723835.1-Fun_BLKC01000037.1_i000_005781	55	288	233	1.04018	0.44894
GCA_010724135.1-Fun_BLKE01000007.1_i000_000779	55	288	233	1.04018	0.44894
GCA_010724335.1-Fun_BLKG01000034.1_i000_003995	55	288	233	1.04018	0.44894
GCA_010724795.1-Fun_BLKK01000057.1_i000_003432	55	288	233	1.04018	0.44894
GCA_013368755.1-Fun_CP055899.1_i000_003123	64	297	233	1.04018	0.458661
GCA_003369625.1-Fun_PVWQ01000007.1_i000_009528	59	292	233	1.04018	0.447217
GCA_018340605.1-Fun_BHVY01000002.1_i000_002504	55	288	233	1.04018	0.452427
GCA_000497085.1-Fun_BAUL01000170.1_i000_003710	56	289	233	1.04018	0.449807
GCA_905216605.1-Pla_LR999453.1_i000_008368	86	280	194	0.866071	0.455399
GCA_012656225.1-Fun_JAAAPY010000068.1_i000_008867	55	288	233	1.04018	0.44894
GCA_012656285.1-Fun_JAAAPX010000059.1_i000_007947	55	288	233	1.04018	0.44894
GCA_012656295.1-Fun_JAAAPW010000067.1_i000_008399	55	288	233	1.04018	0.44894
GCA_012656325.1-Fun_JAAAPV010000066.1_i000_008550	55	288	233	1.04018	0.44894
GCA_000143415.2-Pla_GL377576.1_i000_008798	20	245	225	1.00446	0.747508
GCA_010015605.1-Fun_ML975291.1_i000_004637	117	345	228	1.01786	0.418349
GCA_020536175.1-Fun_JAEUBF010000782.1_i000_004997	119	340	221	0.986607	0.483589
GCA_000149645.3-Fun_DS027688.1_i000_007476	55	288	233	1.04018	0.44894
GCA_016748045.1-Fun_WHVT01000013.1_i000_001074	55	288	233	1.04018	0.44894
GCA_000149615.1-Fun_CH476594.1_i000_009630	60	293	233	1.04018	0.447217
GCA_009014675.2-Fun_BKZM02000003.1_i000_002132	60	293	233	1.04018	0.447217
GCA_009932835.1-Fun_BLJY01000003.1_i000_002377	60	293	233	1.04018	0.447217
GCA_900231445.1-Pla_LT934114.1_i000_015513	91	250	159	0.709821	0.625984
GCA_905330535.1-Ani_CAJNVN010000035.1_i000_011823	30	145	115	0.513393	0.527523
GCA_905330535.1-Ani_CAJNVN010000035.1_i000_011823	144	191	47	0.209821	0.215596
GCA_905332185.1-Ani_CAJOBM010000840.1_i000_006478	30	145	115	0.513393	0.527523
GCA_905332185.1-Ani_CAJOBM010000840.1_i000_006478	144	191	47	0.209821	0.215596
GCA_016808415.1-Fun_JAAWWR010000007.1_i000_006469	60	293	233	1.04018	0.447217
GCA_000151665.1-Pro_FN668646.1_i000_002462	63	282	219	0.977679	0.483444
GCA_002234965.2-Fun_NKHV02000092.1_i000_008939	55	288	233	1.04018	0.450677
GCA_002234975.2-Fun_NIDN02000192.1_i000_003084	55	288	233	1.04018	0.450677
GCA_900100905.1-Fun_FMWP01000012.1_i000_007944	171	404	233	1.04018	0.410935
GCA_900102585.1-Fun_FMWQ01000021.1_i000_005506	171	404	233	1.04018	0.410935
GCA_004022145.1-Fun_RCNU01000009.1_i000_009142	56	289	233	1.04018	0.448077
GCA_000220395.1-Pro_GL983931.1_i000_004008	148	369	221	0.986607	0.453799
GCA_018404265.1-Fun_BOPL01000004.1_i000_004894	55	288	233	1.04018	0.44894
GCA_907166805.1-Fun_CAJRGZ010000009.1_i000_000106	127	345	218	0.973214	0.4
GCA_008330625.1-Pro_VLTM01000090.1_i000_006137	158	384	226	1.00893	0.417745
GCA_008330635.1-Pro_VLTL01000093.1_i000_004977	158	384	226	1.00893	0.417745
GCA_008330645.1-Pro_VLTN01000053.1_i000_006642	158	384	226	1.00893	0.417745
GCA_008330665.1-Pro_VLTO01000011.1_i000_002578	158	384	226	1.00893	0.417745
GCA_014058105.1-Pla_JACGCM010002660.1_i000_006086	86	307	221	0.986607	0.633238
GCA_001696595.2-Fun_MBFL02000478.1_i000_009052	89	322	233	1.04018	0.422101
GCA_001896365.1-Fun_MIKG01000002.1_i000_004592	64	297	233	1.04018	0.455078
GCA_000985935.1-Fun_CVMT01000002.1_i000_002230	64	297	233	1.04018	0.455969
GCA_002847465.1-Fun_MSZS01000004.1_i000_006992	55	288	233	1.04018	0.44894
GCA_019968955.1-Pro_JAHYSE010000215.1_i000_001205	107	328	221	0.986607	0.563776
GCA_001889945.1-Fun_KV878682.1_i000_005171	56	289	233	1.04018	0.449807
GCA_002157105.1-Fun_KZ151150.1_i000_011790	1	121	120	0.535714	0.454545
GCA_900660405.1-Pro_CAACVS010000001.1_i000_000146	144	374	230	1.02679	0.433145
GCA_001908125.1-Fun_MNBE01000099.1_i000_014176	58	291	233	1.04018	0.449807
GCA_014281875.1-Ani_CM024804.1_i000_010608	122	213	91	0.40625	0.42723
GCA_001890105.1-Fun_KV878337.1_i000_001565	65	298	233	1.04018	0.441288
GCA_003589665.1-Fun_MVGC01000151.1_i000_004886	53	286	233	1.04018	0.455078
GCA_902860255.1-Pla_LR794324.1_i000_007231	115	253	138	0.616071	0.545455
GCA_020499035.1-Fun_JAIBQD010000314.1_i000_004755	56	289	233	1.04018	0.44894
GCA_000002655.1-Fun_CM000169.1_i000_000859	56	289	233	1.04018	0.44894
GCA_001029325.1-Fun_KQ087361.1_i000_002753	56	289	233	1.04018	0.44894
GCA_002234955.1-Fun_NKHT01000103.1_i000_000292	56	289	233	1.04018	0.44894
GCA_012656165.1-Fun_JAAAQB010000068.1_i000_007635	56	289	233	1.04018	0.44894
GCA_012656185.1-Fun_JAAAQA010000212.1_i000_002514	56	289	233	1.04018	0.44894
GCA_020498755.1-Fun_JAIBPP010000125.1_i000_001104	56	289	233	1.04018	0.44894
GCA_020498765.1-Fun_JAIBPQ010000070.1_i000_008409	56	289	233	1.04018	0.44894
GCA_020498815.1-Fun_JAIBPS010000101.1_i000_000434	56	289	233	1.04018	0.44894
GCA_020498885.1-Fun_JAIBPT010000009.1_i000_008955	56	289	233	1.04018	0.44894
GCA_020498895.1-Fun_JAIBPU010000008.1_i000_008744	56	289	233	1.04018	0.44894
GCA_020499005.1-Fun_JAIBQC010000006.1_i000_007637	56	289	233	1.04018	0.44894
GCA_020499015.1-Fun_JAIBQB010000024.1_i000_004311	56	289	233	1.04018	0.44894
GCA_020499045.1-Fun_JAIBQE010000070.1_i000_008191	56	289	233	1.04018	0.44894
GCA_020499195.1-Fun_JAIBQM010000056.1_i000_007596	56	289	233	1.04018	0.44894
GCA_020499225.1-Fun_JAIBQN010000099.1_i000_009359	56	289	233	1.04018	0.44894
GCA_020499245.1-Fun_JAIBQI010000083.1_i000_009346	56	289	233	1.04018	0.44894
GCA_020499325.1-Fun_JAIBQS010000085.1_i000_008733	56	289	233	1.04018	0.44894
GCA_020499335.1-Fun_JAIBQT010000089.1_i000_009002	56	289	233	1.04018	0.44894
GCA_020499355.1-Fun_JAIBQU010000169.1_i000_001856	56	289	233	1.04018	0.44894
GCA_020499395.1-Fun_JAIBQV010000012.1_i000_000889	56	289	233	1.04018	0.44894
GCA_020499405.1-Fun_JAIBQW010000086.1_i000_008848	56	289	233	1.04018	0.44894
GCA_020499415.1-Fun_JAIBQX010000108.1_i000_000580	56	289	233	1.04018	0.44894
GCA_020499455.1-Fun_JAIBQY010000077.1_i000_008319	56	289	233	1.04018	0.44894
GCA_020499475.1-Fun_JAIBQZ010000005.1_i000_007151	56	289	233	1.04018	0.44894
GCA_020499495.1-Fun_JAIBRB010000091.1_i000_008983	56	289	233	1.04018	0.44894
GCA_020499505.1-Fun_JAIBRC010000006.1_i000_007655	56	289	233	1.04018	0.44894
GCA_020499585.1-Fun_JAIBRG010000001.1_i000_000053	56	289	233	1.04018	0.44894
GCA_020499595.1-Fun_JAIBRF010000009.1_i000_008914	56	289	233	1.04018	0.44894
GCA_020499645.1-Fun_JAIBRJ010000022.1_i000_003764	56	289	233	1.04018	0.44894
GCA_020499675.1-Fun_JAIBRZ010000016.1_i000_002528	56	289	233	1.04018	0.44894
GCA_020499685.1-Fun_JAIBSA010000010.1_i000_000304	56	289	233	1.04018	0.44894
GCA_020499695.1-Fun_JAIBRY010000002.1_i000_003214	56	289	233	1.04018	0.44894
GCA_020499755.1-Fun_JAIBSC010000008.1_i000_008566	56	289	233	1.04018	0.44894
GCA_020499775.1-Fun_JAIBSD010000005.1_i000_006882	56	289	233	1.04018	0.44894
GCA_020499785.1-Fun_JAIBSE010000099.1_i000_009540	56	289	233	1.04018	0.44894
GCA_020499885.1-Fun_JAIBRH010000021.1_i000_003615	56	289	233	1.04018	0.44894
GCA_020499905.1-Fun_JAIBRK010000119.1_i000_001115	56	289	233	1.04018	0.44894
GCA_020499935.1-Fun_JAIBRM010000045.1_i000_006423	56	289	233	1.04018	0.44894
GCA_020500085.1-Fun_JAIBRS010000001.1_i000_000135	56	289	233	1.04018	0.44894
GCA_020500115.1-Fun_JAIBRV010000121.1_i000_001274	56	289	233	1.04018	0.44894
GCA_020500235.1-Fun_JAIBSM010000004.1_i000_006397	56	289	233	1.04018	0.44894
GCA_020500295.1-Fun_JAIBSN010000003.1_i000_004411	56	289	233	1.04018	0.44894
GCA_020500355.1-Fun_JAIBSS010000011.1_i000_000762	56	289	233	1.04018	0.44894
GCA_020500365.1-Fun_JAIBSR010000002.1_i000_003217	56	289	233	1.04018	0.44894
GCA_020500395.1-Fun_JAIBSU010000083.1_i000_008532	56	289	233	1.04018	0.44894
GCA_020500445.1-Fun_JAIBSV010000003.1_i000_004434	56	289	233	1.04018	0.44894
GCA_020500455.1-Fun_JAIBSW010000052.1_i000_006840	56	289	233	1.04018	0.44894
GCA_020500465.1-Fun_JAIBSY010000019.1_i000_002944	56	289	233	1.04018	0.44894
GCA_020500475.1-Fun_JAIBSX010000009.1_i000_008907	56	289	233	1.04018	0.44894
GCA_020500535.1-Fun_JAIBTB010000004.1_i000_006437	56	289	233	1.04018	0.44894
GCA_020500555.1-Fun_JAIBTD010000022.1_i000_004001	56	289	233	1.04018	0.44894
GCA_020500565.1-Fun_JAIBTE010000185.1_i000_003072	56	289	233	1.04018	0.44894
GCA_020500595.1-Fun_JAIBTF010000001.1_i000_000074	56	289	233	1.04018	0.44894
GCA_020500645.1-Fun_JAIBTH010000008.1_i000_008472	56	289	233	1.04018	0.44894
GCA_020500655.1-Fun_JAIBTI010000024.1_i000_003703	56	289	233	1.04018	0.44894
GCA_020500695.1-Fun_JAIBTK010000042.1_i000_005715	56	289	233	1.04018	0.44894
GCA_020500705.1-Fun_JAIBTL010000016.1_i000_002318	56	289	233	1.04018	0.44894
GCA_020500765.1-Fun_JAIBTA010000051.1_i000_006530	56	289	233	1.04018	0.44894
GCA_020500805.1-Fun_JAIBTO010000059.1_i000_006980	56	289	233	1.04018	0.44894
GCA_020500815.1-Fun_JAIBTP010000004.1_i000_005472	56	289	233	1.04018	0.44894
GCA_020500845.1-Fun_JAIBTQ010000003.1_i000_004321	56	289	233	1.04018	0.44894
GCA_020500865.1-Fun_JAIBTS010000050.1_i000_006346	56	289	233	1.04018	0.44894
GCA_020500945.1-Fun_JAIBTV010000001.1_i000_000095	56	289	233	1.04018	0.44894
GCA_020500975.1-Fun_JAIBTX010000083.1_i000_008659	56	289	233	1.04018	0.44894
GCA_020501005.1-Fun_JAIBTZ010000009.1_i000_009287	56	289	233	1.04018	0.44894
GCA_020501045.1-Fun_JAIBUA010000004.1_i000_006332	56	289	233	1.04018	0.44894
GCA_020501115.1-Fun_JAIBUD010000292.1_i000_004827	56	289	233	1.04018	0.44894
GCA_020501175.1-Fun_JAIBUH010000075.1_i000_008608	56	289	233	1.04018	0.44894
GCA_020501185.1-Fun_JAIBUI010000008.1_i000_008382	56	289	233	1.04018	0.44894
GCA_020501235.1-Fun_JAIBUJ010000002.1_i000_002956	56	289	233	1.04018	0.44894
GCA_020501245.1-Fun_JAIBUK010000020.1_i000_003465	56	289	233	1.04018	0.44894
GCA_020501335.1-Fun_JAIBUN010000001.1_i000_000038	56	289	233	1.04018	0.44894
GCA_020501375.1-Fun_JAIBUR010000004.1_i000_006144	56	289	233	1.04018	0.44894
GCA_020501425.1-Fun_JAIBUT010000002.1_i000_003199	56	289	233	1.04018	0.44894
GCA_020501465.1-Fun_JAIBUV010000111.1_i000_000584	56	289	233	1.04018	0.44894
GCA_020501475.1-Fun_JAIBUX010000001.1_i000_000059	56	289	233	1.04018	0.44894
GCA_020501495.1-Fun_JAIBUW010000113.1_i000_000960	56	289	233	1.04018	0.44894
GCA_020501615.1-Fun_JAIBVD010000002.1_i000_003406	56	289	233	1.04018	0.44894
GCA_020501695.1-Fun_JAIBVG010000023.1_i000_004030	56	289	233	1.04018	0.44894
GCA_020501705.1-Fun_JAIBVI010000018.1_i000_002674	56	289	233	1.04018	0.44894
GCA_020501765.1-Fun_JAIBVK010000039.1_i000_006196	56	289	233	1.04018	0.44894
GCA_020501785.1-Fun_JAIBVL010000012.1_i000_000965	56	289	233	1.04018	0.44894
GCA_020501835.1-Fun_JAIBVN010000001.1_i000_000004	56	289	233	1.04018	0.44894
GCA_020501935.1-Fun_JAIBVT010000001.1_i000_000033	56	289	233	1.04018	0.44894
GCA_020501995.1-Fun_JAIBVV010000030.1_i000_006499	56	289	233	1.04018	0.44894
GCA_020502005.1-Fun_JAIBVW010000004.1_i000_005887	56	289	233	1.04018	0.44894
GCA_020502045.1-Fun_JAIBVZ010000050.1_i000_006589	56	289	233	1.04018	0.44894
GCA_020502095.1-Fun_JAIBWA010000005.1_i000_006641	56	289	233	1.04018	0.44894
GCA_020502115.1-Fun_JAIBWC010000056.1_i000_007642	56	289	233	1.04018	0.44894
GCA_020502215.1-Fun_JAIBWG010000086.1_i000_008839	56	289	233	1.04018	0.44894
GCA_020502225.1-Fun_JAIBWH010000010.1_i000_000194	56	289	233	1.04018	0.44894
GCA_020502235.1-Fun_JAIBWJ010000001.1_i000_000081	56	289	233	1.04018	0.44894
GCA_020502245.1-Fun_JAIBWI010000001.1_i000_000004	56	289	233	1.04018	0.44894
GCA_020502335.1-Fun_JAIBWL010000102.1_i000_000337	56	289	233	1.04018	0.44894
GCA_020502365.1-Fun_JAIBWM010000002.1_i000_003136	56	289	233	1.04018	0.44894
GCA_020502435.1-Fun_JAIBWQ010000085.1_i000_008813	56	289	233	1.04018	0.44894
GCA_020502485.1-Fun_JAIBWS010000097.1_i000_009287	56	289	233	1.04018	0.44894
GCA_020502615.1-Fun_JAIBWZ010000104.1_i000_000435	56	289	233	1.04018	0.44894
GCA_020502675.1-Fun_JAIBXB010000007.1_i000_008066	56	289	233	1.04018	0.44894
GCA_020502725.1-Fun_JAIBXF010000049.1_i000_007080	56	289	233	1.04018	0.44894
GCA_020502985.1-Fun_JAIBXH010000001.1_i000_000003	56	289	233	1.04018	0.44894
GCA_020503055.1-Fun_JAIBXK010000002.1_i000_003038	56	289	233	1.04018	0.44894
GCA_020503085.1-Fun_JAIBXM010000092.1_i000_009065	56	289	233	1.04018	0.44894
GCA_020503105.1-Fun_JAIBXO010000113.1_i000_000710	56	289	233	1.04018	0.44894
GCA_020503175.1-Fun_JAIBXP010000003.1_i000_005126	56	289	233	1.04018	0.44894
GCA_020503185.1-Fun_JAIBXR010000101.1_i000_000272	56	289	233	1.04018	0.44894
GCA_020503195.1-Fun_JAIBXT010000028.1_i000_004855	56	289	233	1.04018	0.44894
GCA_020503245.1-Fun_JAIBXU010000056.1_i000_007639	56	289	233	1.04018	0.44894
GCA_020503275.1-Fun_JAIBXW010000056.1_i000_007438	56	289	233	1.04018	0.44894
GCA_020503305.1-Fun_JAIBXY010000103.1_i000_000359	56	289	233	1.04018	0.44894
GCA_020503345.1-Fun_JAIBXZ010000098.1_i000_009495	56	289	233	1.04018	0.44894
GCA_020503375.1-Fun_JAIBYB010000038.1_i000_006054	56	289	233	1.04018	0.44894
GCA_020503435.1-Fun_JAIBYE010000001.1_i000_000168	56	289	233	1.04018	0.44894
GCA_020503465.1-Fun_JAIBYG010000002.1_i000_003139	56	289	233	1.04018	0.44894
GCA_020503535.1-Fun_JAIBYI010000089.1_i000_009127	56	289	233	1.04018	0.44894
GCA_020503545.1-Fun_JAIBYK010000002.1_i000_003150	56	289	233	1.04018	0.44894
GCA_020503555.1-Fun_JAIBYJ010000006.1_i000_007717	56	289	233	1.04018	0.44894
GCA_020503565.1-Fun_JAIBYL010000080.1_i000_008815	56	289	233	1.04018	0.44894
GCA_020503595.1-Fun_JAIBYM010000016.1_i000_002199	56	289	233	1.04018	0.44894
GCA_020503645.1-Fun_JAIBYO010000106.1_i000_000423	56	289	233	1.04018	0.44894
GCA_020503665.1-Fun_JAIBYP010000012.1_i000_000892	56	289	233	1.04018	0.44894
GCA_020503705.1-Fun_JAIBYQ010000114.1_i000_000759	56	289	233	1.04018	0.44894
GCA_020503745.1-Fun_JAIBYU010000015.1_i000_001980	56	289	233	1.04018	0.44894
GCA_020503795.1-Fun_JAIBYX010000102.1_i000_000465	56	289	233	1.04018	0.44894
GCA_020503805.1-Fun_JAIBYW010000090.1_i000_009058	56	289	233	1.04018	0.44894
GCA_020503815.1-Fun_JAIBYV010000011.1_i000_000556	56	289	233	1.04018	0.44894
GCA_020503895.1-Fun_JAIBZA010000046.1_i000_006385	56	289	233	1.04018	0.44894
GCA_020503905.1-Fun_JAIBZB010000049.1_i000_006598	56	289	233	1.04018	0.44894
GCA_020503915.1-Fun_JAIBZC010000034.1_i000_005645	56	289	233	1.04018	0.44894
GCA_020503935.1-Fun_JAIBZD010000008.1_i000_008509	56	289	233	1.04018	0.44894
GCA_020510485.1-Fun_JAIBQR010000110.1_i000_000694	56	289	233	1.04018	0.44894
GCA_000731615.1-Fun_JHOI01000627.1_i000_007951	56	289	233	1.04018	0.44894
GCA_020499155.1-Fun_JAIBQK010000005.1_i000_006862	56	289	233	1.04018	0.44894
GCA_020499315.1-Fun_JAIBQQ010000009.1_i000_009059	56	289	233	1.04018	0.44894
GCA_020500215.1-Fun_JAIBSK010000011.1_i000_000840	56	289	233	1.04018	0.44894
GCA_020500905.1-Fun_JAIBTT010000006.1_i000_006984	56	289	233	1.04018	0.44894
GCA_020501635.1-Fun_JAIBVE010000001.1_i000_000038	56	289	233	1.04018	0.44894
GCA_020501815.1-Fun_JAIBVO010000013.1_i000_001407	56	289	233	1.04018	0.44894
GCA_020502165.1-Fun_JAIBWE010000011.1_i000_000598	56	289	233	1.04018	0.44894
GCA_020502425.1-Fun_JAIBWP010000019.1_i000_003042	56	289	233	1.04018	0.44894
GCA_020502705.1-Fun_JAIBXD010000026.1_i000_004499	56	289	233	1.04018	0.44894
GCA_020502995.1-Fun_JAIBXI010000001.1_i000_000078	56	289	233	1.04018	0.44894
GCA_020503015.1-Fun_JAIBXJ010000006.1_i000_007622	56	289	233	1.04018	0.44894
GCA_020503165.1-Fun_JAIBXQ010000018.1_i000_002780	56	289	233	1.04018	0.44894
GCA_020503715.1-Fun_JAIBYR010000003.1_i000_005182	56	289	233	1.04018	0.44894
GCA_000230395.2-Fun_ACJE01000021.1_i000_000184	56	289	233	1.04018	0.449807
GCA_002211485.2-Fun_NKJJ02000001.1_i000_000685	56	289	233	1.04018	0.449807
GCA_003184595.1-Fun_KZ821350.1_i000_006666	56	289	233	1.04018	0.449807
GCA_003344505.1-Fun_KZ851844.1_i000_000789	56	289	233	1.04018	0.449807
GCA_003344705.1-Fun_KZ851904.1_i000_002596	56	289	233	1.04018	0.449807
GCA_003344945.1-Fun_KZ852098.1_i000_012613	56	289	233	1.04018	0.449807
GCA_003850985.1-Fun_BDHI01000014.1_i000_005348	56	289	233	1.04018	0.449807
GCA_900248155.1-Fun_OGUI01000017.1_i000_001838	56	289	233	1.04018	0.449807
GCA_003184835.1-Fun_KZ824536.1_i000_000901	56	289	233	1.04018	0.449807
GCA_000239835.2-Fun_DF126468.1_i000_007664	56	289	233	1.04018	0.449807
GCA_001515345.1-Fun_BCMY01000006.1_i000_004204	56	289	233	1.04018	0.449807
GCA_001602395.1-Fun_BCWF01000028.1_i000_005569	56	289	233	1.04018	0.449807
GCA_001890685.1-Fun_KV878239.1_i000_004306	56	289	233	1.04018	0.449807
GCA_001890745.1-Fun_KV878176.1_i000_000777	56	289	233	1.04018	0.449807
GCA_013340325.1-Fun_BLWE01000009.1_i000_008931	56	289	233	1.04018	0.449807
GCA_016861625.1-Fun_AP024427.1_i000_004515	56	289	233	1.04018	0.449807
GCA_016865315.1-Fun_AP024436.1_i000_004314	56	289	233	1.04018	0.449807
GCA_003184755.1-Fun_KZ825056.1_i000_002389	56	289	233	1.04018	0.449807
GCA_003184925.1-Fun_KZ821641.1_i000_010403	56	289	233	1.04018	0.449807
GCA_003184535.1-Fun_MSFU01000022.1_i000_004688	56	289	233	1.04018	0.449807
GCA_020499135.1-Fun_JAIBQJ010000001.1_i000_000038	56	289	233	1.04018	0.44894
GCA_021365285.1-Fun_JAJTJA010000010.1_i000_002007	63	296	233	1.04018	0.453307
GCA_000011425.1-Fun_BN001308.1_i000_009141	59	292	233	1.04018	0.447217
GCA_000149205.2-Fun_CH236920.1_i000_008991	59	292	233	1.04018	0.447217
GCA_905221625.1-Pro_CAJNDU010009187.1_i000_010939	190	416	226	1.00893	0.241195
GCA_003184865.1-Fun_KZ824288.1_i000_006334	66	299	233	1.04018	0.439623
GCA_002104985.1-Fun_MCGO01000002.1_i000_004510	74	114	40	0.178571	0.101266
GCA_002104985.1-Fun_MCGO01000002.1_i000_004510	107	181	74	0.330357	0.187342
GCA_002104985.1-Fun_MCGO01000002.1_i000_004510	175	245	70	0.3125	0.177215
GCA_000986645.1-Fun_JZBS01003505.1_i000_005049	62	295	233	1.04018	0.44636
GCA_000986665.1-Fun_JYKN01000301.1_i000_006799	62	295	233	1.04018	0.44636
GCA_002846915.2-Fun_MSFN02000002.1_i000_003114	62	295	233	1.04018	0.44636
GCA_000002715.1-Fun_DS027059.1_i000_001565	56	289	233	1.04018	0.449807
GCA_003184635.1-Fun_KZ826382.1_i000_009431	57	290	233	1.04018	0.44894
GCA_003184845.1-Fun_KZ824485.1_i000_010655	56	289	233	1.04018	0.450677
GCA_001048715.1-Fun_CDHK01000006.1_i000_007622	56	289	233	1.04018	0.45155
GCA_002016555.1-Fun_LJBN01000068.1_i000_001405	56	289	233	1.04018	0.45155
GCA_008009225.1-Pla_CM017761.1_i000_000781	92	295	203	0.90625	0.519182
GCA_000981445.1-Pro_LK391707.1_i000_000400	123	337	214	0.955357	0.431452
GCA_010094095.1-Fun_ML979136.1_i000_006421	123	330	207	0.924107	0.386916
GCA_003184585.1-Fun_KZ821228.1_i000_003847	65	298	233	1.04018	0.43797
GCA_001990825.1-Fun_KV907493.1_i000_000838	56	289	233	1.04018	0.449807
GCA_011392555.1-Fun_QMFL01000027.1_i000_002167	58	291	233	1.04018	0.449807
GCA_002237265.2-Fun_NKHU02000054.1_i000_007563	55	288	233	1.04018	0.448077
GCA_003184545.1-Fun_MSFL01000013.1_i000_002137	60	293	233	1.04018	0.445507
GCA_015476325.1-Pro_JADAQX010000480.1_i000_003793	98	302	204	0.910714	0.451327
GCA_001890725.1-Fun_KV878210.1_i000_002835	56	289	233	1.04018	0.450677
GCA_003184625.1-Fun_KZ821445.1_i000_000522	56	289	233	1.04018	0.449807
GCA_020502025.1-Fun_JAIBVX010000002.1_i000_003407	56	289	233	1.04018	0.44894
GCA_020501905.1-Fun_JAIBVS010000102.1_i000_000370	56	289	233	1.04018	0.44894
GCA_000150145.1-Fun_DS499594.1_i000_009196	56	289	233	1.04018	0.44894
GCA_002234985.1-Fun_NKHS01000083.1_i000_008692	56	289	233	1.04018	0.44894
GCA_012656115.1-Fun_JAAAQC010000280.1_i000_004334	56	289	233	1.04018	0.44894
GCA_012656125.1-Fun_JAAAQD010000251.1_i000_003894	56	289	233	1.04018	0.44894
GCA_012656215.1-Fun_JAAAPZ010000211.1_i000_002812	56	289	233	1.04018	0.44894
GCA_020498725.1-Fun_JAIBPO010000002.1_i000_003298	56	289	233	1.04018	0.44894
GCA_020498735.1-Fun_JAIBPN010000001.1_i000_000025	56	289	233	1.04018	0.44894
GCA_020498745.1-Fun_JAIBPM010000069.1_i000_008011	56	289	233	1.04018	0.44894
GCA_020498805.1-Fun_JAIBPR010000001.1_i000_000166	56	289	233	1.04018	0.44894
GCA_020498865.1-Fun_JAIBPV010000002.1_i000_003380	56	289	233	1.04018	0.44894
GCA_020498875.1-Fun_JAIBPW010000032.1_i000_005297	56	289	233	1.04018	0.44894
GCA_020498905.1-Fun_JAIBPX010000003.1_i000_005073	56	289	233	1.04018	0.44894
GCA_020498945.1-Fun_JAIBPY010000002.1_i000_003349	56	289	233	1.04018	0.44894
GCA_020498965.1-Fun_JAIBPZ010000001.1_i000_000082	56	289	233	1.04018	0.44894
GCA_020498985.1-Fun_JAIBQA010000085.1_i000_008829	56	289	233	1.04018	0.44894
GCA_020499075.1-Fun_JAIBQF010000001.1_i000_000039	56	289	233	1.04018	0.44894
GCA_020499115.1-Fun_JAIBQG010000120.1_i000_001072	56	289	233	1.04018	0.44894
GCA_020499125.1-Fun_JAIBQH010000083.1_i000_008727	56	289	233	1.04018	0.44894
GCA_020499185.1-Fun_JAIBQL010000035.1_i000_005851	56	289	233	1.04018	0.44894
GCA_020499255.1-Fun_JAIBQP010000092.1_i000_009089	56	289	233	1.04018	0.44894
GCA_020499265.1-Fun_JAIBQO010000003.1_i000_005232	56	289	233	1.04018	0.44894
GCA_020499485.1-Fun_JAIBRA010000058.1_i000_007452	56	289	233	1.04018	0.44894
GCA_020499565.1-Fun_JAIBRD010000021.1_i000_003492	56	289	233	1.04018	0.44894
GCA_020499575.1-Fun_JAIBRE010000001.1_i000_000034	56	289	233	1.04018	0.44894
GCA_020499605.1-Fun_JAIBRI010000019.1_i000_003010	56	289	233	1.04018	0.44894
GCA_020499715.1-Fun_JAIBSB010000003.1_i000_004772	56	289	233	1.04018	0.44894
GCA_020499805.1-Fun_JAIBSF010000090.1_i000_009011	56	289	233	1.04018	0.44894
GCA_020499815.1-Fun_JAIBSG010000003.1_i000_004548	56	289	233	1.04018	0.44894
GCA_020499825.1-Fun_JAIBSH010000086.1_i000_008677	56	289	233	1.04018	0.44894
GCA_020499865.1-Fun_JAIBSI010000002.1_i000_003220	56	289	233	1.04018	0.44894
GCA_020499915.1-Fun_JAIBRL010000027.1_i000_004390	56	289	233	1.04018	0.44894
GCA_020499975.1-Fun_JAIBRN010000001.1_i000_000180	56	289	233	1.04018	0.44894
GCA_020499985.1-Fun_JAIBRO010000099.1_i000_009251	56	289	233	1.04018	0.44894
GCA_020499995.1-Fun_JAIBRP010000001.1_i000_000053	56	289	233	1.04018	0.44894
GCA_020500025.1-Fun_JAIBRQ010000001.1_i000_000167	56	289	233	1.04018	0.44894
GCA_020500065.1-Fun_JAIBRT010000069.1_i000_008227	56	289	233	1.04018	0.44894
GCA_020500075.1-Fun_JAIBRR010000013.1_i000_001455	56	289	233	1.04018	0.44894
GCA_020500105.1-Fun_JAIBRU010000094.1_i000_009195	56	289	233	1.04018	0.44894
GCA_020500165.1-Fun_JAIBRW010000113.1_i000_000759	56	289	233	1.04018	0.44894
GCA_020500185.1-Fun_JAIBSL010000009.1_i000_008918	56	289	233	1.04018	0.44894
GCA_020500195.1-Fun_JAIBRX010000005.1_i000_006958	56	289	233	1.04018	0.44894
GCA_020500205.1-Fun_JAIBSJ010000093.1_i000_009255	56	289	233	1.04018	0.44894
GCA_020500275.1-Fun_JAIBSO010000001.1_i000_000126	56	289	233	1.04018	0.44894
GCA_020500285.1-Fun_JAIBSP010000062.1_i000_007401	56	289	233	1.04018	0.44894
GCA_020500305.1-Fun_JAIBSQ010000002.1_i000_003289	56	289	233	1.04018	0.44894
GCA_020500385.1-Fun_JAIBST010000002.1_i000_003059	56	289	233	1.04018	0.44894
GCA_020500485.1-Fun_JAIBSZ010000008.1_i000_008447	56	289	233	1.04018	0.44894
GCA_020500545.1-Fun_JAIBTC010000054.1_i000_007535	56	289	233	1.04018	0.44894
GCA_020500605.1-Fun_JAIBTG010000038.1_i000_005495	56	289	233	1.04018	0.44894
GCA_020500685.1-Fun_JAIBTJ010000004.1_i000_005657	56	289	233	1.04018	0.44894
GCA_020500775.1-Fun_JAIBTM010000014.1_i000_001821	56	289	233	1.04018	0.44894
GCA_020500785.1-Fun_JAIBTN010000005.1_i000_006428	56	289	233	1.04018	0.44894
GCA_020500875.1-Fun_JAIBTR010000009.1_i000_009170	56	289	233	1.04018	0.44894
GCA_020500935.1-Fun_JAIBTU010000047.1_i000_006123	56	289	233	1.04018	0.44894
GCA_020500965.1-Fun_JAIBTW010000037.1_i000_005852	56	289	233	1.04018	0.44894
GCA_020500995.1-Fun_JAIBTY010000002.1_i000_003229	56	289	233	1.04018	0.44894
GCA_020501075.1-Fun_JAIBUB010000003.1_i000_005006	56	289	233	1.04018	0.44894
GCA_020501095.1-Fun_JAIBUC010000002.1_i000_003412	56	289	233	1.04018	0.44894
GCA_020501105.1-Fun_JAIBUE010000101.1_i000_000400	56	289	233	1.04018	0.44894
GCA_020501135.1-Fun_JAIBUF010000001.1_i000_000108	56	289	233	1.04018	0.44894
GCA_020501145.1-Fun_JAIBUG010000085.1_i000_008737	56	289	233	1.04018	0.44894
GCA_020501255.1-Fun_JAIBUO010000081.1_i000_008615	56	289	233	1.04018	0.44894
GCA_020501265.1-Fun_JAIBUM010000004.1_i000_005918	56	289	233	1.04018	0.44894
GCA_020501325.1-Fun_JAIBUL010000004.1_i000_006225	56	289	233	1.04018	0.44894
GCA_020501345.1-Fun_JAIBUP010000110.1_i000_000606	56	289	233	1.04018	0.44894
GCA_020501355.1-Fun_JAIBUQ010000060.1_i000_007880	56	289	233	1.04018	0.44894
GCA_020501405.1-Fun_JAIBUS010000098.1_i000_009255	56	289	233	1.04018	0.44894
GCA_020501445.1-Fun_JAIBUU010000087.1_i000_008838	56	289	233	1.04018	0.44894
GCA_020501535.1-Fun_JAIBUY010000002.1_i000_003513	56	289	233	1.04018	0.44894
GCA_020501545.1-Fun_JAIBUZ010000001.1_i000_000059	56	289	233	1.04018	0.44894
GCA_020501555.1-Fun_JAIBVA010000085.1_i000_008822	56	289	233	1.04018	0.44894
GCA_020501575.1-Fun_JAIBVB010000042.1_i000_006419	56	289	233	1.04018	0.44894
GCA_020501605.1-Fun_JAIBVC010000093.1_i000_009059	56	289	233	1.04018	0.44894
GCA_020501645.1-Fun_JAIBVF010000003.1_i000_005001	56	289	233	1.04018	0.44894
GCA_020501715.1-Fun_JAIBVH010000001.1_i000_000037	56	289	233	1.04018	0.44894
GCA_020501735.1-Fun_JAIBVJ010000085.1_i000_008719	56	289	233	1.04018	0.44894
GCA_020501805.1-Fun_JAIBVM010000001.1_i000_000038	56	289	233	1.04018	0.44894
GCA_020501875.1-Fun_JAIBVP010000018.1_i000_002843	56	289	233	1.04018	0.44894
GCA_020501885.1-Fun_JAIBVR010000002.1_i000_003389	56	289	233	1.04018	0.44894
GCA_020501895.1-Fun_JAIBVQ010000001.1_i000_000037	56	289	233	1.04018	0.44894
GCA_020501985.1-Fun_JAIBVU010000097.1_i000_009296	56	289	233	1.04018	0.44894
GCA_020502035.1-Fun_JAIBVY010000103.1_i000_000337	56	289	233	1.04018	0.44894
GCA_020502105.1-Fun_JAIBWB010000099.1_i000_009502	56	289	233	1.04018	0.44894
GCA_020502125.1-Fun_JAIBWD010000103.1_i000_000351	56	289	233	1.04018	0.44894
GCA_020502185.1-Fun_JAIBWF010000086.1_i000_008785	56	289	233	1.04018	0.44894
GCA_020502325.1-Fun_JAIBWK010000088.1_i000_008983	56	289	233	1.04018	0.44894
GCA_020502375.1-Fun_JAIBWN010000022.1_i000_003788	56	289	233	1.04018	0.44894
GCA_020502385.1-Fun_JAIBWO010000376.1_i000_005127	56	289	233	1.04018	0.44894
GCA_020502455.1-Fun_JAIBWR010000071.1_i000_008313	56	289	233	1.04018	0.44894
GCA_020502495.1-Fun_JAIBWT010000022.1_i000_003744	56	289	233	1.04018	0.44894
GCA_020502525.1-Fun_JAIBWU010000070.1_i000_008203	56	289	233	1.04018	0.44894
GCA_020502545.1-Fun_JAIBWV010000117.1_i000_000854	56	289	233	1.04018	0.44894
GCA_020502575.1-Fun_JAIBWW010000001.1_i000_000057	56	289	233	1.04018	0.44894
GCA_020502595.1-Fun_JAIBWX010000082.1_i000_008680	56	289	233	1.04018	0.44894
GCA_020502605.1-Fun_JAIBWY010000023.1_i000_003985	56	289	233	1.04018	0.44894
GCA_020502625.1-Fun_JAIBXA010000001.1_i000_000038	56	289	233	1.04018	0.44894
GCA_020502695.1-Fun_JAIBXC010000007.1_i000_008039	56	289	233	1.04018	0.44894
GCA_020502715.1-Fun_JAIBXE010000080.1_i000_008666	56	289	233	1.04018	0.44894
GCA_020502875.1-Fun_JAIBXG010000082.1_i000_008776	56	289	233	1.04018	0.44894
GCA_020503065.1-Fun_JAIBXL010000003.1_i000_005156	56	289	233	1.04018	0.44894
GCA_020503095.1-Fun_JAIBXN010000001.1_i000_000111	56	289	233	1.04018	0.44894
GCA_020503205.1-Fun_JAIBXS010000078.1_i000_008375	56	289	233	1.04018	0.44894
GCA_020503265.1-Fun_JAIBXV010000094.1_i000_009292	56	289	233	1.04018	0.44894
GCA_020503295.1-Fun_JAIBXX010000169.1_i000_001817	56	289	233	1.04018	0.44894
GCA_020503365.1-Fun_JAIBYA010000008.1_i000_008501	56	289	233	1.04018	0.44894
GCA_020503395.1-Fun_JAIBYC010000001.1_i000_000110	56	289	233	1.04018	0.44894
GCA_020503445.1-Fun_JAIBYF010000020.1_i000_003500	56	289	233	1.04018	0.44894
GCA_020503455.1-Fun_JAIBYD010000001.1_i000_000110	56	289	233	1.04018	0.44894
GCA_020503515.1-Fun_JAIBYH010000159.1_i000_002132	56	289	233	1.04018	0.44894
GCA_020503635.1-Fun_JAIBYN010000076.1_i000_008477	56	289	233	1.04018	0.44894
GCA_020503725.1-Fun_JAIBYS010000081.1_i000_008611	56	289	233	1.04018	0.44894
GCA_020503735.1-Fun_JAIBYT010000103.1_i000_000442	56	289	233	1.04018	0.44894
GCA_020503825.1-Fun_JAIBYY010000113.1_i000_000880	56	289	233	1.04018	0.44894
GCA_020503885.1-Fun_JAIBYZ010000096.1_i000_009172	56	289	233	1.04018	0.44894
GCA_001890905.1-Fun_KV878976.1_i000_005163	32	265	233	1.04018	0.466
GCA_003184685.1-Fun_KZ825471.1_i000_001898	66	299	233	1.04018	0.437148
GCA_003184525.1-Fun_MSFK01000019.1_i000_003777	58	291	233	1.04018	0.448077
GCA_003426965.1-Fun_QUQM01000002.1_i000_002951	62	295	233	1.04018	0.441288
GCA_004798825.1-Fun_SOSA01000169.1_i000_002970	62	295	233	1.04018	0.441288
GCA_000346795.1-Fun_KB644414.1_i000_007115	55	288	233	1.04018	0.44894
GCA_001447515.1-Pro_LDAU01000100.1_i000_000022	136	357	221	0.986607	0.422562
GCA_003184825.1-Fun_KZ824622.1_i000_000394	66	299	233	1.04018	0.43633
GCA_003184745.1-Fun_KZ821698.1_i000_005267	66	299	233	1.04018	0.437148
GCA_003184705.1-Fun_KZ825161.1_i000_007830	66	299	233	1.04018	0.437148
GCA_003184785.1-Fun_KZ824795.1_i000_006267	66	299	233	1.04018	0.437148
GCA_003184695.1-Fun_KZ825361.1_i000_008072	66	299	233	1.04018	0.43633
GCA_003184765.1-Fun_KZ824950.1_i000_004497	66	299	233	1.04018	0.43633
GCA_000829775.1-Fun_DF933838.1_i000_002405	64	297	233	1.04018	0.455078
GCA_001305275.1-Fun_LHCL01000003.1_i000_005129	64	297	233	1.04018	0.455078
GCA_001983305.1-Fun_MPUK01000001.1_i000_000518	130	351	221	0.986607	0.461378
GCA_003205855.1-Fun_LK052886.1_i000_005069	130	351	221	0.986607	0.461378
GCA_016508695.1-Fun_VNKQ01000007.1_i000_006593	191	337	146	0.651786	0.231379
GCA_016508695.1-Fun_VNKQ01000007.1_i000_006593	333	407	74	0.330357	0.117274
GCA_009193465.1-Fun_ML742209.1_i000_007964	58	291	233	1.04018	0.447217
GCA_905332045.1-Ani_CAJOBB010024824.1_i000_051167	1	114	113	0.504464	0.941667
GCA_003184645.1-Fun_KZ825975.1_i000_009567	57	290	233	1.04018	0.45155
GCA_002847485.1-Fun_MSFM01000002.1_i000_004955	64	296	232	1.03571	0.444444
GCA_002850765.1-Fun_KZ559536.1_i000_004491	63	295	232	1.03571	0.444444
GCA_002847045.1-Fun_KZ559126.1_i000_002662	64	296	232	1.03571	0.444444
GCA_000151295.1-Fun_GG745329.1_i000_017363	174	433	259	1.15625	0.386567
GCA_001792695.1-Fun_LYCR01000022.1_i000_003849	58	291	233	1.04018	0.467871
GCA_002849105.1-Fun_MSFO01000010.1_i000_002751	63	296	233	1.04018	0.438795
GCA_002382835.1-Fun_NPFJ01000117.1_i000_000742	64	297	233	1.04018	0.455078
GCA_002382855.1-Fun_NPFK01000115.1_i000_000708	64	297	233	1.04018	0.455078
GCA_001204775.2-Fun_JNOM01000495.1_i000_010635	58	291	233	1.04018	0.447217
GCA_009176395.1-Fun_ML734373.1_i000_011636	58	291	233	1.04018	0.447217
GCA_009193645.1-Fun_ML736755.1_i000_003863	58	291	233	1.04018	0.447217
GCA_900624965.1-Ani_UYYB01096125.1_i000_010878	14	154	140	0.625	0.909091
GCA_020536225.1-Fun_JAEUBG010003403.1_i000_006205	123	348	225	1.00446	0.474684
GCA_001049375.1-Pro_CDSF01000002.1_i000_000749	118	342	224	1	0.445328
GCA_002217885.1-Pro_BDSP01000153.1_i000_001056	104	334	230	1.02679	0.547619
GCA_900005855.1-Pro_CVMV01000143.1_i000_004247	137	358	221	0.986607	0.439364
GCA_009193585.1-Fun_ML737651.1_i000_006509	58	291	233	1.04018	0.447217
GCA_009193665.1-Fun_ML735756.1_i000_007873	58	291	233	1.04018	0.447217
GCA_000750115.1-Fun_JPOX01000014.1_i000_004398	64	297	233	1.04018	0.454191
GCA_011392495.1-Fun_QMIJ01000008.1_i000_011291	64	297	233	1.04018	0.455078
GCA_014839625.1-Fun_WIWV01000006.1_i000_006351	56	289	233	1.04018	0.448077
GCA_014839855.1-Fun_WIWU01000030.1_i000_004391	56	289	233	1.04018	0.448077
GCA_001661405.1-Fun_KV453932.1_i000_003441	24	245	221	0.986607	0.624294
GCA_009193485.1-Fun_ML738665.1_i000_008743	58	291	233	1.04018	0.447217
GCA_002563875.1-Pro_CM008354.1_i000_005645	203	436	233	1.04018	0.384488
GCA_009193565.1-Fun_ML739102.1_i000_003771	58	291	233	1.04018	0.449807
GCA_000524495.1-Pro_KI965484.1_i000_004523	209	430	221	0.986607	0.385689
GCA_900618425.1-Ani_UZAN01049057.1_i000_010426	5	109	104	0.464286	0.362369
GCA_001750085.1-Pro_KV784359.1_i000_008220	105	334	229	1.02232	0.475104
GCA_019650175.1-Pla_BNCO01000001.1_i000_000420	6	179	173	0.772321	0.488701
GCA_002007945.1-Fun_MKZY01000005.1_i000_006484	58	291	233	1.04018	0.447217
GCA_002217885.1-Pro_BDSP01000025.1_i000_000026	104	334	230	1.02679	0.469388
GCA_014904985.1-Fun_MU128919.1_i000_002000	156	358	202	0.901786	0.37757
GCA_910592135.1-Fun_CAJVPZ010020541.1_i000_010412	39	177	138	0.616071	0.353846
GCA_910592135.1-Fun_CAJVPZ010020541.1_i000_010412	179	204	25	0.111607	0.0641026
GCA_000001985.1-Fun_DS995904.1_i000_001999	64	297	233	1.04018	0.454191
GCA_009556855.1-Fun_CP045654.1_i000_003126	64	297	233	1.04018	0.454191
GCA_009650675.1-Fun_CM018878.1_i000_008022	64	297	233	1.04018	0.454191
GCA_009193445.1-Fun_ML743593.1_i000_008613	58	291	233	1.04018	0.447217
GCA_900005765.1-Pro_LN835298.1_i000_000410	138	359	221	0.986607	0.437624
GCA_013358455.1-Pla_JABWDY010007207.1_i000_005344	1	170	169	0.754464	0.908602
GCA_009193595.1-Fun_ML736405.1_i000_012245	58	291	233	1.04018	0.447217
GCA_001245095.1-Fun_CDQK01000001.1_i000_000196	88	309	221	0.986607	0.508046
GCA_900090045.1-Pro_LT594624.1_i000_000427	180	401	221	0.986607	0.406998
GCA_900090005.1-Pro_LT594491.1_i000_000340	180	401	221	0.986607	0.406998
GCA_900088575.1-Pro_FLQW01000118.1_i000_000231	194	415	221	0.986607	0.396768
GCA_000002415.2-Pro_CM000444.2_i000_000385	176	397	221	0.986607	0.409259
GCA_000320625.2-Pro_KQ234166.1_i000_000510	176	397	221	0.986607	0.409259
GCA_000320645.2-Pro_KQ234729.1_i000_000512	176	397	221	0.986607	0.409259
GCA_000320665.2-Pro_KQ234986.1_i000_000555	176	397	221	0.986607	0.409259
GCA_000320685.2-Pro_KQ235217.1_i000_000690	176	397	221	0.986607	0.409259
GCA_900093535.1-Pro_LT615258.1_i000_000460	176	397	221	0.986607	0.409259
GCA_900093545.1-Pro_LT615241.1_i000_000419	176	397	221	0.986607	0.409259
GCA_900093555.2-Pro_LT635614.2_i000_000519	176	397	221	0.986607	0.409259
GCA_914969965.1-Pro_CAJZCX010000014.1_i000_005362	176	397	221	0.986607	0.409259
GCA_000321355.1-Pro_DF157095.1_i000_000388	194	415	221	0.986607	0.396057
GCA_000006275.3-Fun_AAIH03000170.1_i000_008760	58	291	233	1.04018	0.447217
GCA_000184455.3-Fun_BA000054.1_i000_009521	58	291	233	1.04018	0.447217
GCA_000952835.1-Fun_JZDT01000862.1_i000_010104	58	291	233	1.04018	0.447217
GCA_002443195.2-Fun_NWUI02000026.1_i000_003155	58	291	233	1.04018	0.447217
GCA_002443215.2-Fun_NWUG02001363.1_i000_008940	58	291	233	1.04018	0.447217
GCA_002456175.2-Fun_NWUH02000093.1_i000_009985	58	291	233	1.04018	0.447217
GCA_009017415.1-Fun_CP044623.1_i000_010496	58	291	233	1.04018	0.447217
GCA_009176455.1-Fun_ML732769.1_i000_001765	58	291	233	1.04018	0.447217
GCA_014117465.1-Fun_CP059871.1_i000_009553	58	291	233	1.04018	0.447217
GCA_014117485.1-Fun_CP059863.1_i000_009597	58	291	233	1.04018	0.447217
GCA_000269785.2-Fun_AKHY01000187.1_i000_008895	58	291	233	1.04018	0.447217
GCA_000691885.1-Fun_AMCJ01000185.1_i000_010786	58	291	233	1.04018	0.447217
GCA_003709025.1-Fun_QQZZ01000052.1_i000_002488	58	291	233	1.04018	0.447217
GCA_009176375.1-Fun_ML734646.1_i000_010195	58	291	233	1.04018	0.447217
GCA_014784225.2-Fun_CP061809.2_i000_010355	58	291	233	1.04018	0.447217
GCA_001890805.1-Fun_KV878899.1_i000_006152	66	299	233	1.04018	0.441288
GCA_000600275.1-Fun_KK088447.1_i000_008747	66	299	233	1.04018	0.441288
GCA_900618425.1-Ani_UZAN01044772.1_i000_007555	89	216	127	0.566964	0.579909
GCA_009176385.1-Fun_ML734942.1_i000_002115	58	291	233	1.04018	0.447217
GCA_009176405.1-Fun_ML733430.1_i000_006538	58	291	233	1.04018	0.447217
GCA_009193505.1-Fun_ML738349.1_i000_009545	58	291	233	1.04018	0.447217
GCA_009193525.1-Fun_ML741811.1_i000_008984	58	291	233	1.04018	0.447217
GCA_019154785.2-Pro_JAGRRH010000006.1_i000_031853	158	387	229	1.02232	0.421731
GCA_000208865.2-Pro_FR823387.1_i000_001905	146	381	235	1.04911	0.131874
GCA_002749805.1-Fun_NEXV01000567.1_i000_000479	58	291	233	1.04018	0.447217
GCA_009193545.1-Fun_ML737115.1_i000_001332	58	291	233	1.04018	0.447217
GCA_013421405.2-Fun_SPNV01000116.1_i000_000975	58	291	233	1.04018	0.447217
GCA_009176365.1-Fun_ML733061.1_i000_000707	58	291	233	1.04018	0.447217
GCA_009193605.1-Fun_ML735224.1_i000_002454	58	291	233	1.04018	0.447217
GCA_001680005.1-Pro_CP016241.1_i000_000546	170	391	221	0.986607	0.413858
GCA_000006355.3-Pro_AM910985.2_i000_000410	174	395	221	0.986607	0.410781
GCA_002140095.1-Pro_NETL01000016.1_i000_002807	174	395	221	0.986607	0.410781
GCA_900004885.2-Pro_CWHQ02000010.1_i000_000448	174	395	221	0.986607	0.410781
GCA_900005025.2-Pro_CWHR02000037.1_i000_000069	174	395	221	0.986607	0.410781
GCA_000151295.1-Fun_GG745333.1_i000_014141	151	410	259	1.15625	0.399691
GCA_900090035.2-Pro_LT594584.1_i000_000360	182	403	221	0.986607	0.405505
GCA_900090025.2-Pro_LT594507.1_i000_000330	182	403	221	0.986607	0.405505
GCA_009176345.1-Fun_ML732169.1_i000_002367	58	291	233	1.04018	0.448077
GCA_000224865.2-Pro_KN046786.1_i000_009649	3	238	235	1.04911	0.571776
GCA_000250965.2-Pro_KQ973619.1_i000_004700	3	238	235	1.04911	0.571776
GCA_007844105.2-Pla_CM017578.2_i000_004274	1	62	61	0.272321	0.0748466
GCA_007844105.2-Pla_CM017578.2_i000_004274	45	185	140	0.625	0.171779
GCA_007844105.2-Pla_CM017578.2_i000_004274	435	644	209	0.933036	0.256442
GCA_900088485.1-Pro_FLRD01000011.1_i000_000547	239	460	221	0.986607	0.36711
GCA_900088545.1-Pro_FLRE01000024.1_i000_000558	239	460	221	0.986607	0.36711
GCA_003112345.1-Pla_PKPP01003791.1_i000_029958	189	407	218	0.973214	0.2725
GCA_003112345.1-Pla_PKPP01003791.1_i000_029958	476	650	174	0.776786	0.2175
GCA_900088565.1-Pro_FLQU01000054.1_i000_000383	323	544	221	0.986607	0.322157
GCA_000149405.2-Pro_CM000643.1_i000_005177	119	349	230	1.02679	0.458167
GCA_019154785.2-Pro_JAGRRH010000020.1_i000_017204	146	375	229	1.02232	0.432075
GCA_000006565.2-Pro_CM002040.1_i000_002240	145	380	235	1.04911	0.424955
GCA_013099955.1-Pro_CM023087.1_i000_001964	145	380	235	1.04911	0.424955
GCA_000150015.2-Pro_KI544502.1_i000_004855	145	380	235	1.04911	0.424955
GCA_001773325.1-Fun_LXJU01000003.1_i000_002589	56	289	233	1.04018	0.454191
GCA_016861735.1-Fun_AP024418.1_i000_004276	66	299	233	1.04018	0.441288
GCA_001717485.1-Fun_JXNT01000002.1_i000_004639	66	299	233	1.04018	0.441288
GCA_002102555.1-Fun_MCFL01000092.1_i000_012631	109	351	242	1.08036	0.469903
GCA_002157705.1-Pro_BDQF01000003.1_i000_000413	186	407	221	0.986607	0.401818
GCA_905337335.1-Fun_CAJPDQ010000015.1_i000_004911	137	370	233	1.04018	0.396259
GCA_016097325.1-Fun_JADPPX010000002.1_i000_003529	65	298	233	1.04018	0.437148
GCA_000956335.1-Pro_KQ001662.1_i000_001935	242	463	221	0.986607	0.364686
GCA_002897355.1-Pro_BEYU01000034.1_i000_003888	120	342	222	0.991071	0.428571
GCA_900095605.1-Pro_LT608162.1_i000_002155	158	379	221	0.986607	0.424184
GCA_900095555.1-Pro_LT608176.1_i000_002053	158	379	221	0.986607	0.424184
GCA_900002335.2-Pro_LK022887.2_i000_002453	158	379	221	0.986607	0.424184
GCA_900095565.1-Pro_LT608204.1_i000_002165	158	379	221	0.986607	0.424184
GCA_900095625.1-Pro_LT608190.1_i000_002158	158	379	221	0.986607	0.424184
GCA_903994205.1-Pro_LR865386.1_i000_001594	158	379	221	0.986607	0.424184
GCA_006542485.1-Fun_VIFY01000060.1_i000_006560	60	293	233	1.04018	0.442125
GCA_900240055.1-Pro_LT969441.1_i000_000603	170	391	221	0.986607	0.414634
GCA_001602025.1-Pro_CM003859.1_i000_000556	182	403	221	0.986607	0.405505
GCA_013400055.1-Ani_VXBJ01007307.1_i000_013328	108	159	51	0.227679	0.153614
GCA_013400055.1-Ani_VXBJ01007307.1_i000_013328	163	219	56	0.25	0.168675
GCA_903994225.1-Pro_LR865370.1_i000_001692	157	378	221	0.986607	0.425
GCA_000524515.1-Pro_KI965399.1_i000_002594	158	379	221	0.986607	0.424184
GCA_903994235.1-Pro_LR865413.1_i000_001768	158	379	221	0.986607	0.424184
GCA_903994265.1-Pro_LR865429.1_i000_001820	158	379	221	0.986607	0.424184
GCA_002072345.1-Fun_MDYN01000046.1_i000_009652	55	288	233	1.04018	0.455078
GCA_000193285.1-Fun_GL876970.1_i000_006560	151	360	209	0.933036	0.555851
GCA_900002375.2-Pro_LK023125.2_i000_002269	153	374	221	0.986607	0.428295
GCA_900044335.1-Pro_LT160030.1_i000_002230	153	374	221	0.986607	0.428295
GCA_900088445.1-Pro_LT614636.1_i000_002105	153	374	221	0.986607	0.428295
GCA_900095545.1-Pro_LT608146.1_i000_002098	153	374	221	0.986607	0.428295
GCA_900095585.1-Pro_LT608274.1_i000_002105	153	374	221	0.986607	0.428295
GCA_900095635.1-Pro_LT608258.1_i000_002093	153	374	221	0.986607	0.428295
GCA_013339685.1-Ani_CM023490.1_i000_024796	1	89	88	0.392857	0.354839
GCA_900681995.1-Pro_LR215064.1_i000_001511	158	379	221	0.986607	0.424184
GCA_000709005.1-Pro_KL446950.1_i000_003188	168	389	221	0.986607	0.416196
GCA_018258275.1-Pla_CM031107.1_i000_011982	4	188	184	0.821429	0.555891
GCA_000505035.1-Pro_KI635766.1_i000_003190	156	377	221	0.986607	0.425819
GCA_900002385.2-Pro_LM993664.2_i000_002966	156	377	221	0.986607	0.425819
GCA_900002395.1-Pro_LK934638.1_i000_002462	156	377	221	0.986607	0.425819
GCA_000003085.2-Pro_AABL01001227.1_i000_000738	164	385	221	0.986607	0.419355
GCA_002072255.1-Fun_MDYP01000016.1_i000_004844	58	291	233	1.04018	0.448077
GCA_000189635.1-Pro_GG662798.1_i000_004313	146	369	223	0.995536	0.3568
GCA_018107945.1-Pla_JACEIK010006309.1_i000_043285	113	161	48	0.214286	0.137536
GCA_018107945.1-Pla_JACEIK010006309.1_i000_043285	160	311	151	0.674107	0.432665
GCA_900097015.1-Pro_LT969413.1_i000_000602	170	391	221	0.986607	0.414634
GCA_000763605.2-Pla_JRKL02003099.1_i000_018458	95	313	218	0.973214	0.543641
GCA_000342415.1-Pro_CP001669.1_i000_000646	113	325	212	0.946429	0.446316
GCA_010015725.1-Fun_ML977575.1_i000_005425	92	325	233	1.04018	0.439623
GCA_009797565.1-Pla_CM020522.1_i000_008039	85	164	79	0.352679	0.175947
GCA_009797565.1-Pla_CM020522.1_i000_008039	160	283	123	0.549107	0.273942
GCA_003194525.1-Pro_NBIV01000001.1_i000_000073	108	328	220	0.982143	0.45082
GCA_900097035.1-Pro_LT969553.1_i000_000541	228	449	221	0.986607	0.373942
GCA_902459845.2-Pro_CABPSV020000458.1_i000_002713	226	447	221	0.986607	0.374576
GCA_014058105.1-Pla_JACGCM010002299.1_i000_028294	86	270	184	0.821429	0.45098
GCA_900095595.1-Pro_LT963417.1_i000_000666	172	393	221	0.986607	0.413084
GCA_000521035.1-Pro_KI925496.1_i000_000731	171	392	221	0.986607	0.413858
GCA_000521155.1-Pro_KI927810.1_i000_000407	171	392	221	0.986607	0.413858
GCA_000002765.3-Pro_AL844503.2_i000_000679	171	392	221	0.986607	0.413858
GCA_000150435.3-Pro_KE123714.1_i000_006212	171	392	221	0.986607	0.413858
GCA_000186055.2-Pro_GG664961.1_i000_004982	171	392	221	0.986607	0.413858
GCA_000401695.2-Pro_KE123739.1_i000_000697	171	392	221	0.986607	0.413858
GCA_000401715.2-Pro_KE124427.1_i000_000788	171	392	221	0.986607	0.413858
GCA_000521015.1-Pro_KI925021.1_i000_000698	171	392	221	0.986607	0.413858
GCA_000521055.1-Pro_KI926305.1_i000_000778	171	392	221	0.986607	0.413858
GCA_000521095.1-Pro_KI927252.1_i000_000475	171	392	221	0.986607	0.413858
GCA_000521115.1-Pro_KI927475.1_i000_000721	171	392	221	0.986607	0.413858
GCA_002831795.1-Pro_NYMT01000003.1_i000_001675	171	392	221	0.986607	0.413858
GCA_012898025.1-Pro_QFXU01000010.1_i000_001006	171	392	221	0.986607	0.413858
GCA_000521075.1-Pro_KI926023.1_i000_000772	171	392	221	0.986607	0.413858
GCA_000149665.2-Pro_CH672011.1_i000_001745	203	424	221	0.986607	0.390459
GCA_000149795.1-Pro_DS016083.1_i000_003218	203	424	221	0.986607	0.390459
GCA_015529785.1-Fun_JAAAUK010000136.1_i000_001840	145	238	93	0.415179	0.191753
GCA_015529785.1-Fun_JAAAUK010000136.1_i000_001840	234	326	92	0.410714	0.189691
GCA_010356995.1-Fun_ML996687.1_i000_000449	2	195	193	0.861607	0.471883
GCA_000150955.2-Pro_CM000606.1_i000_001379	106	336	230	1.02679	0.47619
GCA_001601855.1-Pro_CM003845.1_i000_000536	172	393	221	0.986607	0.413084
GCA_000723685.1-Pro_HG810765.1_i000_001156	177	398	221	0.986607	0.409259
GCA_900097025.1-Pro_LT969567.1_i000_000697	179	400	221	0.986607	0.407749
GCA_014058105.1-Pla_JACGCM010001662.1_i000_022777	5	215	210	0.9375	0.972222
GCA_900617795.1-Ani_CAAALY010001107.1_i000_000586	1	103	102	0.455357	0.33887
GCA_010093685.1-Fun_MU006216.1_i000_000280	114	347	233	1.04018	0.422101
GCA_001561935.1-Fun_LHQR01000070.1_i000_006906	57	290	233	1.04018	0.449807
GCA_002072245.1-Fun_MDYL01000002.1_i000_001060	55	288	233	1.04018	0.45776
GCA_002920065.1-Fun_PKSL01000178.1_i000_011582	154	359	205	0.915179	0.40275
GCA_001742945.1-Pla_DF973672.1_i000_026445	4	117	113	0.504464	0.355346
GCA_001742945.1-Pla_DF973672.1_i000_026445	113	158	45	0.200893	0.141509
GCA_000150455.3-Pro_KE123476.1_i000_000651	171	392	221	0.986607	0.075017
GCA_905178165.1-Pro_CAJINU010000038.1_i000_014266	134	357	223	0.995536	0.422348
GCA_002072405.1-Fun_MDDG01000009.1_i000_006908	57	290	233	1.04018	0.44894
GCA_000296195.2-Pro_AGNL01039177.1_i000_025284	652	884	232	1.03571	0.223722
GCA_015680905.1-Pla_CM027383.1_i000_029852	13	197	184	0.821429	0.627986
GCA_002906115.4-Pla_PKMF03015734.1_i000_055044	97	316	219	0.977679	0.282216
GCA_000710275.1-Fun_CM002801.1_i000_010594	58	291	233	1.04018	0.44894
GCA_011058885.1-Fun_SWKS01000054.1_i000_009378	58	291	233	1.04018	0.44894
GCA_000388065.2-Pro_KB932201.1_i000_000587	166	385	219	0.977679	0.378238
GCA_003072545.2-Pro_CP056068.1_i000_001446	115	327	212	0.946429	0.449153
GCA_001445595.3-Fun_DF977528.1_i000_011318	2	118	116	0.517857	0.264237
GCA_001445595.3-Fun_DF977528.1_i000_011318	116	215	99	0.441964	0.225513
GCA_000513255.1-Fun_HG792016.1_i000_004091	58	291	233	1.04018	0.44894
GCA_015533775.1-Fun_JABCSE010000011.1_i000_004867	58	291	233	1.04018	0.44894
GCA_000003225.1-Pro_CR940348.1_i000_001529	112	340	228	1.01786	0.486141
GCA_002600585.1-Pro_MIGC01000004.1_i000_000004	176	424	248	1.10714	0.548673
GCA_002072425.1-Fun_MOOB01000036.1_i000_007158	58	291	233	1.04018	0.44894
GCA_003327735.1-Fun_QLNQ01000001.1_i000_000672	133	359	226	1.00893	0.426415
GCA_008009225.1-Pla_CM017761.1_i000_000776	92	142	50	0.223214	0.134771
GCA_008009225.1-Pla_CM017761.1_i000_000776	135	275	140	0.625	0.377358
GCA_002072365.1-Fun_MLQL01000027.1_i000_007233	58	291	233	1.04018	0.44894
GCA_015680905.1-Pla_CM027381.1_i000_019633	1	195	194	0.866071	0.994872
GCA_003327735.1-Fun_QLNQ01000030.1_i000_004087	133	359	226	1.00893	0.426415
GCA_003072535.2-Pro_CP056071.1_i000_001275	112	325	213	0.950893	0.453191
GCA_000165365.1-Pro_AAGK01000002.1_i000_001799	112	324	212	0.946429	0.452991
GCA_018397855.1-Fun_JAGFBS010000006.1_i000_010755	143	227	84	0.375	0.165029
GCA_018397855.1-Fun_JAGFBS010000006.1_i000_010755	230	330	100	0.446429	0.196464
GCA_000150825.1-Fun_DS985219.1_i000_004428	154	233	79	0.352679	0.135739
GCA_000150825.1-Fun_DS985219.1_i000_004428	214	359	145	0.647321	0.249141
GCA_014621375.1-Fun_JAAOZQ010000136.1_i000_002048	58	291	233	1.04018	0.44894
GCA_000344705.1-Fun_AOGT01000133.1_i000_000404	126	353	227	1.01339	0.441634
GCA_018107945.1-Pla_JACEIK010001419.1_i000_023493	1	141	140	0.625	0.992908
GCA_002072265.1-Fun_MDYM01000010.1_i000_007311	58	291	233	1.04018	0.44894
GCA_001513925.1-Fun_LLXE01000125.1_i000_001181	58	291	233	1.04018	0.44894
GCA_004837865.1-Pla_CM017196.1_i000_024983	86	212	126	0.5625	0.315
GCA_004837865.1-Pla_CM017196.1_i000_024983	209	241	32	0.142857	0.08
GCA_002897235.1-Pro_BDSA01000002.1_i000_002236	110	312	202	0.901786	0.440087
GCA_009445465.1-Pla_NMUH01004148.1_i000_040827	232	347	115	0.513393	0.21576
GCA_009445465.1-Pla_NMUH01004148.1_i000_040827	346	382	36	0.160714	0.0675422
GCA_905182995.1-Pro_CAJJDP010000015.1_i000_005975	85	306	221	0.986607	0.477322
GCA_000006405.1-Pro_GG677981.1_i000_014602	59	139	80	0.357143	0.144928
GCA_000006405.1-Pro_GG677981.1_i000_014602	134	369	235	1.04911	0.425725
GCA_000006405.1-Pro_GG673648.1_i000_005685	59	139	80	0.357143	0.144928
GCA_000006405.1-Pro_GG673648.1_i000_005685	134	369	235	1.04911	0.425725
GCA_000751015.1-Pla_LK032453.1_i000_032345	107	223	116	0.517857	0.254386
GCA_000751015.1-Pla_LK032453.1_i000_032345	221	300	79	0.352679	0.173246
GCA_015680905.1-Pla_CM027380.1_i000_014376	89	267	178	0.794643	0.429952
GCA_019722365.1-Pla_JADFUC010001333.1_i000_002608	47	111	64	0.285714	0.164524
GCA_019722365.1-Pla_JADFUC010001333.1_i000_002608	108	225	117	0.522321	0.300771
GCA_905182995.1-Pro_CAJJDP010000011.1_i000_004902	85	306	221	0.986607	0.477322
GCA_013358455.1-Pla_JABWDY010014209.1_i000_010680	1	164	163	0.727679	0.765258
GCA_002271885.2-Pla_CM008449.1_i000_017922	1	162	161	0.71875	0.108931
GCA_000315645.2-Fun_JH993636.1_i000_000622	58	291	233	1.04018	0.44894
GCA_000315665.1-Fun_JH993724.1_i000_004177	58	291	233	1.04018	0.44894
GCA_016767815.1-Fun_CP060778.1_i000_007222	58	291	233	1.04018	0.44894
GCA_012295545.2-Fun_JAAQRF020000025.1_i000_007165	58	291	233	1.04018	0.44894
GCA_002946425.1-Fun_NJPT01000014.1_i000_000768	1	140	139	0.620536	0.390449
GCA_013138035.1-Fun_JAASRZ010000043.1_i000_013017	58	291	233	1.04018	0.463221
GCA_000769765.1-Fun_JQGA01000031.1_i000_000655	58	291	233	1.04018	0.44894
GCA_001661335.1-Fun_KV454438.1_i000_005512	123	356	233	1.04018	0.510965
GCA_000740895.1-Pro_AP011947.1_i000_001794	113	325	212	0.946429	0.451064
GCA_002072235.1-Fun_MDYO01000103.1_i000_011493	58	291	233	1.04018	0.44894
GCA_001278595.1-Fun_LHQQ01000053.1_i000_010207	58	291	233	1.04018	0.445507
GCA_000513335.1-Fun_HG793136.1_i000_002358	58	291	233	1.04018	0.44894
GCA_000165425.1-Pro_CT868052.1_i000_011917	85	306	221	0.986607	0.477322
GCA_000165425.1-Pro_CT868429.1_i000_026636	85	306	221	0.986607	0.477322
GCA_000769735.1-Fun_JQFY01000032.1_i000_008154	58	291	233	1.04018	0.44894
GCA_000769745.1-Fun_JQFZ01000064.1_i000_007622	58	291	233	1.04018	0.44894
GCA_000769755.1-Fun_JQFX01000864.1_i000_002533	58	291	233	1.04018	0.44894
GCA_905183005.1-Pro_CAJJDO010000016.1_i000_007983	85	306	221	0.986607	0.477322
GCA_002738505.1-Pla_KZ305034.1_i000_012221	99	307	208	0.928571	0.594286
GCA_004115385.1-Pla_CM014063.1_i000_035842	9	134	125	0.558036	0.925926
GCA_018446385.1-Pla_CM031516.1_i000_031085	3	136	133	0.59375	0.47331
GCA_015342445.1-Pla_JACEFO010001785.1_i000_029882	1	121	120	0.535714	0.472441
GCA_000006335.3-Fun_GG692396.1_i000_001795	138	364	226	1.00893	0.42243
GCA_017315405.1-Fun_JAFIQD010000002.1_i000_002123	138	364	226	1.00893	0.42243
GCA_000733195.1-Pla_CM002871.1_i000_004744	85	302	217	0.96875	0.611268
GCA_000182765.2-Fun_HE605203.1_i000_004838	129	354	225	1.00446	0.440313
GCA_014049445.1-Fun_JABWAB010000003.1_i000_002060	129	354	225	1.00446	0.440313
GCA_014049455.1-Fun_JABWAA010000005.1_i000_003433	129	354	225	1.00446	0.440313
GCA_014049495.1-Fun_JABWAC010000002.1_i000_001857	129	354	225	1.00446	0.440313
GCA_014049585.1-Fun_JABVZZ010000004.1_i000_002908	129	354	225	1.00446	0.440313
GCA_903989565.1-Fun_CAJEJE010000002.1_i000_001866	129	354	225	1.00446	0.440313
GCA_000576695.1-Fun_HG793126.1_i000_001658	95	325	230	1.02679	0.516854
GCA_905182975.1-Pro_CAJJDM010000010.1_i000_004487	85	306	221	0.986607	0.477322
GCA_018994105.1-Fun_JAFKAI010011605.1_i000_004660	1	155	154	0.6875	0.425414
GCA_000512085.1-Pro_ASPP01035117.1_i000_034371	1	188	187	0.834821	0.935
GCA_905183005.1-Pro_CAJJDO010000022.1_i000_010433	85	306	221	0.986607	0.477322
GCA_905182975.1-Pro_CAJJDM010000016.1_i000_006202	85	306	221	0.986607	0.477322
GCA_905182985.1-Pro_CAJJDN010000012.1_i000_006319	85	306	221	0.986607	0.477322
GCA_006547085.1-Pla_VIEB01000381.1_i000_021540	1	106	105	0.46875	0.37234
GCA_006547085.1-Pla_VIEB01000381.1_i000_021540	100	137	37	0.165179	0.131206
GCA_015680905.1-Pla_CM027377.1_i000_000876	96	256	160	0.714286	0.430108
GCA_014058105.1-Pla_JACGCM010002660.1_i000_006101	7	217	210	0.9375	0.388889
GCA_007844105.2-Pla_CM017577.2_i000_025907	153	294	141	0.629464	0.185283
GCA_904845875.1-Pla_CAJGYO010000008.1_i000_033423	199	279	80	0.357143	0.083682
GCA_904845875.1-Pla_CAJGYO010000008.1_i000_033423	271	380	109	0.486607	0.114017
GCA_013305925.1-Fun_QVTG01000260.1_i000_001313	1	163	162	0.723214	0.483582
GCA_902498895.1-Fun_CABVLU010000003.1_i000_003321	396	629	233	1.04018	0.28519
GCA_008636045.1-Pro_SNRW01000043.1_i000_000517	481	704	223	0.995536	0.277709
GCA_018446385.1-Pla_CM031514.1_i000_024811	1	120	119	0.53125	0.452471
GCA_000027005.1-Fun_FN392321.1_i000_003642	101	316	215	0.959821	0.480984
GCA_000223565.1-Fun_FR839630.1_i000_003404	101	316	215	0.959821	0.480984
GCA_001708085.1-Fun_CP014710.1_i000_003605	101	316	215	0.959821	0.480984
GCA_001746955.1-Fun_CP014717.1_i000_003600	101	316	215	0.959821	0.480984
GCA_900235035.1-Fun_LT962478.1_i000_003405	101	316	215	0.959821	0.480984
GCA_000331365.3-Pla_AMZH03001119.1_i000_005682	97	215	118	0.526786	0.415493
GCA_000512085.1-Pro_ASPP01018222.1_i000_020594	1	187	186	0.830357	0.550296
GCA_019677385.1-Fun_WSLO01005687.1_i000_012615	1	121	120	0.535714	0.415225
GCA_001708105.1-Fun_CP014586.1_i000_003628	101	316	215	0.959821	0.479911
GCA_905178155.1-Pro_CAJINV010000004.1_i000_011024	185	411	226	1.00893	0.392361
GCA_902702945.1-Fun_CACRXN010000252.1_i000_004462	179	238	59	0.263393	0.102076
GCA_902702945.1-Fun_CACRXN010000252.1_i000_004462	235	361	126	0.5625	0.217993
GCA_000499605.1-Pro_HG719365.1_i000_001804	121	371	250	1.11607	0.551876
GCA_003013735.1-Fun_PYFQ01000001.1_i000_000686	135	361	226	1.00893	0.441406
GCA_015039405.1-Fun_WJDU01000054.1_i000_012622	130	323	193	0.861607	0.389113
GCA_000827895.1-Ani_JWZT01003622.1_i000_009167	1	101	100	0.446429	0.380228
GCA_002271895.2-Pla_CM008435.1_i000_014040	97	322	225	1.00446	0.542169
GCA_900618505.1-Ani_UZAH01029137.1_i000_015909	112	250	138	0.616071	0.524715
GCA_002775015.1-Fun_PGLS01000004.1_i000_000735	134	359	225	1.00446	0.438596
GCA_003013715.2-Fun_CP043531.1_i000_000650	134	359	225	1.00446	0.438596
GCA_003014415.1-Fun_PYGM01000055.1_i000_003303	134	359	225	1.00446	0.438596
GCA_007168705.1-Fun_BGOX01000002.1_i000_002413	134	359	225	1.00446	0.438596
GCA_008275145.1-Fun_CP043442.1_i000_001228	134	359	225	1.00446	0.438596
GCA_013266265.1-Fun_JABFAK010009070.1_i000_013941	1	168	167	0.745536	0.436031
GCA_000149685.1-Fun_CH981525.1_i000_004022	164	389	225	1.00446	0.528169
GCA_011745845.1-Pla_VYZY01000856.1_i000_004574	38	119	81	0.361607	0.216578
GCA_011745845.1-Pla_VYZY01000856.1_i000_004574	114	231	117	0.522321	0.312834
GCA_000836295.1-Fun_KN847534.1_i000_002393	151	385	234	1.04464	0.388704
GCA_019202705.1-Fun_JAGSYN010000219.1_i000_003079	141	367	226	1.00893	0.416206
GCA_000209165.1-Fun_CP000499.1_i000_004142	144	370	226	1.00893	0.415441
GCA_003324165.2-Pro_PYSW02000014.1_i000_004734	263	458	195	0.870536	0.265306
GCA_003324165.2-Pro_PYSW02000014.1_i000_004734	450	529	79	0.352679	0.107483
GCA_016809505.1-Fun_CP050673.1_i000_000652	134	359	225	1.00446	0.438596
GCA_003325415.1-Fun_PJQM01002225.1_i000_006726	1	128	127	0.566964	0.137297
GCA_016859295.1-Fun_CM029108.1_i000_004305	165	391	226	1.00893	0.4
GCA_021029115.1-Pro_JAFCAG010000004.1_i000_011387	547	669	122	0.544643	0.144721
GCA_021029115.1-Pro_JAFCAG010000004.1_i000_011387	666	727	61	0.272321	0.0723606
GCA_000004985.1-Pro_GG738845.1_i000_000549	154	328	174	0.776786	0.278846
GCA_000004985.1-Pro_GG738845.1_i000_000549	342	418	76	0.339286	0.121795
GCA_002759435.2-Fun_PEKT02000007.1_i000_000237	134	359	225	1.00446	0.438596
GCA_019332045.1-Fun_CP076749.1_i000_001082	134	359	225	1.00446	0.438596
GCA_001189475.1-Fun_LGST01000017.1_i000_000819	142	367	225	1.00446	0.431862
GCA_000315875.1-Fun_HE681720.1_i000_001871	127	353	226	1.00893	0.444008
GCA_916048055.1-Pla_CAJZHL010000032.1_i000_007694	177	396	219	0.977679	0.452479
GCA_902728275.1-Fun_CACVBS010000024.1_i000_001140	183	281	98	0.4375	0.186667
GCA_902728275.1-Fun_CACVBS010000024.1_i000_001140	278	370	92	0.410714	0.175238
GCA_002926085.1-Fun_PKFP01000008.1_i000_000616	135	361	226	1.00893	0.496703
GCA_008403515.1-Pro_VFQX01000002.1_i000_002706	268	446	178	0.794643	0.240541
GCA_008403515.1-Pro_VFQX01000002.1_i000_002706	456	534	78	0.348214	0.105405
GCA_900074745.1-Fun_LT598465.1_i000_001978	112	333	221	0.986607	0.452869
GCA_019332025.1-Fun_CP076661.1_i000_000559	135	361	226	1.00893	0.441406
GCA_002271885.2-Pla_CM008447.1_i000_012817	97	322	225	1.00446	0.542169
GCA_013115145.1-Pro_JAAPAO010000041.1_i000_006862	143	391	248	1.10714	0.20462
GCA_003719485.1-Pro_MKKU01000599.1_i000_007497	110	328	218	0.973214	0.615819
GCA_905216605.1-Pla_LR999453.1_i000_008366	228	305	77	0.34375	0.143123
GCA_905216605.1-Pla_LR999453.1_i000_008366	299	392	93	0.415179	0.172862
GCA_000492115.1-Pro_AUPL01001491.1_i000_001466	110	328	218	0.973214	0.615819
GCA_003676015.1-Fun_NSDU01000021.1_i000_003579	147	373	226	1.00893	0.477801
GCA_019677385.1-Fun_WSLO01005526.1_i000_012467	1	119	118	0.526786	0.414035
GCA_905250045.1-Ani_CAJNOG010001477.1_i000_040240	179	398	219	0.977679	0.41635
GCA_905250045.1-Ani_CAJNOG010001477.1_i000_040240	414	459	45	0.200893	0.0855513
GCA_000188675.2-Pro_ADWP02014321.1_i000_004721	110	328	218	0.973214	0.615819
GCA_003177105.1-Pro_PRFA01000113.1_i000_001199	110	328	218	0.973214	0.615819
GCA_003719455.1-Pro_MKKV01000182.1_i000_007889	110	328	218	0.973214	0.615819
GCA_015033625.1-Pro_CM026586.1_i000_002561	110	328	218	0.973214	0.615819
GCA_003719475.1-Pro_MKGL01000190.1_i000_005526	110	328	218	0.973214	0.615819
GCA_003704595.1-Fun_QWIO01001256.1_i000_009703	162	310	148	0.660714	0.477419
GCA_000300495.1-Pro_AHKC01009743.1_i000_003496	110	328	218	0.973214	0.615819
GCA_000209065.1-Pro_CH473479.1_i000_004931	110	328	218	0.973214	0.615819
GCA_003177095.1-Pro_PRFC01000167.1_i000_006040	110	328	218	0.973214	0.615819
GCA_003676035.1-Fun_NSGQ01000004.1_i000_002473	140	368	228	1.01786	0.424581
GCA_000496795.1-Pro_AYLP01000075.1_i000_005273	110	328	218	0.973214	0.615819
GCA_002219105.2-Pro_MBSY01000545.1_i000_005879	110	328	218	0.973214	0.615819
GCA_012184645.1-Fun_WYDC01000029.1_i000_002771	135	361	226	1.00893	0.439689
GCA_012184655.1-Fun_WYDD01000092.1_i000_005380	135	361	226	1.00893	0.439689
GCA_002926055.1-Fun_PKFO01000003.1_i000_002112	146	372	226	1.00893	0.430476
GCA_905330665.1-Ani_HG994580.1_i000_001151	1	49	48	0.214286	0.183908
GCA_905330665.1-Ani_HG994580.1_i000_001151	44	97	53	0.236607	0.203065
GCA_001742945.1-Pla_DF973223.1_i000_010011	68	178	110	0.491071	0.474138
GCA_001742945.1-Pla_DF973223.1_i000_010011	176	227	51	0.227679	0.219828
GCA_001970955.1-Pro_MPUH01000449.1_i000_019723	181	400	219	0.977679	0.482379
GCA_007726485.1-Pla_CM017443.1_i000_021064	1	119	118	0.526786	0.485597
GCA_007252995.1-Ani_SWJQ01002202.1_i000_020343	1	53	52	0.232143	0.440678
GCA_007252995.1-Ani_SWJQ01002202.1_i000_020343	52	69	17	0.0758929	0.144068
GCA_000006515.1-Pro_DS989730.1_i000_002446	82	307	225	1.00446	0.534442
GCA_021927905.1-Pro_BLLK01000047.1_i000_010563	101	347	246	1.09821	0.6703
GCA_019788955.1-Ani_JAFBMS010000154.1_i000_007869	120	187	67	0.299107	0.358289
GCA_015033655.1-Pro_CM026629.1_i000_002554	110	328	218	0.973214	0.615819
GCA_000209065.1-Pro_CH473698.1_i000_000716	110	328	218	0.973214	0.615819
GCA_003177095.1-Pro_PRFC01000019.1_i000_007494	110	328	218	0.973214	0.615819
GCA_905231925.1-Pro_CAJNJV010007745.1_i000_008831	59	283	224	1	0.429119
GCA_905231925.1-Pro_CAJNJV010007745.1_i000_008831	373	423	50	0.223214	0.0957854
GCA_001970955.1-Pro_MPUH01000347.1_i000_016622	181	400	219	0.977679	0.482379
GCA_021962125.1-Ani_JAGDYQ010000107.1_i000_001737	213	433	220	0.982143	0.39783
GCA_000223485.1-Fun_GL996501.1_i000_002617	138	364	226	1.00893	0.420857
GCA_001411555.2-Pla_LIHL02000143.1_i000_036930	177	396	219	0.977679	0.378238
GCA_001411555.2-Pla_CM023851.1_i000_023623	177	396	219	0.977679	0.378238
GCA_003097735.1-Ani_NHOQ01001560.1_i000_009495	149	225	76	0.339286	0.336283
GCA_017918235.1-Pro_CM030536.1_i000_005518	98	303	205	0.915179	0.601173
GCA_001179505.1-Pro_CDMY01000733.1_i000_019217	182	401	219	0.977679	0.412429
GCA_021927905.1-Pro_BLLK01000047.1_i000_010562	101	347	246	1.09821	0.485207
GCA_002158475.1-Pla_KZ155786.1_i000_004018	177	396	219	0.977679	0.460084
GCA_000214015.2-Pla_CAID01000003.2_i000_001275	177	396	219	0.977679	0.460084
GCA_011764265.1-Fun_JAANRE010008462.1_i000_010834	99	318	219	0.977679	0.532847
GCA_927797965.1-Ani_OV696702.1_i000_023296	180	398	218	0.973214	0.409006
GCA_000816745.1-Ani_KN740860.1_i000_016063	1	89	88	0.392857	0.347826
GCA_000002845.2-Pro_FR799008.1_i000_006396	98	305	207	0.924107	0.607038
GCA_900537975.1-Pro_LS997632.1_i000_006629	98	305	207	0.924107	0.607038
GCA_011763645.1-Fun_JAASGZ010000666.1_i000_006257	181	400	219	0.977679	0.444219
GCA_011763975.1-Fun_JAANJF010000515.1_i000_004375	181	400	219	0.977679	0.444219
GCA_011763995.1-Fun_JAANJE010002751.1_i000_008085	181	400	219	0.977679	0.444219
GCA_011764025.1-Fun_JAANQT010000461.1_i000_004279	181	400	219	0.977679	0.444219
GCA_011764055.1-Fun_JAANQS010000819.1_i000_006330	181	400	219	0.977679	0.444219
GCA_011764125.1-Fun_JAANQV010000814.1_i000_003155	181	400	219	0.977679	0.444219
GCA_011764145.1-Fun_JAANQZ010000429.1_i000_002664	181	400	219	0.977679	0.444219
GCA_011764185.1-Fun_JAANRA010000885.1_i000_006705	181	400	219	0.977679	0.444219
GCA_011764225.1-Fun_JAANRQ010001215.1_i000_003902	181	400	219	0.977679	0.444219
GCA_011800955.1-Fun_JAANRM010000660.1_i000_006479	181	400	219	0.977679	0.444219
GCA_011800985.1-Fun_JAANRL010000617.1_i000_005672	181	400	219	0.977679	0.444219
GCA_011801035.1-Fun_JAANRN010000437.1_i000_004883	181	400	219	0.977679	0.444219
GCA_011801055.1-Fun_JAANRO010000518.1_i000_005344	181	400	219	0.977679	0.444219
GCA_011801305.1-Fun_JAANRS010000866.1_i000_007144	181	400	219	0.977679	0.444219
GCA_011801335.1-Fun_JAANRP010000761.1_i000_005884	181	400	219	0.977679	0.444219
GCA_011801385.1-Fun_JAANRR010000518.1_i000_004646	181	400	219	0.977679	0.444219
GCA_011801495.1-Fun_JAANRV010000875.1_i000_007296	181	400	219	0.977679	0.444219
GCA_011801505.1-Fun_JAANRU010000626.1_i000_005973	181	400	219	0.977679	0.444219
GCA_011801555.1-Fun_JAANRX010000902.1_i000_007323	181	400	219	0.977679	0.444219
GCA_011801575.1-Fun_JAANRW010000917.1_i000_007598	181	400	219	0.977679	0.444219
GCA_011801605.1-Fun_JAANRT010000572.1_i000_005637	181	400	219	0.977679	0.444219
GCA_011801645.1-Fun_JAANRB010000632.1_i000_005863	181	400	219	0.977679	0.444219
GCA_011801675.1-Fun_JAANQW010000873.1_i000_006223	181	400	219	0.977679	0.444219
GCA_011801705.1-Fun_JAANQY010000840.1_i000_006320	181	400	219	0.977679	0.444219
GCA_011801725.1-Fun_JAANQX010000542.1_i000_004834	181	400	219	0.977679	0.444219
GCA_011801785.1-Fun_JAANQR010000685.1_i000_005369	181	400	219	0.977679	0.444219
GCA_011801815.1-Fun_JAANQU010000472.1_i000_004209	181	400	219	0.977679	0.444219
GCA_011950945.1-Fun_JAANRD010000893.1_i000_007526	181	400	219	0.977679	0.444219
GCA_011950985.1-Fun_JAANRF010000112.1_i000_001770	181	400	219	0.977679	0.444219
GCA_011951285.1-Fun_JAANRG010000905.1_i000_008336	181	400	219	0.977679	0.444219
GCA_011951295.1-Fun_JAANRC010000487.1_i000_004432	181	400	219	0.977679	0.444219
GCA_011952045.1-Fun_JAANRH010000765.1_i000_006045	181	400	219	0.977679	0.444219
GCA_011952115.1-Fun_JAANRI010000389.1_i000_003438	181	400	219	0.977679	0.444219
GCA_011952145.1-Fun_JAANRJ010000845.1_i000_007239	181	400	219	0.977679	0.444219
GCA_011952175.1-Fun_JAANRK010000216.1_i000_002994	181	400	219	0.977679	0.444219
GCA_011763935.1-Fun_JAANJC010000027.1_i000_000548	181	400	219	0.977679	0.444219
GCA_011763955.1-Fun_JAANJD010000107.1_i000_001587	181	400	219	0.977679	0.444219
GCA_000149305.1-Fun_CH476749.1_i000_001107	181	400	219	0.977679	0.444219
GCA_011763585.1-Fun_JAANIP010002875.1_i000_010676	181	400	219	0.977679	0.444219
GCA_011763695.1-Fun_JAANIQ010001314.1_i000_007590	181	400	219	0.977679	0.444219
GCA_011763715.1-Fun_JAANIR010000340.1_i000_003168	181	400	219	0.977679	0.444219
GCA_011763735.1-Fun_JAANIS010000869.1_i000_004059	181	400	219	0.977679	0.444219
GCA_011763755.1-Fun_JAANIW010001311.1_i000_009091	181	400	219	0.977679	0.444219
GCA_011763775.1-Fun_JAANIT010000181.1_i000_002182	181	400	219	0.977679	0.444219
GCA_011763795.1-Fun_JAANIV010001363.1_i000_009173	181	400	219	0.977679	0.444219
GCA_011763815.1-Fun_JAANIU010001334.1_i000_007936	181	400	219	0.977679	0.444219
GCA_011763835.1-Fun_JAANIX010001366.1_i000_009320	181	400	219	0.977679	0.444219
GCA_011763855.1-Fun_JAANJA010000066.1_i000_001148	181	400	219	0.977679	0.444219
GCA_011763875.1-Fun_JAANIZ010001285.1_i000_007780	181	400	219	0.977679	0.444219
GCA_011763895.1-Fun_JAANIY010000354.1_i000_003492	181	400	219	0.977679	0.444219
GCA_011763915.1-Fun_JAANJB010000347.1_i000_003786	181	400	219	0.977679	0.444219
GCA_000149425.1-Fun_CH408159.1_i000_001487	148	374	226	1.00893	0.476793
GCA_000827895.1-Ani_JWZT01004662.1_i000_011746	18	242	224	1	0.759322
GCA_013115115.1-Pro_JABAHT010000061.1_i000_008415	493	739	246	1.09821	0.266811
GCA_015499975.1-Fun_JAAAUD010000157.1_i000_002441	189	413	224	1	0.447106
GCA_002007985.1-Fun_MSRX01000017.1_i000_001357	127	365	238	1.0625	0.452471
GCA_002008025.1-Fun_MSRY01000025.1_i000_002057	127	365	238	1.0625	0.452471
GCA_003614735.1-Fun_KZ992546.1_i000_002167	182	401	219	0.977679	0.433663
GCA_001299535.1-Pro_LJSK01000112.1_i000_004009	98	312	214	0.955357	0.627566
GCA_910591765.1-Fun_CAJVPS010015411.1_i000_011042	189	414	225	1.00446	0.456389
GCA_005406065.1-Fun_BIMT01000050.1_i000_003835	137	365	228	1.01786	0.450593
GCA_019207005.1-Fun_JAHLUH010000007.1_i000_004770	97	325	228	1.01786	0.488223
GCA_015529795.1-Fun_JAAAUH010000913.1_i000_010420	186	410	224	1	0.447106
GCA_015500005.1-Fun_JAAAUG010000481.1_i000_007555	186	410	224	1	0.447106
GCA_002245835.2-Pla_LHPG02000008.1_i000_009005	179	399	220	0.982143	0.42885
GCA_016748015.1-Fun_JAAOMT010000566.1_i000_004874	189	412	223	0.995536	0.342025
GCA_902829235.1-Ani_CADEPI010000019.1_i000_003015	180	400	220	0.982143	0.40293
GCA_003427395.1-Pla_BFEA01000767.1_i000_030370	769	987	218	0.973214	0.180763
GCA_000755165.1-Pro_CP009402.1_i000_006178	98	303	205	0.915179	0.601173
GCA_002008015.1-Fun_MSSE01000067.1_i000_004450	127	365	238	1.0625	0.452471
GCA_002008075.1-Fun_MSSB01000174.1_i000_001474	127	365	238	1.0625	0.452471
GCA_017916325.1-Pro_CM030428.1_i000_005958	98	305	207	0.924107	0.607038
GCA_000691245.1-Pro_JMRU01000033.1_i000_000955	110	328	218	0.973214	0.615819
GCA_014529505.1-Pro_JABXOJ010000025.1_i000_001526	11	236	225	1.00446	0.635593
GCA_000478725.1-Pla_KI517408.1_i000_007574	91	138	47	0.209821	0.141141
GCA_000478725.1-Pla_KI517408.1_i000_007574	136	283	147	0.65625	0.441441
GCA_001865355.1-Pro_LRBS01000109.1_i000_001926	311	536	225	1.00446	0.345622
GCA_011764145.1-Fun_JAANQZ010005811.1_i000_012193	99	318	219	0.977679	0.638484
GCA_020536995.1-Ani_CM035924.1_i000_137299	179	398	219	0.977679	0.41635
GCA_019207235.1-Fun_JAHLUK010000002.1_i000_002741	97	325	228	1.01786	0.488223
GCA_019207415.1-Fun_JAHLUU010000001.1_i000_001638	97	325	228	1.01786	0.488223
GCA_003704095.1-Ani_RCHS01001528.1_i000_003342	180	399	219	0.977679	0.431102
GCA_001879085.1-Pla_MJEQ01009756.1_i000_032558	93	302	209	0.933036	0.667732
GCA_019206905.1-Fun_JAHLUB010000001.1_i000_002022	97	325	228	1.01786	0.488223
GCA_019206915.1-Fun_JAHLUA010000005.1_i000_003967	97	325	228	1.01786	0.488223
GCA_019206925.1-Fun_JAHLUE010000008.1_i000_004954	97	325	228	1.01786	0.488223
GCA_019206965.1-Fun_JAHLUF010000007.1_i000_004707	97	325	228	1.01786	0.488223
GCA_019206985.1-Fun_JAHLUC010000008.1_i000_005028	97	325	228	1.01786	0.488223
GCA_019207125.1-Fun_JAHLUD010000003.1_i000_003234	97	325	228	1.01786	0.488223
GCA_019207165.1-Fun_JAHLUV010000009.1_i000_005300	97	325	228	1.01786	0.488223
GCA_019207175.1-Fun_JAHLUI010000006.1_i000_004456	97	325	228	1.01786	0.488223
GCA_019207185.1-Fun_JAHLUG010000003.1_i000_003017	97	325	228	1.01786	0.488223
GCA_019207205.1-Fun_JAHLUJ010000002.1_i000_002617	97	325	228	1.01786	0.488223
GCA_019207265.1-Fun_JAHLUN010000009.1_i000_005217	97	325	228	1.01786	0.488223
GCA_019207285.1-Fun_JAHLUL010000002.1_i000_002803	97	325	228	1.01786	0.488223
GCA_019207295.1-Fun_JAHLUM010000002.1_i000_002831	97	325	228	1.01786	0.488223
GCA_019207315.1-Fun_JAHLUO010000002.1_i000_002619	97	325	228	1.01786	0.488223
GCA_019207325.1-Fun_JAHLUP010000001.1_i000_001660	97	325	228	1.01786	0.488223
GCA_019207365.1-Fun_JAHLUQ010000007.1_i000_004780	97	325	228	1.01786	0.488223
GCA_019207375.1-Fun_JAHLUR010000006.1_i000_004516	97	325	228	1.01786	0.488223
GCA_019207405.1-Fun_JAHLUS010000005.1_i000_003749	97	325	228	1.01786	0.488223
GCA_019207435.1-Fun_JAHLUT010000001.1_i000_001676	97	325	228	1.01786	0.488223
GCA_011763645.1-Fun_JAASGZ010000814.1_i000_007101	181	400	219	0.977679	0.345426
GCA_000223845.4-Pro_KK211489.1_i000_004199	206	361	155	0.691964	0.293561
GCA_000223845.4-Pro_KK211489.1_i000_004199	382	461	79	0.352679	0.149621
GCA_019448385.1-Pro_JAGTXO010000001.1_i000_001928	175	393	218	0.973214	0.452282
GCA_000827895.1-Ani_JWZT01002547.1_i000_006063	183	407	224	1	0.486957
GCA_018688675.1-Pla_CM031831.1_i000_014242	177	396	219	0.977679	0.380208
GCA_000092065.1-Pla_CP000583.1_i000_001237	177	396	219	0.977679	0.462025
GCA_013115865.1-Pro_JABANO010007042.1_i000_005635	498	753	255	1.13839	0.272436
GCA_003325435.1-Fun_PJQL01004865.1_i000_015515	85	301	216	0.964286	0.717608
GCA_001673695.2-Fun_LYUB02000002.1_i000_001061	133	358	225	1.00446	0.462012
GCA_009498055.1-Fun_CP038485.1_i000_002006	133	358	225	1.00446	0.462012
GCA_009498075.1-Fun_CP039551.1_i000_001998	133	358	225	1.00446	0.462012
GCA_009498095.1-Fun_CP039653.1_i000_002005	133	358	225	1.00446	0.462012
GCA_009498115.1-Fun_CP039661.1_i000_002004	133	358	225	1.00446	0.462012
GCA_009498135.1-Fun_CP039619.1_i000_002005	133	358	225	1.00446	0.462012
GCA_003675555.2-Fun_QOBI02000002.1_i000_001252	133	358	225	1.00446	0.462012
GCA_014636115.1-Fun_JAASFG010000002.1_i000_001351	133	358	225	1.00446	0.462012
GCA_905331495.1-Ani_CAJNYV010004736.1_i000_025942	63	282	219	0.977679	0.627507
GCA_905332285.1-Ani_CAJOBS010000561.1_i000_010661	63	282	219	0.977679	0.627507
GCA_016098015.1-Fun_JAAAIT010000174.1_i000_002845	19	243	224	1	0.689231
GCA_000002445.1-Pro_CM000208.1_i000_006534	111	329	218	0.973214	0.614085
GCA_000210295.1-Pro_FN554973.1_i000_007218	111	329	218	0.973214	0.614085
GCA_001457755.2-Pro_CZPT02001685.1_i000_007583	111	329	218	0.973214	0.614085
GCA_021029115.1-Pro_JAFCAG010000002.1_i000_007747	140	362	222	0.991071	0.508009
GCA_905250025.1-Ani_CAJNOJ010000244.1_i000_032022	179	398	219	0.977679	0.470968
GCA_905250095.1-Ani_CAJNOR010000465.1_i000_009124	179	398	219	0.977679	0.470968
GCA_016808215.1-Pla_CM029002.1_i000_014270	177	396	219	0.977679	0.380208
GCA_018689175.1-Pla_CM031847.1_i000_013392	177	396	219	0.977679	0.380208
GCA_011763915.1-Fun_JAANJB010000017.1_i000_000337	181	400	219	0.977679	0.210173
GCA_015679545.1-Fun_JAAAUZ010000340.1_i000_004647	186	410	224	1	0.446215
GCA_015852425.1-Fun_JAAAIG010000421.1_i000_007213	186	410	224	1	0.463768
GCA_006535975.1-Fun_QEAP01000306.1_i000_006757	181	401	220	0.982143	0.419048
GCA_000938895.1-Fun_LN731665.1_i000_007867	182	401	219	0.977679	0.44332
GCA_002083745.1-Fun_KV921998.1_i000_008567	181	400	219	0.977679	0.44332
GCA_002708625.1-Fun_KZ303844.1_i000_002491	181	400	219	0.977679	0.44332
GCA_000186865.1-Pro_GL833122.1_i000_001798	193	415	222	0.991071	0.439604
GCA_015680635.1-Fun_JAABOA010005701.1_i000_009907	18	243	225	1.00446	0.694444
GCA_020536995.1-Ani_CM035924.1_i000_137331	252	471	219	0.977679	0.365609
GCA_003543875.1-Pro_CM010681.1_i000_005494	151	369	218	0.973214	0.551899
GCA_000825725.1-Fun_CDGI01000307.1_i000_010298	181	400	219	0.977679	0.44332
GCA_002083735.1-Fun_KV921409.1_i000_007714	181	400	219	0.977679	0.44332
GCA_011762625.1-Fun_JAANIL010000361.1_i000_005156	181	400	219	0.977679	0.44332
GCA_011762635.1-Fun_JAANIK010000363.1_i000_005154	181	400	219	0.977679	0.44332
GCA_011763475.1-Fun_JAANIM010000089.1_i000_009178	181	400	219	0.977679	0.44332
GCA_011763565.1-Fun_JAANIN010000224.1_i000_004966	181	400	219	0.977679	0.44332
GCA_011764045.1-Fun_JAANQQ010000060.1_i000_001784	181	400	219	0.977679	0.44332
GCA_006535975.1-Fun_QEAP01000016.1_i000_001065	181	401	220	0.982143	0.419048
GCA_011764225.1-Fun_JAANRQ010007175.1_i000_012080	147	366	219	0.977679	0.477124
GCA_018994065.1-Fun_JAFKAH010000225.1_i000_002546	162	306	144	0.642857	0.35732
GCA_018687715.1-Pla_CM031815.1_i000_014436	177	396	219	0.977679	0.38087
GCA_011801725.1-Fun_JAANQX010002674.1_i000_011388	161	380	219	0.977679	0.463002
GCA_910592255.1-Fun_CAJVPO010002007.1_i000_009232	179	401	222	0.991071	0.395722
GCA_011764025.1-Fun_JAANQT010003743.1_i000_012383	181	400	219	0.977679	0.444219
GCA_011764125.1-Fun_JAANQV010006571.1_i000_011428	181	400	219	0.977679	0.444219
GCA_011801675.1-Fun_JAANQW010002677.1_i000_011023	181	400	219	0.977679	0.444219
GCA_011801505.1-Fun_JAANRU010000772.1_i000_006796	165	384	219	0.977679	0.459119
GCA_003335185.2-Ani_QKKF02036444.1_i000_016752	179	396	217	0.96875	0.405607
GCA_905331015.1-Ani_CAJNXB010002433.1_i000_014971	179	398	219	0.977679	0.470968
GCA_905331295.1-Ani_CAJNYD010002417.1_i000_019058	179	398	219	0.977679	0.470968
GCA_905331475.1-Ani_CAJNYU010002677.1_i000_020808	179	398	219	0.977679	0.470968
GCA_905331485.1-Ani_CAJNYT010005054.1_i000_028894	179	398	219	0.977679	0.470968
GCA_905332235.1-Ani_CAJOBO010000135.1_i000_003653	179	398	219	0.977679	0.470968
GCA_905332265.1-Ani_CAJOBQ010000556.1_i000_011496	179	398	219	0.977679	0.470968
GCA_017552425.1-Pla_CM029812.1_i000_024063	113	276	163	0.727679	0.503086
GCA_017552425.1-Pla_CM029812.1_i000_024063	271	298	27	0.120536	0.0833333
GCA_011801335.1-Fun_JAANRP010002770.1_i000_011537	168	387	219	0.977679	0.45625
GCA_022059095.1-Pro_JAJSEB010000060.1_i000_008756	112	330	218	0.973214	0.61236
GCA_011763935.1-Fun_JAANJC010001274.1_i000_008933	181	400	219	0.977679	0.444219
GCA_011763955.1-Fun_JAANJD010000599.1_i000_005664	181	400	219	0.977679	0.444219
GCA_007210705.1-Ani_CM017373.1_i000_000471	135	354	219	0.977679	0.433663
GCA_011763975.1-Fun_JAANJF010000902.1_i000_006329	181	400	219	0.977679	0.444219
GCA_011763995.1-Fun_JAANJE010005837.1_i000_011581	181	400	219	0.977679	0.444219
GCA_011764055.1-Fun_JAANQS010001260.1_i000_008123	181	400	219	0.977679	0.444219
GCA_011764185.1-Fun_JAANRA010002800.1_i000_011800	181	400	219	0.977679	0.444219
GCA_011764265.1-Fun_JAANRE010007012.1_i000_009596	181	400	219	0.977679	0.444219
GCA_011800955.1-Fun_JAANRM010001937.1_i000_011126	181	400	219	0.977679	0.444219
GCA_011800985.1-Fun_JAANRL010002493.1_i000_011555	181	400	219	0.977679	0.444219
GCA_011801035.1-Fun_JAANRN010000152.1_i000_002265	181	400	219	0.977679	0.444219
GCA_011801055.1-Fun_JAANRO010000401.1_i000_004541	181	400	219	0.977679	0.444219
GCA_011801305.1-Fun_JAANRS010002412.1_i000_011460	181	400	219	0.977679	0.444219
GCA_011801385.1-Fun_JAANRR010002659.1_i000_011332	181	400	219	0.977679	0.444219
GCA_011801495.1-Fun_JAANRV010002426.1_i000_011551	181	400	219	0.977679	0.444219
GCA_011801555.1-Fun_JAANRX010002483.1_i000_011664	181	400	219	0.977679	0.444219
GCA_011801575.1-Fun_JAANRW010002406.1_i000_011629	181	400	219	0.977679	0.444219
GCA_011801605.1-Fun_JAANRT010002452.1_i000_011601	181	400	219	0.977679	0.444219
GCA_011801645.1-Fun_JAANRB010000413.1_i000_004405	181	400	219	0.977679	0.444219
GCA_011801705.1-Fun_JAANQY010000902.1_i000_006602	181	400	219	0.977679	0.444219
GCA_011801785.1-Fun_JAANQR010002286.1_i000_010409	181	400	219	0.977679	0.444219
GCA_011801815.1-Fun_JAANQU010002709.1_i000_011288	181	400	219	0.977679	0.444219
GCA_011950945.1-Fun_JAANRD010002417.1_i000_011669	181	400	219	0.977679	0.444219
GCA_011951285.1-Fun_JAANRG010002158.1_i000_011820	181	400	219	0.977679	0.444219
GCA_011951295.1-Fun_JAANRC010002661.1_i000_011377	181	400	219	0.977679	0.444219
GCA_011952045.1-Fun_JAANRH010000903.1_i000_006688	181	400	219	0.977679	0.444219
GCA_011952115.1-Fun_JAANRI010002915.1_i000_011159	181	400	219	0.977679	0.444219
GCA_011952145.1-Fun_JAANRJ010003265.1_i000_012520	181	400	219	0.977679	0.444219
GCA_011952175.1-Fun_JAANRK010001958.1_i000_011115	181	400	219	0.977679	0.444219
GCA_015679695.1-Fun_JAAAVD010001529.1_i000_002408	186	410	224	1	0.455285
GCA_015849335.1-Fun_JAAAIC010000583.1_i000_008473	186	410	224	1	0.447106
GCA_003614755.1-Fun_KZ989902.1_i000_003265	182	401	219	0.977679	0.438878
GCA_015500005.1-Fun_JAAAUG010000591.1_i000_008388	186	410	224	1	0.448
GCA_015529795.1-Fun_JAAAUH010000141.1_i000_001826	186	410	224	1	0.448
GCA_015502575.1-Fun_JAAAUR010001442.1_i000_002065	195	419	224	1	0.447106
GCA_900000135.1-Fun_CCYT01000016.1_i000_006514	181	400	219	0.977679	0.44332
GCA_905250095.1-Ani_CAJNOR010008878.1_i000_052920	133	352	219	0.977679	0.522673
GCA_016808215.1-Pla_CM029002.1_i000_014268	177	396	219	0.977679	0.379549
GCA_018687715.1-Pla_CM031815.1_i000_014434	177	396	219	0.977679	0.380208
GCA_018688675.1-Pla_CM031831.1_i000_014240	177	396	219	0.977679	0.380208
GCA_018689175.1-Pla_CM031847.1_i000_013390	177	396	219	0.977679	0.380208
GCA_905332095.1-Ani_CAJOBD010004826.1_i000_026780	34	254	220	0.982143	0.6875
GCA_001683725.1-Fun_LUGH01000160.1_i000_002368	182	400	218	0.973214	0.440404
GCA_015852335.1-Fun_JAAAID010003431.1_i000_010762	127	350	223	0.995536	0.491189
GCA_019207715.1-Fun_JAHLVL010000001.1_i000_001979	97	325	228	1.01786	0.488223
GCA_019207815.1-Fun_JAHLVO010000001.1_i000_001952	97	325	228	1.01786	0.488223
GCA_019207825.1-Fun_JAHLVP010000002.1_i000_002074	97	325	228	1.01786	0.488223
GCA_019207965.1-Fun_JAHLVM010000002.1_i000_002248	97	325	228	1.01786	0.488223
GCA_020536115.1-Fun_JAEUBD010000983.1_i000_003071	97	325	228	1.01786	0.488223
GCA_001664045.1-Fun_AECK01000002.1_i000_001292	97	325	228	1.01786	0.488223
GCA_019207725.1-Fun_JAHLVK010000002.1_i000_002585	97	325	228	1.01786	0.488223
GCA_019207735.1-Fun_JAHLVJ010000007.1_i000_004666	97	325	228	1.01786	0.488223
GCA_019207835.1-Fun_JAHLVN010000001.1_i000_001549	97	325	228	1.01786	0.488223
GCA_019207905.1-Fun_JAHLVQ010000003.1_i000_003164	97	325	228	1.01786	0.488223
GCA_019207995.1-Fun_JAHLVT010000004.1_i000_003629	97	325	228	1.01786	0.488223
GCA_019208005.1-Fun_JAHLVR010000002.1_i000_002396	97	325	228	1.01786	0.488223
GCA_019208045.1-Fun_JAHLVS010000002.1_i000_002398	97	325	228	1.01786	0.488223
GCA_905250095.1-Ani_CAJNOR010000052.1_i000_001650	179	398	219	0.977679	0.470968
GCA_905261645.1-Ani_CAJNOV010001887.1_i000_006271	179	398	219	0.977679	0.470968
GCA_905273325.1-Ani_CAJNOW010014759.1_i000_026867	179	398	219	0.977679	0.470968
GCA_905319835.1-Ani_CAJNRE010000056.1_i000_000845	179	398	219	0.977679	0.470968
GCA_905321285.1-Ani_CAJNRF010003477.1_i000_010099	179	398	219	0.977679	0.470968
GCA_905321535.1-Ani_CAJNRG010007994.1_i000_018425	179	398	219	0.977679	0.470968
GCA_905332145.1-Ani_CAJOBF010000897.1_i000_009716	179	398	219	0.977679	0.470968
GCA_905332155.1-Ani_CAJOBG010000583.1_i000_005751	179	398	219	0.977679	0.470968
GCA_001664035.1-Fun_LXTC01000001.1_i000_000028	78	304	226	1.00893	0.511312
GCA_003427335.1-Ani_BEZZ01000489.1_i000_011528	180	399	219	0.977679	0.41635
GCA_011950985.1-Fun_JAANRF010000144.1_i000_002158	181	400	219	0.977679	0.366221
GCA_002105155.1-Fun_MCFF01000030.1_i000_005829	186	410	224	1	0.445328
GCA_015847225.1-Fun_JAAAHT010000512.1_i000_003829	186	410	224	1	0.445328
GCA_013358835.1-Ani_JABSTQ010010080.1_i000_016022	180	398	218	0.973214	0.422481
GCA_001632505.1-Ani_LRGB01002384.1_i000_014220	180	398	218	0.973214	0.422481
GCA_905329745.1-Ani_CAJNSZ010000940.1_i000_031027	179	398	219	0.977679	0.470968
GCA_905330235.1-Ani_CAJNUA010001009.1_i000_029619	179	398	219	0.977679	0.470968
GCA_905332175.1-Ani_CAJOBL010001847.1_i000_010822	179	398	219	0.977679	0.470968
GCA_905330535.1-Ani_CAJNVN010000388.1_i000_024454	179	398	219	0.977679	0.470968
GCA_905330805.1-Ani_CAJNWK010000598.1_i000_025767	179	398	219	0.977679	0.470968
GCA_905332165.1-Ani_CAJOBK010002658.1_i000_018752	179	398	219	0.977679	0.470968
GCA_905332185.1-Ani_CAJOBM010000979.1_i000_007241	179	398	219	0.977679	0.470968
GCA_905332225.1-Ani_CAJOBN010009894.1_i000_027835	179	398	219	0.977679	0.470968
GCA_001049375.1-Pro_CDSF01000077.1_i000_002707	181	400	219	0.977679	0.431953
GCA_007210665.1-Pro_PYHZ01000004.1_i000_001383	96	320	224	1	0.509091
GCA_016098035.1-Fun_JAAAIV010000353.1_i000_005387	186	410	224	1	0.46473
GCA_002261195.1-Fun_MVBO01000022.1_i000_002431	183	402	219	0.977679	0.430255
GCA_004794745.1-Ani_QBLH01003970.1_i000_009833	867	1086	219	0.977679	0.159505
GCA_015502455.1-Fun_JAAAUM010000629.1_i000_009133	186	409	223	0.995536	0.444223
GCA_016097935.1-Fun_JAAAIP010000505.1_i000_007097	186	410	224	1	0.455285
GCA_000187245.3-Fun_CM002305.1_i000_003954	97	325	228	1.01786	0.488223
GCA_019207595.1-Fun_JAHLVG010000002.1_i000_002589	97	325	228	1.01786	0.488223
GCA_019207695.1-Fun_JAHLVH010000001.1_i000_001547	97	325	228	1.01786	0.488223
GCA_905250105.1-Ani_CAJNOC010000567.1_i000_005272	178	398	220	0.982143	0.485651
GCA_905332305.1-Ani_CAJOBU010004361.1_i000_020505	19	238	219	0.977679	0.718033
GCA_020891255.1-Fun_BQFW01000003.1_i000_002591	186	410	224	1	0.461856
GCA_014466195.1-Ani_CM025369.1_i000_010045	179	397	218	0.973214	0.404453
GCA_003710015.1-Ani_REGN01009978.1_i000_045083	179	399	220	0.982143	0.484581
GCA_001293395.1-Pro_LGTL01000019.1_i000_007428	98	311	213	0.950893	0.624633
GCA_003614695.1-Fun_ML004474.1_i000_003311	130	356	226	1.00893	0.47983
GCA_001661345.1-Fun_KV454478.1_i000_002620	174	437	263	1.17411	0.493433
GCA_910592215.1-Fun_CAJVPN010000350.1_i000_003195	179	401	222	0.991071	0.272393
GCA_905332315.1-Ani_CAJOBV010003787.1_i000_023433	31	250	219	0.977679	0.690852
GCA_000739165.1-Fun_KN042421.1_i000_006231	186	410	224	1	0.450704
GCA_000739165.1-Fun_KN042423.1_i000_008074	186	410	224	1	0.448898
GCA_015852495.1-Fun_JAAAIK010000138.1_i000_001746	186	410	224	1	0.448898
GCA_000151265.1-Pla_GG663736.1_i000_009036	177	396	219	0.977679	0.466951
GCA_019207455.1-Fun_JAHLUW010000002.1_i000_002347	97	325	228	1.01786	0.488223
GCA_011763605.1-Fun_JAANIO010006126.1_i000_010219	99	318	219	0.977679	0.528986
GCA_905331505.1-Ani_CAJNYZ010001887.1_i000_031839	39	258	219	0.977679	0.673846
GCA_011763695.1-Fun_JAANIQ010000015.1_i000_000246	181	400	219	0.977679	0.0938303
GCA_011763715.1-Fun_JAANIR010000012.1_i000_000223	181	400	219	0.977679	0.0938303
GCA_011763835.1-Fun_JAANIX010000044.1_i000_000861	181	400	219	0.977679	0.0938303
GCA_011763585.1-Fun_JAANIP010000005.1_i000_000074	181	400	219	0.977679	0.0938303
GCA_011763735.1-Fun_JAANIS010000004.1_i000_000039	181	400	219	0.977679	0.0938303
GCA_011763755.1-Fun_JAANIW010000010.1_i000_000259	181	400	219	0.977679	0.0938303
GCA_011763775.1-Fun_JAANIT010000021.1_i000_000377	181	400	219	0.977679	0.0938303
GCA_011763795.1-Fun_JAANIV010000038.1_i000_000752	181	400	219	0.977679	0.0938303
GCA_011763815.1-Fun_JAANIU010000016.1_i000_000310	181	400	219	0.977679	0.0938303
GCA_011763855.1-Fun_JAANJA010000040.1_i000_000782	181	400	219	0.977679	0.0938303
GCA_011763875.1-Fun_JAANIZ010000017.1_i000_000331	181	400	219	0.977679	0.0938303
GCA_011763895.1-Fun_JAANIY010000018.1_i000_000303	181	400	219	0.977679	0.0938303
GCA_000750675.1-Fun_JPJR01001111.1_i000_005542	152	301	149	0.665179	0.495017
GCA_000499425.1-Pro_HG670747.1_i000_001478	136	353	217	0.96875	0.452083
GCA_904063045.1-Ani_CAJFCJ010000014.1_i000_009153	180	399	219	0.977679	0.515294
GCA_015852385.1-Fun_JAAAIE010000708.1_i000_009759	186	410	224	1	0.461856
GCA_015852385.1-Fun_JAAAIE010000239.1_i000_004428	186	410	224	1	0.454361
GCA_000187875.1-Ani_GL732533.1_i000_005609	180	398	218	0.973214	0.423301
GCA_015679595.1-Fun_JAAAVB010001372.1_i000_001942	186	410	224	1	0.450704
GCA_014080715.1-Pla_JACERP010000051.1_i000_012862	177	396	219	0.977679	0.424419
GCA_004936735.2-Pro_SCFC02000028.1_i000_003538	94	321	227	1.01339	0.515909
GCA_015849275.1-Fun_JAAAIA010000331.1_i000_004465	186	410	224	1	0.452525
GCA_014466175.1-Ani_CM025344.1_i000_010094	179	397	218	0.973214	0.404453
GCA_002104985.1-Fun_MCGO01000033.1_i000_008849	64	284	220	0.982143	0.561224
GCA_003325415.1-Fun_PJQM01002008.1_i000_006275	140	359	219	0.977679	0.481319
GCA_905332135.1-Ani_CAJOBI010001881.1_i000_006792	178	398	220	0.982143	0.520095
GCA_000204515.1-Ani_GL888584.1_i000_011851	179	397	218	0.973214	0.338509
GCA_017607455.1-Ani_JAANHZ010000208.1_i000_000922	179	397	218	0.973214	0.337984
GCA_015679405.1-Fun_JAAAUU010000008.1_i000_010535	292	516	224	1	0.373957
GCA_016097885.1-Fun_JAAAIO010000807.1_i000_009431	186	410	224	1	0.455285
GCA_016097715.1-Fun_JAAZWU010000330.1_i000_005762	182	401	219	0.977679	0.440644
GCA_016097735.1-Fun_JAAZWV010000320.1_i000_004684	182	401	219	0.977679	0.440644
GCA_016097755.1-Fun_JAAZWW010000348.1_i000_005796	182	401	219	0.977679	0.440644
GCA_000150275.1-Ani_DS985255.1_i000_002718	180	399	219	0.977679	0.471983
GCA_904845305.1-Ani_CAJGYM010000001.1_i000_000832	177	396	219	0.977679	0.444219
GCA_017607525.1-Ani_JAANIA010000279.1_i000_005577	179	397	218	0.973214	0.339036
GCA_021613535.1-Ani_CP075496.1_i000_018925	185	404	219	0.977679	0.464968
GCA_001661415.1-Fun_KV453909.1_i000_000666	136	361	225	1.00446	0.435203
GCA_015502445.1-Fun_JAAAUN010000490.1_i000_008080	186	410	224	1	0.458078
GCA_019364655.1-Ani_JAGXCG010013980.1_i000_040855	180	398	218	0.973214	0.377163
GCA_019207505.1-Fun_JAHLUZ010000001.1_i000_001870	97	325	228	1.01786	0.488223
GCA_019207555.1-Fun_JAHLUY010000001.1_i000_001753	97	325	228	1.01786	0.488223
GCA_015502445.1-Fun_JAAAUN010000317.1_i000_005977	185	409	224	1	0.457143
GCA_019049445.1-Ani_JAHFVI010000010.1_i000_004276	180	397	217	0.96875	0.368421
GCA_019207635.1-Fun_JAHLVE010000005.1_i000_003854	97	325	228	1.01786	0.488223
GCA_017607545.1-Ani_JAANIC010006140.1_i000_008128	179	397	218	0.973214	0.339036
GCA_905250005.1-Ani_CAJNOH010000251.1_i000_012952	179	398	219	0.977679	0.470968
GCA_905250125.1-Ani_CAJNOL010000362.1_i000_015485	179	398	219	0.977679	0.470968
GCA_905250125.1-Ani_CAJNOL010000363.1_i000_015510	179	398	219	0.977679	0.470968
GCA_905250875.1-Ani_CAJNOO010000464.1_i000_011579	179	398	219	0.977679	0.470968
GCA_905251635.1-Ani_CAJNOT010000716.1_i000_015613	179	398	219	0.977679	0.470968
GCA_905252715.1-Ani_CAJNOU010000411.1_i000_010144	179	398	219	0.977679	0.470968
GCA_905332085.1-Ani_CAJOAX010000442.1_i000_006360	179	398	219	0.977679	0.470968
GCA_905332105.1-Ani_CAJOBE010002353.1_i000_015900	179	398	219	0.977679	0.470968
GCA_019207515.1-Fun_JAHLVA010000003.1_i000_002807	97	325	228	1.01786	0.488223
GCA_019207525.1-Fun_JAHLVB010000001.1_i000_001759	97	325	228	1.01786	0.488223
GCA_019207585.1-Fun_JAHLVF010000002.1_i000_002203	97	325	228	1.01786	0.488223
GCA_019207605.1-Fun_JAHLVD010000001.1_i000_001618	97	325	228	1.01786	0.488223
GCA_019207615.1-Fun_JAHLVC010000002.1_i000_002429	97	325	228	1.01786	0.488223
GCA_905319835.1-Ani_CAJNRE010019907.1_i000_036103	178	399	221	0.986607	0.452869
GCA_905261645.1-Ani_CAJNOV010004679.1_i000_011117	178	398	220	0.982143	0.472103
GCA_905273325.1-Ani_CAJNOW010015586.1_i000_028511	178	398	220	0.982143	0.472103
GCA_905321285.1-Ani_CAJNRF010009828.1_i000_022840	178	398	220	0.982143	0.472103
GCA_905321535.1-Ani_CAJNRG010007540.1_i000_017668	178	398	220	0.982143	0.472103
GCA_905332115.1-Ani_CAJOBH010000078.1_i000_000672	178	398	220	0.982143	0.472103
GCA_905332125.1-Ani_CAJOBJ010000157.1_i000_001049	178	398	220	0.982143	0.472103
GCA_905332145.1-Ani_CAJOBF010001015.1_i000_010552	178	398	220	0.982143	0.472103
GCA_905332155.1-Ani_CAJOBG010000648.1_i000_006242	178	398	220	0.982143	0.472103
GCA_000143415.2-Pla_GL377578.1_i000_009987	177	396	219	0.977679	0.38087
GCA_000582765.1-Pro_HF955072.1_i000_003515	101	319	218	0.973214	0.633721
GCA_001594075.1-Ani_KQ980575.1_i000_012033	184	402	218	0.973214	0.401473
GCA_009445465.1-Pla_NMUH01000193.1_i000_006411	177	395	218	0.973214	0.373288
GCA_021730765.1-Ani_JAIZAO010000154.1_i000_020762	181	400	219	0.977679	0.431102
GCA_015679585.1-Fun_JAAAVF010002239.1_i000_004452	186	410	224	1	0.451613
GCA_015245375.1-Pro_CP044419.1_i000_001311	96	321	225	1.00446	0.511364
GCA_001272555.1-Ani_KQ434946.1_i000_008623	180	396	216	0.964286	0.36425
GCA_001593475.1-Pro_JIBN01000123.1_i000_001537	42	267	225	1.00446	0.582902
GCA_001483515.1-Pro_JTAI01000022.1_i000_002532	42	267	225	1.00446	0.582902
GCA_015847185.1-Fun_JAAAHX010000640.1_i000_008880	183	407	224	1	0.454361
GCA_000784635.1-Fun_AJJF01000006.1_i000_005750	158	396	238	1.0625	0.416084
GCA_000784575.1-Fun_JSXR01000016.1_i000_001284	155	393	238	1.0625	0.419014
GCA_000773735.1-Fun_AJIW01000012.1_i000_000611	157	395	238	1.0625	0.413913
GCA_000784695.1-Fun_AJJG01000014.1_i000_004617	157	395	238	1.0625	0.413913
GCA_015849325.1-Fun_JAAAIB010000055.1_i000_007540	186	410	224	1	0.451613
GCA_019788775.1-Fun_JAIFTL010000131.1_i000_001126	186	410	224	1	0.451613
GCA_000182965.3-Fun_CP017624.1_i000_001962	156	394	238	1.0625	0.418278
GCA_905250005.1-Ani_CAJNOH010000096.1_i000_007662	179	398	219	0.977679	0.470968
GCA_905250125.1-Ani_CAJNOL010000201.1_i000_010474	179	398	219	0.977679	0.470968
GCA_905251635.1-Ani_CAJNOT010000736.1_i000_015870	179	398	219	0.977679	0.470968
GCA_905332095.1-Ani_CAJOBD010000801.1_i000_010798	179	398	219	0.977679	0.470968
GCA_002105135.1-Fun_MCGN01000003.1_i000_005837	181	400	219	0.977679	0.491031
GCA_000784515.1-Fun_JSXQ01000009.1_i000_006253	156	394	238	1.0625	0.417544
GCA_015502455.1-Fun_JAAAUM010000060.1_i000_008928	186	410	224	1	0.448
GCA_016098005.1-Fun_JAAAIS010000023.1_i000_004332	186	410	224	1	0.448898
GCA_002217175.1-Ani_LNIX01000003.1_i000_008040	180	399	219	0.977679	0.431953
GCA_015679535.1-Fun_JAAAUX010000119.1_i000_000876	186	410	224	1	0.451613
GCA_001594045.1-Ani_KQ976417.1_i000_002180	179	397	218	0.973214	0.337984
GCA_000165345.1-Pro_CM000432.1_i000_001270	119	344	225	1.00446	0.485961
GCA_016098105.1-Fun_JAAAIY010000218.1_i000_003066	186	410	224	1	0.458078
GCA_016098135.1-Fun_JAAAIZ010000104.1_i000_000267	186	410	224	1	0.458078
GCA_014905795.1-Fun_JACBPP010000001.1_i000_000037	135	360	225	1.00446	0.446429
GCA_000006445.2-Fun_CR382135.2_i000_001681	144	368	224	1	0.422642
GCA_013694445.1-Fun_CP059270.1_i000_002465	103	332	229	1.02232	0.514607
GCA_019207475.1-Fun_JAHLUX010000002.1_i000_002232	97	325	228	1.01786	0.488223
GCA_000227135.2-Pro_FR799620.2_i000_006024	98	303	205	0.915179	0.601173
GCA_003719575.1-Pro_CP029532.1_i000_006468	98	303	205	0.915179	0.601173
GCA_900635355.2-Pro_LR812653.1_i000_006284	98	303	205	0.915179	0.601173
GCA_003730175.1-Pro_RHLD01000006.1_i000_001794	100	305	205	0.915179	0.597668
GCA_003730215.1-Pro_RHLC01000007.1_i000_001572	100	305	205	0.915179	0.597668
GCA_015679485.1-Fun_JAAAUY010000070.1_i000_009426	186	410	224	1	0.448898
GCA_018446385.1-Pla_CM031515.1_i000_027314	120	237	117	0.522321	0.403448
GCA_001594065.1-Ani_KQ978106.1_i000_012192	179	397	218	0.973214	0.335901
GCA_015680655.1-Fun_JAABKD010000010.1_i000_000129	186	410	224	1	0.444444
GCA_905250055.1-Ani_CAJNOF010000495.1_i000_028612	179	398	219	0.977679	0.470968
GCA_905250075.1-Ani_CAJNOP010000888.1_i000_052110	179	398	219	0.977679	0.470968
GCA_905250075.1-Ani_CAJNOP010000890.1_i000_052134	179	398	219	0.977679	0.470968
GCA_905331535.1-Ani_CAJNZB010001076.1_i000_033780	179	398	219	0.977679	0.470968
GCA_003344405.1-Ani_NOWV01000019.1_i000_003704	180	399	219	0.977679	0.359016
GCA_900106125.1-Fun_LT635764.1_i000_001304	128	354	226	1.00893	0.455645
GCA_016097885.1-Fun_JAAAIO010001555.1_i000_002172	19	243	224	1	0.695652
GCA_015847195.1-Fun_JAAAHV010000161.1_i000_002246	186	409	223	0.995536	0.466527
GCA_015502565.1-Fun_JAAAUS010000075.1_i000_008614	186	410	224	1	0.459016
GCA_016098155.1-Fun_JAAAJB010000025.1_i000_003519	186	410	224	1	0.459016
GCA_016097855.1-Fun_JAAAIM010000369.1_i000_007195	185	409	224	1	0.460905
GCA_015680655.1-Fun_JAABKD010000240.1_i000_004297	186	410	224	1	0.457143
GCA_001593465.1-Pro_JIBM01000098.1_i000_001507	94	321	227	1.01339	0.515909
GCA_002223825.1-Pro_LN877950.1_i000_001282	94	321	227	1.01339	0.515909
GCA_020891255.1-Fun_BQFW01000005.1_i000_003727	186	410	224	1	0.46281
GCA_002742825.1-Ani_CM008509.1_i000_000952	177	395	218	0.973214	0.450413
GCA_021491975.1-Ani_CP090891.1_i000_000559	177	395	218	0.973214	0.450413
GCA_022453885.1-Ani_CP092620.1_i000_000541	177	395	218	0.973214	0.450413
GCA_006535975.1-Fun_QEAP01000104.1_i000_003841	298	523	225	1.00446	0.375626
GCA_002335675.1-Pla_BEGY01000001.1_i000_000275	177	396	219	0.977679	0.412429
GCA_015847185.1-Fun_JAAAHX010000785.1_i000_009732	106	330	224	1	0.543689
GCA_003325415.1-Fun_PJQM01000758.1_i000_003140	182	400	218	0.973214	0.436874
GCA_001949185.1-Ani_BDGG01000003.1_i000_008470	180	398	218	0.973214	0.40824
GCA_900106115.1-Fun_LT635756.1_i000_000304	128	354	226	1.00893	0.465021
GCA_017916305.1-Pro_CM030608.1_i000_006288	99	306	207	0.924107	0.605263
GCA_014466185.1-Ani_CM025394.1_i000_008916	180	397	217	0.96875	0.364094
GCA_000982615.1-Pro_HF955199.1_i000_000222	100	318	218	0.973214	0.633721
GCA_001411555.2-Pla_CM023851.1_i000_023621	177	396	219	0.977679	0.378893
GCA_009887335.1-Ani_SGJC01007666.1_i000_007188	178	400	222	0.991071	0.463466
GCA_016097945.1-Fun_JAAAIR010000001.1_i000_000011	224	448	224	1	0.421053
GCA_015679535.1-Fun_JAAAUX010000004.1_i000_006861	186	410	224	1	0.458078
GCA_905250025.1-Ani_CAJNOJ010000001.1_i000_000109	186	411	225	1.00446	0.407609
GCA_905250025.1-Ani_CAJNOJ010000001.1_i000_000109	447	497	50	0.223214	0.0905797
GCA_000708835.1-Pla_DF237240.1_i000_007155	177	396	219	0.977679	0.393885
GCA_017607565.1-Ani_JAANIB010009931.1_i000_008050	179	397	218	0.973214	0.339036
GCA_015849285.1-Fun_JAAAHZ010000367.1_i000_005721	186	410	224	1	0.451613
GCA_002007995.1-Fun_MSRZ01000001.1_i000_001492	127	365	238	1.0625	0.451613
GCA_002008065.1-Fun_MSSA01000001.1_i000_001817	127	365	238	1.0625	0.451613
GCA_000182565.2-Fun_KQ257450.1_i000_000333	186	409	223	0.995536	0.435547
GCA_001718145.1-Ani_LJIJ01000077.1_i000_003361	180	399	219	0.977679	0.410882
GCA_900079185.1-Fun_LT554895.1_i000_010283	182	400	218	0.973214	0.42998
GCA_019973975.1-Ani_BMAO01038273.1_i000_067943	180	398	218	0.973214	0.466809
GCA_011764045.1-Fun_JAANQQ010002644.1_i000_010897	43	262	219	0.977679	0.616901
GCA_002261195.1-Fun_MVBO01000035.1_i000_003562	185	410	225	1.00446	0.27339
GCA_002008085.1-Fun_MSSD01000089.1_i000_005240	127	365	238	1.0625	0.451613
GCA_002008095.1-Fun_MSSC01000009.1_i000_005479	127	365	238	1.0625	0.451613
GCA_009663115.1-Fun_CP023101.1_i000_000555	179	233	54	0.241071	0.0952381
GCA_009663115.1-Fun_CP023101.1_i000_000555	232	350	118	0.526786	0.208113
GCA_016098165.1-Fun_JAAAJA010000091.1_i000_009764	182	400	218	0.973214	0.427451
GCA_905250125.1-Ani_CAJNOL010000197.1_i000_010327	179	398	219	0.977679	0.470968
GCA_905250875.1-Ani_CAJNOO010000425.1_i000_010999	179	398	219	0.977679	0.470968
GCA_905332085.1-Ani_CAJOAX010000178.1_i000_003325	179	398	219	0.977679	0.470968
GCA_011752425.2-Ani_CACVKT020004335.1_i000_024417	180	400	220	0.982143	0.422265
GCA_002290385.1-Ani_KZ288387.1_i000_008558	180	397	217	0.96875	0.376083
GCA_001865345.1-Pro_LRBP01000023.1_i000_001677	96	315	219	0.977679	0.498861
GCA_013841205.1-Ani_JACDQY010000123.1_i000_006112	180	397	217	0.96875	0.375433
GCA_013841245.2-Ani_CM034066.1_i000_003817	180	397	217	0.96875	0.375433
GCA_019207935.1-Fun_JAHLVI010000005.1_i000_003995	97	325	228	1.01786	0.488223
GCA_015852435.1-Fun_JAAAIJ010000744.1_i000_010242	186	410	224	1	0.454361
GCA_021613535.1-Ani_CP075493.1_i000_002057	179	398	219	0.977679	0.470968
GCA_019857665.1-Ani_WNTK01000015.1_i000_013621	180	399	219	0.977679	0.405556
GCA_019788775.1-Fun_JAIFTL010000015.1_i000_001604	204	428	224	1	0.439216
GCA_001483705.1-Ani_KQ760547.1_i000_003013	180	397	217	0.96875	0.375433
GCA_000002875.2-Pro_FR796465.1_i000_006093	98	303	205	0.915179	0.601173
GCA_900500625.2-Pro_LR812966.1_i000_006410	98	303	205	0.915179	0.601173
GCA_905250065.1-Ani_CAJNON010000103.1_i000_013036	178	399	221	0.986607	0.475269
GCA_905332015.1-Ani_CAJOAZ010000117.1_i000_003346	178	399	221	0.986607	0.475269
GCA_905332035.1-Ani_CAJOAY010002127.1_i000_025408	178	399	221	0.986607	0.475269
GCA_001593445.1-Pro_JIBK01000017.1_i000_001689	95	320	225	1.00446	0.513699
GCA_905250015.1-Ani_CAJNOM010000092.1_i000_016452	178	399	221	0.986607	0.475269
GCA_905250115.1-Ani_CAJNOI010000087.1_i000_017655	178	399	221	0.986607	0.475269
GCA_021442195.1-Pla_CM038195.1_i000_002877	216	435	219	0.977679	0.357259
GCA_905250015.1-Ani_CAJNOM010000213.1_i000_027727	178	399	221	0.986607	0.475269
GCA_905250035.1-Ani_CAJNOE010000063.1_i000_009111	178	399	221	0.986607	0.475269
GCA_905332045.1-Ani_CAJOBB010000291.1_i000_007232	178	399	221	0.986607	0.475269
GCA_015502505.1-Fun_JAAAUQ010001021.1_i000_000170	186	410	224	1	0.461856
GCA_009078355.1-Ani_CM018542.1_i000_001816	177	397	220	0.982143	0.39356
GCA_000002725.2-Pro_FR796429.1_i000_006215	98	303	205	0.915179	0.601173
GCA_916722125.1-Pro_OU755567.1_i000_006382	98	303	205	0.915179	0.601173
GCA_012274485.2-Pla_MU105674.1_i000_011089	177	395	218	0.973214	0.407477
GCA_013115135.1-Pro_JABANP010000028.1_i000_006084	181	404	223	0.995536	0.447791
GCA_902439185.1-Ani_CABPRJ010001441.1_i000_009711	178	396	218	0.973214	0.36394
GCA_013115115.1-Pro_JABAHT010000751.1_i000_009321	181	404	223	0.995536	0.447791
GCA_016097895.1-Fun_JAAAIL010000152.1_i000_002035	186	410	224	1	0.46281
GCA_002891405.2-Ani_NEVH01015872.1_i000_010372	113	330	217	0.96875	0.455882
GCA_900074715.1-Fun_LT598481.1_i000_001948	96	321	225	1.00446	0.485961
GCA_004217705.1-Fun_CP034458.1_i000_002710	135	360	225	1.00446	0.446429
GCA_000180635.4-Ani_CM026579.1_i000_022944	178	395	217	0.96875	0.445585
GCA_016097865.1-Fun_JAAAIN010000978.1_i000_006437	246	470	224	1	0.411009
GCA_000143415.2-Pla_GL377631.1_i000_025179	177	396	219	0.977679	0.380208
GCA_011763645.1-Fun_JAASGZ010007451.1_i000_019719	19	238	219	0.977679	0.657658
GCA_019788955.1-Ani_JAFBMS010000009.1_i000_026101	165	385	220	0.982143	0.419847
GCA_015847235.1-Fun_JAAAHU010000402.1_i000_007506	186	410	224	1	0.46281
GCA_002087225.1-Pro_NBCO01000008.1_i000_010723	112	330	218	0.973214	0.61236
GCA_013340265.1-Ani_BLKM01000294.1_i000_001725	139	356	217	0.96875	0.357496
GCA_001447935.2-Fun_LMYN01000007.1_i000_000629	144	368	224	1	0.422642
GCA_905338405.1-Ani_CAJPEX010000312.1_i000_002668	406	624	218	0.973214	0.289894
GCA_004104545.1-Ani_SAUD01003735.1_i000_006311	10	227	217	0.96875	0.62536
GCA_016097935.1-Fun_JAAAIP010000043.1_i000_006316	199	423	224	1	0.446215
GCA_004104545.1-Ani_SAUD01031839.1_i000_015550	10	227	217	0.96875	0.623563
GCA_017916335.1-Pro_CM030464.1_i000_006130	98	303	205	0.915179	0.601173
GCA_017918215.1-Pro_CM030500.1_i000_006052	98	303	205	0.915179	0.601173
GCA_002897355.1-Pro_BEYU01000135.1_i000_009131	179	398	219	0.977679	0.408582
GCA_019671135.1-Fun_JAHRHY010000008.1_i000_011691	186	410	224	1	0.456212
GCA_905331015.1-Ani_CAJNXB010003085.1_i000_017784	178	399	221	0.986607	0.474249
GCA_905331295.1-Ani_CAJNYD010002575.1_i000_020245	178	399	221	0.986607	0.474249
GCA_905331475.1-Ani_CAJNYU010004239.1_i000_029921	178	399	221	0.986607	0.474249
GCA_905331485.1-Ani_CAJNYT010000910.1_i000_008364	178	399	221	0.986607	0.474249
GCA_905331495.1-Ani_CAJNYV010005958.1_i000_031812	178	399	221	0.986607	0.474249
GCA_905332235.1-Ani_CAJOBO010001753.1_i000_020475	178	399	221	0.986607	0.474249
GCA_905332245.1-Ani_CAJOBP010000309.1_i000_003975	178	399	221	0.986607	0.474249
GCA_905332265.1-Ani_CAJOBQ010001397.1_i000_019723	178	399	221	0.986607	0.474249
GCA_905332275.1-Ani_CAJOBR010001201.1_i000_010654	178	399	221	0.986607	0.474249
GCA_905332285.1-Ani_CAJOBS010001306.1_i000_017957	178	399	221	0.986607	0.474249
GCA_002105175.1-Fun_MCGE01000004.1_i000_009779	182	400	218	0.973214	0.440404
GCA_902829315.1-Ani_CADEPM010000011.1_i000_012230	177	395	218	0.973214	0.459916
GCA_001594115.1-Ani_KQ981193.1_i000_000445	164	382	218	0.973214	0.353323
GCA_016946835.1-Fun_JACVTC010000047.1_i000_018614	157	376	219	0.977679	0.451546
GCA_011009095.1-Ani_VTPC01000652.1_i000_001261	180	398	218	0.973214	0.439516
GCA_003675905.2-Ani_NCKV01004329.1_i000_007187	181	398	217	0.96875	0.203374
GCA_000723665.1-Fun_CBTN010000010.1_i000_003225	182	400	218	0.973214	0.438632
GCA_015680635.1-Fun_JAABOA010001080.1_i000_004412	182	399	217	0.96875	0.420543
GCA_002157105.1-Fun_KZ150985.1_i000_009381	181	400	219	0.977679	0.479212
GCA_002104895.1-Fun_MCFG01000054.1_i000_009877	181	400	219	0.977679	0.432806
GCA_002104945.1-Fun_MCFH01000015.1_i000_001957	186	410	224	1	0.453441
GCA_000733195.1-Pla_CM002871.1_i000_004651	177	396	219	0.977679	0.413989
GCA_008124465.1-Pla_CM017883.1_i000_017246	62	280	218	0.973214	0.531707
GCA_002104975.1-Fun_MCOG01000349.1_i000_012222	181	400	219	0.977679	0.430255
GCA_003675995.1-Ani_NCKU01001137.1_i000_004985	178	397	219	0.977679	0.462025
GCA_002104975.1-Fun_MCOG01000064.1_i000_017146	181	400	219	0.977679	0.432806
GCA_016946835.1-Fun_JACVTC010000089.1_i000_026261	181	400	219	0.977679	0.432806
GCA_002287475.2-Fun_CM008253.1_i000_003162	180	400	220	0.982143	0.395683
GCA_020744185.1-Fun_JAGSXK010000003.1_i000_008862	176	400	224	1	0.468619
GCA_015680655.1-Fun_JAABKD010000146.1_i000_001765	182	401	219	0.977679	0.42607
GCA_015847185.1-Fun_JAAAHX010000112.1_i000_000581	182	401	219	0.977679	0.42607
GCA_015849325.1-Fun_JAAAIB010000205.1_i000_002975	182	401	219	0.977679	0.42607
GCA_019788775.1-Fun_JAIFTL010000039.1_i000_005654	182	401	219	0.977679	0.42607
GCA_000142805.1-Fun_CU928170.1_i000_003249	145	368	223	0.995536	0.425573
GCA_014805685.1-Ani_CM025885.1_i000_000150	180	398	218	0.973214	0.391382
GCA_000006405.1-Pro_GG679756.1_i000_022931	181	404	223	0.995536	0.450505
GCA_002105175.1-Fun_MCGE01000003.1_i000_007537	178	403	225	1.00446	0.379427
GCA_000950595.1-Fun_DF836346.1_i000_007744	182	400	218	0.973214	0.436874
GCA_015679425.1-Fun_JAAAUV010001515.1_i000_002708	186	410	224	1	0.461856
GCA_020744185.1-Fun_JAGSXK010000014.1_i000_003562	185	409	224	1	0.457143
GCA_001651415.1-Fun_KV442072.1_i000_010918	186	410	224	1	0.459016
GCA_016098015.1-Fun_JAAAIT010000563.1_i000_007925	186	410	224	1	0.450704
GCA_001651415.1-Fun_KV442014.1_i000_001324	186	410	224	1	0.453441
GCA_015680625.1-Fun_JAAAXW010000007.1_i000_010639	186	410	224	1	0.461856
GCA_014905635.1-Pla_JABVCE010000002.1_i000_003262	137	356	219	0.977679	0.479212
GCA_900074765.1-Fun_LT598488.1_i000_002505	107	331	224	1	0.472574
GCA_015847235.1-Fun_JAAAHU010000024.1_i000_004556	182	400	218	0.973214	0.434263
GCA_016097895.1-Fun_JAAAIL010002666.1_i000_010896	182	400	218	0.973214	0.43083
GCA_000234665.4-Pro_FR799585.1_i000_006734	98	303	205	0.915179	0.601173
GCA_002105175.1-Fun_MCGE01000001.1_i000_000575	186	411	225	1.00446	0.451807
GCA_016098035.1-Fun_JAAAIV010000054.1_i000_007538	186	410	224	1	0.451613
GCA_001594055.1-Ani_KQ983203.1_i000_014029	179	397	218	0.973214	0.311429
GCA_000327385.1-Ani_KB201785.1_i000_011070	180	399	219	0.977679	0.464968
GCA_000151315.2-Pro_KE346369.1_i000_006319	129	349	220	0.982143	0.463158
GCA_003427355.1-Ani_BFAA01013637.1_i000_018666	165	384	219	0.977679	0.420345
GCA_015679415.1-Fun_JAAAUT010000706.1_i000_009078	218	437	219	0.977679	0.398182
GCA_017918225.1-Pro_CM030572.1_i000_006194	98	303	205	0.915179	0.601173
GCA_014773175.1-Ani_VXCM01001619.1_i000_011120	180	400	220	0.982143	0.411215
GCA_006535975.1-Fun_QEAP01000017.1_i000_001097	729	954	225	1.00446	0.218872
GCA_003325415.1-Fun_PJQM01000418.1_i000_002019	140	359	219	0.977679	0.487751
GCA_020466585.1-Ani_JAFETG010000009.1_i000_013041	179	397	218	0.973214	0.420039
GCA_900079185.1-Fun_LT554356.1_i000_005725	195	413	218	0.973214	0.423301
GCA_000346045.2-Ani_KB632387.1_i000_011640	179	397	218	0.973214	0.417625
GCA_000355655.1-Ani_KB741231.1_i000_011091	179	397	218	0.973214	0.417625
GCA_020466635.1-Ani_JAFETF010000009.1_i000_013251	179	397	218	0.973214	0.417625
GCA_000401635.1-Fun_KE123935.1_i000_003724	182	400	218	0.973214	0.43513
GCA_003675995.1-Ani_NCKU01005291.1_i000_013036	189	415	226	1.00893	0.419295
GCA_000696155.1-Ani_KK852458.1_i000_000981	180	398	218	0.973214	0.375862
GCA_900618515.1-Ani_UZAO01079827.1_i000_014393	1	89	88	0.392857	0.956522
GCA_015502445.1-Fun_JAAAUN010000376.1_i000_006691	182	400	218	0.973214	0.431683
GCA_015502475.1-Fun_JAAAUL010000197.1_i000_003909	182	400	218	0.973214	0.431683
GCA_016098085.1-Fun_JAAAIX010000048.1_i000_008152	182	400	218	0.973214	0.431683
GCA_016758965.1-Fun_JAEPRB010000016.1_i000_001828	182	400	218	0.973214	0.43254
GCA_905332335.1-Ani_CAJOBX010051891.1_i000_040344	167	386	219	0.977679	0.409346
GCA_000004255.1-Pla_GL348715.1_i000_008854	178	397	219	0.977679	0.412429
GCA_014839865.1-Fun_JABAYA010000065.1_i000_007917	181	400	219	0.977679	0.436255
GCA_021399445.1-Fun_JAJTUQ010000001.1_i000_000673	193	419	226	1.00893	0.450199
GCA_000945115.1-Fun_LK023315.1_i000_001899	182	400	218	0.973214	0.439516
GCA_001643675.2-Pro_LSRY02000004.1_i000_011296	80	299	219	0.977679	0.251435
GCA_001593445.1-Pro_JIBK01000043.1_i000_002431	182	404	222	0.991071	0.476395
GCA_015143295.1-Pla_CM026558.1_i000_012241	177	396	219	0.977679	0.44877
GCA_003260385.1-Pla_NQVE01000098.1_i000_005558	166	385	219	0.977679	0.511682
GCA_011763605.1-Fun_JAANIO010003775.1_i000_007876	181	400	219	0.977679	0.446939
GCA_000006405.1-Pro_GG673069.1_i000_002791	181	404	223	0.995536	0.450505
GCA_013115125.1-Pro_JABANN010000490.1_i000_006688	181	403	222	0.991071	0.44668
GCA_905250035.1-Ani_CAJNOE010000659.1_i000_033954	179	398	219	0.977679	0.470968
GCA_905332045.1-Ani_CAJOBB010000133.1_i000_003992	179	398	219	0.977679	0.470968
GCA_900332095.2-Pla_OOIL02006685.1_i000_042057	166	385	219	0.977679	0.471983
GCA_905250065.1-Ani_CAJNON010000573.1_i000_032000	179	398	219	0.977679	0.470968
GCA_905332035.1-Ani_CAJOAY010000485.1_i000_010767	179	398	219	0.977679	0.470968
GCA_001263275.1-Ani_KQ414663.1_i000_006047	180	397	217	0.96875	0.370307
GCA_905216605.1-Pla_LR999453.1_i000_006324	178	397	219	0.977679	0.413208
GCA_019202805.1-Pla_CM032907.1_i000_033915	178	397	219	0.977679	0.412429
GCA_019202795.1-Pla_CM032920.1_i000_033655	178	397	219	0.977679	0.412429
GCA_015679515.1-Fun_JAAAVA010002323.1_i000_010995	247	472	225	1.00446	0.389948
GCA_016097945.1-Fun_JAAAIR010001920.1_i000_003202	186	410	224	1	0.455285
GCA_015849285.1-Fun_JAAAHZ010000197.1_i000_003033	182	401	219	0.977679	0.42607
GCA_021556665.1-Fun_JAKFGG010000003.1_i000_001155	105	330	225	1.00446	0.463918
GCA_018292915.1-Ani_JACVVK010000005.1_i000_001123	180	400	220	0.982143	0.417457
GCA_900079185.1-Fun_LT554760.1_i000_009253	216	441	225	1.00446	0.431034
GCA_014300015.1-Ani_CM025008.1_i000_000296	180	400	220	0.982143	0.388007
GCA_016758945.1-Fun_JAEPRC010001140.1_i000_011325	182	400	218	0.973214	0.439516
GCA_008330625.1-Pro_VLTM01000065.1_i000_005308	183	399	216	0.964286	0.427723
GCA_008330635.1-Pro_VLTL01000009.1_i000_001068	183	399	216	0.964286	0.427723
GCA_008330645.1-Pro_VLTN01000060.1_i000_007018	183	399	216	0.964286	0.427723
GCA_008330665.1-Pro_VLTO01000036.1_i000_005293	183	399	216	0.964286	0.427723
GCA_003999625.1-Ani_CM012438.1_i000_001515	180	400	220	0.982143	0.410448
GCA_015529505.1-Fun_JAAAUI010000044.1_i000_006337	182	400	218	0.973214	0.428291
GCA_015529515.1-Fun_JAAAUJ010000074.1_i000_008733	182	400	218	0.973214	0.428291
GCA_905368565.1-Ani_CAJPIZ010002285.1_i000_004718	181	400	219	0.977679	0.407821
GCA_009733165.1-Ani_CM019148.1_i000_002092	180	400	220	0.982143	0.412758
GCA_000516915.1-Ani_AZIM01001659.1_i000_008057	177	397	220	0.982143	0.412758
GCA_002105155.1-Fun_MCFF01000003.1_i000_005262	182	400	218	0.973214	0.424125
GCA_015847225.1-Fun_JAAAHT010000816.1_i000_005063	182	400	218	0.973214	0.424125
GCA_010094145.1-Fun_ML979003.1_i000_010862	192	417	225	1.00446	0.435203
GCA_900079185.1-Fun_LT554895.1_i000_010468	186	411	225	1.00446	0.453629
GCA_016758905.1-Fun_JAEPQZ010000008.1_i000_007787	185	410	225	1.00446	0.349922
GCA_015849305.1-Fun_JAAAHY010000139.1_i000_001671	182	401	219	0.977679	0.42607
GCA_905332325.1-Ani_CAJOBW010009718.1_i000_025987	32	254	222	0.991071	0.689441
GCA_015679605.1-Fun_JAAAVE010000060.1_i000_008232	182	400	218	0.973214	0.427451
GCA_019097595.1-Ani_CM032604.1_i000_010227	180	400	220	0.982143	0.39783
GCA_905331505.1-Ani_CAJNYZ010004361.1_i000_035505	35	257	222	0.991071	0.683077
GCA_905331525.1-Ani_CAJNZF010002559.1_i000_032782	35	257	222	0.991071	0.683077
GCA_905332305.1-Ani_CAJOBU010019135.1_i000_037167	35	257	222	0.991071	0.683077
GCA_905332315.1-Ani_CAJOBV010007267.1_i000_030405	35	257	222	0.991071	0.683077
GCA_009735665.1-Ani_MQTX01000085.1_i000_003259	183	401	218	0.973214	0.443992
GCA_003731715.1-Ani_RJVU01051519.1_i000_013888	180	398	218	0.973214	0.218876
GCA_021235465.1-Fun_JAJSME010000015.1_i000_002635	186	411	225	1.00446	0.456389
GCA_000775465.1-Fun_AJIZ01000014.1_i000_001344	161	399	238	1.0625	0.409639
GCA_000784615.1-Fun_JPEW01000016.1_i000_000844	161	399	238	1.0625	0.409639
GCA_014170095.1-Ani_WKFB01000039.1_i000_002018	139	359	220	0.982143	0.444444
GCA_015529505.1-Fun_JAAAUI010000042.1_i000_006129	182	400	218	0.973214	0.424125
GCA_001691775.3-Fun_JNHW02000036.1_i000_004949	183	403	220	0.982143	0.376712
GCA_000773725.1-Fun_AJIX01000013.1_i000_000599	156	394	238	1.0625	0.416813
GCA_000774085.1-Fun_AJIT01000008.1_i000_005858	155	393	238	1.0625	0.415358
GCA_000773755.1-Fun_AJIS01000033.1_i000_001964	157	395	238	1.0625	0.414634
GCA_000784595.1-Fun_JPEV01000011.1_i000_000454	156	394	238	1.0625	0.414634
GCA_000773805.1-Fun_AJIY01000006.1_i000_005859	150	388	238	1.0625	0.420495
GCA_000784505.1-Fun_AJJD01000006.1_i000_005330	150	388	238	1.0625	0.420495
GCA_000784525.1-Fun_JSXP01000007.1_i000_005878	156	394	238	1.0625	0.409639
GCA_000773825.1-Fun_AJJA01000011.1_i000_000193	158	396	238	1.0625	0.416084
GCA_000775505.1-Fun_AJJB01000009.1_i000_005935	161	399	238	1.0625	0.410345
GCA_015499985.1-Fun_JAAAUF010000038.1_i000_006578	871	1095	224	1	0.190963
GCA_000773745.1-Fun_AJIU01000007.1_i000_005873	158	396	238	1.0625	0.415358
GCA_001663975.1-Ani_CM004483.1_i000_040764	180	399	219	0.977679	0.461053
GCA_000376725.2-Ani_KZ308157.1_i000_001513	180	401	221	0.986607	0.418561
GCA_001638945.1-Fun_AMYB01000001.1_i000_000554	182	400	218	0.973214	0.434263
GCA_010203745.1-Fun_JAAECE010000004.1_i000_006746	182	400	218	0.973214	0.434263
GCA_019671135.1-Fun_JAHRHY010000002.1_i000_005589	186	410	224	1	0.459016
GCA_000784655.1-Fun_JTBX01000023.1_i000_001528	158	396	238	1.0625	0.416813
GCA_000784495.1-Fun_AJJE01000008.1_i000_005856	150	388	238	1.0625	0.420495
GCA_000775525.1-Fun_AJJC01000012.1_i000_000509	156	394	238	1.0625	0.415358
GCA_000775445.1-Fun_AJIV01000012.1_i000_000580	156	394	238	1.0625	0.416813
GCA_001005745.2-Ani_JARO02001421.1_i000_004829	169	388	219	0.977679	0.478166
GCA_019648995.1-Ani_BLXT01007282.1_i000_064166	181	401	220	0.982143	0.418251
GCA_000691765.2-Fun_KK667224.1_i000_001999	159	397	238	1.0625	0.414634
GCA_016758985.1-Fun_JAEPRD010000032.1_i000_004442	182	400	218	0.973214	0.441296
GCA_002157105.1-Fun_KZ150841.1_i000_005551	186	410	224	1	0.453441
GCA_000149445.2-Fun_CH672350.1_i000_001916	158	396	238	1.0625	0.416084
GCA_014170095.1-Ani_WKFB01000039.1_i000_002010	180	400	220	0.982143	0.410448
GCA_010093635.1-Fun_MU006783.1_i000_005851	193	417	224	1	0.433269
GCA_905331515.1-Ani_CAJNZC010003154.1_i000_034709	61	282	221	0.986607	0.62963
GCA_016835505.1-Ani_CM029060.1_i000_006426	180	399	219	0.977679	0.343799
GCA_000219495.2-Pla_CM001220.2_i000_022353	177	396	219	0.977679	0.396022
GCA_003473485.2-Pla_CM010651.1_i000_020758	177	396	219	0.977679	0.396022
GCA_015529515.1-Fun_JAAAUJ010000046.1_i000_006594	182	400	218	0.973214	0.424125
GCA_015847195.1-Fun_JAAAHV010000005.1_i000_007424	826	1050	224	1	0.193604
GCA_001275005.1-Pro_JWZX01003164.1_i000_013818	182	399	217	0.96875	0.502315
GCA_000775455.1-Fun_AJIR01000008.1_i000_005894	158	396	238	1.0625	0.416084
GCA_014049485.1-Fun_JABWAD010000060.1_i000_005222	129	353	224	1	0.424242
GCA_003550305.1-Fun_QKYT01000095.1_i000_020688	184	408	224	1	0.336336
GCA_001483515.1-Pro_JTAI01000028.1_i000_002734	182	404	222	0.991071	0.477419
GCA_001593465.1-Pro_JIBM01000109.1_i000_003066	182	404	222	0.991071	0.477419
GCA_001593475.1-Pro_JIBN01000026.1_i000_000500	182	404	222	0.991071	0.477419
GCA_002223825.1-Pro_LN877949.1_i000_001041	182	404	222	0.991071	0.477419
GCA_007210665.1-Pro_PYHZ01000003.1_i000_001127	182	404	222	0.991071	0.476395
GCA_015245375.1-Pro_CP044420.1_i000_001066	182	404	222	0.991071	0.476395
GCA_000165345.1-Pro_CM000431.1_i000_001028	183	405	222	0.991071	0.475375
GCA_002105175.1-Fun_MCGE01000023.1_i000_006308	182	400	218	0.973214	0.443992
GCA_016758935.1-Fun_JAEPRE010000346.1_i000_006071	177	395	218	0.973214	0.446721
GCA_002104935.1-Fun_MCGT01000055.1_i000_009297	182	401	219	0.977679	0.439759
GCA_905332295.1-Ani_CAJOBT010008075.1_i000_028068	85	305	220	0.982143	0.588235
GCA_013398625.1-Ani_VZSS01000012.1_i000_012336	177	395	218	0.973214	0.468817
GCA_016745375.1-Ani_WIOS01000033.1_i000_014950	180	398	218	0.973214	0.398537
GCA_905329745.1-Ani_CAJNSZ010005333.1_i000_040728	19	238	219	0.977679	0.718033
GCA_905330235.1-Ani_CAJNUA010001883.1_i000_033046	19	238	219	0.977679	0.718033
GCA_905330535.1-Ani_CAJNVN010006278.1_i000_040132	19	238	219	0.977679	0.718033
GCA_020887355.1-Pla_AP024989.1_i000_001567	178	398	220	0.982143	0.397112
GCA_004119915.2-Ani_CM014078.1_i000_000239	180	400	220	0.982143	0.412758
GCA_013396435.1-Ani_WBMU01008842.1_i000_013476	115	335	220	0.982143	0.467091
GCA_007224835.1-Ani_SRMA01026906.1_i000_017976	180	398	218	0.973214	0.365159
GCA_015847235.1-Fun_JAAAHU010000141.1_i000_001822	258	482	224	1	0.401434
GCA_015680905.1-Pla_CM027383.1_i000_029558	130	259	129	0.575893	0.498069
GCA_000147195.1-Ani_GL446332.1_i000_002170	178	396	218	0.973214	0.322963
GCA_001691755.2-Fun_JNHY02000298.1_i000_003844	252	473	221	0.986607	0.348031
GCA_019176425.1-Ani_CM032886.1_i000_013444	180	399	219	0.977679	0.401099
GCA_015529505.1-Fun_JAAAUI010000427.1_i000_006221	186	410	224	1	0.459016
GCA_015529515.1-Fun_JAAAUJ010000015.1_i000_001629	186	410	224	1	0.459016
GCA_000265015.1-Fun_JH687742.1_i000_005263	186	410	224	1	0.433269
GCA_002249905.1-Ani_NNAY01000126.1_i000_001566	204	423	219	0.977679	0.366221
GCA_905332165.1-Ani_CAJOBK010015936.1_i000_042920	34	253	219	0.977679	0.684375
GCA_905332175.1-Ani_CAJOBL010024350.1_i000_044722	34	253	219	0.977679	0.684375
GCA_905332185.1-Ani_CAJOBM010026551.1_i000_041256	34	253	219	0.977679	0.684375
GCA_001447645.1-Ani_JYDV01000005.1_i000_001246	224	449	225	1.00446	0.387931
GCA_001447575.1-Ani_JYDT01000116.1_i000_009174	224	449	225	1.00446	0.387931
GCA_001447675.1-Ani_JYDR01000064.1_i000_006179	224	449	225	1.00446	0.387931
GCA_016098035.1-Fun_JAAAIV010000027.1_i000_004154	1005	1224	219	0.977679	0.1638
GCA_016618255.1-Pla_VFSX01000039.1_i000_000096	177	396	219	0.977679	0.438
GCA_905249995.1-Ani_CAJNOK010003109.1_i000_008989	179	398	219	0.977679	0.498861
GCA_905250885.1-Ani_CAJNOQ010000432.1_i000_003480	179	398	219	0.977679	0.498861
GCA_905332065.1-Ani_CAJOBC010000432.1_i000_003480	179	398	219	0.977679	0.498861
GCA_905332075.1-Ani_CAJOBA010003109.1_i000_008983	179	398	219	0.977679	0.498861
GCA_013115145.1-Pro_JAAPAO010000636.1_i000_008925	181	404	223	0.995536	0.453252
GCA_001447725.1-Ani_JYDS01000138.1_i000_005828	224	449	225	1.00446	0.391304
GCA_017589495.1-Ani_CM030068.1_i000_025254	180	399	219	0.977679	0.407063
GCA_003336725.1-Ani_JOJR01000706.1_i000_018752	63	281	218	0.973214	0.714754
GCA_009731335.1-Pro_BLBS01000050.1_i000_006400	98	303	205	0.915179	0.601173
GCA_021904315.1-Pla_CM038910.1_i000_006508	177	396	219	0.977679	0.503448
GCA_016097945.1-Fun_JAAAIR010000044.1_i000_005416	182	400	218	0.973214	0.465812
GCA_004119895.1-Ani_SCEB01214839.1_i000_016368	180	399	219	0.977679	0.417143
GCA_000281105.1-Fun_JH767603.1_i000_008171	192	416	224	1	0.414048
GCA_000002985.3-Ani_BX284601.5_i000_000447	177	395	218	0.973214	0.447639
GCA_004936735.2-Pro_SCFC02000005.1_i000_001030	182	404	222	0.991071	0.476395
GCA_001045655.1-Ani_LBMM01000512.1_i000_001419	179	398	219	0.977679	0.348172
GCA_000695815.1-Ani_KK828678.1_i000_002558	167	386	219	0.977679	0.42607
GCA_019650175.1-Pla_BNCO01000003.1_i000_001800	178	397	219	0.977679	0.37372
GCA_000828355.1-Ani_JXLN01005820.1_i000_002066	168	387	219	0.977679	0.455301
GCA_009761285.1-Ani_VYZN01000001.1_i000_000713	178	396	218	0.973214	0.381119
GCA_002245815.2-Pla_LHPF02000042.1_i000_006726	179	399	220	0.982143	0.426357
GCA_015679485.1-Fun_JAAAUY010000300.1_i000_005296	182	400	218	0.973214	0.428291
GCA_018991925.1-Ani_JAHLQT010031643.1_i000_018181	180	398	218	0.973214	0.468817
GCA_013400115.1-Ani_VXBP01000619.1_i000_000946	115	340	225	1.00446	0.475687
GCA_001663975.1-Ani_CM004482.1_i000_038427	180	399	219	0.977679	0.410112
GCA_000006295.1-Ani_DS235832.1_i000_002489	180	398	218	0.973214	0.381119
GCA_019650235.1-Pla_BNCP01000003.1_i000_001583	178	397	219	0.977679	0.401099
GCA_019650255.1-Pla_BNCQ01000001.1_i000_000416	178	397	219	0.977679	0.401099
GCA_905250055.1-Ani_CAJNOF010000307.1_i000_025818	178	398	220	0.982143	0.471092
GCA_905250075.1-Ani_CAJNOP010001934.1_i000_057087	178	398	220	0.982143	0.471092
GCA_905331535.1-Ani_CAJNZB010001969.1_i000_037150	178	398	220	0.982143	0.471092
GCA_014595675.1-Ani_WVUK01000065.1_i000_006425	181	400	219	0.977679	0.44332
GCA_003952965.2-Pla_CM025856.1_i000_024568	177	396	219	0.977679	0.376289
GCA_907169785.1-Ani_CAJRST010015557.1_i000_012609	180	399	219	0.977679	0.411654
GCA_000090985.2-Pla_CP001574.1_i000_000649	174	394	220	0.982143	0.467091
GCA_000209185.1-Ani_DS232376.1_i000_005164	180	397	217	0.96875	0.386121
GCA_003086735.1-Fun_MBFR01000155.1_i000_003458	184	402	218	0.973214	0.403704
GCA_910592005.1-Fun_CAJVPP010003079.1_i000_009935	190	414	224	1	0.445328
GCA_015679405.1-Fun_JAAAUU010000110.1_i000_000640	182	400	218	0.973214	0.425781
GCA_016098005.1-Fun_JAAAIS010000295.1_i000_005510	182	400	218	0.973214	0.425781
GCA_015529795.1-Fun_JAAAUH010000122.1_i000_001065	182	400	218	0.973214	0.425781
GCA_016098165.1-Fun_JAAAJA010000305.1_i000_004585	182	400	218	0.973214	0.426614
GCA_003711565.2-Ani_CM011071.1_i000_004465	180	399	219	0.977679	0.417143
GCA_004026145.2-Ani_CP034986.1_i000_002389	180	399	219	0.977679	0.417143
GCA_019669825.1-Fun_MU253914.1_i000_005026	193	418	225	1.00446	0.437743
GCA_002082055.1-Ani_MTYJ01000028.1_i000_005288	180	398	218	0.973214	0.403704
GCA_015500005.1-Fun_JAAAUG010000073.1_i000_009380	182	400	218	0.973214	0.422481
GCA_013339765.1-Ani_CM023450.1_i000_007852	180	398	218	0.973214	0.404453
GCA_015529785.1-Fun_JAAAUK010001547.1_i000_002507	182	400	218	0.973214	0.426614
GCA_000002335.3-Ani_CM000278.3_i000_003149	180	398	218	0.973214	0.392086
GCA_009805615.1-Ani_VIIS01000589.1_i000_006849	178	396	218	0.973214	0.369492
GCA_905397405.1-Ani_CAJPVJ010000897.1_i000_003165	166	315	149	0.665179	0.319058
GCA_905397405.1-Ani_CAJPVJ010000897.1_i000_003165	309	429	120	0.535714	0.256959
GCA_000688135.1-Ani_JARK01001341.1_i000_009043	198	416	218	0.973214	0.4334
GCA_910591825.1-Fun_CAJVPQ010002259.1_i000_008031	190	413	223	0.995536	0.42315
GCA_015679595.1-Fun_JAAAVB010000877.1_i000_011352	182	400	218	0.973214	0.428291
GCA_002287525.1-Ani_LIAE01008690.1_i000_014685	177	398	221	0.986607	0.440239
GCA_001447755.1-Ani_JYDO01000001.1_i000_004144	211	436	225	1.00446	0.391304
GCA_019721115.1-Ani_CM033896.1_i000_006682	180	400	220	0.982143	0.392857
GCA_008638375.1-Pla_CM018042.1_i000_033166	5	118	113	0.504464	0.480851
GCA_000401635.1-Fun_KE123950.1_i000_004680	186	411	225	1.00446	0.456389
GCA_000004555.3-Ani_FR847112.2_i000_000630	160	378	218	0.973214	0.466809
GCA_002287525.1-Ani_LIAE01006789.1_i000_006244	177	398	221	0.986607	0.438492
GCA_001651475.1-Pla_CM004361.1_i000_011516	178	397	219	0.977679	0.410882
GCA_019202795.1-Pla_CM032915.1_i000_011597	178	397	219	0.977679	0.410882
GCA_019202805.1-Pla_CM032902.1_i000_011113	178	397	219	0.977679	0.410882
GCA_902651935.1-Pla_CACRSJ010000106.1_i000_011803	178	397	219	0.977679	0.410882
GCA_902705455.1-Pla_CACSHJ010000089.1_i000_011639	178	397	219	0.977679	0.410882
GCA_904420315.1-Pla_LR881468.1_i000_009675	178	397	219	0.977679	0.410882
GCA_015039405.1-Fun_WJDU01000074.1_i000_015042	180	406	226	1.00893	0.40942
GCA_013399455.1-Ani_VWYI01038321.1_i000_010167	168	386	218	0.973214	0.43083
GCA_018446385.1-Pla_CM031527.1_i000_070654	177	395	218	0.973214	0.380454
GCA_000219495.2-Pla_CM001221.2_i000_026810	177	396	219	0.977679	0.371186
GCA_003473485.2-Pla_CM010652.1_i000_024994	177	396	219	0.977679	0.371186
GCA_003990785.1-Fun_RBNK01007040.1_i000_007765	185	409	224	1	0.430769
GCA_004193795.1-Ani_QDEB01124868.1_i000_014061	180	398	218	0.973214	0.389286
GCA_000235365.1-Fun_CP002500.1_i000_002234	92	313	221	0.986607	0.478355
GCA_015679695.1-Fun_JAAAVD010001340.1_i000_001651	182	400	218	0.973214	0.418426
GCA_015849335.1-Fun_JAAAIC010000092.1_i000_010698	182	400	218	0.973214	0.418426
GCA_015852335.1-Fun_JAAAID010000405.1_i000_003608	182	400	218	0.973214	0.418426
GCA_015502455.1-Fun_JAAAUM010000636.1_i000_009198	182	400	218	0.973214	0.420849
GCA_001270105.1-Ani_LHQP01030838.1_i000_038277	187	405	218	0.973214	0.388592
GCA_006535965.1-Fun_QEAR01000025.1_i000_003873	186	409	223	0.995536	0.437255
GCA_002201585.1-Pla_MTKT01017405.1_i000_029127	177	396	219	0.977679	0.388988
GCA_001638945.1-Fun_AMYB01000006.1_i000_007659	187	412	225	1.00446	0.456389
GCA_010203745.1-Fun_JAAECE010000012.1_i000_002476	187	412	225	1.00446	0.456389
GCA_021235465.1-Fun_JAJSME010000001.1_i000_000457	181	401	220	0.982143	0.427184
GCA_015847195.1-Fun_JAAAHV010000263.1_i000_004247	182	400	218	0.973214	0.462845
GCA_000271605.1-Fun_JH717974.1_i000_006992	180	391	211	0.941964	0.375445
GCA_013400215.1-Ani_VXBR01000875.1_i000_000904	167	385	218	0.973214	0.437751
GCA_009805615.1-Ani_VIIS01001978.1_i000_022381	141	360	219	0.977679	0.395307
GCA_002786265.1-Pla_KZ451969.1_i000_010261	177	395	218	0.973214	0.372014
GCA_018320845.1-Ani_CM031335.1_i000_024155	180	400	220	0.982143	0.404412
GCA_000004195.4-Ani_CM004451.2_i000_023094	180	399	219	0.977679	0.410882
GCA_001865345.1-Pro_LRBP01000039.1_i000_001817	182	404	222	0.991071	0.476395
GCA_000182805.2-Fun_CABT02000019.1_i000_004120	191	305	114	0.508929	0.183575
GCA_000182805.2-Fun_CABT02000019.1_i000_004120	322	404	82	0.366071	0.132045
GCA_009835225.1-Ani_VUJU01007000.1_i000_021354	138	356	218	0.973214	0.383128
GCA_002104945.1-Fun_MCFH01000012.1_i000_001183	181	400	219	0.977679	0.439759
GCA_000227115.2-Fun_HE580273.2_i000_003736	122	354	232	1.03571	0.467742
GCA_001974805.1-Pla_AWWV01006115.1_i000_002314	101	228	127	0.566964	0.40836
GCA_001974805.1-Pla_AWWV01006115.1_i000_002314	221	300	79	0.352679	0.254019
GCA_013399015.1-Ani_VWZX01010881.1_i000_013630	168	386	218	0.973214	0.47807
GCA_000315915.1-Fun_HE806318.1_i000_002231	139	375	236	1.05357	0.46184
GCA_000827335.1-Fun_KN831978.1_i000_012257	183	406	223	0.995536	0.414498
GCA_018446385.1-Pla_CM031526.1_i000_067747	250	468	218	0.973214	0.33694
GCA_905221625.1-Pro_CAJNDU010008459.1_i000_010222	213	429	216	0.964286	0.164009
GCA_013398195.1-Ani_VZSB01002942.1_i000_005131	165	383	218	0.973214	0.481236
GCA_905250015.1-Ani_CAJNOM010000577.1_i000_043807	179	398	219	0.977679	0.470968
GCA_905250115.1-Ani_CAJNOI010000008.1_i000_003616	179	398	219	0.977679	0.470968
GCA_004119895.1-Ani_SCEB01214950.1_i000_017112	264	483	219	0.977679	0.362583
GCA_905250015.1-Ani_CAJNOM010000498.1_i000_041463	179	398	219	0.977679	0.470968
GCA_015502465.1-Fun_JAAAUP010000041.1_i000_006999	186	410	224	1	0.456212
GCA_000143925.2-Ani_GL379959.1_i000_020776	177	395	218	0.973214	0.450413
GCA_905250025.1-Ani_CAJNOJ010000129.1_i000_023445	179	394	215	0.959821	0.466377
GCA_013397635.1-Ani_VYZG01000371.1_i000_004130	165	383	218	0.973214	0.481236
GCA_019512145.1-Ani_CM033648.1_i000_015547	180	399	219	0.977679	0.410882
GCA_004369175.1-Fun_QPFP01000027.1_i000_009963	199	424	225	1.00446	0.376884
GCA_910592325.1-Fun_CAJVPM010010450.1_i000_005924	182	402	220	0.982143	0.399274
GCA_003709365.1-Pla_QOKY01000171.1_i000_002841	181	401	220	0.982143	0.427184
GCA_017311285.1-Fun_JABTEG010000009.1_i000_001260	186	412	226	1.00893	0.43295
GCA_009982855.1-Fun_JAADKA010000002.1_i000_003695	192	417	225	1.00446	0.436893
GCA_000697945.4-Ani_ML763204.1_i000_012253	188	405	217	0.96875	0.382042
GCA_019059645.1-Ani_JAFELL010003276.1_i000_029436	180	399	219	0.977679	0.412429
GCA_000002595.3-Pla_CM008971.1_i000_010466	178	397	219	0.977679	0.431102
GCA_016098015.1-Fun_JAAAIT010001534.1_i000_002226	182	400	218	0.973214	0.424125
GCA_019973955.1-Ani_BMAV01006855.1_i000_012187	179	398	219	0.977679	0.468951
GCA_002914805.1-Pla_JXTB01000031.1_i000_005492	176	395	219	0.977679	0.384211
GCA_902729315.2-Pla_LR746275.1_i000_016602	177	395	218	0.973214	0.377163
GCA_013396955.1-Ani_VWZN01000679.1_i000_000323	180	398	218	0.973214	0.465812
GCA_910591945.1-Fun_CAJVPL010000503.1_i000_004403	189	414	225	1.00446	0.237592
GCA_003547095.1-Fun_PQFF01000551.1_i000_024898	185	409	224	1	0.393673
GCA_003614755.1-Fun_KZ989510.1_i000_002200	189	414	225	1.00446	0.451807
GCA_000798715.1-Fun_JNVN01001741.1_i000_003577	192	418	226	1.00893	0.504464
GCA_016984175.1-Ani_JAAWVO010062580.1_i000_011659	180	399	219	0.977679	0.414773
GCA_014462685.1-Ani_JAACXV010000399.1_i000_008685	180	399	219	0.977679	0.387611
GCA_013399365.1-Ani_VWYH01001147.1_i000_001548	165	383	218	0.973214	0.481236
GCA_900074755.1-Fun_LT598453.1_i000_003707	96	322	226	1.00893	0.469854
GCA_000281125.4-Ani_AKHW03003682.1_i000_011999	180	400	220	0.982143	0.427184
GCA_016618385.1-Ani_JABFOP010000285.1_i000_007176	179	398	219	0.977679	0.390374
GCA_000143455.1-Pla_GL378324.1_i000_000860	178	397	219	0.977679	0.41635
GCA_001531365.1-Pla_CM009734.1_i000_006343	188	412	224	1	0.416357
GCA_000816745.1-Ani_KN729761.1_i000_007775	231	448	217	0.96875	0.416507
GCA_902806785.1-Ani_CADCXU010035394.1_i000_024102	64	283	219	0.977679	0.477124
GCA_002554575.1-Fun_KZ302241.1_i000_008830	183	403	220	0.982143	0.381282
GCA_905249995.1-Ani_CAJNOK010000026.1_i000_000234	179	399	220	0.982143	0.47619
GCA_905250885.1-Ani_CAJNOQ010000434.1_i000_003494	179	399	220	0.982143	0.47619
GCA_905332065.1-Ani_CAJOBC010000434.1_i000_003494	179	399	220	0.982143	0.47619
GCA_905332075.1-Ani_CAJOBA010000026.1_i000_000234	179	399	220	0.982143	0.47619
GCA_015039405.1-Fun_WJDU01000017.1_i000_004161	180	406	226	1.00893	0.40942
GCA_013400935.1-Ani_VZTY01002268.1_i000_000780	178	397	219	0.977679	0.44332
GCA_904066225.2-Ani_CAJFCW020000001.1_i000_000976	178	398	220	0.982143	0.477223
GCA_904067145.1-Ani_CAJFDH010000001.1_i000_000976	178	398	220	0.982143	0.477223
GCA_009768925.2-Pro_VHIT02000014.1_i000_002524	182	404	222	0.991071	0.476395
GCA_013396655.1-Ani_WBMV01009146.1_i000_013307	167	385	218	0.973214	0.477024
GCA_006535965.1-Fun_QEAR01000035.1_i000_004631	181	400	219	0.977679	0.414773
GCA_015679545.1-Fun_JAAAUZ010001244.1_i000_009357	182	400	218	0.973214	0.421663
GCA_009792415.2-Pro_VHLK02000010.1_i000_003040	182	404	222	0.991071	0.476395
GCA_004798865.1-Ani_SJPD01000030.1_i000_007557	180	399	219	0.977679	0.408582
GCA_000611955.2-Ani_KK120312.1_i000_021813	180	399	219	0.977679	0.464968
GCA_000471905.1-Pla_KI394767.1_i000_019543	177	395	218	0.973214	0.368866
GCA_015849305.1-Fun_JAAAHY010001126.1_i000_000619	174	398	224	1	0.46281
GCA_019968535.1-Ani_JAIFTH010000014.1_i000_002079	177	397	220	0.982143	0.514019
GCA_003711585.2-Ani_CM011673.2_i000_022812	180	400	220	0.982143	0.411985
GCA_001186125.1-Pro_KQ241691.1_i000_002172	208	427	219	0.977679	0.414773
GCA_003610855.1-Fun_MCFK01001957.1_i000_000834	192	418	226	1.00893	0.432122
GCA_000583005.2-Pla_ASHM01002427.1_i000_004712	22	241	219	0.977679	0.5475
GCA_003845795.1-Ani_CM011686.1_i000_012489	180	400	220	0.982143	0.412758
GCA_016097855.1-Fun_JAAAIM010001969.1_i000_004085	182	400	218	0.973214	0.431683
GCA_020080795.1-Fun_JAGHQM010001125.1_i000_000499	191	417	226	1.00893	0.4
GCA_000375325.1-Pla_KB870807.1_i000_007360	212	431	219	0.977679	0.369309
GCA_015680905.1-Pla_CM027381.1_i000_021266	178	397	219	0.977679	0.382199
GCA_012274485.2-Pla_MU105707.1_i000_012641	177	395	218	0.973214	0.407477
GCA_016906555.1-Fun_CP059646.1_i000_005523	187	411	224	1	0.415584
GCA_016906575.1-Fun_CP059614.1_i000_005595	187	411	224	1	0.415584
GCA_010078415.1-Ani_VUKZ01002993.1_i000_002650	83	301	218	0.973214	0.587601
GCA_910591965.1-Fun_CAJVPY010005893.1_i000_010255	182	401	219	0.977679	0.439759
GCA_019343175.1-Ani_CM033276.1_i000_009185	180	398	218	0.973214	0.47807
GCA_003434825.1-Pla_CM010633.1_i000_022064	177	395	218	0.973214	0.407477
GCA_020796205.1-Pla_CM036891.1_i000_004540	235	454	219	0.977679	0.332322
GCA_900412535.3-Pla_LS974622.2_i000_031042	177	395	218	0.973214	0.407477
GCA_000699085.1-Ani_KL218130.1_i000_007294	167	386	219	0.977679	0.481319
GCA_013398575.1-Ani_WBNC01000655.1_i000_005045	173	391	218	0.973214	0.472885
GCA_000337935.2-Ani_AKCR02000142.1_i000_011758	180	397	217	0.96875	0.284031
GCA_013399355.1-Ani_VXAJ01000022.1_i000_004711	174	392	218	0.973214	0.471861
GCA_902806795.1-Ani_CADCXV010000602.1_i000_002993	179	397	218	0.973214	0.174679
GCA_000750925.1-Fun_JPKC01000027.1_i000_000071	193	418	225	1.00446	0.445545
GCA_000750995.1-Fun_JPKE01004179.1_i000_010758	193	418	225	1.00446	0.445545
GCA_016906575.1-Fun_CP059630.1_i000_020406	187	411	224	1	0.414815
GCA_903813345.1-Ani_CAIIXF010000001.1_i000_002324	186	411	225	1.00446	0.435203
GCA_006348945.1-Ani_SRLO01000995.1_i000_046694	180	399	219	0.977679	0.410112
GCA_012432095.1-Ani_CM022815.1_i000_006728	180	398	218	0.973214	0.389982
GCA_013399695.1-Ani_VXAU01003312.1_i000_007156	167	385	218	0.973214	0.409006
GCA_019176455.1-Ani_CM032855.1_i000_002858	180	399	219	0.977679	0.412429
GCA_002081605.1-Ani_MNPL01001452.1_i000_001292	180	398	218	0.973214	0.428291
GCA_013400955.1-Ani_VZTZ01024241.1_i000_006237	168	386	218	0.973214	0.47807
GCA_016097925.1-Fun_JAAAIQ010002461.1_i000_005278	182	400	218	0.973214	0.531707
GCA_003550325.1-Fun_QKWP01000456.1_i000_011299	182	402	220	0.982143	0.510441
GCA_000375325.1-Pla_KB870807.1_i000_007466	101	307	206	0.919643	0.556757
GCA_000182565.2-Fun_KQ257457.1_i000_005400	181	400	219	0.977679	0.413208
GCA_016098045.1-Fun_JAAAIW010000080.1_i000_010497	182	400	218	0.973214	0.389286
GCA_016098035.1-Fun_JAAAIV010000048.1_i000_006910	590	808	218	0.973214	0.235421
GCA_001638985.2-Fun_KV441024.1_i000_014215	182	400	218	0.973214	0.439516
GCA_003990765.1-Fun_RBNJ01002733.1_i000_003828	185	410	225	1.00446	0.431034
GCA_000820885.1-Fun_CCBQ010000027.1_i000_002253	102	325	223	0.995536	0.501124
GCA_013400795.1-Ani_VZTS01006160.1_i000_002781	178	395	217	0.96875	0.535802
GCA_000692075.1-Ani_KK735554.1_i000_009945	170	388	218	0.973214	0.473913
GCA_016098005.1-Fun_JAAAIS010000851.1_i000_011026	152	370	218	0.973214	0.455115
GCA_013398885.1-Ani_VYZL01003715.1_i000_008558	115	340	225	1.00446	0.477707
GCA_013400255.1-Ani_VXBS01003965.1_i000_004795	167	385	218	0.973214	0.437751
GCA_000764305.3-Ani_JQDR03009694.1_i000_004779	166	384	218	0.973214	0.426614
GCA_001883845.1-Fun_MNUE01000014.1_i000_001848	192	417	225	1.00446	0.429389
GCA_017639395.1-Pla_CM029887.1_i000_036303	177	395	218	0.973214	0.406716
GCA_000751015.1-Pla_LK032100.1_i000_012423	177	395	218	0.973214	0.407477
GCA_003434825.1-Pla_CM010636.1_i000_030432	177	395	218	0.973214	0.407477
GCA_900412535.3-Pla_LS974625.2_i000_041506	177	395	218	0.973214	0.407477
GCA_003260655.2-Pla_QGKV02000759.1_i000_030365	177	395	218	0.973214	0.406716
GCA_001447665.1-Ani_JYDP01000001.1_i000_000253	187	412	225	1.00446	0.219727
GCA_003260675.2-Pla_QGKX02001621.1_i000_031345	177	395	218	0.973214	0.406716
GCA_016771965.1-Pla_CM028698.1_i000_061169	177	395	218	0.973214	0.406716
GCA_020379485.1-Pla_CM035454.1_i000_031900	180	398	218	0.973214	0.405204
GCA_020379485.1-Pla_JAGKQM010003136.1_i000_096408	180	398	218	0.973214	0.405204
GCA_020379485.1-Pla_CM035464.1_i000_084439	180	398	218	0.973214	0.404453
GCA_015852495.1-Fun_JAAAIK010001872.1_i000_003291	152	370	218	0.973214	0.456067
GCA_019447015.1-Ani_CM033477.1_i000_017417	180	399	219	0.977679	0.413208
GCA_013400355.1-Ani_VXBV01003542.1_i000_005876	170	388	218	0.973214	0.402214
GCA_004786185.1-Ani_CM015734.1_i000_022061	180	399	219	0.977679	0.401835
GCA_008690995.1-Pro_VRMN01000003.1_i000_001984	136	372	236	1.05357	0.426763
GCA_016097885.1-Fun_JAAAIO010000667.1_i000_008606	182	400	218	0.973214	0.419231
GCA_003072535.2-Pro_CP056071.1_i000_001313	181	401	220	0.982143	0.516432
GCA_013339725.1-Ani_CM023459.1_i000_004559	113	331	218	0.973214	0.519048
GCA_000189635.1-Pro_GG662712.1_i000_009124	181	400	219	0.977679	0.478166
GCA_905332095.1-Ani_CAJOBD010001210.1_i000_013830	185	411	226	1.00893	0.469854
GCA_905251635.1-Ani_CAJNOT010001410.1_i000_022431	186	412	226	1.00893	0.46888
GCA_003203555.1-Fun_BEXD01004253.1_i000_025747	187	411	224	1	0.33383
GCA_015698045.1-Fun_BLAL01000044.1_i000_006710	187	411	224	1	0.33383
GCA_905250005.1-Ani_CAJNOH010000310.1_i000_014263	186	412	226	1.00893	0.46888
GCA_905250125.1-Ani_CAJNOL010002328.1_i000_039630	186	412	226	1.00893	0.46888
GCA_905250875.1-Ani_CAJNOO010001727.1_i000_023995	186	412	226	1.00893	0.46888
GCA_905252715.1-Ani_CAJNOU010001667.1_i000_022899	186	412	226	1.00893	0.46888
GCA_905332085.1-Ani_CAJOAX010000878.1_i000_010001	186	412	226	1.00893	0.46888
GCA_905332105.1-Ani_CAJOBE010007312.1_i000_027735	186	412	226	1.00893	0.46888
GCA_005966545.1-Pro_SPLM01000001.1_i000_002400	181	400	219	0.977679	0.435388
GCA_001687445.1-Fun_KV722333.1_i000_000718	180	400	220	0.982143	0.389381
GCA_016748015.1-Fun_JAAOMT010000436.1_i000_015068	182	403	221	0.986607	0.343168
GCA_002104895.1-Fun_MCFG01000011.1_i000_000529	186	410	224	1	0.453441
GCA_921294245.1-Ani_OV121132.1_i000_001301	178	396	218	0.973214	0.391382
GCA_013390105.1-Ani_WAAG01066741.1_i000_007686	174	391	217	0.96875	0.545226
GCA_015852425.1-Fun_JAAAIG010000039.1_i000_006789	182	400	218	0.973214	0.43254
GCA_907166875.3-Ani_CAJRHG030000002.1_i000_003209	180	397	217	0.96875	0.398165
GCA_013390065.1-Ani_WEIW01000504.1_i000_005048	180	398	218	0.973214	0.431683
GCA_000341285.1-Pro_KB454518.1_i000_003948	178	398	220	0.982143	0.427184
GCA_013399535.1-Ani_VZZW01000126.1_i000_002129	176	395	219	0.977679	0.471983
GCA_000750805.1-Fun_JPJY01001474.1_i000_007740	193	418	225	1.00446	0.446429
GCA_001662575.1-Fun_KV454979.1_i000_001544	193	418	225	1.00446	0.444664
GCA_015679405.1-Fun_JAAAUU010000052.1_i000_008306	182	400	218	0.973214	0.428291
GCA_013400295.1-Ani_WAAC01009728.1_i000_005612	179	398	219	0.977679	0.468951
GCA_013397655.1-Ani_VYZF01000782.1_i000_007006	180	399	219	0.977679	0.467949
GCA_013401015.1-Ani_VZUC01000003.1_i000_000467	179	398	219	0.977679	0.468951
GCA_013401055.1-Ani_VZUE01000119.1_i000_007455	179	398	219	0.977679	0.468951
GCA_013401065.1-Ani_VZUD01000126.1_i000_009128	180	399	219	0.977679	0.467949
GCA_000611835.1-Ani_KK107324.1_i000_010424	179	397	218	0.973214	0.326837
GCA_003672135.1-Ani_CM010861.1_i000_005616	179	397	218	0.973214	0.326837
GCA_016771965.1-Pla_JAAMPC010000105.1_i000_091083	177	395	218	0.973214	0.219095
GCA_013398955.1-Ani_VWPU01000869.1_i000_000564	180	397	217	0.96875	0.537129
GCA_021432655.1-Fun_MU271814.1_i000_015755	184	408	224	1	0.463768
GCA_020747045.1-Fun_JAGTJN010000012.1_i000_002483	192	416	224	1	0.430769
GCA_905368565.1-Ani_CAJPIZ010004518.1_i000_007465	144	372	228	1.01786	0.608
GCA_000750745.1-Fun_JPJV01001606.1_i000_004127	193	418	225	1.00446	0.445545
GCA_000002865.1-Pro_CH991588.1_i000_000400	180	399	219	0.977679	0.445122
GCA_013400035.1-Ani_VXBH01007413.1_i000_010294	171	390	219	0.977679	0.449692
GCA_019677355.1-Fun_WSLN01000245.1_i000_002776	189	413	224	1	0.400716
GCA_001638985.2-Fun_KV440980.1_i000_007764	182	400	218	0.973214	0.442191
GCA_015499985.1-Fun_JAAAUF010000334.1_i000_006046	182	400	218	0.973214	0.431683
GCA_016858145.1-Pla_JAEHOE010000002.1_i000_000962	178	397	219	0.977679	0.417939
GCA_003991915.1-Ani_RQTK01000017.1_i000_001058	181	401	220	0.982143	0.419048
GCA_015852395.1-Fun_JAAAII010003649.1_i000_011984	182	400	218	0.973214	0.431683
GCA_015849275.1-Fun_JAAAIA010000010.1_i000_000110	182	400	218	0.973214	0.427451
GCA_000441895.2-Ani_KE525025.1_i000_005871	180	398	218	0.973214	0.402214
GCA_013390045.1-Ani_WEKY01010189.1_i000_002311	180	398	218	0.973214	0.426614
GCA_014871385.1-Pla_CM026430.1_i000_024241	177	396	219	0.977679	0.374359
GCA_000165365.1-Pro_AAGK01000002.1_i000_001753	181	401	220	0.982143	0.517647
GCA_013339685.1-Ani_CM023482.1_i000_006742	180	398	218	0.973214	0.405959
GCA_007859695.1-Pla_CP031045.1_i000_006496	170	389	219	0.977679	0.464968
GCA_017639395.1-Pla_CM029884.1_i000_027526	177	401	224	1	0.415584
GCA_013398295.1-Ani_VZSF01000770.1_i000_000996	180	398	218	0.973214	0.465812
GCA_015679485.1-Fun_JAAAUY010000484.1_i000_007477	182	400	218	0.973214	0.426614
GCA_015679535.1-Fun_JAAAUX010000215.1_i000_003688	182	400	218	0.973214	0.426614
GCA_000209225.1-Ani_DS469511.1_i000_023766	180	399	219	0.977679	0.42607
GCA_000184105.1-Fun_GL573184.1_i000_001329	193	418	225	1.00446	0.43021
GCA_001641265.1-Fun_KV441400.1_i000_006184	193	418	225	1.00446	0.43021
GCA_022376525.1-Fun_WTXL01000042.1_i000_008071	180	400	220	0.982143	0.378657
GCA_022478865.1-Ani_JAHXPS010004637.1_i000_022026	180	399	219	0.977679	0.407063
GCA_020796205.1-Pla_CM036898.1_i000_017365	164	383	219	0.977679	0.391771
GCA_000750875.1-Fun_JPKA01005524.1_i000_010423	211	436	225	1.00446	0.431034
GCA_000769735.1-Fun_JQFY01000144.1_i000_001008	190	416	226	1.00893	0.44227
GCA_000769745.1-Fun_JQFZ01000170.1_i000_005124	190	416	226	1.00893	0.44227
GCA_000769755.1-Fun_JQFX01000717.1_i000_002519	190	416	226	1.00893	0.44227
GCA_004354835.1-Ani_CM014958.1_i000_021153	180	399	219	0.977679	0.412429
GCA_010077915.1-Ani_VUKU01022231.1_i000_011896	170	388	218	0.973214	0.475983
GCA_001651415.1-Fun_KV442035.1_i000_006487	182	400	218	0.973214	0.431683
GCA_006912115.1-Fun_VCMJ01000222.1_i000_000655	188	414	226	1.00893	0.432122
GCA_010076225.1-Ani_VUKV01002571.1_i000_002707	177	395	218	0.973214	0.468817
GCA_010076325.1-Ani_VUKW01001680.1_i000_002152	177	395	218	0.973214	0.468817
GCA_010077935.1-Ani_VUKX01011740.1_i000_010570	177	395	218	0.973214	0.468817
GCA_019623705.1-Fun_WSTJ01004851.1_i000_020055	189	413	224	1	0.404332
GCA_013677255.1-Pla_CM025222.1_i000_006719	19	237	218	0.973214	0.848249
GCA_010015445.1-Ani_CM020932.1_i000_023781	180	399	219	0.977679	0.411654
GCA_015502485.1-Fun_JAAAUO010002030.1_i000_005223	182	400	218	0.973214	0.431683
GCA_006937295.1-Pla_CM017321.1_i000_002871	177	396	219	0.977679	0.376289
GCA_000950595.1-Fun_DF836295.1_i000_010663	187	412	225	1.00446	0.454545
GCA_016758945.1-Fun_JAEPRC010000576.1_i000_008609	186	411	225	1.00446	0.457317
GCA_019623705.1-Fun_WSTJ01004850.1_i000_020053	110	334	224	1	0.471579
GCA_000750665.1-Fun_JPJS01001154.1_i000_004273	193	418	225	1.00446	0.445545
GCA_000750675.1-Fun_JPJR01000545.1_i000_003305	193	418	225	1.00446	0.445545
GCA_910591835.1-Fun_CAJVPV010001232.1_i000_002769	182	402	220	0.982143	0.332326
GCA_011058895.1-Fun_SWKV01000002.1_i000_003304	192	417	225	1.00446	0.435203
GCA_017552425.1-Pla_CM029803.1_i000_009206	177	398	221	0.986607	0.389085
GCA_002029285.1-Ani_LSYS01005888.1_i000_011377	180	398	218	0.973214	0.402214
GCA_000709895.1-Ani_KL493517.1_i000_007336	170	388	218	0.973214	0.421663
GCA_009739505.2-Ani_CM019170.2_i000_015568	179	399	220	0.982143	0.40146
GCA_000026945.1-Fun_FM992689.1_i000_002825	143	377	234	1.04464	0.417112
GCA_905182985.1-Pro_CAJJDN010000007.1_i000_003610	188	410	222	0.991071	0.457732
GCA_001020605.1-Fun_KQ085884.1_i000_000848	181	400	219	0.977679	0.359606
GCA_015680625.1-Fun_JAAAXW010000054.1_i000_009465	182	400	218	0.973214	0.431683
GCA_015680655.1-Fun_JAABKD010000029.1_i000_005205	567	785	218	0.973214	0.241417
GCA_000699145.1-Ani_KL226294.1_i000_010862	168	386	218	0.973214	0.424125
GCA_000739165.1-Fun_KN042426.1_i000_010042	182	400	218	0.973214	0.42998
GCA_015500155.1-Fun_JAAAUE010002984.1_i000_004485	182	400	218	0.973214	0.42998
GCA_019616345.1-Fun_WSTH01001507.1_i000_009077	199	423	224	1	0.409506
GCA_014871385.1-Pla_CM026427.1_i000_017447	177	396	219	0.977679	0.390374
GCA_016097865.1-Fun_JAAAIN010003076.1_i000_011259	182	400	218	0.973214	0.431683
GCA_001277935.1-Ani_CP012523.1_i000_000731	180	397	217	0.96875	0.423002
GCA_013398245.1-Ani_VZSD01011889.1_i000_008823	171	390	219	0.977679	0.402574
GCA_014871845.1-Pla_CM026442.1_i000_023390	177	396	219	0.977679	0.374359
GCA_015502505.1-Fun_JAAAUQ010002390.1_i000_005136	182	400	218	0.973214	0.431683
GCA_000750795.1-Fun_JPJX01003163.1_i000_008518	193	418	225	1.00446	0.445545
GCA_000750815.1-Fun_JPJZ01001191.1_i000_007478	193	418	225	1.00446	0.445545
GCA_002104975.1-Fun_MCOG01000296.1_i000_010575	186	410	224	1	0.456212
GCA_016946835.1-Fun_JACVTC010000075.1_i000_024080	186	410	224	1	0.456212
GCA_013339745.1-Ani_CM023471.1_i000_006135	180	398	218	0.973214	0.405204
GCA_013397455.1-Ani_VYZB01000197.1_i000_003653	180	398	218	0.973214	0.465812
GCA_022432365.1-Fun_JAJJXE010000002.1_i000_004376	191	417	226	1.00893	0.445759
GCA_900005825.1-Ani_CVRI01000040.1_i000_008298	180	397	217	0.96875	0.399632
GCA_020497125.1-Ani_CM035642.1_i000_014462	180	400	220	0.982143	0.418251
GCA_000004075.3-Pla_CM002923.2_i000_003905	177	395	218	0.973214	0.400735
GCA_000767015.2-Ani_ASGP02000003.1_i000_007093	181	401	220	0.982143	0.37037
GCA_020809275.1-Ani_SDOV01000001.1_i000_001424	181	401	220	0.982143	0.37037
GCA_014282415.2-Ani_JABDTM020025902.1_i000_010166	774	990	216	0.964286	0.189807
GCA_013397295.1-Ani_VYXF01008334.1_i000_008862	168	386	218	0.973214	0.436874
GCA_015679425.1-Fun_JAAAUV010001999.1_i000_004317	182	400	218	0.973214	0.431683
GCA_015852415.1-Fun_JAAAIH010001358.1_i000_001845	182	400	218	0.973214	0.431683
GCA_020744185.1-Fun_JAGSXK010000005.1_i000_011480	182	400	218	0.973214	0.431683
GCA_000751175.1-Pro_CCKQ01005390.1_i000_005493	181	402	221	0.986607	0.491111
GCA_000750935.1-Fun_JPKD01003233.1_i000_009803	193	418	225	1.00446	0.443787
GCA_008636185.1-Pla_VXIU01000020.1_i000_004426	191	412	221	0.986607	0.379725
GCA_000750895.1-Fun_JPKB01000793.1_i000_005196	193	418	225	1.00446	0.443787
GCA_001662655.1-Fun_KV460241.1_i000_007275	193	418	225	1.00446	0.443787
GCA_001662605.1-Fun_KV458931.1_i000_009713	193	418	225	1.00446	0.443787
GCA_019671135.1-Fun_JAHRHY010000006.1_i000_010586	182	400	218	0.973214	0.431683
GCA_001662645.1-Fun_KV459729.1_i000_009951	193	418	225	1.00446	0.441176
GCA_019616345.1-Fun_WSTH01000339.1_i000_003257	176	400	224	1	0.414048
GCA_000507365.1-Ani_KI658066.1_i000_003415	218	436	218	0.973214	0.389982
GCA_000006515.1-Pro_DS989732.1_i000_002913	182	404	222	0.991071	0.477419
GCA_000513255.1-Fun_HG792017.1_i000_007812	190	416	226	1.00893	0.44227
GCA_015533775.1-Fun_JABCSE010000004.1_i000_002611	190	416	226	1.00893	0.44227
GCA_003990745.1-Fun_RBNI01001938.1_i000_002556	251	475	224	1	0.440945
GCA_010090195.1-Ani_VUKY01007200.1_i000_005789	177	395	218	0.973214	0.468817
GCA_010078445.1-Ani_VULE01001562.1_i000_001833	177	395	218	0.973214	0.468817
GCA_010078485.1-Ani_VULA01000650.1_i000_000796	177	395	218	0.973214	0.468817
GCA_010080425.1-Ani_VULF01010304.1_i000_009747	177	395	218	0.973214	0.468817
GCA_010082375.1-Ani_VULI01016291.1_i000_012395	177	395	218	0.973214	0.468817
GCA_010084205.1-Ani_VULJ01006091.1_i000_006940	177	395	218	0.973214	0.468817
GCA_010085315.1-Ani_VULG01044751.1_i000_011054	177	395	218	0.973214	0.468817
GCA_010085335.1-Ani_VULH01002953.1_i000_000563	177	395	218	0.973214	0.468817
GCA_010085355.1-Ani_VULL01001210.1_i000_005075	177	395	218	0.973214	0.468817
GCA_010085365.1-Ani_VULK01000684.1_i000_007581	177	395	218	0.973214	0.468817
GCA_014871845.1-Pla_CM026439.1_i000_016892	177	396	219	0.977679	0.390374
GCA_013398455.1-Ani_VZSM01001468.1_i000_003336	177	396	219	0.977679	0.470968
GCA_013401335.1-Ani_VYZX01010825.1_i000_004220	177	395	218	0.973214	0.468817
GCA_001876935.1-Pla_CM007385.1_i000_011577	163	381	218	0.973214	0.392793
GCA_013400835.1-Ani_VZTU01029592.1_i000_011047	168	386	218	0.973214	0.409774
GCA_002900925.1-Fun_LN890563.1_i000_003555	99	322	223	0.995536	0.470464
GCA_010094085.1-Fun_ML986488.1_i000_003375	193	417	224	1	0.429942
GCA_000223465.1-Fun_GL996527.1_i000_003451	16	240	224	1	0.589474
GCA_016758895.1-Fun_JAEPRA010000001.1_i000_000425	181	401	220	0.982143	0.421456
GCA_002104905.1-Fun_MCFE01000314.1_i000_007196	186	409	223	0.995536	0.457906
GCA_000003745.2-Pla_FN597038.1_i000_016818	177	396	219	0.977679	0.462025
GCA_003260675.2-Pla_QGKX02001521.1_i000_030933	19	243	224	1	0.638177
GCA_010093885.1-Fun_ML995478.1_i000_002491	192	417	225	1.00446	0.416667
GCA_905250025.1-Ani_CAJNOJ010000017.1_i000_005931	186	411	225	1.00446	0.471698
GCA_000945115.1-Fun_LK023323.1_i000_004139	186	411	225	1.00446	0.45
GCA_013398995.1-Ani_VWYE01016862.1_i000_007691	165	383	218	0.973214	0.481236
GCA_905250095.1-Ani_CAJNOR010004535.1_i000_040148	186	411	225	1.00446	0.471698
GCA_000750755.1-Fun_JPJW01002213.1_i000_006707	193	418	225	1.00446	0.442913
GCA_009078335.1-Pla_CM018576.1_i000_007230	199	417	218	0.973214	0.37138
GCA_000750735.1-Fun_JPJU01002306.1_i000_006367	193	418	225	1.00446	0.443787
GCA_013397245.1-Ani_VZTB01008355.1_i000_006063	168	386	218	0.973214	0.406716
GCA_003076615.3-Ani_NJHN03000037.1_i000_002126	168	387	219	0.977679	0.390374
GCA_013399055.1-Ani_WBNM01005192.1_i000_001418	175	393	218	0.973214	0.470842
GCA_001638985.2-Fun_KV440989.1_i000_011420	186	411	225	1.00446	0.457317
GCA_016771965.1-Pla_CM028690.1_i000_019650	177	395	218	0.973214	0.40824
GCA_016834605.1-Pla_JAEHOC010000020.1_i000_008592	178	397	219	0.977679	0.431102
GCA_010080355.1-Ani_VULC01000331.1_i000_000328	168	386	218	0.973214	0.47807
GCA_010080465.1-Ani_VULD01005650.1_i000_006193	168	386	218	0.973214	0.47807
GCA_003112345.1-Pla_PKPP01004048.1_i000_031175	188	412	224	1	0.419476
GCA_003112345.1-Pla_PKPP01005822.1_i000_038377	188	412	224	1	0.419476
GCA_905332225.1-Ani_CAJOBN010010149.1_i000_028190	60	285	225	1.00446	0.626741
GCA_000699105.1-Ani_KL224607.1_i000_001159	168	386	218	0.973214	0.424125
GCA_002105135.1-Fun_MCGN01000002.1_i000_004960	186	410	224	1	0.422642
GCA_020536065.1-Fun_JAEUBE010000295.1_i000_003805	98	327	229	1.02232	0.489316
GCA_013339695.1-Ani_CM023522.1_i000_008182	180	398	218	0.973214	0.405959
GCA_013397555.1-Ani_VZRH01003520.1_i000_005598	168	386	218	0.973214	0.403704
GCA_013399595.1-Ani_VXAP01000601.1_i000_010083	180	398	218	0.973214	0.465812
GCA_008373055.1-Ani_VSRR010001753.1_i000_019993	78	295	217	0.96875	0.507009
GCA_000511025.2-Pla_CM002324.2_i000_008207	180	396	216	0.964286	0.371773
GCA_013400095.1-Ani_VXBK01005364.1_i000_005871	180	398	218	0.973214	0.465812
GCA_013399225.1-Ani_VXAC01002952.1_i000_004841	168	386	218	0.973214	0.403704
GCA_000691785.1-Ani_KK680127.1_i000_006830	170	388	218	0.973214	0.422481
GCA_010078495.1-Ani_VULB01004343.1_i000_003445	177	395	218	0.973214	0.468817
GCA_011058875.1-Fun_SWKT01000015.1_i000_003299	186	412	226	1.00893	0.450199
GCA_014621435.1-Fun_JAANBA010000220.1_i000_005567	186	412	226	1.00893	0.450199
GCA_013397515.1-Ani_VZRI01013885.1_i000_013058	115	340	225	1.00446	0.470711
GCA_010085315.1-Ani_VULG01039168.1_i000_009741	178	398	220	0.982143	0.475162
GCA_004837865.1-Pla_CM017198.1_i000_029552	177	395	218	0.973214	0.37265
GCA_000769765.1-Fun_JQGA01001044.1_i000_007481	190	416	226	1.00893	0.44227
GCA_022478985.1-Fun_JAKSZP010003099.1_i000_000944	104	217	113	0.504464	0.242489
GCA_022478985.1-Fun_JAKSZP010003099.1_i000_000944	223	317	94	0.419643	0.201717
GCA_905330805.1-Ani_CAJNWK010000025.1_i000_009606	69	294	225	1.00446	0.611413
GCA_904066235.2-Ani_CAJFCV020000001.1_i000_001094	178	398	220	0.982143	0.474138
GCA_904067135.1-Ani_CAJFDI010000001.1_i000_001094	178	398	220	0.982143	0.474138
GCA_905219575.1-Fun_CAJMWT010003305.1_i000_005647	187	411	224	1	0.405063
GCA_001531365.1-Pla_CM009732.1_i000_000947	177	395	218	0.973214	0.395644
GCA_005549225.1-Pla_SSTD01007912.1_i000_013373	185	403	218	0.973214	0.473913
GCA_013400755.1-Ani_VZTQ01005779.1_i000_005212	122	340	218	0.973214	0.531707
GCA_905219615.1-Fun_CAJMWW010000065.1_i000_001029	187	411	224	1	0.398577
GCA_005549215.1-Pla_SSTE01002358.1_i000_004634	190	408	218	0.973214	0.468817
GCA_002072365.1-Fun_MLQL01000009.1_i000_003756	190	416	226	1.00893	0.440546
GCA_000710275.1-Fun_CM002798.1_i000_001818	190	416	226	1.00893	0.440546
GCA_011058885.1-Fun_SWKS01000015.1_i000_002659	190	416	226	1.00893	0.440546
GCA_015502565.1-Fun_JAAAUS010000188.1_i000_002321	182	400	218	0.973214	0.421663
GCA_013398675.1-Ani_WBNF01000164.1_i000_012217	175	393	218	0.973214	0.470842
GCA_013400135.1-Ani_VXBO01004505.1_i000_004008	171	389	218	0.973214	0.447639
GCA_016098155.1-Fun_JAAAJB010000237.1_i000_003301	182	400	218	0.973214	0.421663
GCA_900618405.1-Ani_UYSL01007859.1_i000_004331	63	282	219	0.977679	0.634783
GCA_013396855.1-Ani_VWZJ01010746.1_i000_010187	168	386	218	0.973214	0.47807
GCA_014300015.1-Ani_CM025021.1_i000_014325	185	410	225	1.00446	0.405405
GCA_019845555.1-Pla_CM034080.1_i000_010863	177	396	219	0.977679	0.378893
GCA_002127325.2-Pla_CM007905.2_i000_061569	188	412	224	1	0.413284
GCA_003086715.1-Fun_MBFS01001688.1_i000_004755	180	404	224	1	0.415584
GCA_013398375.1-Ani_VZSI01000014.1_i000_000435	181	399	218	0.973214	0.464819
GCA_000690875.1-Ani_KK625057.1_i000_005205	170	387	217	0.96875	0.525424
GCA_000832345.2-Fun_LN679106.1_i000_006192	187	411	224	1	0.404332
GCA_000708925.1-Ani_KL423524.1_i000_003630	168	386	218	0.973214	0.423301
GCA_013399305.1-Ani_VXAI01000146.1_i000_002307	122	341	219	0.977679	0.534146
GCA_014529505.1-Pro_JABXOJ010000091.1_i000_000348	182	404	222	0.991071	0.477419
GCA_013398915.1-Ani_VYZM01014436.1_i000_007858	180	398	218	0.973214	0.439516
GCA_013401295.1-Ani_VWPO01000377.1_i000_002822	180	398	218	0.973214	0.439516
GCA_910591835.1-Fun_CAJVPV010002311.1_i000_004317	185	410	225	1.00446	0.362319
GCA_002072405.1-Fun_MDDG01000001.1_i000_000781	190	416	226	1.00893	0.44227
GCA_008369825.1-Ani_CM017905.1_i000_012959	180	398	218	0.973214	0.396364
GCA_013398555.1-Ani_VZSQ01000063.1_i000_005407	175	393	218	0.973214	0.470842
GCA_017639395.1-Pla_CM029886.1_i000_032224	188	412	224	1	0.431599
GCA_000743755.1-Pro_JPUL02000309.1_i000_004599	78	303	225	1.00446	0.635593
GCA_001662585.1-Fun_KV454586.1_i000_003269	193	418	225	1.00446	0.443787
GCA_013398815.1-Ani_VZSZ01008375.1_i000_009521	184	402	218	0.973214	0.436
GCA_019776745.2-Pla_CM034156.1_i000_036259	204	423	219	0.977679	0.34434
GCA_000938895.1-Fun_LN719426.1_i000_001412	186	411	225	1.00446	0.456389
GCA_013396715.1-Ani_VWZC01014015.1_i000_012082	180	398	218	0.973214	0.427451
GCA_013399555.1-Ani_VZZV01000649.1_i000_011162	180	398	218	0.973214	0.465812
GCA_013397515.1-Ani_VZRI01001158.1_i000_001007	168	386	218	0.973214	0.436874
GCA_002174775.1-Pla_MVGT01000924.1_i000_021720	177	396	219	0.977679	0.391771
GCA_004153795.2-Pla_SDRB02012158.1_i000_025379	177	395	218	0.973214	0.393502
GCA_013400335.1-Ani_VZZY01025707.1_i000_013564	170	388	218	0.973214	0.404453
GCA_013396895.1-Ani_VWZM01020157.1_i000_013880	168	387	219	0.977679	0.405556
GCA_010093625.1-Fun_MU006737.1_i000_010600	192	417	225	1.00446	0.434363
GCA_001447565.1-Ani_JYDW01000056.1_i000_010926	205	430	225	1.00446	0.406872
GCA_000313135.1-Pro_KB007917.1_i000_005317	176	394	218	0.973214	0.415238
GCA_902206195.3-Pla_CABITT030000005.1_i000_014859	188	412	224	1	0.511416
GCA_000692015.2-Ani_KL672766.1_i000_011440	162	380	218	0.973214	0.428291
GCA_013399135.1-Ani_VXBZ01007979.1_i000_008098	115	340	225	1.00446	0.475687
GCA_000313135.1-Pro_KB008172.1_i000_014904	197	421	224	1	0.433269
GCA_016584175.1-Fun_PUHR01000094.1_i000_005323	126	361	235	1.04911	0.496829
GCA_013396755.1-Ani_VWZF01004364.1_i000_007975	171	389	218	0.973214	0.472885
GCA_000723665.1-Fun_CBTN010000003.1_i000_000974	186	411	225	1.00446	0.45
GCA_013339905.1-Ani_CM023519.1_i000_020699	180	400	220	0.982143	0.412758
GCA_002573585.1-Fun_PDNB01000059.1_i000_008242	190	416	226	1.00893	0.440546
GCA_013398225.1-Ani_VZSC01010945.1_i000_007746	139	357	218	0.973214	0.510539
GCA_900617895.1-Ani_UZAF01016764.1_i000_007820	177	367	190	0.848214	0.362595
GCA_900617895.1-Ani_UZAF01016764.1_i000_007820	358	429	71	0.316964	0.135496
GCA_013397465.1-Ani_VYZD01000310.1_i000_006804	167	385	218	0.973214	0.477024
GCA_011763645.1-Fun_JAASGZ010000846.1_i000_007258	186	411	225	1.00446	0.457317
GCA_011763975.1-Fun_JAANJF010000177.1_i000_001957	186	411	225	1.00446	0.457317
GCA_011763995.1-Fun_JAANJE010000468.1_i000_002428	186	411	225	1.00446	0.457317
GCA_011764025.1-Fun_JAANQT010001010.1_i000_007090	186	411	225	1.00446	0.457317
GCA_011764055.1-Fun_JAANQS010000741.1_i000_005927	186	411	225	1.00446	0.457317
GCA_011764125.1-Fun_JAANQV010001189.1_i000_004134	186	411	225	1.00446	0.457317
GCA_011764145.1-Fun_JAANQZ010000249.1_i000_001771	186	411	225	1.00446	0.457317
GCA_011764185.1-Fun_JAANRA010000759.1_i000_006097	186	411	225	1.00446	0.457317
GCA_011764225.1-Fun_JAANRQ010000117.1_i000_000604	186	411	225	1.00446	0.457317
GCA_011764265.1-Fun_JAANRE010001202.1_i000_002684	186	411	225	1.00446	0.457317
GCA_011800955.1-Fun_JAANRM010000864.1_i000_007641	186	411	225	1.00446	0.457317
GCA_011800985.1-Fun_JAANRL010000831.1_i000_006868	186	411	225	1.00446	0.457317
GCA_011801035.1-Fun_JAANRN010000850.1_i000_007412	186	411	225	1.00446	0.457317
GCA_011801055.1-Fun_JAANRO010000824.1_i000_007133	186	411	225	1.00446	0.457317
GCA_011801305.1-Fun_JAANRS010000024.1_i000_000468	186	411	225	1.00446	0.457317
GCA_011801335.1-Fun_JAANRP010001007.1_i000_007026	186	411	225	1.00446	0.457317
GCA_011801385.1-Fun_JAANRR010000029.1_i000_000495	186	411	225	1.00446	0.457317
GCA_011801495.1-Fun_JAANRV010000808.1_i000_006969	186	411	225	1.00446	0.457317
GCA_011801505.1-Fun_JAANRU010000829.1_i000_007098	186	411	225	1.00446	0.457317
GCA_011801555.1-Fun_JAANRX010000836.1_i000_006997	186	411	225	1.00446	0.457317
GCA_011801575.1-Fun_JAANRW010000853.1_i000_007290	186	411	225	1.00446	0.457317
GCA_011801605.1-Fun_JAANRT010000815.1_i000_006975	186	411	225	1.00446	0.457317
GCA_011801645.1-Fun_JAANRB010000277.1_i000_003273	186	411	225	1.00446	0.457317
GCA_011801675.1-Fun_JAANQW010000710.1_i000_005436	186	411	225	1.00446	0.457317
GCA_011801705.1-Fun_JAANQY010000742.1_i000_005815	186	411	225	1.00446	0.457317
GCA_011801725.1-Fun_JAANQX010000755.1_i000_006048	186	411	225	1.00446	0.457317
GCA_011801785.1-Fun_JAANQR010000348.1_i000_003354	186	411	225	1.00446	0.457317
GCA_011801815.1-Fun_JAANQU010001027.1_i000_007069	186	411	225	1.00446	0.457317
GCA_011950945.1-Fun_JAANRD010000840.1_i000_007272	186	411	225	1.00446	0.457317
GCA_011950985.1-Fun_JAANRF010000006.1_i000_000140	186	411	225	1.00446	0.457317
GCA_011951285.1-Fun_JAANRG010000013.1_i000_000370	186	411	225	1.00446	0.457317
GCA_011951295.1-Fun_JAANRC010000745.1_i000_005914	186	411	225	1.00446	0.457317
GCA_011952045.1-Fun_JAANRH010001025.1_i000_007234	186	411	225	1.00446	0.457317
GCA_011952115.1-Fun_JAANRI010000006.1_i000_000093	186	411	225	1.00446	0.457317
GCA_011952145.1-Fun_JAANRJ010000832.1_i000_007177	186	411	225	1.00446	0.457317
GCA_011952175.1-Fun_JAANRK010000008.1_i000_000201	186	411	225	1.00446	0.457317
GCA_013396355.1-Ani_VWPS01000135.1_i000_001741	173	391	218	0.973214	0.472885
GCA_013398175.1-Ani_VZRZ01002289.1_i000_003429	167	385	218	0.973214	0.479121
GCA_002072265.1-Fun_MDYM01000001.1_i000_000655	190	416	226	1.00893	0.44227
GCA_013676235.1-Pla_CM025502.1_i000_016136	199	417	218	0.973214	0.378472
GCA_011763955.1-Fun_JAANJD010001830.1_i000_010369	186	411	225	1.00446	0.457317
GCA_000004195.4-Ani_CM004443.2_i000_000023	184	409	225	1.00446	0.419776
GCA_013399415.1-Ani_VWYJ01026547.1_i000_009898	170	388	218	0.973214	0.43513
GCA_013396555.1-Ani_VZRD01000025.1_i000_005038	179	397	218	0.973214	0.466809
GCA_013397595.1-Ani_WBNJ01000103.1_i000_014054	175	394	219	0.977679	0.473002
GCA_001447435.1-Ani_JYDK01000001.1_i000_000021	222	447	225	1.00446	0.394737
GCA_013399335.1-Ani_VZZT01000831.1_i000_006387	122	340	218	0.973214	0.531707
GCA_001447745.1-Ani_JYDM01000080.1_i000_013415	222	447	225	1.00446	0.394737
GCA_001447655.1-Ani_JYDQ01000059.1_i000_004486	222	447	225	1.00446	0.394737
GCA_001447585.1-Ani_JYDI01000040.1_i000_003302	222	447	225	1.00446	0.394737
GCA_016584185.1-Fun_PUHS01000079.1_i000_004679	132	369	237	1.05804	0.460194
GCA_013389865.1-Ani_WAAB01006418.1_i000_003214	179	397	218	0.973214	0.466809
GCA_013399755.1-Ani_VZTK01011587.1_i000_004976	122	340	218	0.973214	0.531707
GCA_000190715.1-Pro_GL871019.1_i000_003946	181	400	219	0.977679	0.403315
GCA_000691975.1-Ani_KK718916.1_i000_007415	168	386	218	0.973214	0.423301
GCA_002914845.1-Pla_JXTC01000288.1_i000_025915	176	395	219	0.977679	0.383538
GCA_013400975.1-Ani_WBMZ01003116.1_i000_002598	180	398	218	0.973214	0.465812
GCA_000344685.1-Fun_KB469297.1_i000_002456	180	396	216	0.964286	0.381625
GCA_016834595.1-Pla_JAEHOD010000016.1_i000_006214	178	397	219	0.977679	0.433663
GCA_000243375.1-Fun_HE616747.1_i000_003781	87	316	229	1.02232	0.52765
GCA_013398745.1-Ani_VZSY01000070.1_i000_003029	179	397	218	0.973214	0.466809
GCA_013397495.1-Ani_VYZC01000081.1_i000_012522	175	393	218	0.973214	0.471861
GCA_013399855.1-Ani_VXAY01000699.1_i000_001211	167	385	218	0.973214	0.406716
GCA_013397825.1-Ani_VZRK01000015.1_i000_001112	180	398	218	0.973214	0.465812
GCA_016758895.1-Fun_JAEPRA010000004.1_i000_005883	186	411	225	1.00446	0.329912
GCA_002891735.1-Pla_PGGS01000151.1_i000_005044	51	270	219	0.977679	0.558673
GCA_000747805.1-Ani_KN125898.1_i000_001475	168	386	218	0.973214	0.424125
GCA_013401255.1-Ani_WBNH01002161.1_i000_002443	170	388	218	0.973214	0.475983
GCA_000751015.1-Pla_LK032523.1_i000_035123	188	412	224	1	0.431599
GCA_003434825.1-Pla_CM010635.1_i000_026874	188	412	224	1	0.431599
GCA_000690535.1-Ani_KK524918.1_i000_009892	168	386	218	0.973214	0.424125
GCA_013398075.1-Ani_VZRX01003196.1_i000_001746	61	286	225	1.00446	0.740132
GCA_005393395.2-Pla_CM016621.1_i000_014543	166	384	218	0.973214	0.392793
GCA_000691405.1-Ani_KK649042.1_i000_003552	170	388	218	0.973214	0.421663
GCA_002072255.1-Fun_MDYP01000003.1_i000_001336	190	416	226	1.00893	0.44227
GCA_013390085.1-Ani_WEIX01012545.1_i000_010173	178	396	218	0.973214	0.467811
GCA_002197715.1-Ani_MUZQ01000149.1_i000_002538	85	310	225	1.00446	0.496689
GCA_009809945.1-Fun_WTPW01000111.1_i000_003175	182	402	220	0.982143	0.266022
GCA_000816705.1-Ani_KN716157.1_i000_000820	187	405	218	0.973214	0.440404
GCA_014904855.1-Fun_MU118106.1_i000_009401	185	411	226	1.00893	0.434615
GCA_020379485.1-Pla_CM035453.1_i000_028212	195	419	224	1	0.425856
GCA_013401115.1-Ani_VZUG01013387.1_i000_004533	180	398	218	0.973214	0.465812
GCA_001566745.1-Fun_KQ964435.1_i000_001564	182	407	225	1.00446	0.463918
GCA_013399295.1-Ani_VXAH01000182.1_i000_001177	170	388	218	0.973214	0.43513
GCA_013397275.1-Ani_VYXH01001426.1_i000_001482	121	339	218	0.973214	0.498856
GCA_005059845.1-Fun_NAJN01001336.1_i000_001990	191	417	226	1.00893	0.420857
GCA_000740895.1-Pro_AP011947.1_i000_001744	242	462	220	0.982143	0.451745
GCA_016413885.1-Pla_CM028168.1_i000_011931	177	395	218	0.973214	0.367622
GCA_013400995.1-Ani_VZUB01000021.1_i000_000029	167	386	219	0.977679	0.417143
GCA_013396835.1-Ani_VWZI01014185.1_i000_007764	167	385	218	0.973214	0.437751
GCA_900000015.1-Pro_CCYD01000286.1_i000_002498	181	400	219	0.977679	0.451546
GCA_013400055.1-Ani_VXBJ01007228.1_i000_013158	180	399	219	0.977679	0.467949
GCA_013396675.1-Ani_VWZE01018308.1_i000_009822	115	340	225	1.00446	0.466805
GCA_000293215.1-Fun_JH977602.1_i000_006406	196	421	225	1.00446	0.400356
GCA_000299215.2-Fun_JH925089.1_i000_001868	196	421	225	1.00446	0.400356
GCA_019202795.1-Pla_CM032923.1_i000_046164	178	396	218	0.973214	0.453222
GCA_000004255.1-Pla_GL348718.1_i000_022459	177	395	218	0.973214	0.409774
GCA_003072545.2-Pro_CP056068.1_i000_001407	181	401	220	0.982143	0.516432
GCA_013397025.1-Ani_VWZR01006030.1_i000_004261	170	388	218	0.973214	0.39781
GCA_016097935.1-Fun_JAAAIP010000184.1_i000_002655	182	400	218	0.973214	0.420849
GCA_013399225.1-Ani_VXAC01001309.1_i000_002336	115	339	224	1	0.625698
GCA_019974015.1-Ani_BMAW01081477.1_i000_045427	180	398	218	0.973214	0.46383
GCA_013396775.1-Ani_VZRE01014216.1_i000_011919	167	385	218	0.973214	0.437751
GCA_013397565.1-Ani_VZRJ01008927.1_i000_008523	168	386	218	0.973214	0.437751
GCA_013397135.1-Ani_VYXB01002302.1_i000_002906	177	395	218	0.973214	0.429134
GCA_013398615.1-Ani_VZSR01000028.1_i000_005834	177	395	218	0.973214	0.468817
GCA_021605115.1-Pla_BMAR01000001.1_i000_000516	178	397	219	0.977679	0.432806
GCA_013396505.1-Ani_VZRC01000215.1_i000_004696	177	395	218	0.973214	0.42998
GCA_019649035.1-Ani_BMAT01013298.1_i000_066289	226	445	219	0.977679	0.383538
GCA_013399895.1-Ani_VXBA01002855.1_i000_006418	170	388	218	0.973214	0.406716
GCA_013398395.1-Ani_VZSK01002545.1_i000_000606	173	391	218	0.973214	0.472885
GCA_013400375.1-Ani_VXBW01004283.1_i000_006785	177	395	218	0.973214	0.468817
GCA_000208865.2-Pro_FR823388.1_i000_002057	183	396	213	0.950893	0.434694
GCA_013399215.1-Ani_VXAF01000241.1_i000_003568	170	388	218	0.973214	0.400735
GCA_013401215.1-Ani_VZUJ01154355.1_i000_013304	175	393	218	0.973214	0.470842
GCA_002251995.2-Fun_NDIQ01000001.1_i000_000731	187	413	226	1.00893	0.452
GCA_000224845.2-Pro_KN042496.1_i000_006488	183	398	215	0.959821	0.501166
GCA_000256705.2-Pro_ML130720.1_i000_004687	183	398	215	0.959821	0.501166
GCA_000004985.1-Pro_GG738901.1_i000_011592	179	401	222	0.991071	0.479482
GCA_002918395.1-Fun_PEDP01000363.1_i000_002188	171	397	226	1.00893	0.453815
GCA_013399455.1-Ani_VWYI01006412.1_i000_001814	115	340	225	1.00446	0.464876
GCA_905250075.1-Ani_CAJNOP010000020.1_i000_015396	186	411	225	1.00446	0.46875
GCA_905331505.1-Ani_CAJNYZ010000022.1_i000_008433	186	411	225	1.00446	0.46875
GCA_905331525.1-Ani_CAJNZF010000004.1_i000_002854	186	411	225	1.00446	0.46875
GCA_905332305.1-Ani_CAJOBU010000594.1_i000_006158	186	411	225	1.00446	0.46875
GCA_905332315.1-Ani_CAJOBV010000949.1_i000_011214	186	411	225	1.00446	0.46875
GCA_905332325.1-Ani_CAJOBW010002062.1_i000_010666	186	411	225	1.00446	0.46875
GCA_905250055.1-Ani_CAJNOF010000020.1_i000_012169	186	411	225	1.00446	0.46875
GCA_905250075.1-Ani_CAJNOP010000004.1_i000_005398	186	411	225	1.00446	0.46875
GCA_905331515.1-Ani_CAJNZC010000023.1_i000_008845	186	411	225	1.00446	0.46875
GCA_905331535.1-Ani_CAJNZB010000004.1_i000_003084	186	411	225	1.00446	0.46875
GCA_905332295.1-Ani_CAJOBT010001595.1_i000_012033	186	411	225	1.00446	0.46875
GCA_900617775.1-Ani_UYRU01076123.1_i000_014815	125	350	225	1.00446	0.547445
GCA_003547095.1-Fun_PQFF01000327.1_i000_016680	179	397	218	0.973214	0.30618
GCA_000687285.1-Ani_KK451937.1_i000_006009	168	386	218	0.973214	0.424951
GCA_013396615.1-Ani_VWZA01000569.1_i000_005175	180	398	218	0.973214	0.428291
GCA_013399655.1-Ani_VXAS01023220.1_i000_013421	115	340	225	1.00446	0.467775
GCA_012184305.1-Fun_LDUB01000189.1_i000_004037	190	414	224	1	0.397869
GCA_000699005.1-Ani_KL215353.1_i000_003250	168	386	218	0.973214	0.424951
GCA_000691845.1-Ani_JJRJ01015721.1_i000_001747	170	388	218	0.973214	0.421663
GCA_000414095.2-Pla_KE344566.1_i000_010831	177	389	212	0.946429	0.412451
GCA_013398835.1-Ani_VYZJ01000167.1_i000_003796	174	392	218	0.973214	0.471861
GCA_000690835.1-Ani_KK595040.1_i000_004672	168	386	218	0.973214	0.423301
GCA_000002425.2-Pla_CM009317.1_i000_003314	177	396	219	0.977679	0.392473
GCA_907169785.1-Ani_CAJRST010033334.1_i000_015585	190	415	225	1.00446	0.394737
GCA_019425475.1-Pro_NLFJ01000118.1_i000_001782	108	328	220	0.982143	0.623229
GCA_021307395.1-Pro_SOPI01000598.1_i000_014766	108	328	220	0.982143	0.623229
GCA_000687265.1-Ani_KK407664.1_i000_001536	168	386	218	0.973214	0.423301
GCA_013400615.1-Ani_VZTO01001223.1_i000_000583	176	394	218	0.973214	0.469828
GCA_013399055.1-Ani_WBNM01001946.1_i000_000513	115	340	225	1.00446	0.465839
GCA_000709325.1-Ani_KL447622.1_i000_006135	170	388	218	0.973214	0.412879
GCA_013398855.1-Ani_VZTA01017459.1_i000_007822	168	386	218	0.973214	0.47807
GCA_013397895.1-Ani_VZRL01001273.1_i000_002596	168	386	218	0.973214	0.47807
GCA_013400675.1-Ani_VYZR01058383.1_i000_002700	173	391	218	0.973214	0.481236
GCA_002104985.1-Fun_MCGO01000039.1_i000_009903	197	422	225	1.00446	0.457317
GCA_013399755.1-Ani_VZTK01018589.1_i000_007922	115	340	225	1.00446	0.484914
GCA_013400585.1-Ani_WEZZ01019288.1_i000_005952	178	396	218	0.973214	0.48337
GCA_000708025.2-Ani_KL872975.1_i000_011614	170	388	218	0.973214	0.427451
GCA_013398535.1-Ani_VZSP01002383.1_i000_011314	168	386	218	0.973214	0.47807
GCA_013401155.1-Ani_VZUF01142662.1_i000_007317	168	386	218	0.973214	0.47807
GCA_001638985.2-Fun_KV441025.1_i000_014350	186	411	225	1.00446	0.456389
GCA_904063045.1-Ani_CAJFCJ010000006.1_i000_004521	186	410	224	1	0.388889
GCA_010015445.1-Ani_CM020912.1_i000_003623	125	350	225	1.00446	0.443787
GCA_000687185.1-Ani_KK502039.1_i000_011037	168	386	218	0.973214	0.423301
GCA_013390005.1-Ani_WEIV01006667.1_i000_002509	175	393	218	0.973214	0.470842
GCA_013401095.1-Ani_WBNP01003455.1_i000_007454	173	391	218	0.973214	0.472885
GCA_013397055.1-Ani_VWZT01013348.1_i000_010477	115	339	224	1	0.625698
GCA_013398495.1-Ani_WBNB01000197.1_i000_010678	173	391	218	0.973214	0.472885
GCA_013400495.1-Ani_WAAE01018784.1_i000_009210	168	386	218	0.973214	0.469828
GCA_013400655.1-Ani_VYZQ01001037.1_i000_000134	168	386	218	0.973214	0.47807
GCA_013396435.1-Ani_WBMU01001619.1_i000_005933	183	400	217	0.96875	0.393116
GCA_000005155.1-Ani_CH916372.1_i000_005073	180	397	217	0.96875	0.423828
GCA_000002425.2-Pla_CM009326.1_i000_014989	177	396	219	0.977679	0.369932
GCA_015849325.1-Fun_JAAAIB010000424.1_i000_006254	179	397	218	0.973214	0.43083
GCA_013398875.1-Ani_VYZK01000041.1_i000_002086	173	391	218	0.973214	0.472885
GCA_013398715.1-Ani_VZSU01000133.1_i000_001105	173	391	218	0.973214	0.472885
GCA_013397975.1-Ani_VZRQ01000068.1_i000_000087	115	340	225	1.00446	0.571066
GCA_000690715.1-Ani_JJRP01073305.1_i000_008203	170	388	218	0.973214	0.422481
GCA_013400175.1-Ani_VXBQ01016502.1_i000_012301	168	386	218	0.973214	0.47807
GCA_001742945.1-Pla_DF973217.1_i000_009677	177	396	219	0.977679	0.393885
GCA_001975905.1-Fun_MSZU01000075.1_i000_000864	147	372	225	1.00446	0.472689
GCA_015847185.1-Fun_JAAAHX010000076.1_i000_009628	179	397	218	0.973214	0.425781
GCA_013396575.1-Ani_VWYZ01000013.1_i000_001387	174	392	218	0.973214	0.471861
GCA_013401035.1-Ani_VZUA01072535.1_i000_004466	176	394	218	0.973214	0.469828
GCA_013400415.1-Ani_VXBX01006118.1_i000_008250	167	385	218	0.973214	0.409774
GCA_013399255.1-Ani_VXAE01009811.1_i000_006783	171	389	218	0.973214	0.402214
GCA_013397715.1-Ani_WBNL01000009.1_i000_000648	178	396	218	0.973214	0.467811
GCA_013399515.1-Ani_VXAN01000010.1_i000_011636	178	396	218	0.973214	0.467811
GCA_013400235.1-Ani_VXBT01004127.1_i000_004007	115	340	225	1.00446	0.480769
GCA_015178925.1-Fun_WHVC01000023.1_i000_005057	188	408	220	0.982143	0.367893
GCA_013398405.1-Ani_VZSJ01003637.1_i000_008360	178	396	218	0.973214	0.467811
GCA_016413895.1-Pla_CM028154.1_i000_012290	236	454	218	0.973214	0.334356
GCA_013400775.1-Ani_VZTR01002113.1_i000_000863	180	398	218	0.973214	0.465812
GCA_013397695.1-Ani_VYZI01001847.1_i000_003953	115	340	225	1.00446	0.463918
GCA_013400115.1-Ani_VXBP01006372.1_i000_008603	170	388	218	0.973214	0.43513
GCA_013397435.1-Ani_VZRG01003012.1_i000_010734	115	340	225	1.00446	0.478723
GCA_013396735.1-Ani_VWZG01010250.1_i000_010232	167	385	218	0.973214	0.399267
GCA_002217885.1-Pro_BDSP01000143.1_i000_013774	188	414	226	1.00893	0.44664
GCA_013398435.1-Ani_VZSL01000115.1_i000_000733	178	396	218	0.973214	0.467811
GCA_004359215.2-Pro_SHOA02000202.1_i000_008694	181	400	219	0.977679	0.438878
GCA_013398115.1-Ani_VZRV01007336.1_i000_008839	180	398	218	0.973214	0.465812
GCA_000695765.1-Ani_KK822169.1_i000_012061	170	388	218	0.973214	0.421663
GCA_013401135.1-Ani_VZUI01059719.1_i000_010589	180	398	218	0.973214	0.465812
GCA_000699545.1-Ani_JMFS01017699.1_i000_001520	179	397	218	0.973214	0.415238
GCA_020617195.1-Fun_JAFDOU010001043.1_i000_008612	182	400	218	0.973214	0.429134
GCA_020617725.1-Fun_JAFDOT010000615.1_i000_003491	182	400	218	0.973214	0.429134
GCA_002217885.1-Pro_BDSP01000061.1_i000_013402	188	414	226	1.00893	0.44664
GCA_002006685.1-Fun_LYON01000394.1_i000_003061	182	400	218	0.973214	0.426614
GCA_020617715.1-Fun_JAFDOV010000985.1_i000_007714	182	400	218	0.973214	0.426614
GCA_020617735.1-Fun_JAFCIX010000332.1_i000_004987	182	400	218	0.973214	0.426614
GCA_021556675.1-Fun_JAKFGI010000038.1_i000_006485	182	400	218	0.973214	0.426614
GCA_013397725.1-Ani_VZTD01001451.1_i000_002728	115	340	225	1.00446	0.556931
GCA_013397795.1-Ani_VZTJ01005567.1_i000_011405	115	340	225	1.00446	0.474684
GCA_002072425.1-Fun_MOOB01000002.1_i000_000837	190	416	226	1.00893	0.440546
GCA_010015815.1-Fun_ML977505.1_i000_005221	192	416	224	1	0.430769
GCA_000516985.1-Fun_KI912118.1_i000_012259	186	412	226	1.00893	0.44664
GCA_905178165.1-Pro_CAJINU010000010.1_i000_005230	181	401	220	0.982143	0.456432
GCA_013400315.1-Ani_VXBU01016673.1_i000_011818	115	340	225	1.00446	0.469729
GCA_013397375.1-Ani_VXBI01001115.1_i000_000934	115	340	225	1.00446	0.595238
GCA_022376545.1-Fun_WTXJ01000072.1_i000_010559	180	399	219	0.977679	0.379549
GCA_004786065.1-Fun_ML220118.1_i000_004030	189	415	226	1.00893	0.427221
GCA_013398275.1-Ani_VZSE01006401.1_i000_005440	179	397	218	0.973214	0.466809
GCA_905330235.1-Ani_CAJNUA010000021.1_i000_009083	186	411	225	1.00446	0.463918
GCA_905330535.1-Ani_CAJNVN010000021.1_i000_009063	186	411	225	1.00446	0.463918
GCA_905332175.1-Ani_CAJOBL010010329.1_i000_030774	186	411	225	1.00446	0.463918
GCA_001447425.1-Ani_JYDJ01000023.1_i000_001692	209	434	225	1.00446	0.40395
GCA_013389965.1-Ani_WEIS01080820.1_i000_007580	115	340	225	1.00446	0.472689
GCA_019788775.1-Fun_JAIFTL010000038.1_i000_005582	182	400	218	0.973214	0.425781
GCA_013390025.1-Ani_WEKX01023072.1_i000_010634	167	385	218	0.973214	0.407477
GCA_001692895.1-Fun_KV748179.1_i000_001961	191	415	224	1	0.411009
GCA_013397915.1-Ani_VZRO01002709.1_i000_004289	170	388	218	0.973214	0.43254
GCA_001286725.1-Fun_CYGV01001290.1_i000_005966	368	592	224	1	0.305177
GCA_017589495.1-Ani_CM030057.1_i000_014781	185	410	225	1.00446	0.383305
GCA_013397935.1-Ani_VZRN01005202.1_i000_010834	168	386	218	0.973214	0.436874
GCA_905329745.1-Ani_CAJNSZ010000021.1_i000_009205	186	411	225	1.00446	0.464876
GCA_905332165.1-Ani_CAJOBK010002172.1_i000_016652	186	411	225	1.00446	0.464876
GCA_008638375.1-Pla_CM018039.1_i000_029418	177	396	219	0.977679	0.378238
GCA_000787975.1-Pla_JRRC01191467.1_i000_011721	177	395	218	0.973214	0.38448
GCA_022432395.1-Fun_JAJKLJ010000010.1_i000_002022	186	412	226	1.00893	0.449304
GCA_013396485.1-Ani_VWYY01007350.1_i000_013413	1	220	219	0.977679	0.920168
GCA_013399495.1-Ani_VXAM01000056.1_i000_002141	180	398	218	0.973214	0.465812
GCA_001865355.1-Pro_LRBS01000060.1_i000_002854	182	404	222	0.991071	0.477419
GCA_013399795.1-Ani_VWYL01008696.1_i000_003716	167	385	218	0.973214	0.437751
GCA_013398155.1-Ani_VZRU01017002.1_i000_010483	173	392	219	0.977679	0.405556
GCA_013397155.1-Ani_VWZV01010241.1_i000_007874	115	340	225	1.00446	0.556931
GCA_019202795.1-Pla_CM032923.1_i000_046168	177	395	218	0.973214	0.409774
GCA_001890805.1-Fun_KV878894.1_i000_004280	191	416	225	1.00446	0.438596
GCA_905182985.1-Pro_CAJJDN010000197.1_i000_047156	188	410	222	0.991071	0.454918
GCA_019202805.1-Pla_CM032910.1_i000_046481	177	395	218	0.973214	0.409774
GCA_905216605.1-Pla_LR999456.1_i000_016194	177	395	218	0.973214	0.409774
GCA_013399095.1-Ani_VWZZ01005823.1_i000_009261	170	388	218	0.973214	0.406716
GCA_013398125.1-Ani_VZRW01001184.1_i000_001240	179	397	218	0.973214	0.427451
GCA_000687205.1-Ani_KK378771.1_i000_003526	171	388	217	0.96875	0.524155
GCA_001632365.1-Fun_KV427605.1_i000_000678	180	399	219	0.977679	0.380208
GCA_013399915.1-Ani_VXBB01009691.1_i000_005337	167	385	218	0.973214	0.437751
GCA_013400735.1-Ani_VYZT01023780.1_i000_004996	169	387	218	0.973214	0.436
GCA_900618345.1-Ani_UZAJ01039832.1_i000_012340	189	412	223	0.995536	0.379252
GCA_013399035.1-Ani_VWYF01019636.1_i000_006744	168	386	218	0.973214	0.43513
GCA_013397235.1-Ani_VYXG01005935.1_i000_006930	180	398	218	0.973214	0.427451
GCA_013397975.1-Ani_VZRQ01006359.1_i000_007876	168	386	218	0.973214	0.436874
GCA_013397775.1-Ani_VZTE01001920.1_i000_004033	168	386	218	0.973214	0.436874
GCA_013397215.1-Ani_VYXE01005553.1_i000_003062	170	388	218	0.973214	0.402214
GCA_000150015.2-Pro_KI544499.1_i000_003288	183	398	215	0.959821	0.438776
GCA_000325525.2-Pro_KN003127.1_i000_005686	183	398	215	0.959821	0.438776
GCA_013397755.1-Ani_VZTF01008143.1_i000_011558	170	388	218	0.973214	0.43513
GCA_013398035.1-Ani_VZRT01000577.1_i000_004848	168	386	218	0.973214	0.436874
GCA_013401195.1-Ani_VZSW01000041.1_i000_001776	170	388	218	0.973214	0.43513
GCA_013400575.1-Ani_WBNO01010165.1_i000_003977	170	388	218	0.973214	0.43513
GCA_000699245.1-Ani_KL239055.1_i000_005981	170	388	218	0.973214	0.421663
GCA_013399835.1-Ani_VXAX01003481.1_i000_005642	167	386	219	0.977679	0.413208
GCA_013398015.1-Ani_VZRR01014002.1_i000_013320	167	385	218	0.973214	0.437751
GCA_001078535.1-Pro_CAIX01000285.1_i000_010490	180	400	220	0.982143	0.441767
GCA_013397865.1-Ani_VZTI01004304.1_i000_009855	168	386	218	0.973214	0.436874
GCA_013396485.1-Ani_VWYY01000097.1_i000_003231	168	386	218	0.973214	0.436874
GCA_013396525.1-Ani_VWYX01000528.1_i000_006342	168	386	218	0.973214	0.403704
GCA_021525015.1-Fun_JAKELH010000143.1_i000_003665	180	400	220	0.982143	0.391459
GCA_021525025.1-Fun_JAKELI010000306.1_i000_008222	180	400	220	0.982143	0.391459
GCA_000006565.2-Pro_CM002041.1_i000_002472	183	398	215	0.959821	0.438776
GCA_001691785.2-Fun_JNHV02000103.1_i000_003044	183	406	223	0.995536	0.403986
GCA_004115005.2-Pla_CM032139.1_i000_008562	177	396	219	0.977679	0.397459
GCA_002113885.2-Ani_NEDP02076728.1_i000_021473	180	398	218	0.973214	0.422481
GCA_013396875.1-Ani_VZRF01008663.1_i000_007012	168	386	218	0.973214	0.436874
GCA_013398685.1-Ani_VZST01000376.1_i000_003541	173	391	218	0.973214	0.472885
GCA_905219645.1-Fun_CAJMWZ010001686.1_i000_001763	166	390	224	1	0.391608
GCA_017607445.1-Fun_JAEVHH010000002.1_i000_002836	190	416	226	1.00893	0.43295
GCA_013398075.1-Ani_VZRX01015541.1_i000_008477	173	391	218	0.973214	0.43254
GCA_013400915.1-Ani_VZTX01005503.1_i000_002114	174	392	218	0.973214	0.431683
GCA_013397725.1-Ani_VZTD01001642.1_i000_003307	168	386	218	0.973214	0.436874
GCA_013400235.1-Ani_VXBT01001174.1_i000_001257	168	386	218	0.973214	0.436874
GCA_013400515.1-Ani_VZTN01036903.1_i000_012825	168	386	218	0.973214	0.436874
GCA_013399195.1-Ani_VXAD01008599.1_i000_008548	168	386	218	0.973214	0.436874
GCA_902810595.1-Ani_LR778274.1_i000_024713	180	399	219	0.977679	0.410112
GCA_013397015.1-Ani_VWZQ01011413.1_i000_011280	168	386	218	0.973214	0.436874
GCA_013397315.1-Ani_WBMY01011951.1_i000_008939	173	391	218	0.973214	0.472885
GCA_013397845.1-Ani_VZTG01008348.1_i000_010846	168	386	218	0.973214	0.436874
GCA_008932095.1-Pla_CM018516.1_i000_027358	177	396	219	0.977679	0.398182
GCA_905182995.1-Pro_CAJJDP010000009.1_i000_004041	188	410	222	0.991071	0.457732
GCA_000709365.1-Ani_KL470206.1_i000_009831	170	388	218	0.973214	0.423301
GCA_001006355.1-Fun_LAQI01000215.1_i000_003837	192	417	225	1.00446	0.431862
GCA_011057915.1-Ani_RZID01001378.1_i000_001260	162	380	218	0.973214	0.428291
GCA_003675905.2-Ani_NCKV01000721.1_i000_002140	188	414	226	1.00893	0.209842
GCA_013400635.1-Ani_VYZP01014234.1_i000_002172	180	398	218	0.973214	0.426614
GCA_000005175.1-Ani_CH933807.1_i000_009221	180	397	217	0.96875	0.417308
GCA_013397995.1-Ani_VZRP01022776.1_i000_013683	173	391	218	0.973214	0.43254
GCA_000715385.1-Fun_AZST01000846.1_i000_008775	187	411	224	1	0.408015
GCA_013390065.1-Ani_WEIW01006478.1_i000_013158	1	220	219	0.977679	0.920168
GCA_000690775.1-Ani_JJRO01060273.1_i000_006766	165	383	218	0.973214	0.425781
GCA_014362265.1-Pla_BJWL01000008.1_i000_011811	177	396	219	0.977679	0.386926
GCA_003024255.1-Pla_CM009661.1_i000_009143	177	396	219	0.977679	0.385563
GCA_013400715.1-Ani_VZTP01012041.1_i000_003575	173	391	218	0.973214	0.4
GCA_000710305.1-Ani_KL534676.1_i000_010922	167	385	218	0.973214	0.426614
GCA_013397435.1-Ani_VZRG01002786.1_i000_010264	168	386	218	0.973214	0.410546
GCA_003203555.1-Fun_BEXD01003112.1_i000_017133	182	402	220	0.982143	0.326895
GCA_015698045.1-Fun_BLAL01000300.1_i000_026967	182	402	220	0.982143	0.326895
GCA_013400445.1-Ani_VXBY01001122.1_i000_006296	170	388	218	0.973214	0.43513
GCA_013399435.1-Ani_VXAK01027257.1_i000_013063	170	388	218	0.973214	0.407477
GCA_000751015.1-Pla_LK032004.1_i000_003227	188	412	224	1	0.436647
GCA_013397815.1-Ani_VZTH01003588.1_i000_002556	180	398	218	0.973214	0.426614
GCA_013397055.1-Ani_VWZT01009954.1_i000_007484	181	399	218	0.973214	0.425781
GCA_007252995.1-Ani_SWJQ01000118.1_i000_005472	180	398	218	0.973214	0.413662
GCA_013400015.1-Ani_VXBG01005527.1_i000_004396	167	385	218	0.973214	0.411321
GCA_013397535.1-Ani_VYZE01000443.1_i000_007022	175	393	218	0.973214	0.470842
GCA_000524645.1-Fun_JATN01000319.1_i000_004974	187	411	224	1	0.408015
GCA_002197715.1-Ani_MUZQ01000099.1_i000_015237	180	398	218	0.973214	0.413662
GCA_013398885.1-Ani_VYZL01000186.1_i000_000381	182	400	218	0.973214	0.424951
GCA_000403535.1-Pla_CM001883.1_i000_016919	177	395	218	0.973214	0.385841
GCA_013396465.1-Ani_VWYW01000004.1_i000_000374	180	398	218	0.973214	0.429134
GCA_000220395.1-Pro_GL984229.1_i000_006344	188	410	222	0.991071	0.455852
GCA_013099955.1-Pro_CM023088.1_i000_002527	183	398	215	0.959821	0.438776
GCA_015473125.1-Pla_BNJQ01000029.1_i000_009123	295	518	223	0.995536	0.370432
GCA_013400075.1-Ani_VWYN01017802.1_i000_008181	168	386	218	0.973214	0.403704
GCA_013397115.1-Ani_VWZW01005705.1_i000_009153	95	320	225	1.00446	0.66568
GCA_000513335.1-Fun_HG793134.1_i000_000584	190	416	226	1.00893	0.44227
GCA_001513925.1-Fun_LLXE01000151.1_i000_002050	190	416	226	1.00893	0.44227
GCA_013397355.1-Ani_VXBE01010303.1_i000_010821	168	386	218	0.973214	0.403704
GCA_013397395.1-Ani_VXBN01015726.1_i000_012462	167	385	218	0.973214	0.411321
GCA_013399275.1-Ani_VXAG01000108.1_i000_002723	122	340	218	0.973214	0.531707
GCA_016098105.1-Fun_JAAAIY010000088.1_i000_007994	182	400	218	0.973214	0.426614
GCA_013400275.1-Ani_VWYO01009700.1_i000_004619	170	388	218	0.973214	0.409006
GCA_003611195.1-Fun_MCBQ01002865.1_i000_001110	192	417	225	1.00446	0.426945
GCA_016771965.1-Pla_CM028690.1_i000_018732	188	412	224	1	0.448
GCA_016098135.1-Fun_JAAAIZ010000056.1_i000_006893	182	400	218	0.973214	0.424125
GCA_013399155.1-Ani_VWYG01012092.1_i000_006524	170	388	218	0.973214	0.4
GCA_905219595.1-Fun_CAJMWU010006927.1_i000_009522	187	411	224	1	0.404332
GCA_905219605.1-Fun_CAJMWV010004918.1_i000_006608	187	411	224	1	0.404332
GCA_013397095.1-Ani_VWZU01013077.1_i000_008455	173	391	218	0.973214	0.406716
GCA_013399945.1-Ani_VXBC01009940.1_i000_010081	167	385	218	0.973214	0.404453
GCA_013186435.1-Ani_PYHW01010656.1_i000_014390	184	408	224	1	0.406534
GCA_003325435.1-Fun_PJQL01002463.1_i000_012786	185	411	226	1.00893	0.45749
GCA_900000135.1-Fun_CCYT01000018.1_i000_007025	185	411	226	1.00893	0.45749
GCA_004011995.1-Pla_QGNW01000010.1_i000_004948	232	451	219	0.977679	0.363184
GCA_000827275.1-Fun_KN833760.1_i000_010644	183	407	224	1	0.385542
GCA_020379485.1-Pla_CM035458.1_i000_057709	200	424	224	1	0.420263
GCA_000211455.3-Ani_ADMH02002134.1_i000_000714	180	398	218	0.973214	0.394213
GCA_015484485.1-Fun_MU156538.1_i000_008441	180	403	223	0.995536	0.391916
GCA_001692915.1-Fun_KV749239.1_i000_005037	191	415	224	1	0.411765
GCA_013400155.1-Ani_VXBM01000049.1_i000_001567	168	386	218	0.973214	0.410546
GCA_013396935.1-Ani_VWZK01000006.1_i000_000009	115	340	225	1.00446	0.472689
GCA_011763935.1-Fun_JAANJC010001659.1_i000_010076	186	411	225	1.00446	0.457317
GCA_011763955.1-Fun_JAANJD010001450.1_i000_009359	186	411	225	1.00446	0.457317
GCA_013396755.1-Ani_VWZF01003788.1_i000_006778	115	340	225	1.00446	0.473684
GCA_013397175.1-Ani_VYXC01003289.1_i000_003092	168	386	218	0.973214	0.403704
GCA_013399655.1-Ani_VXAS01014328.1_i000_008352	168	386	218	0.973214	0.403704
GCA_001420675.1-Ani_LMAW01002801.1_i000_012525	180	398	218	0.973214	0.394928
GCA_013397395.1-Ani_VXBN01003038.1_i000_002155	115	340	225	1.00446	0.483871
GCA_013397775.1-Ani_VZTE01005230.1_i000_011234	115	340	225	1.00446	0.482833
GCA_013400735.1-Ani_VYZT01043122.1_i000_008662	115	340	225	1.00446	0.479744
GCA_013400435.1-Ani_VWYP01015839.1_i000_005947	170	388	218	0.973214	0.402214
GCA_013398055.1-Ani_VZRS01001745.1_i000_001612	168	386	218	0.973214	0.402957
GCA_003184925.1-Fun_KZ821652.1_i000_011775	64	290	226	1.00893	0.575064
GCA_013396595.1-Ani_VWZB01000535.1_i000_007827	175	393	218	0.973214	0.396364
GCA_013399875.1-Ani_VXAZ01001305.1_i000_001904	168	386	218	0.973214	0.403704
GCA_013400395.1-Ani_WBNN01018653.1_i000_006040	170	388	218	0.973214	0.402214
GCA_013389985.1-Ani_WEIT01029211.1_i000_008686	167	385	218	0.973214	0.404453
GCA_000478725.1-Pla_KI517748.1_i000_021894	177	395	218	0.973214	0.406716
GCA_000708225.1-Ani_KL410237.1_i000_004244	168	386	218	0.973214	0.424951
GCA_001654015.2-Ani_LSRL02000073.1_i000_007939	287	504	217	0.96875	0.344992
GCA_013389905.1-Ani_WEKW01020018.1_i000_007746	169	386	217	0.96875	0.428854
GCA_015849285.1-Fun_JAAAHZ010000417.1_i000_006392	578	796	218	0.973214	0.239297
GCA_013399875.1-Ani_VXAZ01010495.1_i000_014081	115	340	225	1.00446	0.480769
GCA_013399815.1-Ani_VZZX01007702.1_i000_008600	175	393	218	0.973214	0.470842
GCA_014851425.1-Pla_CM026266.1_i000_022809	177	396	219	0.977679	0.394595
GCA_013397235.1-Ani_VYXG01002353.1_i000_002743	115	340	225	1.00446	0.480769
GCA_013398935.1-Ani_VWPQ01005058.1_i000_006462	182	400	218	0.973214	0.392086
GCA_013397015.1-Ani_VWZQ01004206.1_i000_004023	115	340	225	1.00446	0.475687
GCA_003097675.1-Fun_MBFU01000486.1_i000_004785	184	402	218	0.973214	0.412879
GCA_001447455.1-Ani_JYDL01000002.1_i000_006799	209	434	225	1.00446	0.271739
GCA_013397415.1-Ani_VYZA01000849.1_i000_010332	115	340	225	1.00446	0.465839
GCA_003086725.1-Fun_MBFT01000397.1_i000_003831	184	402	218	0.973214	0.40824
GCA_013398095.1-Ani_VZRY01004162.1_i000_008760	173	391	218	0.973214	0.4
GCA_018859375.1-Ani_JAHGAV010000014.1_i000_002317	180	399	219	0.977679	0.41954
GCA_003611215.1-Fun_MCBR01007331.1_i000_002436	192	417	225	1.00446	0.426945
GCA_003692655.1-Ani_QRBI01000105.1_i000_006861	184	409	225	1.00446	0.409091
GCA_000315645.2-Fun_JH993675.1_i000_007605	190	416	226	1.00893	0.439689
GCA_000315665.1-Fun_JH993736.1_i000_006669	190	416	226	1.00893	0.439689
GCA_012295545.2-Fun_JAAQRF020000011.1_i000_001706	190	416	226	1.00893	0.439689
GCA_016767815.1-Fun_CP060774.1_i000_001521	190	416	226	1.00893	0.439689
GCA_013397915.1-Ani_VZRO01006245.1_i000_009978	115	340	225	1.00446	0.477707
GCA_013398635.1-Ani_WBNE01000045.1_i000_001111	173	391	218	0.973214	0.472885
GCA_006346445.1-Ani_VEVO01000002.1_i000_002799	180	399	219	0.977679	0.412429
GCA_013396895.1-Ani_VWZM01017277.1_i000_013762	115	340	225	1.00446	0.479744
GCA_013389925.1-Ani_WEIU01017831.1_i000_009392	167	385	218	0.973214	0.437751
GCA_000698965.1-Ani_KL206820.1_i000_011782	167	386	219	0.977679	0.42607
GCA_013399975.1-Ani_VXBD01009568.1_i000_008139	175	393	218	0.973214	0.470842
GCA_013398795.1-Ani_WBNG01000075.1_i000_002877	180	398	218	0.973214	0.465812
GCA_013400635.1-Ani_VYZP01034525.1_i000_005176	115	340	225	1.00446	0.479744
GCA_002072375.1-Fun_MLKD01000003.1_i000_002525	190	416	226	1.00893	0.437984
GCA_007821545.1-Fun_QGMJ01000405.1_i000_005260	193	418	225	1.00446	0.447316
GCA_013400585.1-Ani_WEZZ01025122.1_i000_007743	115	339	224	1	0.625698
GCA_013400195.1-Ani_VXBL01003409.1_i000_004964	168	386	218	0.973214	0.401473
GCA_013397555.1-Ani_VZRH01001289.1_i000_001928	115	340	225	1.00446	0.479744
GCA_013400075.1-Ani_VWYN01003357.1_i000_001652	115	340	225	1.00446	0.479744
GCA_013400015.1-Ani_VXBG01015871.1_i000_012153	115	340	225	1.00446	0.485961
GCA_003260635.2-Pla_QGKW02001988.1_i000_020586	177	389	212	0.946429	0.386861
GCA_013400855.1-Ani_VZTT01036377.1_i000_004123	175	393	218	0.973214	0.470842
GCA_013396365.1-Ani_VWPP01000163.1_i000_002933	173	391	218	0.973214	0.4
GCA_013399855.1-Ani_VXAY01006789.1_i000_011972	115	340	225	1.00446	0.469729
GCA_013397215.1-Ani_VYXE01012812.1_i000_007338	115	340	225	1.00446	0.479744
GCA_000167075.2-Fun_JH797135.1_i000_002135	112	345	233	1.04018	0.470707
GCA_013398745.1-Ani_VZSY01000696.1_i000_009270	115	340	225	1.00446	0.472689
GCA_000149305.1-Fun_CH476732.1_i000_015331	186	411	225	1.00446	0.454545
GCA_011763585.1-Fun_JAANIP010001020.1_i000_006107	186	411	225	1.00446	0.454545
GCA_011763695.1-Fun_JAANIQ010000006.1_i000_000106	186	411	225	1.00446	0.454545
GCA_011763715.1-Fun_JAANIR010000174.1_i000_001933	186	411	225	1.00446	0.454545
GCA_011763735.1-Fun_JAANIS010002168.1_i000_007434	186	411	225	1.00446	0.454545
GCA_011763755.1-Fun_JAANIW010000079.1_i000_001371	186	411	225	1.00446	0.454545
GCA_011763775.1-Fun_JAANIT010000046.1_i000_000728	186	411	225	1.00446	0.454545
GCA_011763795.1-Fun_JAANIV010000021.1_i000_000436	186	411	225	1.00446	0.454545
GCA_011763815.1-Fun_JAANIU010000031.1_i000_000523	186	411	225	1.00446	0.454545
GCA_011763835.1-Fun_JAANIX010000026.1_i000_000545	186	411	225	1.00446	0.454545
GCA_011763875.1-Fun_JAANIZ010000006.1_i000_000128	186	411	225	1.00446	0.454545
GCA_011763895.1-Fun_JAANIY010000025.1_i000_000412	186	411	225	1.00446	0.454545
GCA_011763915.1-Fun_JAANJB010000065.1_i000_001066	186	411	225	1.00446	0.454545
GCA_006536005.1-Fun_QEAQ01000001.1_i000_000205	181	400	219	0.977679	0.414773
GCA_013400275.1-Ani_VWYO01017904.1_i000_008654	115	340	225	1.00446	0.479744
GCA_013399935.1-Ani_VWYM01004336.1_i000_002197	177	395	218	0.973214	0.468817
GCA_003698115.1-Fun_RAQS01000201.1_i000_005058	190	416	226	1.00893	0.420074
GCA_013397615.1-Ani_WBNI01000145.1_i000_003153	180	398	218	0.973214	0.465812
GCA_002072235.1-Fun_MDYO01000001.1_i000_000915	190	416	226	1.00893	0.44227
GCA_013138035.1-Fun_JAASRZ010000051.1_i000_005584	190	416	226	1.00893	0.44227
GCA_013401035.1-Ani_VZUA01397592.1_i000_008383	61	286	225	1.00446	0.585938
GCA_013398435.1-Ani_VZSL01000014.1_i000_001602	115	340	225	1.00446	0.476695
GCA_000315625.1-Pro_JH992978.1_i000_005061	181	400	219	0.977679	0.437126
GCA_006535985.1-Fun_QEAO01000040.1_i000_005004	186	409	223	0.995536	0.387153
GCA_002083745.1-Fun_KV921927.1_i000_005915	185	411	226	1.00893	0.45749
GCA_002708625.1-Fun_KZ303856.1_i000_007908	185	411	226	1.00893	0.45749
GCA_013399035.1-Ani_VWYF01003535.1_i000_001231	115	340	225	1.00446	0.461066
GCA_013400435.1-Ani_VWYP01023119.1_i000_008815	115	340	225	1.00446	0.467775
GCA_011763935.1-Fun_JAANJC010000123.1_i000_001860	402	627	225	1.00446	0.317797
GCA_000264995.1-Fun_JH687541.1_i000_003773	180	399	219	0.977679	0.378893
GCA_013397075.1-Ani_VWZS01007276.1_i000_009342	115	340	225	1.00446	0.466805
GCA_013400315.1-Ani_VXBU01006960.1_i000_005112	168	386	218	0.973214	0.47807
GCA_013397295.1-Ani_VYXF01005679.1_i000_006089	61	286	225	1.00446	0.587467
GCA_013400815.1-Ani_WBNK01000497.1_i000_006273	175	393	218	0.973214	0.468817
GCA_013397695.1-Ani_VYZI01000089.1_i000_013241	175	393	218	0.973214	0.468817
GCA_013398975.1-Ani_VWYD01021031.1_i000_009228	115	340	225	1.00446	0.470711
GCA_902206195.3-Pla_CABITT030000001.1_i000_003085	177	395	218	0.973214	0.411321
GCA_013398275.1-Ani_VZSE01012720.1_i000_011406	115	340	225	1.00446	0.465839
GCA_013399735.1-Ani_VXAW01013171.1_i000_013091	172	390	218	0.973214	0.4334
GCA_001660665.1-Fun_LGUA01000025.1_i000_003677	1	224	223	0.995536	0.701258
GCA_000825725.1-Fun_CDGI01000041.1_i000_002566	185	411	226	1.00893	0.45749
GCA_003144295.1-Fun_KZ819634.1_i000_001663	191	414	223	0.995536	0.37479
GCA_013398035.1-Ani_VZRT01009222.1_i000_012102	115	340	225	1.00446	0.469729
ACBR001.0722.00001.C001_02161	156	378	222	0.991071	0.532374
GCA_015039395.1-Fun_MU132146.1_i000_004025	187	411	224	1	0.400716
GCA_000613005.1-Ani_HG805811.1_i000_000139	148	368	220	0.982143	0.458333
GCA_013397465.1-Ani_VYZD01002185.1_i000_012785	115	340	225	1.00446	0.480769
GCA_002081575.1-Pro_JNBS01001045.1_i000_005025	181	400	219	0.977679	0.447853
GCA_003676055.1-Ani_QUSF01000024.1_i000_007658	180	398	218	0.973214	0.346032
GCA_002081595.1-Pro_JNBR01002408.1_i000_008653	181	400	219	0.977679	0.44877
GCA_015679515.1-Fun_JAAAVA010002398.1_i000_011065	181	399	218	0.973214	0.394928
GCA_905319865.3-Ani_CAJNRD030001118.1_i000_004049	64	283	219	0.977679	0.505774
GCA_013397665.1-Ani_VYZH01003310.1_i000_009793	115	340	225	1.00446	0.478723
GCA_013398685.1-Ani_VZST01004016.1_i000_011200	115	339	224	1	0.625698
GCA_016758985.1-Fun_JAEPRD010000069.1_i000_006893	486	711	225	1.00446	0.28699
GCA_018873745.1-Pro_JAENGY010000178.1_i000_004754	181	400	219	0.977679	0.446939
GCA_010080465.1-Ani_VULD01012471.1_i000_010217	61	286	225	1.00446	0.542169
GCA_016865095.1-Pro_RCMR01000037.1_i000_002493	181	400	219	0.977679	0.446939
GCA_016880175.1-Pro_RCMS01000034.1_i000_002099	181	400	219	0.977679	0.446939
GCA_016880985.1-Pro_QOKR01000164.1_i000_005515	181	400	219	0.977679	0.446939
GCA_013400475.1-Ani_WAAF01005705.1_i000_003807	175	393	218	0.973214	0.470842
GCA_004354835.1-Ani_CM014938.1_i000_003836	211	436	225	1.00446	0.379427
GCA_016618375.1-Pro_JADEVP010000065.1_i000_019318	181	400	219	0.977679	0.433663
GCA_012295175.1-Pro_WSZM01000706.1_i000_017315	181	400	219	0.977679	0.441532
GCA_012552325.1-Pro_JAACNO010000465.1_i000_003351	181	400	219	0.977679	0.441532
GCA_012552325.1-Pro_JAACNO010000465.1_i000_003358	181	400	219	0.977679	0.441532
GCA_013399135.1-Ani_VXBZ01006975.1_i000_007097	170	388	218	0.973214	0.405959
GCA_002083735.1-Fun_KV921292.1_i000_002942	185	411	226	1.00893	0.45749
GCA_003325435.1-Fun_PJQL01000013.1_i000_000236	185	411	226	1.00893	0.45749
GCA_011762625.1-Fun_JAANIL010000014.1_i000_001391	185	411	226	1.00893	0.45749
GCA_011762635.1-Fun_JAANIK010000160.1_i000_001698	185	411	226	1.00893	0.45749
GCA_011763475.1-Fun_JAANIM010000157.1_i000_001562	185	411	226	1.00893	0.45749
GCA_011763565.1-Fun_JAANIN010000118.1_i000_003248	185	411	226	1.00893	0.45749
GCA_011764045.1-Fun_JAANQQ010000123.1_i000_002991	185	411	226	1.00893	0.45749
GCA_015499975.1-Fun_JAAAUD010000391.1_i000_006811	182	400	218	0.973214	0.424951
GCA_013396815.1-Ani_WBMX01000086.1_i000_000479	139	357	218	0.973214	0.464819
GCA_003942145.1-Ani_QXTE01000015.1_i000_002778	180	400	220	0.982143	0.418251
GCA_003344505.1-Fun_KZ851849.1_i000_004136	190	416	226	1.00893	0.435453
GCA_003549995.1-Fun_QKKE01000010.1_i000_000190	182	402	220	0.982143	0.511628
GCA_015849335.1-Fun_JAAAIC010002731.1_i000_005211	1	210	209	0.933036	0.665605
GCA_013399715.1-Ani_VXAV01006481.1_i000_006977	177	396	219	0.977679	0.414773
GCA_002563875.1-Pro_CM008349.1_i000_003148	184	393	209	0.933036	0.420523
GCA_002844005.1-Ani_KZ505656.1_i000_001406	176	393	217	0.96875	0.338006
GCA_013399075.1-Ani_VWZY01010702.1_i000_009536	167	385	218	0.973214	0.403704
GCA_001278595.1-Fun_LHQQ01000220.1_i000_005021	190	416	226	1.00893	0.439689
GCA_013397935.1-Ani_VZRN01006269.1_i000_012880	115	340	225	1.00446	0.476695
GCA_000722935.2-Pla_KN654438.1_i000_023808	177	396	219	0.977679	0.396022
GCA_004193775.2-Pla_CM014368.1_i000_033310	177	396	219	0.977679	0.396022
GCA_000700745.1-Ani_KL342538.1_i000_003284	168	386	218	0.973214	0.424951
GCA_019155685.1-Pro_JAGDFL010000110.1_i000_000646	181	400	219	0.977679	0.440644
GCA_000004515.5-Pla_CM000845.3_i000_030376	177	396	219	0.977679	0.393885
GCA_012273815.2-Pla_CM022570.2_i000_032641	177	396	219	0.977679	0.393885
GCA_014282035.1-Pla_CM024844.1_i000_021389	177	396	219	0.977679	0.393885
GCA_014282085.1-Pla_CM024904.1_i000_006374	177	396	219	0.977679	0.393885
GCA_014282145.1-Pla_CM024944.1_i000_032842	177	396	219	0.977679	0.393885
GCA_020497155.1-Pla_CM035718.1_i000_033117	177	396	219	0.977679	0.393885
GCA_007825375.1-Fun_QGML01000033.1_i000_000378	193	418	225	1.00446	0.448207
GCA_900245975.1-Ani_OUUW01000006.1_i000_006866	180	397	217	0.96875	0.414914
GCA_001619985.1-Fun_KV407460.1_i000_005522	192	417	225	1.00446	0.437743
GCA_000696875.1-Ani_KK931477.1_i000_001860	170	388	218	0.973214	0.421663
GCA_000142945.1-Pro_DS028132.1_i000_009509	204	423	219	0.977679	0.421965
GCA_015342445.1-Pla_JACEFO010001687.1_i000_021343	189	408	219	0.977679	0.378238
GCA_013368325.1-Fun_JAACJK010000113.1_i000_010752	180	405	225	1.00446	0.391986
GCA_903064755.1-Fun_CAEFZW010000001.1_i000_000053	126	360	234	1.04464	0.490566
GCA_903987035.1-Fun_CAJDZR010000001.1_i000_000053	126	360	234	1.04464	0.490566
GCA_003573695.1-Pla_CM010718.1_i000_015565	177	396	219	0.977679	0.398907
GCA_000757645.3-Ani_AZBU02000003.1_i000_014628	76	300	224	1	0.589474
GCA_003704535.1-Pro_QLLG01000197.1_i000_002014	181	400	219	0.977679	0.444219
GCA_003843895.1-Pro_QKXF01000123.1_i000_002591	181	400	219	0.977679	0.444219
GCA_021491655.1-Pro_CP090810.1_i000_009333	181	400	219	0.977679	0.444219
GCA_013186435.1-Ani_PYHW01010052.1_i000_008727	180	398	218	0.973214	0.413662
GCA_004114815.1-Pla_SDOW01000487.1_i000_034955	177	394	217	0.96875	0.389587
GCA_019202805.1-Pla_CM032907.1_i000_034762	188	412	224	1	0.449799
GCA_015178965.1-Fun_WHVB01000003.1_i000_006573	180	400	220	0.982143	0.37931
GCA_000003745.2-Pla_FN597042.1_i000_020197	188	413	225	1.00446	0.478723
GCA_013397955.1-Ani_VZRM01007610.1_i000_011774	115	340	225	1.00446	0.512528
GCA_013397155.1-Ani_VWZV01004689.1_i000_003501	173	391	218	0.973214	0.4
GCA_020379485.1-Pla_CM035451.1_i000_023564	268	486	218	0.973214	0.091023
GCA_905332185.1-Ani_CAJOBM010009063.1_i000_028879	185	410	225	1.00446	0.464876
GCA_905216605.1-Pla_LR999453.1_i000_006970	186	410	224	1	0.450704
GCA_905216605.1-Pla_LR999456.1_i000_016192	178	396	218	0.973214	0.417625
GCA_001876935.1-Pla_CM007382.1_i000_004960	188	412	224	1	0.401434
GCA_007821495.1-Fun_QGMH01000122.1_i000_006559	193	418	225	1.00446	0.447316
GCA_013202065.2-Ani_JAAOIC020000016.1_i000_001220	179	398	219	0.977679	0.369932
GCA_000005215.1-Ani_CH480818.1_i000_008864	180	397	217	0.96875	0.426326
GCA_014188975.1-Fun_JACGCI010000007.1_i000_021715	180	405	225	1.00446	0.390625
GCA_013266195.1-Fun_JABEYC010000749.1_i000_008505	603	829	226	1.00893	0.246187
GCA_000365505.1-Pro_ANIZ01002825.1_i000_016054	181	400	219	0.977679	0.441532
GCA_000365525.1-Pro_ANJA01002983.1_i000_016021	181	400	219	0.977679	0.441532
GCA_000365545.1-Pro_ANIX01003216.1_i000_015895	181	400	219	0.977679	0.441532
GCA_000367145.1-Pro_ANIY01003379.1_i000_015900	181	400	219	0.977679	0.441532
GCA_000509465.1-Pro_KI688248.1_i000_015623	181	400	219	0.977679	0.441532
GCA_000509525.1-Pro_KI694960.1_i000_015468	181	400	219	0.977679	0.441532
GCA_019202795.1-Pla_CM032920.1_i000_034448	188	412	224	1	0.448898
GCA_013400915.1-Ani_VZTX01005982.1_i000_002357	115	340	225	1.00446	0.475687
GCA_013397375.1-Ani_VXBI01010041.1_i000_009645	167	385	218	0.973214	0.406716
GCA_013397075.1-Ani_VWZS01010376.1_i000_013503	167	385	218	0.973214	0.406716
GCA_001839685.1-Pro_MLAK01000533.1_i000_004342	53	273	220	0.982143	0.599455
GCA_000703405.1-Ani_KL383298.1_i000_006064	170	388	218	0.973214	0.421663
GCA_000509485.1-Pro_KI675008.1_i000_015526	181	400	219	0.977679	0.441532
GCA_000509505.1-Pro_KI681695.1_i000_015330	181	400	219	0.977679	0.441532
GCA_000687375.1-Ani_KK497335.1_i000_011978	166	384	218	0.973214	0.424951
GCA_017506865.1-Pro_JAFCMP010000434.1_i000_013226	181	401	220	0.982143	0.471092
GCA_003370565.1-Pla_QJKJ01002791.1_i000_013536	177	396	219	0.977679	0.394595
GCA_000695195.1-Ani_KK754249.1_i000_006999	170	388	218	0.973214	0.421663
GCA_000005135.1-Ani_CH954177.1_i000_012850	180	397	217	0.96875	0.427165
GCA_000247585.2-Pro_KI669611.1_i000_017574	181	400	219	0.977679	0.441532
GCA_001482985.1-Pro_LNFP01000206.1_i000_003533	181	400	219	0.977679	0.441532
GCA_001483015.1-Pro_LNFO01005725.1_i000_015060	181	400	219	0.977679	0.441532
GCA_013396635.1-Ani_WBMW01002373.1_i000_005278	167	386	219	0.977679	0.405556
GCA_003549995.1-Fun_QKKE01000369.1_i000_012556	187	411	224	1	0.405063
GCA_013397325.1-Ani_VZTC01002365.1_i000_002953	170	388	218	0.973214	0.402214
GCA_000697705.1-Fun_KL198017.1_i000_001087	179	395	216	0.964286	0.375652
GCA_000569095.1-Pro_CM002466.1_i000_005472	181	401	220	0.982143	0.412758
GCA_000005975.1-Ani_CM000157.2_i000_002824	180	397	217	0.96875	0.426326
GCA_016920775.1-Ani_JAFDOW010001337.1_i000_004708	181	397	216	0.964286	0.380952
GCA_019845555.1-Pla_CM034078.1_i000_002105	187	406	219	0.977679	0.379549
GCA_000259055.1-Ani_CM000361.1_i000_000874	180	397	217	0.96875	0.42549
GCA_000754195.3-Ani_CM002910.1_i000_000890	180	397	217	0.96875	0.42549
GCA_905183005.1-Pro_CAJJDO010000004.1_i000_002281	188	410	222	0.991071	0.457732
GCA_013399615.1-Ani_VXAR01012043.1_i000_011315	170	388	218	0.973214	0.400735
GCA_013511315.1-Pla_CM025264.1_i000_012094	19	237	218	0.973214	0.533007
GCA_000375325.1-Pla_KB870810.1_i000_018747	197	415	218	0.973214	0.395644
GCA_001190045.1-Pla_CM003378.1_i000_020477	177	396	219	0.977679	0.397459
GCA_004320505.1-Pla_AP015039.1_i000_018378	177	396	219	0.977679	0.397459
GCA_016808095.1-Pla_CM028989.1_i000_014414	177	396	219	0.977679	0.397459
GCA_000151545.2-Pro_KK583246.1_i000_011739	181	400	219	0.977679	0.445122
GCA_013396455.1-Ani_VWYV01000175.1_i000_003880	176	394	218	0.973214	0.400735
GCA_001561935.1-Fun_LHQR01000065.1_i000_005058	190	416	226	1.00893	0.44227
GCA_000525045.1-Fun_KI966426.1_i000_003471	189	413	224	1	0.405797
GCA_014282095.1-Pla_CM024924.1_i000_033458	217	436	219	0.977679	0.36745
GCA_001630475.1-Fun_KV419396.1_i000_001471	180	402	222	0.991071	0.40884
GCA_021432655.1-Fun_MU271189.1_i000_000901	192	414	222	0.991071	0.373109
GCA_016256075.1-Fun_SDVU01000239.1_i000_000818	143	358	215	0.959821	0.554124
GCA_001584585.1-Pla_LSYV01000039.1_i000_010017	164	383	219	0.977679	0.44332
GCA_013400955.1-Ani_VZTZ01042376.1_i000_010901	115	340	225	1.00446	0.465839
GCA_011058865.1-Fun_SWKW01000188.1_i000_003969	192	416	224	1	0.435798
GCA_013397665.1-Ani_VYZH01001741.1_i000_006956	170	388	218	0.973214	0.392793
GCA_016758905.1-Fun_JAEPQZ010000001.1_i000_000707	181	401	220	0.982143	0.42471
GCA_020744425.1-Fun_JAGMUV010000009.1_i000_020835	193	419	226	1.00893	0.452
GCA_013398175.1-Ani_VZRZ01000983.1_i000_001292	115	340	225	1.00446	0.464876
GCA_013396465.1-Ani_VWYW01002310.1_i000_013457	141	366	225	1.00446	0.441176
GCA_900537205.1-Ani_UYRW01000461.1_i000_002649	189	412	223	0.995536	0.379252
GCA_001632425.1-Fun_KV425564.1_i000_004116	180	400	220	0.982143	0.388693
GCA_000230395.2-Fun_ACJE01000013.1_i000_004247	190	416	226	1.00893	0.435453
GCA_002211485.2-Fun_NKJJ02000008.1_i000_009879	190	416	226	1.00893	0.435453
GCA_003184595.1-Fun_KZ821339.1_i000_002212	190	416	226	1.00893	0.435453
GCA_003344705.1-Fun_KZ851947.1_i000_010514	190	416	226	1.00893	0.435453
GCA_003344945.1-Fun_KZ852043.1_i000_005419	190	416	226	1.00893	0.435453
GCA_003850985.1-Fun_BDHI01000021.1_i000_008087	190	416	226	1.00893	0.435453
GCA_900248155.1-Fun_OGUI01000010.1_i000_006933	190	416	226	1.00893	0.435453
GCA_000239835.2-Fun_DF126452.1_i000_003036	190	416	226	1.00893	0.435453
GCA_001515345.1-Fun_BCMY01000009.1_i000_005824	190	416	226	1.00893	0.435453
GCA_001602395.1-Fun_BCWF01000018.1_i000_010694	190	416	226	1.00893	0.435453
GCA_001890685.1-Fun_KV878241.1_i000_006433	190	416	226	1.00893	0.435453
GCA_001890745.1-Fun_KV878203.1_i000_007295	190	416	226	1.00893	0.435453
GCA_003184755.1-Fun_KZ825073.1_i000_009667	190	416	226	1.00893	0.435453
GCA_003184835.1-Fun_KZ824540.1_i000_002935	190	416	226	1.00893	0.435453
GCA_013340325.1-Fun_BLWE01000011.1_i000_009580	190	416	226	1.00893	0.435453
GCA_016861625.1-Fun_AP024431.1_i000_010438	190	416	226	1.00893	0.435453
GCA_016865315.1-Fun_AP024440.1_i000_009402	190	416	226	1.00893	0.435453
GCA_000478725.1-Pla_KI517408.1_i000_007681	177	396	219	0.977679	0.404806
GCA_013390045.1-Ani_WEKY01052081.1_i000_011107	115	340	225	1.00446	0.469729
GCA_003184535.1-Fun_MSFU01000013.1_i000_001932	190	416	226	1.00893	0.435453
GCA_013399635.1-Ani_VXAQ01000094.1_i000_002688	175	393	218	0.973214	0.470842
GCA_910592225.1-Fun_CAJVPR010000281.1_i000_004716	187	411	224	1	0.403604
GCA_018691285.1-Pla_CM031885.1_i000_009062	411	630	219	0.977679	0.279337
GCA_904420315.1-Pla_LR881470.1_i000_019218	177	395	218	0.973214	0.467811
GCA_000827415.1-Fun_KN824316.1_i000_009379	184	398	214	0.955357	0.363946
GCA_014282345.1-Pla_CM024979.1_i000_032690	234	453	219	0.977679	0.359016
GCA_012931995.1-Fun_JAADYS010000890.1_i000_006715	193	419	226	1.00893	0.444008
GCA_013266205.1-Fun_JAAGWO010000002.1_i000_000010	193	419	226	1.00893	0.444008
GCA_013398675.1-Ani_WBNF01000245.1_i000_000002	115	340	225	1.00446	0.464876
GCA_003184625.1-Fun_KZ821446.1_i000_000696	190	416	226	1.00893	0.430476
GCA_000002515.1-Fun_CR382124.1_i000_002580	105	334	229	1.02232	0.490364
GCA_900411305.1-Pla_LS480641.1_i000_001035	177	394	217	0.96875	0.3875
GCA_002220415.3-Pla_CM022216.1_i000_026947	177	394	217	0.96875	0.3875
GCA_013399475.1-Ani_VXAL01001997.1_i000_001320	169	389	220	0.982143	0.482456
GCA_000355885.1-Ani_KB742873.1_i000_005960	167	387	220	0.982143	0.483516
GCA_002220415.3-Pla_CM022214.1_i000_014877	177	394	217	0.96875	0.3875
GCA_900231445.1-Pla_LT934113.1_i000_009021	177	394	217	0.96875	0.3875
GCA_905232135.1-Fun_CAJNJQ010000257.1_i000_000670	187	411	224	1	0.409506
GCA_000347455.1-Pla_KD049566.1_i000_003932	177	394	217	0.96875	0.3875
GCA_000258705.1-Pla_AGSI01000004.1_i000_002713	178	398	220	0.982143	0.397112
GCA_002104995.1-Fun_MCFD01000010.1_i000_001795	182	401	219	0.977679	0.430255
GCA_013397175.1-Ani_VYXC01000717.1_i000_000483	115	340	225	1.00446	0.571066
GCA_013401095.1-Ani_WBNP01053825.1_i000_012502	115	340	225	1.00446	0.471698
GCA_013396375.1-Ani_VWPR01000049.1_i000_001441	180	398	218	0.973214	0.39781
GCA_013397715.1-Ani_WBNL01002054.1_i000_012680	115	340	225	1.00446	0.465839
GCA_021527685.1-Pro_JAJGMV010000091.1_i000_001966	180	399	219	0.977679	0.436255
GCA_014066315.1-Fun_JACCJB010000020.1_i000_005163	191	417	226	1.00893	0.437984
GCA_014066305.1-Fun_JACCJC010000002.1_i000_001005	191	417	226	1.00893	0.437984
GCA_001632355.1-Fun_KV428024.1_i000_003472	180	402	222	0.991071	0.3821
GCA_019828595.1-Pro_JAHQRK010000005.1_i000_014246	181	400	219	0.977679	0.434524
GCA_021527665.1-Pro_JAJNMJ010005755.1_i000_015032	181	400	219	0.977679	0.435388
GCA_021527785.1-Pro_JAJATU010000122.1_i000_001026	181	400	219	0.977679	0.435388
GCA_021527805.1-Pro_JAJNMK010000526.1_i000_007013	181	400	219	0.977679	0.435388
GCA_013398635.1-Ani_WBNE01000014.1_i000_010790	115	340	225	1.00446	0.46875
GCA_013399995.1-Ani_VXBF01004021.1_i000_003243	115	340	225	1.00446	0.46875
GCA_008271595.1-Pro_SMMQ01002475.1_i000_012061	181	400	219	0.977679	0.436255
GCA_013400035.1-Ani_VXBH01002016.1_i000_002970	115	340	225	1.00446	0.475687
GCA_013399795.1-Ani_VWYL01014125.1_i000_005764	115	340	225	1.00446	0.46875
GCA_009835175.1-Pro_VJMJ01000056.1_i000_017803	181	400	219	0.977679	0.435388
GCA_007825325.1-Fun_QGMG01000084.1_i000_001677	193	418	225	1.00446	0.450902
GCA_013398455.1-Ani_VZSM01004797.1_i000_009885	115	340	225	1.00446	0.470711
GCA_007821475.1-Fun_QGMF01000412.1_i000_005971	193	418	225	1.00446	0.448207
GCA_000277445.1-Pro_AJWJ01000099.1_i000_003225	179	399	220	0.982143	0.344288
GCA_013396635.1-Ani_WBMW01001895.1_i000_004084	1	220	219	0.977679	0.631124
GCA_000004255.1-Pla_GL348718.1_i000_022457	153	371	218	0.973214	0.481236
GCA_002928715.1-Pla_KZ664543.1_i000_015754	177	395	218	0.973214	0.43083
GCA_013398715.1-Ani_VZSU01002064.1_i000_010236	115	340	225	1.00446	0.464876
GCA_013398835.1-Ani_VYZJ01005368.1_i000_012848	115	340	225	1.00446	0.471698
GCA_013399935.1-Ani_VWYM01002981.1_i000_001530	115	340	225	1.00446	0.473684
GCA_022376515.1-Fun_WTXI01000033.1_i000_008484	180	400	220	0.982143	0.378007
GCA_001593155.1-Fun_LLXL01000143.1_i000_003879	216	440	224	1	0.357827
GCA_013397095.1-Ani_VWZU01015577.1_i000_010120	114	339	225	1.00446	0.46875
GCA_000512255.2-Pla_CM008459.1_i000_015134	97	289	192	0.857143	0.66436
GCA_001876935.1-Pla_CM007387.1_i000_017793	152	370	218	0.973214	0.39781
GCA_903231485.1-Fun_CAFBRS010000001.1_i000_000442	188	412	224	1	0.354992
GCA_015039315.1-Fun_WIDE01000135.1_i000_002554	193	418	225	1.00446	0.387263
GCA_003788565.2-Fun_ML119685.1_i000_007609	189	414	225	1.00446	0.442043
GCA_013401155.1-Ani_VZUF01140395.1_i000_003987	115	340	225	1.00446	0.461066
GCA_013400855.1-Ani_VZTT01045877.1_i000_005216	115	340	225	1.00446	0.469729
GCA_905182995.1-Pro_CAJJDP010000003.1_i000_000987	188	410	222	0.991071	0.457732
GCA_903189775.1-Fun_CAEVNN010000059.1_i000_002750	188	412	224	1	0.348367
GCA_013399835.1-Ani_VXAX01005718.1_i000_009441	115	340	225	1.00446	0.475687
GCA_002812745.2-Fun_NCSJ02000090.1_i000_012317	193	419	226	1.00893	0.449304
GCA_000439145.3-Fun_AUPC02000095.1_i000_025754	188	412	224	1	0.351097
GCA_000597685.1-Fun_JEMT01029692.1_i000_026226	188	412	224	1	0.351097
GCA_001593205.1-Fun_LLXJ01000842.1_i000_012342	188	412	224	1	0.351097
GCA_005286985.1-Pla_CM016552.1_i000_003438	1	101	100	0.446429	0.769231
GCA_013368085.1-Ani_JABVZW010002917.1_i000_018293	180	398	218	0.973214	0.391382
GCA_002897155.2-Fun_BDIQ02000106.1_i000_022311	188	412	224	1	0.35
GCA_903470525.1-Fun_CAGKOT010000056.1_i000_019569	188	412	224	1	0.35
GCA_900618515.1-Ani_UZAO01084459.1_i000_015520	2	114	112	0.5	0.982456
GCA_007844105.2-Pla_CM017584.2_i000_019112	177	396	219	0.977679	0.387611
GCA_001593145.1-Fun_LLXI01000799.1_i000_012662	195	419	224	1	0.345679
GCA_000346795.1-Fun_KB644412.1_i000_004951	190	416	226	1.00893	0.439689
GCA_013398535.1-Ani_VZSP01000663.1_i000_004320	115	340	225	1.00446	0.461066
GCA_903189765.1-Fun_CAEVNM010000032.1_i000_017520	188	412	224	1	0.348367
GCA_903470595.1-Fun_CAGKPD010000001.1_i000_000469	188	412	224	1	0.348367
GCA_903189815.1-Fun_CAEVNS010000006.1_i000_004511	188	412	224	1	0.348367
GCA_013398995.1-Ani_VWYE01009513.1_i000_004530	115	340	225	1.00446	0.464876
GCA_002906115.4-Pla_PKMF03022155.1_i000_077960	177	397	220	0.982143	0.364842
GCA_013400775.1-Ani_VZTR01003775.1_i000_001510	115	339	224	1	0.625698
GCA_021525775.1-Fun_JAKELK010000045.1_i000_012409	173	393	220	0.982143	0.419847
GCA_000281045.1-Pro_JH767194.1_i000_013656	181	400	219	0.977679	0.445122
GCA_000005115.1-Ani_CH902620.1_i000_005129	180	397	217	0.96875	0.423828
GCA_001865875.1-Pla_CM007368.1_i000_013848	177	395	218	0.973214	0.310541
GCA_013400715.1-Ani_VZTP01000911.1_i000_000340	115	340	225	1.00446	0.464876
GCA_001644525.1-Fun_KV441723.1_i000_012854	192	416	224	1	0.429942
GCA_013401375.1-Ani_WBNQ01077646.1_i000_006505	170	380	210	0.9375	0.551181
GCA_013398495.1-Ani_WBNB01000658.1_i000_002396	115	340	225	1.00446	0.465839
GCA_004011995.1-Pla_QGNW01000012.1_i000_005998	188	413	225	1.00446	0.40395
GCA_003604175.2-Ani_CM030370.1_i000_007595	187	411	224	1	0.394366
GCA_001048715.1-Fun_CDHK01000002.1_i000_002238	190	416	226	1.00893	0.44227
GCA_002016555.1-Fun_LJBN01000241.1_i000_010218	190	416	226	1.00893	0.44227
GCA_001969505.1-Fun_LSSK01000567.1_i000_000486	167	390	223	0.995536	0.430502
GCA_002911725.1-Pro_NCKW01008312.1_i000_013715	181	400	219	0.977679	0.437126
GCA_018691285.1-Pla_CM031892.1_i000_019023	208	427	219	0.977679	0.359016
GCA_004115005.2-Pla_CM032146.1_i000_017692	206	425	219	0.977679	0.360197
GCA_002928715.1-Pla_KZ662916.1_i000_003012	177	395	218	0.973214	0.405204
GCA_001276565.1-Ani_KQ435789.1_i000_006930	179	397	218	0.973214	0.375862
GCA_000763605.2-Pla_JRKL02004283.1_i000_021541	177	397	220	0.982143	0.364842
GCA_905237085.1-Pro_CAJNNV010031763.1_i000_053073	183	403	220	0.982143	0.465116
GCA_021018615.1-Fun_JAEVFL010000004.1_i000_005435	183	406	223	0.995536	0.38986
GCA_001593125.1-Fun_LLXH01000069.1_i000_002592	216	440	224	1	0.334828
GCA_019455425.1-Pla_CM033494.1_i000_026881	177	395	218	0.973214	0.399267
GCA_002906115.4-Pla_PKMF03010682.1_i000_038651	203	423	220	0.982143	0.351438
GCA_902705455.1-Pla_CACSHJ010000096.1_i000_023323	177	395	218	0.973214	0.409006
GCA_008761655.1-Pla_CM018209.1_i000_039106	177	395	218	0.973214	0.396364
GCA_007990345.1-Pla_CM017669.1_i000_020726	177	395	218	0.973214	0.397086
GCA_004355085.1-Fun_ML170156.1_i000_000195	181	401	220	0.982143	0.37931
GCA_001651475.1-Pla_CM004363.1_i000_022965	177	395	218	0.973214	0.410546
GCA_019202795.1-Pla_CM032917.1_i000_022955	177	395	218	0.973214	0.410546
GCA_019202805.1-Pla_CM032904.1_i000_022283	177	395	218	0.973214	0.410546
GCA_902651935.1-Pla_CACRSJ010000110.1_i000_023445	177	395	218	0.973214	0.410546
GCA_007990325.1-Pla_CM017695.1_i000_042195	177	395	218	0.973214	0.395644
GCA_015179045.1-Fun_WHUZ01000049.1_i000_010227	190	414	224	1	0.421053
GCA_014058105.1-Pla_JACGCM010000067.1_i000_025366	177	396	219	0.977679	0.380208
GCA_013396995.1-Ani_VWZP01006251.1_i000_007374	61	286	225	1.00446	0.533175
GCA_013368075.1-Ani_JABVZV010002219.1_i000_016110	180	400	220	0.982143	0.4
GCA_013398115.1-Ani_VZRV01009661.1_i000_012200	1	220	219	0.977679	0.611732
GCA_000600275.1-Fun_KK088414.1_i000_002037	191	416	225	1.00446	0.438596
GCA_905146915.1-Pla_CAJHUC010001107.1_i000_005121	175	395	220	0.982143	0.40367
GCA_004011705.1-Fun_RZGK01000002.1_i000_000508	192	416	224	1	0.432432
GCA_020875875.1-Pla_CM037029.1_i000_023921	177	395	218	0.973214	0.373288
GCA_000004335.1-Ani_GL192652.1_i000_006092	167	385	218	0.973214	0.479121
GCA_008692635.1-Ani_VOAJ01006362.1_i000_015229	167	385	218	0.973214	0.479121
GCA_001663975.1-Ani_KV467223.1_i000_043791	184	409	225	1.00446	0.422932
GCA_000327365.1-Pla_CM001743.1_i000_009946	177	395	218	0.973214	0.38448
GCA_000375325.1-Pla_KB870807.1_i000_008114	188	413	225	1.00446	0.452716
GCA_013399115.1-Ani_VXAA01007015.1_i000_013070	167	386	219	0.977679	0.42278
GCA_000005245.1-Ani_CH940649.1_i000_007089	180	397	217	0.96875	0.418919
GCA_019616945.1-Fun_WSTK01000353.1_i000_006869	187	411	224	1	0.408015
GCA_007990455.1-Pla_CM017656.1_i000_043230	177	395	218	0.973214	0.385841
GCA_007990345.1-Pla_CM017685.1_i000_067883	177	395	218	0.973214	0.38448
GCA_013398975.1-Ani_VWYD01000180.1_i000_000106	167	385	218	0.973214	0.407477
GCA_015679415.1-Fun_JAAAUT010000086.1_i000_010076	582	800	218	0.973214	0.238512
GCA_000836355.1-Fun_KN847941.1_i000_005787	195	421	226	1.00893	0.395797
GCA_019455425.1-Pla_CM033491.1_i000_019155	177	395	218	0.973214	0.383803
GCA_011763855.1-Fun_JAANJA010000260.1_i000_003227	186	411	225	1.00446	0.454545
GCA_002926015.1-Pla_KZ650136.1_i000_034054	177	395	218	0.973214	0.38448
GCA_007990455.1-Pla_CM017659.1_i000_061678	177	395	218	0.973214	0.38448
GCA_007990485.1-Pla_CM017633.1_i000_064843	177	395	218	0.973214	0.38448
GCA_008761655.1-Pla_CM018225.1_i000_060160	177	395	218	0.973214	0.38448
GCA_000327365.1-Pla_CM001746.1_i000_018889	177	395	218	0.973214	0.38448
GCA_007990325.1-Pla_CM017698.1_i000_060851	177	395	218	0.973214	0.38448
GCA_007990345.1-Pla_CM017672.1_i000_029559	177	395	218	0.973214	0.38448
GCA_007990485.1-Pla_CM017620.1_i000_060739	177	395	218	0.973214	0.38448
GCA_008761655.1-Pla_CM018212.1_i000_056380	177	395	218	0.973214	0.38448
GCA_005393395.2-Pla_CM016624.1_i000_025517	177	395	218	0.973214	0.38448
GCA_014621375.1-Fun_JAAOZQ010000087.1_i000_009846	190	416	226	1.00893	0.44227
GCA_013401445.1-Pla_CM023886.1_i000_022319	188	412	224	1	0.407273
GCA_010405375.1-Fun_MU004298.1_i000_002381	192	416	224	1	0.432432
GCA_005239225.1-Pla_RCHU01000222.1_i000_012560	177	395	218	0.973214	0.3879
GCA_018804465.1-Pla_CM031976.1_i000_041303	177	395	218	0.973214	0.3879
GCA_007990325.1-Pla_CM017711.1_i000_064885	177	395	218	0.973214	0.38448
GCA_020496765.1-Pla_CM035626.1_i000_023287	177	395	218	0.973214	0.38448
GCA_000271625.1-Fun_JH711577.1_i000_005736	182	405	223	0.995536	0.38986
GCA_000935105.1-Fun_KN905631.1_i000_005286	195	421	226	1.00893	0.395797
GCA_000835745.1-Fun_KN848716.1_i000_004477	195	421	226	1.00893	0.395797
GCA_000875815.1-Fun_KN849065.1_i000_004416	195	421	226	1.00893	0.395797
GCA_009650685.1-Fun_CM018863.1_i000_001307	195	421	226	1.00893	0.397887
GCA_000185945.1-Fun_CP000290.1_i000_003278	195	421	226	1.00893	0.395797
GCA_013400155.1-Ani_VXBM01003795.1_i000_013422	1	220	219	0.977679	0.623932
GCA_905237085.1-Pro_CAJNNV010014449.1_i000_020823	183	403	220	0.982143	0.464135
GCA_009835185.1-Pro_VJMH01005219.1_i000_010559	181	400	219	0.977679	0.438
GCA_900708865.1-Pro_CAADRA010005240.1_i000_007906	181	400	219	0.977679	0.438
GCA_007726485.1-Pla_CM017443.1_i000_024209	177	397	220	0.982143	0.392857
GCA_000835755.1-Fun_KN848867.1_i000_004538	195	421	226	1.00893	0.395797
GCA_001630375.1-Fun_JYNV01000183.1_i000_004164	192	416	224	1	0.431599
GCA_004011695.1-Fun_RYYQ01000017.1_i000_008679	192	416	224	1	0.431599
GCA_000855695.1-Fun_KN848903.1_i000_005245	195	421	226	1.00893	0.395797
GCA_000836335.1-Fun_KN847985.1_i000_004474	195	421	226	1.00893	0.395797
GCA_013399175.1-Ani_VXAB01012447.1_i000_011718	180	399	219	0.977679	0.401099
GCA_022432375.1-Fun_JAJKKK010000031.1_i000_005926	191	417	226	1.00893	0.437137
GCA_001889945.1-Fun_KV878684.1_i000_006645	190	416	226	1.00893	0.435453
GCA_013397795.1-Ani_VZTJ01001571.1_i000_003647	168	386	218	0.973214	0.403704
GCA_008932095.1-Pla_CM018516.1_i000_027615	177	396	219	0.977679	0.397459
GCA_011763645.1-Fun_JAASGZ010000006.1_i000_000157	186	411	225	1.00446	0.457317
GCA_011763975.1-Fun_JAANJF010001808.1_i000_009365	186	411	225	1.00446	0.457317
GCA_011763995.1-Fun_JAANJE010001276.1_i000_005008	186	411	225	1.00446	0.457317
GCA_011764025.1-Fun_JAANQT010001249.1_i000_007992	186	411	225	1.00446	0.457317
GCA_011764055.1-Fun_JAANQS010000185.1_i000_002214	186	411	225	1.00446	0.457317
GCA_011764125.1-Fun_JAANQV010002432.1_i000_006713	186	411	225	1.00446	0.457317
GCA_011764145.1-Fun_JAANQZ010001001.1_i000_004902	186	411	225	1.00446	0.457317
GCA_011764185.1-Fun_JAANRA010001254.1_i000_008186	186	411	225	1.00446	0.457317
GCA_011764225.1-Fun_JAANRQ010003381.1_i000_007799	186	411	225	1.00446	0.457317
GCA_011764265.1-Fun_JAANRE010005179.1_i000_007858	186	411	225	1.00446	0.457317
GCA_011800955.1-Fun_JAANRM010000481.1_i000_005308	186	411	225	1.00446	0.457317
GCA_011800985.1-Fun_JAANRL010001271.1_i000_008785	186	411	225	1.00446	0.457317
GCA_011801035.1-Fun_JAANRN010001275.1_i000_009215	186	411	225	1.00446	0.457317
GCA_011801055.1-Fun_JAANRO010001262.1_i000_008991	186	411	225	1.00446	0.457317
GCA_011801305.1-Fun_JAANRS010001574.1_i000_009747	186	411	225	1.00446	0.457317
GCA_011801335.1-Fun_JAANRP010001250.1_i000_007995	186	411	225	1.00446	0.457317
GCA_011801385.1-Fun_JAANRR010001612.1_i000_009220	186	411	225	1.00446	0.457317
GCA_011801495.1-Fun_JAANRV010000270.1_i000_003298	186	411	225	1.00446	0.457317
GCA_011801505.1-Fun_JAANRU010000128.1_i000_001934	186	411	225	1.00446	0.457317
GCA_011801555.1-Fun_JAANRX010000410.1_i000_004414	186	411	225	1.00446	0.457317
GCA_011801575.1-Fun_JAANRW010000731.1_i000_006647	186	411	225	1.00446	0.457317
GCA_011801605.1-Fun_JAANRT010001579.1_i000_009849	186	411	225	1.00446	0.457317
GCA_011801645.1-Fun_JAANRB010000162.1_i000_002150	186	411	225	1.00446	0.457317
GCA_011801675.1-Fun_JAANQW010001720.1_i000_009122	186	411	225	1.00446	0.457317
GCA_011801705.1-Fun_JAANQY010001266.1_i000_008092	186	411	225	1.00446	0.457317
GCA_011801725.1-Fun_JAANQX010001716.1_i000_009546	186	411	225	1.00446	0.457317
GCA_011801785.1-Fun_JAANQR010001194.1_i000_007554	186	411	225	1.00446	0.457317
GCA_011801815.1-Fun_JAANQU010001258.1_i000_007974	186	411	225	1.00446	0.457317
GCA_011950945.1-Fun_JAANRD010000234.1_i000_003063	186	411	225	1.00446	0.457317
GCA_011950985.1-Fun_JAANRF010000356.1_i000_004179	186	411	225	1.00446	0.457317
GCA_011951285.1-Fun_JAANRG010000923.1_i000_008414	186	411	225	1.00446	0.457317
GCA_011951295.1-Fun_JAANRC010000090.1_i000_001219	186	411	225	1.00446	0.457317
GCA_011952045.1-Fun_JAANRH010000246.1_i000_002707	186	411	225	1.00446	0.457317
GCA_011952115.1-Fun_JAANRI010001478.1_i000_008160	186	411	225	1.00446	0.457317
GCA_011952145.1-Fun_JAANRJ010000730.1_i000_006634	186	411	225	1.00446	0.457317
GCA_011952175.1-Fun_JAANRK010000117.1_i000_001892	186	411	225	1.00446	0.457317
GCA_001883805.1-Fun_LGTZ01000284.1_i000_005314	190	416	226	1.00893	0.443137
GCA_007252995.1-Ani_SWJQ01000195.1_i000_008008	184	409	225	1.00446	0.409836
GCA_020726525.1-Fun_JAGPXC010000005.1_i000_010457	186	412	226	1.00893	0.450199
GCA_008787405.2-Ani_CM018480.1_i000_008493	170	388	218	0.973214	0.419231
GCA_008782695.1-Ani_CM018501.1_i000_009549	170	388	218	0.973214	0.419231
GCA_000224845.2-Pro_KN042481.1_i000_004059	3	169	166	0.741071	0.937853
GCA_004379255.2-Pla_CM031492.1_i000_051151	220	444	224	1	0.468619
GCA_006547085.1-Pla_VIEB01000380.1_i000_021513	177	396	219	0.977679	0.398182
GCA_022432505.1-Fun_JAJKKH010000006.1_i000_009057	191	417	226	1.00893	0.44227
GCA_907164705.1-Ani_CAJQZP010001269.1_i000_020338	180	398	218	0.973214	0.399267
GCA_900618435.1-Ani_UYSU01036572.1_i000_011458	164	389	225	1.00446	0.497788
GCA_000230445.1-Ani_JH172931.1_i000_018275	136	354	218	0.973214	0.443089
GCA_013389845.1-Ani_VWPX01006284.1_i000_004050	180	399	219	0.977679	0.469957
GCA_000230795.1-Ani_CM001264.1_i000_010579	179	397	218	0.973214	0.411321
GCA_000230815.1-Ani_CM001287.1_i000_009629	179	397	218	0.973214	0.411321
GCA_002880775.3-Ani_CM009264.2_i000_002849	179	397	218	0.973214	0.411321
GCA_000256725.2-Pro_KQ986313.1_i000_008309	3	169	166	0.741071	0.937853
GCA_000005195.1-Ani_CH479184.1_i000_010230	180	397	217	0.96875	0.419729
GCA_013396975.1-Ani_VWZO01020120.1_i000_012477	168	387	219	0.977679	0.397459
GCA_019616945.1-Fun_WSTK01000011.1_i000_000628	180	403	223	0.995536	0.38918
GCA_013397845.1-Ani_VZTG01009635.1_i000_012543	115	340	225	1.00446	0.481799
GCA_013398775.1-Ani_VZSX01000144.1_i000_002486	178	398	220	0.982143	0.472103
GCA_020800215.1-Pro_JAICDV010000001.1_i000_000473	181	400	219	0.977679	0.445122
GCA_020800235.1-Pro_JAICDX010000005.1_i000_006626	181	400	219	0.977679	0.445122
GCA_021193595.1-Fun_JAJJMK010000211.1_i000_008194	186	412	226	1.00893	0.439689
GCA_000599465.2-Ani_AWGT02000109.1_i000_008187	180	399	219	0.977679	0.442424
GCA_902860255.1-Pla_LR794324.1_i000_007787	188	412	224	1	0.420263
GCA_011066875.1-Fun_JAABOE010000017.1_i000_003308	189	413	224	1	0.414048
GCA_000165425.1-Pro_CT868207.1_i000_019990	188	410	222	0.991071	0.440476
GCA_000743755.1-Pro_JPUL02000275.1_i000_004382	180	400	220	0.982143	0.419048
GCA_004768765.1-Fun_SOZJ01000002.1_i000_002996	189	413	224	1	0.404332
GCA_011066565.1-Fun_WIRA01000002.1_i000_003966	189	413	224	1	0.404332
GCA_011066575.1-Fun_WIQW01000045.1_i000_007641	189	413	224	1	0.404332
GCA_011066585.1-Fun_WIQY01000064.1_i000_009598	189	413	224	1	0.404332
GCA_011066595.1-Fun_WIQZ01000058.1_i000_008395	189	413	224	1	0.404332
GCA_011066605.1-Fun_WIQX01000018.1_i000_003760	189	413	224	1	0.404332
GCA_011066695.1-Fun_WIRB01000039.1_i000_006877	189	413	224	1	0.404332
GCA_011066715.1-Fun_WIWQ01000010.1_i000_000391	189	413	224	1	0.404332
GCA_011066735.1-Fun_JAABOI010000019.1_i000_003715	189	413	224	1	0.404332
GCA_011066745.1-Fun_JAABOH010000035.1_i000_006455	189	413	224	1	0.404332
GCA_011066795.1-Fun_WIWR01000033.1_i000_005933	189	413	224	1	0.404332
GCA_011067015.1-Fun_JAABLO010000014.1_i000_002332	189	413	224	1	0.404332
GCA_011066885.1-Fun_WIWS01000017.1_i000_003213	189	413	224	1	0.408759
GCA_011066905.1-Fun_WIWT01000042.1_i000_007266	189	413	224	1	0.408759
GCA_011066925.1-Fun_WIPF01000045.1_i000_007230	189	413	224	1	0.408759
GCA_011066985.1-Fun_WIPG01000002.1_i000_004139	189	413	224	1	0.408759
GCA_003186165.1-Ani_CP026243.1_i000_000070	180	399	219	0.977679	0.263538
GCA_009363875.1-Pla_CM018690.1_i000_041082	188	412	224	1	0.415584
GCA_002880755.3-Ani_CM009240.2_i000_002862	179	397	218	0.973214	0.412098
GCA_017524585.1-Ani_CM029820.1_i000_003107	179	397	218	0.973214	0.404453
GCA_013634535.1-Ani_JACDTQ010004070.1_i000_015042	179	397	218	0.973214	0.405959
GCA_015679585.1-Fun_JAAAVF010001543.1_i000_002414	141	359	218	0.973214	0.458947
GCA_000803125.3-Ani_CM016631.2_i000_003613	169	387	218	0.973214	0.416031
GCA_013389825.1-Ani_VWPW01019556.1_i000_008057	180	399	219	0.977679	0.469957
GCA_001481415.2-Fun_LNZH02000204.1_i000_004988	180	403	223	0.995536	0.203653
GCA_013053245.1-Fun_JAACJL010000032.1_i000_002822	176	399	223	0.995536	0.223
GCA_000325575.1-Ani_KB031068.1_i000_015125	179	397	218	0.973214	0.412879
GCA_013398735.1-Ani_VZSV01000046.1_i000_009131	180	399	219	0.977679	0.467949
GCA_000298355.1-Ani_JH882248.1_i000_012908	166	384	218	0.973214	0.414449
GCA_013399275.1-Ani_VXAG01002620.1_i000_012934	115	340	225	1.00446	0.475687
GCA_009363875.1-Pla_CM018690.1_i000_041095	188	412	224	1	0.412523
GCA_020341155.1-Ani_JAHMML010000017.1_i000_002977	179	401	222	0.991071	0.382759
GCA_000448345.1-Ani_KE670805.1_i000_008395	179	397	218	0.973214	0.39781
GCA_900231445.1-Pla_LT934114.1_i000_014352	225	442	217	0.96875	0.356908
GCA_001447595.1-Ani_JYDH01000002.1_i000_000401	231	456	225	1.00446	0.212064
GCA_002220415.3-Pla_CM022215.1_i000_021238	224	441	217	0.96875	0.357496
GCA_002072245.1-Fun_MDYL01000005.1_i000_002206	190	416	226	1.00893	0.434615
GCA_000743615.1-Ani_KN125438.1_i000_020278	179	397	218	0.973214	0.409006
GCA_013399295.1-Ani_VXAH01000562.1_i000_009246	115	340	225	1.00446	0.465839
GCA_007821535.1-Fun_QGMI01000364.1_i000_005201	193	418	225	1.00446	0.447316
GCA_006381635.2-Pla_VEPZ02001081.1_i000_041068	177	395	218	0.973214	0.388592
GCA_004329165.1-Pla_CM014731.1_i000_010332	177	396	219	0.977679	0.421154
GCA_000165425.1-Pro_CT868540.1_i000_029696	188	410	222	0.991071	0.457732
GCF_000001405.40-Hum_NC_000002.12_i000_003021	179	397	218	0.973214	0.412098
GCA_007990325.1-Pla_CM017708.1_i000_045355	177	395	218	0.973214	0.385159
GCA_007990345.1-Pla_CM017682.1_i000_058514	177	395	218	0.973214	0.385159
GCA_007990485.1-Pla_CM017630.1_i000_045261	177	395	218	0.973214	0.385159
GCA_014108255.1-Ani_JACAGC010000006.1_i000_016098	179	397	218	0.973214	0.409006
GCA_014176215.1-Ani_JACASE010000002.1_i000_009696	179	397	218	0.973214	0.409774
GCA_002104975.1-Fun_MCOG01000039.1_i000_013211	186	410	224	1	0.456212
GCA_016946835.1-Fun_JACVTC010000072.1_i000_023612	186	410	224	1	0.456212
GCA_010015675.1-Fun_ML976991.1_i000_007358	189	413	224	1	0.433269
GCA_004026145.2-Ani_CP034992.1_i000_004803	18	243	225	1.00446	0.659824
GCA_013389885.1-Ani_VWPV01018733.1_i000_006523	22	247	225	1.00446	0.581395
GCA_013397495.1-Ani_VYZC01001903.1_i000_003694	61	286	225	1.00446	0.528169
GCA_020080175.1-Fun_JAGHQL010000145.1_i000_001486	191	417	226	1.00893	0.407942
GCA_905182975.1-Pro_CAJJDM010000004.1_i000_002156	188	410	222	0.991071	0.457732
GCA_002102555.1-Fun_MCFL01000011.1_i000_001186	181	406	225	1.00446	0.448207
GCA_020740775.1-Fun_JAHEWK010000010.1_i000_002956	193	419	226	1.00893	0.444008
GCA_013401355.1-Ani_VYZU01070814.1_i000_008391	116	340	224	1	0.478632
GCA_000499545.1-Pro_HG673812.1_i000_001181	183	389	206	0.919643	0.411178
GCA_022539455.1-Pla_CM039732.1_i000_020538	177	395	218	0.973214	0.355628
GCA_010015635.1-Fun_ML976002.1_i000_001338	192	416	224	1	0.433269
GCA_000612305.1-Pla_KK198760.1_i000_025943	177	396	219	0.977679	0.378238
GCA_000499385.1-Pro_HG723058.1_i000_003141	183	389	206	0.919643	0.411178
GCA_014108235.1-Ani_JABWUV010000008.1_i000_019708	179	397	218	0.973214	0.403704
GCA_013397995.1-Ani_VZRP01010431.1_i000_006208	115	340	225	1.00446	0.467775
GCA_000327345.1-Ani_KB102035.1_i000_002868	179	397	218	0.973214	0.403704
GCA_007990455.1-Pla_CM017646.1_i000_057800	177	395	218	0.973214	0.38448
GCA_001972305.1-Pla_BDDD01000337.1_i000_007737	177	396	219	0.977679	0.382867
GCA_013399975.1-Ani_VXBD01009548.1_i000_008057	115	340	225	1.00446	0.470711
GCA_000334495.1-Ani_KB320805.1_i000_010355	167	385	218	0.973214	0.419231
GCA_020379485.1-Pla_CM035462.1_i000_077135	194	412	218	0.973214	0.095698
GCA_000701005.1-Ani_KL363183.1_i000_000446	202	421	219	0.977679	0.300412
GCA_900661375.1-Ani_CAAGRJ010012530.1_i000_008303	179	397	218	0.973214	0.388592
GCA_010094095.1-Fun_ML979132.1_i000_000419	192	416	224	1	0.432432
GCA_000224905.2-Pro_KN000241.1_i000_002664	3	168	165	0.736607	0.932203
GCA_000325525.2-Pro_KN003134.1_i000_007310	3	168	165	0.736607	0.932203
GCA_013398575.1-Ani_WBNC01024961.1_i000_011782	115	340	225	1.00446	0.466805
GCA_011799765.1-Pla_JAANDH010000423.1_i000_014597	164	383	219	0.977679	0.384886
GCA_002897155.2-Fun_BDIQ02000026.1_i000_009478	182	402	220	0.982143	0.332326
GCA_000511025.2-Pla_KQ090245.1_i000_006889	24	222	198	0.883929	0.770428
GCA_019925795.1-Pla_CM034311.1_i000_016400	177	395	218	0.973214	0.351047
GCA_000439145.3-Fun_AUPC02000115.1_i000_001811	182	402	220	0.982143	0.324963
GCA_003287315.1-Pro_MJFZ01000345.1_i000_012577	181	400	219	0.977679	0.446939
GCA_016864635.1-Pro_RCME01000153.1_i000_006526	181	400	219	0.977679	0.446939
GCA_016864655.1-Pro_NHQK01000085.1_i000_027508	181	400	219	0.977679	0.446939
GCA_016864665.1-Pro_RCMF01000765.1_i000_017457	181	400	219	0.977679	0.446939
GCA_016864695.1-Pro_RCMG01000133.1_i000_006437	181	400	219	0.977679	0.446939
GCA_016864715.1-Pro_RCMK01000165.1_i000_007865	181	400	219	0.977679	0.446939
GCA_016864735.1-Pro_RCMI01000118.1_i000_005602	181	400	219	0.977679	0.446939
GCA_016864755.1-Pro_RCMH01000159.1_i000_007879	181	400	219	0.977679	0.446939
GCA_016864775.1-Pro_RCMO01000543.1_i000_015801	181	400	219	0.977679	0.446939
GCA_016864795.1-Pro_RCMN01000079.1_i000_004191	181	400	219	0.977679	0.446939
GCA_016864815.1-Pro_RCML01000391.1_i000_012275	181	400	219	0.977679	0.446939
GCA_016864835.1-Pro_RCMM01000755.1_i000_018466	181	400	219	0.977679	0.446939
GCA_016864855.1-Pro_RCMP01000759.1_i000_017132	181	400	219	0.977679	0.446939
GCA_016865055.1-Pro_RCMV01000774.1_i000_015985	181	400	219	0.977679	0.446939
GCA_016865075.1-Pro_RCMT01000773.1_i000_024836	181	400	219	0.977679	0.446939
GCA_016865085.1-Pro_RCMU01000087.1_i000_026162	181	400	219	0.977679	0.446939
GCA_016906365.1-Pro_RCMQ01000138.1_i000_006424	181	400	219	0.977679	0.446939
GCA_017309695.1-Pro_RCMJ01000047.1_i000_004212	181	400	219	0.977679	0.446939
GCA_018873755.1-Pro_JAENGZ010000209.1_i000_006503	181	400	219	0.977679	0.446939
GCA_020004485.1-Ani_JAATJU010022199.1_i000_010093	179	397	218	0.973214	0.360331
GCA_020746845.1-Fun_JAGPNJ010000009.1_i000_012500	187	411	224	1	0.412523
GCA_001593205.1-Fun_LLXJ01000250.1_i000_005630	182	402	220	0.982143	0.323054
GCA_903231485.1-Fun_CAFBRS010000195.1_i000_008568	182	402	220	0.982143	0.323054
GCA_019616975.1-Fun_WSTL01000129.1_i000_001366	111	329	218	0.973214	0.419231
GCA_000597685.1-Fun_JEMT01029310.1_i000_025299	182	402	220	0.982143	0.323054
GCA_001593125.1-Fun_LLXH01000163.1_i000_004996	182	402	220	0.982143	0.323054
GCA_903189815.1-Fun_CAEVNS010000051.1_i000_018111	182	402	220	0.982143	0.323054
GCA_903470525.1-Fun_CAGKOT010000025.1_i000_011767	182	402	220	0.982143	0.323054
GCA_000150115.1-Fun_GG663365.1_i000_006470	190	416	226	1.00893	0.435453
GCA_017355575.1-Fun_CP069118.1_i000_002256	190	416	226	1.00893	0.435453
GCA_017607465.1-Fun_JAEVHI010000001.1_i000_001310	190	416	226	1.00893	0.435453
GCA_020496765.1-Pla_CM035623.1_i000_012356	177	395	218	0.973214	0.383803
GCA_000005925.1-Ani_CH963920.1_i000_006036	180	397	217	0.96875	0.420543
GCA_903189775.1-Fun_CAEVNN010000254.1_i000_010454	182	402	220	0.982143	0.332326
GCA_003611235.1-Fun_MCBS01024996.1_i000_006237	192	417	225	1.00446	0.426945
GCA_910592225.1-Fun_CAJVPR010001555.1_i000_012508	189	409	220	0.982143	0.324006
GCA_014839625.1-Fun_WIWV01000013.1_i000_001397	190	416	226	1.00893	0.439689
GCA_014839855.1-Fun_WIWU01000094.1_i000_007984	190	416	226	1.00893	0.439689
GCA_021730765.1-Ani_JAIZAO010000106.1_i000_012024	748	974	226	1.00893	0.212406
GCA_001593145.1-Fun_LLXI01000157.1_i000_004369	182	402	220	0.982143	0.323054
GCA_013390105.1-Ani_WAAG01087397.1_i000_010397	115	340	225	1.00446	0.463918
GCA_000002265.1-Ani_CM000239.2_i000_018568	179	397	218	0.973214	0.40824
GCA_018446385.1-Pla_CM031518.1_i000_039540	194	411	217	0.96875	0.364706
GCA_000827485.1-Fun_KN818232.1_i000_004607	183	406	223	0.995536	0.393298
GCA_000151665.1-Pro_FN668654.1_i000_003547	180	400	220	0.982143	0.406654
GCA_014362265.1-Pla_BJWL01000015.1_i000_022635	177	396	219	0.977679	0.413989
GCA_905146905.1-Ani_CAJHUB010000761.1_i000_018823	179	397	218	0.973214	0.402214
GCA_014058105.1-Pla_JACGCM010001659.1_i000_015095	177	396	219	0.977679	0.38087
GCA_013399195.1-Ani_VXAD01001640.1_i000_001522	115	340	225	1.00446	0.477707
GCA_015849305.1-Fun_JAAAHY010000349.1_i000_006210	182	400	218	0.973214	0.423301
GCA_000701025.1-Ani_KL367479.1_i000_001298	202	421	219	0.977679	0.292
GCA_018320845.1-Ani_CM031334.1_i000_022943	185	410	225	1.00446	0.379427
GCA_014049915.1-Ani_JABVXQ010000004.1_i000_013115	179	397	218	0.973214	0.402214
GCA_904845875.1-Pla_CAJGYO010000001.1_i000_001777	253	472	219	0.977679	0.339009
GCA_000149755.2-Pro_JH159156.1_i000_017061	181	400	219	0.977679	0.447853
GCA_019623675.1-Fun_WSTN01000067.1_i000_009914	128	346	218	0.973214	0.405959
GCA_000333075.3-Pro_AOFI03000065.1_i000_009656	193	412	219	0.977679	0.430255
GCA_000785725.3-Pro_JPWU03000056.1_i000_007589	193	412	219	0.977679	0.430255
GCA_000785735.3-Pro_JPWV03000055.1_i000_007478	193	412	219	0.977679	0.430255
GCA_001707905.2-Pro_MAYM02000222.1_i000_005753	193	412	219	0.977679	0.430255
GCA_001712715.2-Pro_MBDN02000081.1_i000_009115	193	412	219	0.977679	0.430255
GCA_000005505.4-Pla_CM000880.3_i000_007901	177	395	218	0.973214	0.389286
GCA_000705375.2-Ani_KL893085.1_i000_008099	167	386	219	0.977679	0.424419
GCA_001712645.2-Pro_MBAD02002532.1_i000_006241	193	412	219	0.977679	0.430255
GCA_001712705.2-Pro_MBDO02000095.1_i000_009890	193	412	219	0.977679	0.430255
GCA_905332335.1-Ani_CAJOBX010025557.1_i000_028267	179	397	218	0.973214	0.400735
GCA_003018175.1-Ani_PYGN01000356.1_i000_010363	186	411	225	1.00446	0.460123
GCA_000827355.1-Fun_KN831777.1_i000_007376	182	405	223	0.995536	0.38918
GCA_000412655.1-Ani_KE161251.1_i000_001540	216	434	218	0.973214	0.380454
GCA_019455555.1-Ani_JAGFMF010011501.1_i000_004174	242	460	218	0.973214	0.368243
GCA_000835765.1-Fun_KN848835.1_i000_002762	195	421	226	1.00893	0.395797
GCA_000836315.1-Fun_KN848135.1_i000_002095	195	421	226	1.00893	0.395797
GCA_000836375.1-Fun_KN847911.1_i000_005631	195	421	226	1.00893	0.395797
GCA_000836455.1-Fun_KN848955.1_i000_002441	195	421	226	1.00893	0.395797
GCA_000875795.1-Fun_KN848507.1_i000_002308	195	421	226	1.00893	0.395797
GCA_000875855.1-Fun_KN848926.1_i000_002914	195	421	226	1.00893	0.395797
GCA_002954075.1-Fun_CP025764.1_i000_003649	195	421	226	1.00893	0.395797
GCA_021307315.1-Fun_JAJSPD010000023.1_i000_006900	193	418	225	1.00446	0.438596
GCA_000739165.1-Fun_KN042416.1_i000_000983	171	387	216	0.964286	0.433735
GCA_003369635.1-Fun_PDLN01000010.1_i000_001333	193	418	225	1.00446	0.444664
GCA_000981605.1-Fun_HF935394.1_i000_003963	189	415	226	1.00893	0.437137
GCA_001661395.1-Fun_KV454545.1_i000_005267	3	166	163	0.727679	0.503086
GCA_008636005.1-Pla_BKCP01004113.1_i000_005168	177	396	219	0.977679	0.395307
GCA_015143295.1-Pla_CM026570.1_i000_025983	183	402	219	0.977679	0.374359
GCA_004802695.1-Fun_SGPK01000017.1_i000_002100	426	646	220	0.982143	0.179007
GCA_003260385.1-Pla_NQVE01000076.1_i000_002061	177	396	219	0.977679	0.37372
GCA_001014755.1-Fun_LDEV01002583.1_i000_005356	190	416	226	1.00893	0.443137
GCA_013401135.1-Ani_VZUI01054035.1_i000_009436	115	340	225	1.00446	0.467775
GCA_900231445.1-Pla_LT934112.1_i000_007187	177	394	217	0.96875	0.3875
GCA_014764975.1-Fun_JACYFE010005850.1_i000_007716	193	419	226	1.00893	0.443137
GCA_903813345.1-Ani_CAIIXF010000014.1_i000_023240	180	398	218	0.973214	0.397086
GCA_003012285.1-Fun_PXOG01000228.1_i000_009019	193	419	226	1.00893	0.438835
GCA_009613015.1-Fun_VXCB01000080.1_i000_013161	149	374	225	1.00446	0.476695
GCA_019426215.1-Pla_CM033393.1_i000_007438	166	385	219	0.977679	0.390374
GCA_001792695.1-Fun_LYCR01000038.1_i000_005612	190	416	226	1.00893	0.43295
GCA_010411085.1-Ani_CM021199.1_i000_005404	75	293	218	0.973214	0.501149
GCA_020744215.1-Fun_JAGMVJ010000001.1_i000_000954	192	416	224	1	0.429942
GCA_001566745.1-Fun_KQ964435.1_i000_001558	182	400	218	0.973214	0.424951
GCA_000146945.2-Fun_CH476640.1_i000_002246	193	418	225	1.00446	0.436047
GCA_001857865.1-Fun_CP017825.1_i000_009126	193	418	225	1.00446	0.436047
GCA_003024255.1-Pla_CM009668.1_i000_016753	177	396	219	0.977679	0.384886
GCA_905216605.1-Pla_LR999453.1_i000_008362	105	180	75	0.334821	0.190355
GCA_905216605.1-Pla_LR999453.1_i000_008362	176	255	79	0.352679	0.200508
GCA_905216605.1-Pla_LR999453.1_i000_008374	105	180	75	0.334821	0.190355
GCA_905216605.1-Pla_LR999453.1_i000_008374	176	255	79	0.352679	0.200508
GCA_013396555.1-Ani_VZRD01000877.1_i000_013563	115	340	225	1.00446	0.467775
GCA_014805555.1-Fun_SBIQ01000039.1_i000_000850	170	391	221	0.986607	0.347484
GCA_002220235.1-Pla_FO082273.1_i000_003200	177	398	221	0.986607	0.458506
GCA_000151295.1-Fun_GG745349.1_i000_006953	181	405	224	1	0.5
GCA_020744155.1-Fun_JAGPNQ010000007.1_i000_018552	202	428	226	1.00893	0.434615
GCA_002127325.2-Pla_CM007894.2_i000_019256	188	412	224	1	0.417132
GCA_013389925.1-Ani_WEIU01023497.1_i000_012344	115	340	225	1.00446	0.469729
GCA_015178995.1-Fun_WHVE01000001.1_i000_000137	189	415	226	1.00893	0.513636
GCA_022453515.1-Fun_JAJNNY010000033.1_i000_006245	191	416	225	1.00446	0.436047
GCA_010093815.1-Fun_ML996567.1_i000_002279	192	417	225	1.00446	0.441176
GCA_014925845.1-Fun_JACGCL010000002.1_i000_005580	182	402	220	0.982143	0.385289
GCA_020875895.1-Ani_JNEY01000011.1_i000_005477	177	398	221	0.986607	0.443775
GCA_900618005.1-Ani_UYRS01000890.1_i000_002015	181	401	220	0.982143	0.501139
GCA_001243155.1-Fun_LM651686.1_i000_002435	189	412	223	0.995536	0.385147
GCA_900002365.1-Fun_LK056657.1_i000_005427	189	412	223	0.995536	0.385147
GCA_000733195.1-Pla_CM002872.1_i000_007047	188	412	224	1	0.440945
GCA_013400575.1-Ani_WBNO01033415.1_i000_013434	115	340	225	1.00446	0.482833
GCA_020744225.1-Fun_JAGMWG010000001.1_i000_000950	192	416	224	1	0.427481
GCA_003426235.1-Fun_NQIM01000020.1_i000_003253	264	490	226	1.00893	0.386325
GCA_007825345.1-Fun_QGMK01000050.1_i000_000745	193	418	225	1.00446	0.442043
GCA_008403515.1-Pro_VFQX01000007.1_i000_012417	180	402	222	0.991071	0.474359
GCA_021365365.1-Fun_JAJTIX010000016.1_i000_005173	193	419	226	1.00893	0.444882
GCA_000827205.1-Fun_KN832554.1_i000_001520	181	401	220	0.982143	0.383275
GCA_000264905.1-Fun_JH687383.1_i000_005173	180	400	220	0.982143	0.389381
GCA_013401445.1-Pla_CM023885.1_i000_021526	188	412	224	1	0.409506
GCA_001712635.2-Pro_MBAC02001470.1_i000_003440	11	231	220	0.982143	0.664653
GCA_014898435.1-Fun_RCTB01000027.1_i000_010816	193	418	225	1.00446	0.438596
GCA_013398475.1-Ani_VZSO01000025.1_i000_001260	175	395	220	0.982143	0.475162
GCA_003521335.2-Ani_QWLN02003564.1_i000_003019	179	397	218	0.973214	0.405959
GCA_003324165.2-Pro_PYSW02000031.1_i000_010118	180	402	222	0.991071	0.474359
GCA_000005505.4-Pla_CM000880.3_i000_002303	177	394	217	0.96875	0.3875
GCA_015499995.1-Fun_JADNRV010000030.1_i000_009350	182	404	222	0.991071	0.388112
GCA_019677335.1-Fun_WSLM01000044.1_i000_000932	178	402	224	1	0.392982
GCA_022496195.1-Fun_WTXC01000017.1_i000_003316	180	400	220	0.982143	0.383944
GCA_001632445.1-Fun_KV424513.1_i000_006378	180	400	220	0.982143	0.383275
GCA_019623665.1-Fun_WSTM01000435.1_i000_008850	184	402	218	0.973214	0.367622
GCA_019627725.1-Fun_WSTQ01000283.1_i000_006036	184	402	218	0.973214	0.367622
GCA_019627735.1-Fun_WSTP01000103.1_i000_000233	184	402	218	0.973214	0.367622
GCA_019627755.1-Fun_WSTS01000191.1_i000_003469	184	402	218	0.973214	0.367622
GCA_019633565.1-Fun_WSUH01000213.1_i000_003935	184	402	218	0.973214	0.367622
GCA_001593155.1-Fun_LLXL01000620.1_i000_010646	182	402	220	0.982143	0.323529
GCA_903189765.1-Fun_CAEVNM010000004.1_i000_004766	182	402	220	0.982143	0.323529
GCA_903470595.1-Fun_CAGKPD010000054.1_i000_016194	182	402	220	0.982143	0.323529
GCA_002600585.1-Pro_MIGC01001157.1_i000_002753	184	402	218	0.973214	0.415238
GCA_004802705.1-Fun_SGPL01000025.1_i000_003796	186	403	217	0.96875	0.381371
GCA_900074725.1-Fun_LT598459.1_i000_001114	107	332	225	1.00446	0.460123
GCA_005125345.1-Ani_RWIC01000747.1_i000_013461	181	399	218	0.973214	0.417625
GCA_013397895.1-Ani_VZRL01002953.1_i000_005956	115	340	225	1.00446	0.466805
GCA_004117975.1-Fun_SDIL01000052.1_i000_005807	191	405	214	0.955357	0.358459
GCA_000225545.1-Fun_JH119053.1_i000_003297	189	413	224	1	0.402154
GCA_002705745.1-Fun_KZ303502.1_i000_003711	183	408	225	1.00446	0.458248
GCA_000326865.1-Ani_KB097650.1_i000_020904	185	410	225	1.00446	0.494505
GCA_011066845.1-Fun_JAABOJ010000054.1_i000_009100	189	413	224	1	0.402154
GCA_020744375.1-Fun_JAGMUU010000002.1_i000_006438	193	419	226	1.00893	0.452
GCA_018290095.1-Ani_CM031381.1_i000_012823	181	398	217	0.96875	0.412548
GCA_910592285.1-Fun_CAJVQC010006529.1_i000_004634	235	460	225	1.00446	0.41744
GCA_011763605.1-Fun_JAANIO010003256.1_i000_007245	186	411	225	1.00446	0.454545
GCA_020004445.1-Ani_JAATJV010425555.1_i000_019888	280	498	218	0.973214	0.333333
GCA_905066765.1-Fun_CAJHIA010000037.1_i000_010203	193	418	225	1.00446	0.433526
GCA_004000055.1-Fun_SAEB01000012.1_i000_003031	189	413	224	1	0.399287
GCA_019627745.1-Fun_WSTR01000439.1_i000_008854	202	420	218	0.973214	0.356792
GCA_004369125.1-Fun_ML178828.1_i000_007399	183	403	220	0.982143	0.390071
GCA_013401235.1-Ani_WEIY01001127.1_i000_011079	115	340	225	1.00446	0.471698
GCA_003427355.1-Ani_BFAA01019326.1_i000_021240	186	410	224	1	0.402878
GCA_013390085.1-Ani_WEIX01003942.1_i000_003281	24	249	225	1.00446	0.585938
GCA_000497045.1-Fun_KI545891.1_i000_005316	189	412	223	0.995536	0.387153
GCA_013398915.1-Ani_VYZM01004279.1_i000_002230	109	334	225	1.00446	0.479744
GCA_000499845.1-Pla_CM002298.1_i000_026177	177	396	219	0.977679	0.393885
GCA_000338975.1-Fun_KB445569.1_i000_000473	192	416	224	1	0.434109
GCA_000354255.1-Fun_KB733459.1_i000_007519	192	416	224	1	0.434109
GCA_019454015.1-Fun_JAHUAA010000007.1_i000_009682	192	416	224	1	0.434109
GCA_004000445.1-Ani_RSAL01000206.1_i000_011005	180	398	218	0.973214	0.414449
GCA_013399355.1-Ani_VXAJ01000986.1_i000_014089	115	340	225	1.00446	0.471698
GCA_000149305.1-Fun_CH476739.1_i000_006246	150	374	224	1	0.479657
GCA_016771965.1-Pla_CM028692.1_i000_025505	188	413	225	1.00446	0.446429
GCA_014108415.1-Ani_JACASF010000011.1_i000_003111	179	397	218	0.973214	0.409006
GCA_014108245.1-Ani_JACAGB010000007.1_i000_016737	179	397	218	0.973214	0.40824
GCA_013398555.1-Ani_VZSQ01000039.1_i000_003757	115	340	225	1.00446	0.488069
GCA_013400555.1-Ani_VZTM01025371.1_i000_007851	115	340	225	1.00446	0.466805
GCA_011068445.1-Fun_JAAGKP010000016.1_i000_002853	189	413	224	1	0.402154
GCA_002572885.1-Fun_PDNC01000054.1_i000_005880	190	416	226	1.00893	0.443137
GCA_013397275.1-Ani_VYXH01012473.1_i000_013444	115	340	225	1.00446	0.465839
GCA_019202805.1-Pla_CM032910.1_i000_046477	251	469	218	0.973214	0.386525
GCA_014805705.1-Fun_SBJP01000179.1_i000_001061	156	381	225	1.00446	0.56962
GCA_010094035.1-Fun_ML987209.1_i000_015370	192	416	224	1	0.430769
GCA_010093715.1-Fun_MU005794.1_i000_013133	192	416	224	1	0.431599
GCA_003614145.1-Fun_KZ987751.1_i000_000338	183	404	221	0.986607	0.440239
GCA_007993695.1-Fun_CP042458.1_i000_002940	105	334	229	1.02232	0.490364
GCA_905183005.1-Pro_CAJJDO010000008.1_i000_003989	188	410	222	0.991071	0.457732
GCA_013401015.1-Ani_VZUC01000089.1_i000_008213	115	340	225	1.00446	0.465839
GCA_013401055.1-Ani_VZUE01000006.1_i000_000463	115	340	225	1.00446	0.472689
GCA_000328475.2-Fun_CM003145.1_i000_002989	189	412	223	0.995536	0.383162
GCA_013399555.1-Ani_VZZV01001644.1_i000_003116	115	340	225	1.00446	0.48913
GCA_000002165.1-Ani_CM000209.2_i000_000452	179	397	218	0.973214	0.406716
GCA_013400095.1-Ani_VXBK01005790.1_i000_006623	115	340	225	1.00446	0.465839
GCA_013398245.1-Ani_VZSD01007662.1_i000_005769	115	340	225	1.00446	0.471698
GCA_013401065.1-Ani_VZUD01000029.1_i000_003422	115	340	225	1.00446	0.471698
GCA_020184695.1-Pro_JAANOX010000280.1_i000_011084	53	271	218	0.973214	0.594005
GCA_020186115.1-Pro_WSYJ01000142.1_i000_006614	53	271	218	0.973214	0.594005
GCA_905221605.1-Pro_CAJNDS010000499.1_i000_007225	183	403	220	0.982143	0.444444
GCA_013305925.1-Fun_QVTG01000075.1_i000_002806	192	417	225	1.00446	0.442913
GCA_001712635.2-Pro_MBAC02000992.1_i000_002257	12	231	219	0.977679	0.661631
GCA_000835815.1-Fun_KN848529.1_i000_003124	195	421	226	1.00893	0.395797
GCA_013397955.1-Ani_VZRM01005241.1_i000_008005	180	398	218	0.973214	0.465812
GCA_000151295.1-Fun_GG745331.1_i000_015724	181	405	224	1	0.448
GCA_016808335.1-Pla_CM029053.1_i000_039042	177	397	220	0.982143	0.387324
GCA_016097325.1-Fun_JADPPX010000001.1_i000_001718	190	416	226	1.00893	0.432122
GCA_013399435.1-Ani_VXAK01002383.1_i000_001112	115	340	225	1.00446	0.467775
GCA_013401295.1-Ani_VWPO01004781.1_i000_011874	115	340	225	1.00446	0.467775
GCA_003573695.1-Pla_CM010717.1_i000_012166	177	395	218	0.973214	0.405959
GCA_013396915.1-Ani_VWZL01003872.1_i000_008392	115	340	225	1.00446	0.469729
GCA_000003195.3-Pla_CM000760.3_i000_003905	177	396	219	0.977679	0.384886
GCA_015952705.1-Pla_CM027680.1_i000_003967	177	396	219	0.977679	0.384886
GCA_000236905.1-Fun_HE612859.1_i000_001933	113	351	238	1.0625	0.505308
GCA_001651215.1-Pro_LXWW01000210.1_i000_003517	180	400	220	0.982143	0.436508
GCA_013399535.1-Ani_VZZW01002005.1_i000_010476	115	340	225	1.00446	0.465839
GCA_013400295.1-Ani_WAAC01005225.1_i000_003007	120	345	225	1.00446	0.461066
GCA_001717485.1-Fun_JXNT01000005.1_i000_008386	187	412	225	1.00446	0.431862
GCA_016758965.1-Fun_JAEPRB010000009.1_i000_001184	185	410	225	1.00446	0.45
GCA_016906325.1-Fun_RKRL01000042.1_i000_008694	193	418	225	1.00446	0.441176
GCA_013400135.1-Ani_VXBO01006303.1_i000_005524	110	335	225	1.00446	0.480769
GCA_013400795.1-Ani_VZTS01007716.1_i000_003452	115	340	225	1.00446	0.466805
GCA_013399215.1-Ani_VXAF01001158.1_i000_000366	115	340	225	1.00446	0.481799
GCA_013399475.1-Ani_VXAL01020572.1_i000_013027	115	340	225	1.00446	0.487013
GCA_003260565.1-Fun_QKRW01000013.1_i000_003965	193	418	225	1.00446	0.436047
GCA_905178155.1-Pro_CAJINV010000008.1_i000_016997	182	402	220	0.982143	0.456432
GCA_003427335.1-Ani_BEZZ01003839.1_i000_021223	186	410	224	1	0.404332
GCA_003614705.1-Fun_KZ994111.1_i000_001057	187	410	223	0.995536	0.444223
GCA_000149305.1-Fun_CH476735.1_i000_011138	186	411	225	1.00446	0.457317
GCA_011763585.1-Fun_JAANIP010001311.1_i000_007139	186	411	225	1.00446	0.457317
GCA_011763695.1-Fun_JAANIQ010001149.1_i000_007019	186	411	225	1.00446	0.457317
GCA_011763715.1-Fun_JAANIR010000601.1_i000_004742	186	411	225	1.00446	0.457317
GCA_011763735.1-Fun_JAANIS010000718.1_i000_003544	186	411	225	1.00446	0.457317
GCA_011763755.1-Fun_JAANIW010001235.1_i000_008814	186	411	225	1.00446	0.457317
GCA_011763775.1-Fun_JAANIT010001211.1_i000_007802	186	411	225	1.00446	0.457317
GCA_011763795.1-Fun_JAANIV010001257.1_i000_008826	186	411	225	1.00446	0.457317
GCA_011763815.1-Fun_JAANIU010001205.1_i000_007524	186	411	225	1.00446	0.457317
GCA_011763835.1-Fun_JAANIX010001280.1_i000_009019	186	411	225	1.00446	0.457317
GCA_011763855.1-Fun_JAANJA010001222.1_i000_008604	186	411	225	1.00446	0.457317
GCA_011763875.1-Fun_JAANIZ010001175.1_i000_007395	186	411	225	1.00446	0.457317
GCA_011763895.1-Fun_JAANIY010000617.1_i000_005104	186	411	225	1.00446	0.457317
GCA_014904905.1-Fun_MU122107.1_i000_003112	189	415	226	1.00893	0.418519
GCA_001683725.1-Fun_LUGH01000009.1_i000_010722	185	410	225	1.00446	0.463918
GCA_014362265.1-Pla_BJWL01000010.1_i000_014627	177	396	219	0.977679	0.400366
GCA_902860255.1-Pla_LR794333.1_i000_005474	177	395	218	0.973214	0.328808
GCA_905237095.1-Pro_CAJNNW010026952.1_i000_026084	183	403	220	0.982143	0.31339
GCA_011763915.1-Fun_JAANJB010001185.1_i000_008235	186	411	225	1.00446	0.454545
GCA_013398315.1-Ani_VZSG01000403.1_i000_007212	165	384	219	0.977679	0.483444
GCA_013398335.1-Ani_VZSH01000054.1_i000_010520	165	384	219	0.977679	0.483444
GCA_013398225.1-Ani_VZSC01000688.1_i000_000654	115	340	225	1.00446	0.479744
GCA_003789085.1-Ani_QCYY01001345.1_i000_002576	181	397	216	0.964286	0.215354
GCA_008636005.1-Pla_BKCP01005517.1_i000_014343	177	395	218	0.973214	0.398537
GCA_003369665.1-Fun_PDLM01000010.1_i000_002297	193	418	225	1.00446	0.444664
GCA_004379255.2-Pla_CM031493.1_i000_052912	188	412	224	1	0.436647
GCA_010405405.1-Fun_MU004238.1_i000_008372	191	415	224	1	0.426667
GCA_002111425.1-Fun_KZ107831.1_i000_009321	193	418	225	1.00446	0.520833
GCA_000583005.2-Pla_ASHM01032079.1_i000_032585	22	239	217	0.96875	0.552163
GCA_013398475.1-Ani_VZSO01008843.1_i000_012386	115	340	225	1.00446	0.482833
GCA_016861735.1-Fun_AP024417.1_i000_002847	191	416	225	1.00446	0.433526
GCA_020891255.1-Fun_BQFW01000004.1_i000_003479	182	399	217	0.96875	0.432271
GCA_000005005.6-Pla_CM000785.4_i000_035398	177	396	219	0.977679	0.38968
GCA_003185045.1-Pla_CM009914.1_i000_034293	177	396	219	0.977679	0.38968
GCA_007990455.1-Pla_CM017643.1_i000_040181	177	395	218	0.973214	0.397086
GCA_003573695.1-Pla_CM010716.1_i000_008553	177	395	218	0.973214	0.407477
GCA_900622495.1-Ani_UYWX01020583.1_i000_008734	181	401	220	0.982143	0.501139
GCA_001632425.1-Fun_KV425585.1_i000_007531	185	411	226	1.00893	0.425612
GCA_009771035.1-Pla_CM020001.1_i000_004241	177	395	218	0.973214	0.389286
GCA_010261695.1-Pla_CM020997.1_i000_002469	177	395	218	0.973214	0.389286
GCA_020884735.1-Fun_BPWL01000002.1_i000_001882	180	402	222	0.991071	0.379487
GCA_020169575.1-Pla_CM035008.1_i000_029212	177	395	218	0.973214	0.397086
GCA_009732905.1-Pro_QXFV01003243.1_i000_024789	181	400	219	0.977679	0.438878
GCA_009732945.1-Pro_QXFU01002360.1_i000_022235	181	400	219	0.977679	0.438878
GCA_022376525.1-Fun_WTXL01000115.1_i000_001476	159	384	225	1.00446	0.511364
GCA_002352805.1-Ani_KZ358800.1_i000_018748	179	397	218	0.973214	0.515366
GCA_000236345.1-Ani_DF142836.1_i000_010038	211	435	224	1	0.378378
GCA_002218305.1-Ani_MCFN01000125.1_i000_004901	180	399	219	0.977679	0.388988
GCA_905115235.1-Ani_LR899009.1_i000_001576	180	397	217	0.96875	0.464668
GCA_000004255.1-Pla_GL348715.1_i000_009694	188	412	224	1	0.448898
GCA_009729455.1-Pro_QWGH01000011.1_i000_003576	181	400	219	0.977679	0.438878
GCA_009732925.1-Pro_QXFW01001672.1_i000_019550	181	400	219	0.977679	0.438878
GCA_009732985.1-Pro_QXGB01001738.1_i000_020885	181	400	219	0.977679	0.438878
GCA_009733005.1-Pro_QXFX01001698.1_i000_020179	181	400	219	0.977679	0.438878
GCA_009733025.1-Pro_QXGA01001659.1_i000_019704	181	400	219	0.977679	0.438878
GCA_009733065.1-Pro_QXFZ01001720.1_i000_020914	181	400	219	0.977679	0.438878
GCA_009733085.1-Pro_QXGD01001748.1_i000_022012	181	400	219	0.977679	0.438878
GCA_009733105.1-Pro_QXGE01001667.1_i000_019895	181	400	219	0.977679	0.438878
GCA_009733125.1-Pro_QXFY01001720.1_i000_020302	181	400	219	0.977679	0.438878
GCA_000180635.4-Ani_CM026575.1_i000_000432	196	422	226	1.00893	0.439689
GCA_900537275.1-Ani_UYRX01000003.1_i000_003396	189	412	223	0.995536	0.375421
GCA_000751015.1-Pla_LK033727.1_i000_049969	188	412	224	1	0.434951
GCA_020379485.1-Pla_CM035461.1_i000_070270	188	412	224	1	0.434951
GCA_008124465.1-Pla_CM017872.1_i000_000218	177	395	218	0.973214	0.373288
GCA_016771965.1-Pla_CM028690.1_i000_021171	188	412	224	1	0.447106
GCA_006381635.2-Pla_VEPZ02000238.1_i000_007382	188	404	216	0.964286	0.533333
GCA_021015755.1-Fun_JABWDW010000015.1_i000_002493	182	389	207	0.924107	0.366372
GCA_013398955.1-Ani_VWPU01006265.1_i000_004141	115	340	225	1.00446	0.471698
GCA_000312925.2-Fun_HE965173.1_i000_003810	177	399	222	0.991071	0.422053
GCA_018446385.1-Pla_CM031515.1_i000_027315	83	195	112	0.5	0.335329
GCA_900536885.1-Fun_UWZB01000051.1_i000_003333	186	412	226	1.00893	0.425612
GCA_904845875.1-Pla_CAJGYO010000002.1_i000_007170	177	396	219	0.977679	0.384886
GCA_019364595.1-Fun_JAHRGV010000022.1_i000_002872	182	404	222	0.991071	0.388112
GCA_013398295.1-Ani_VZSF01006486.1_i000_008124	115	340	225	1.00446	0.466805
GCA_005223365.2-Pla_SPHZ02000006.1_i000_021400	177	395	218	0.973214	0.424951
GCA_009193525.1-Fun_ML741815.1_i000_009366	190	416	226	1.00893	0.431298
GCA_000151005.2-Fun_DS990636.1_i000_009243	190	416	226	1.00893	0.437984
GCA_000151035.1-Fun_GG692420.1_i000_007893	190	416	226	1.00893	0.437984
GCA_017310615.1-Fun_CP069103.1_i000_002643	190	416	226	1.00893	0.437984
GCA_000751015.1-Pla_LK034306.1_i000_052502	188	412	224	1	0.429942
GCA_003434825.1-Pla_CM010633.1_i000_019187	188	412	224	1	0.429942
GCA_900412535.3-Pla_LS974621.2_i000_026380	188	412	224	1	0.429942
GCA_012274485.2-Pla_MU105828.1_i000_019865	177	395	218	0.973214	0.409774
GCA_000520075.1-Pro_KI913148.1_i000_011373	181	400	219	0.977679	0.429412
GCA_001606155.1-Pro_LODT01000041.1_i000_008314	180	399	219	0.977679	0.334351
GCA_014905375.1-Pla_BMAC01000981.1_i000_026257	177	396	219	0.977679	0.391771
GCA_015143295.1-Pla_CM026573.1_i000_028796	188	412	224	1	0.405797
GCA_009733045.1-Pro_QXGC01001680.1_i000_019626	181	400	219	0.977679	0.433663
GCA_003692655.1-Ani_QRBI01000096.1_i000_026464	180	398	218	0.973214	0.416031
GCA_001500285.1-Fun_KQ947419.1_i000_009630	192	417	225	1.00446	0.436893
GCA_013396835.1-Ani_VWZI01017907.1_i000_009885	115	340	225	1.00446	0.476695
GCA_000956085.1-Fun_JZEE01000597.1_i000_005812	190	416	226	1.00893	0.43295
GCA_002749805.1-Fun_NEXV01000110.1_i000_010050	190	416	226	1.00893	0.43295
GCA_009176385.1-Fun_ML734990.1_i000_009074	190	416	226	1.00893	0.43295
GCA_009176405.1-Fun_ML733460.1_i000_009093	190	416	226	1.00893	0.43295
GCA_009193505.1-Fun_ML738334.1_i000_008008	190	416	226	1.00893	0.43295
GCA_009193545.1-Fun_ML737166.1_i000_009420	190	416	226	1.00893	0.43295
GCA_000524195.1-Ani_APAU02000002.1_i000_010770	181	401	220	0.982143	0.505747
GCA_002116315.1-Fun_KZ107851.1_i000_008817	192	416	224	1	0.432432
GCA_019721275.1-Fun_JAASLF010000028.1_i000_004579	192	416	224	1	0.432432
GCA_012932025.1-Fun_JAADJG010000245.1_i000_006280	193	419	226	1.00893	0.443137
GCA_013389845.1-Ani_VWPX01013435.1_i000_008858	115	339	224	1	0.615385
GCA_014898675.1-Fun_JACXVL010000630.1_i000_018210	182	398	216	0.964286	0.375652
GCA_014898675.1-Fun_JACXVL010000102.1_i000_000438	182	398	216	0.964286	0.376307
GCA_009193595.1-Fun_ML736186.1_i000_003880	190	416	226	1.00893	0.45935
GCA_021223945.1-Ani_JAJJHW010000014.1_i000_000802	185	409	224	1	0.459959
GCA_905332035.1-Ani_CAJOAY010006271.1_i000_037464	186	411	225	1.00446	0.490196
GCA_000372725.1-Pro_KB865350.1_i000_016998	280	403	123	0.549107	0.195238
GCA_010093705.1-Fun_MU006096.1_i000_005004	191	416	225	1.00446	0.443787
GCA_019049425.1-Fun_JAHMUF010000002.1_i000_002090	95	328	233	1.04018	0.498929
GCA_905250065.1-Ani_CAJNON010000184.1_i000_018805	186	411	225	1.00446	0.484914
GCA_013396505.1-Ani_VZRC01001240.1_i000_001474	115	340	225	1.00446	0.471698
GCA_000002775.3-Pla_CM009294.1_i000_012892	177	395	218	0.973214	0.3879
GCA_019627685.1-Fun_WSTO01003174.1_i000_009425	66	284	218	0.973214	0.460888
GCA_001027345.1-Fun_KQ087230.1_i000_005889	196	420	224	1	0.392982
GCA_008065305.1-Fun_QKWL01000001.1_i000_000446	196	420	224	1	0.392982
GCA_018804465.1-Pla_CM031977.1_i000_043167	177	395	218	0.973214	0.3879
GCA_005223365.2-Pla_SPHZ02000006.1_i000_021364	177	396	219	0.977679	0.468951
GCA_000320585.2-Fun_KI925458.1_i000_005669	185	411	226	1.00893	0.423221
GCA_008355005.1-Fun_NIDF01000106.1_i000_000514	195	421	226	1.00893	0.402852
GCA_002870075.2-Pla_CM022518.1_i000_002023	177	396	219	0.977679	0.404059
GCA_019616325.1-Fun_WSTG01003581.1_i000_013477	94	318	224	1	0.442688
GCA_002105025.1-Fun_MCFA01000082.1_i000_014593	192	416	224	1	0.417132
GCA_008795845.1-Ani_SGJD01002184.1_i000_011295	179	397	218	0.973214	0.358553
GCA_021604985.1-Pla_BQKI01000084.1_i000_049011	177	396	219	0.977679	0.391771
GCA_002215365.1-Pro_NBNE01010559.1_i000_027519	181	400	219	0.977679	0.436255
GCA_014621425.1-Fun_JAANBB010000059.1_i000_010689	193	419	226	1.00893	0.444882
GCA_001447505.1-Ani_JYDN01000020.1_i000_002454	1454	1679	225	1.00446	0.0577367
GCA_000334115.1-Fun_KB317726.1_i000_006971	412	636	224	1	0.341985
GCA_016097925.1-Fun_JAAAIQ010001148.1_i000_000852	1	207	206	0.919643	0.789272
GCA_019787685.1-Fun_JAHNUO010000002.1_i000_001239	184	406	222	0.991071	0.388112
GCA_001720245.1-Fun_AWGL01000002.1_i000_002991	196	421	225	1.00446	0.39267
GCA_002705745.1-Fun_KZ303487.1_i000_000651	182	402	220	0.982143	0.421456
GCA_004565275.1-Pro_SDOX01000008.1_i000_007976	181	401	220	0.982143	0.412758
GCA_019857665.1-Ani_WNTK01008177.1_i000_020733	183	408	225	1.00446	0.422932
GCA_001720155.1-Fun_AWGH01000017.1_i000_002315	195	421	226	1.00893	0.402852
GCA_002105065.1-Fun_MCFC01000007.1_i000_006698	191	402	211	0.941964	0.384335
GCA_004379255.2-Pla_CM031473.1_i000_005398	177	395	218	0.973214	0.394928
GCA_009078325.1-Fun_SSOP01000005.1_i000_006880	187	404	217	0.96875	0.386809
GCA_001720205.1-Fun_AWGJ01000006.1_i000_006389	195	421	226	1.00893	0.400709
GCA_004798865.1-Ani_SJPD01000002.1_i000_006000	240	464	224	1	0.378378
GCA_000825705.1-Fun_CDHN01000007.1_i000_010314	192	418	226	1.00893	0.44227
GCA_018127085.1-Fun_CM030735.1_i000_003344	180	399	219	0.977679	0.431953
GCA_020744475.1-Fun_JAGMUX010000015.1_i000_004810	193	419	226	1.00893	0.443137
GCA_001720235.1-Fun_MEKH01000006.1_i000_006160	195	421	226	1.00893	0.396491
GCA_009733145.1-Pro_QXFT01003113.1_i000_025609	181	400	219	0.977679	0.441532
GCA_002003045.1-Fun_BDGU01000086.1_i000_003595	182	389	207	0.924107	0.366372
GCA_020536535.1-Pro_JAHLWZ010000972.1_i000_014862	187	411	224	1	0.302294
GCA_000005005.6-Pla_CM007647.1_i000_001531	177	396	219	0.977679	0.388298
GCA_904845875.1-Pla_CAJGYO010000006.1_i000_023514	177	396	219	0.977679	0.384211
GCA_002197585.2-Pro_MZMZ02004209.1_i000_011793	210	429	219	0.977679	0.406308
GCA_002980475.2-Fun_PVQB02000090.1_i000_002596	193	419	226	1.00893	0.444008
GCA_022432385.1-Fun_JAJJXC010000027.1_i000_005333	191	416	225	1.00446	0.442043
GCA_902860255.1-Pla_LR794324.1_i000_008811	177	396	219	0.977679	0.401835
GCA_015178965.1-Fun_WHVB01000005.1_i000_008672	185	410	225	1.00446	0.420561
GCA_021556725.1-Ani_CM038612.1_i000_000603	229	447	218	0.973214	0.454167
GCA_016097715.1-Fun_JAAZWU010000004.1_i000_006588	186	411	225	1.00446	0.438596
GCA_016097735.1-Fun_JAAZWV010000007.1_i000_008519	186	411	225	1.00446	0.438596
GCA_905221625.1-Pro_CAJNDU010002900.1_i000_003904	183	403	220	0.982143	0.456432
GCA_905231925.1-Pro_CAJNJV010002383.1_i000_003365	183	403	220	0.982143	0.456432
GCA_001276565.1-Ani_KQ435789.1_i000_006929	179	397	218	0.973214	0.383803
GCA_002938385.1-Fun_NHYE01001291.1_i000_004989	182	405	223	0.995536	0.218842
GCA_010411085.1-Ani_CM021214.1_i000_014591	859	1084	225	1.00446	0.177305
GCA_015476405.1-Fun_CM027201.1_i000_005682	182	388	206	0.919643	0.364602
GCA_015473125.1-Pla_BNJQ01000023.1_i000_007756	182	403	221	0.986607	0.446465
GCA_000003855.2-Fun_GG657448.1_i000_000463	190	416	226	1.00893	0.51954
GCA_019097595.1-Ani_CM032611.1_i000_015130	185	410	225	1.00446	0.401786
GCA_014851425.1-Pla_CM026263.1_i000_011034	177	396	219	0.977679	0.397459
GCA_002249935.1-Ani_KZ269981.1_i000_001664	189	419	230	1.02679	0.386555
GCA_008802855.1-Ani_VVIM01000006.1_i000_008593	180	398	218	0.973214	0.376511
GCA_018691715.1-Pro_JAFJYM010000048.1_i000_012476	181	400	219	0.977679	0.440644
GCA_020726555.1-Fun_JAHBNH010000004.1_i000_007613	192	416	224	1	0.433269
GCA_902702965.1-Ani_CACRXP010000637.1_i000_020474	188	413	225	1.00446	0.390625
GCA_013396975.1-Ani_VWZO01014668.1_i000_009058	115	340	225	1.00446	0.469729
GCA_002895965.2-Ani_PIJE02017940.1_i000_035163	1	219	218	0.973214	0.633721
GCA_000403515.1-Fun_DF238782.1_i000_001646	189	412	223	0.995536	0.382504
GCA_003546765.1-Pro_QUTG01006336.1_i000_012703	210	429	219	0.977679	0.407063
GCA_003546825.1-Pro_QUTH01003004.1_i000_006248	210	429	219	0.977679	0.407063
GCA_022160315.1-Fun_MU275175.1_i000_003205	180	400	220	0.982143	0.380623
GCA_021524915.1-Fun_JAKELL010000055.1_i000_009705	180	400	220	0.982143	0.414313
GCA_015679415.1-Fun_JAAAUT010000064.1_i000_008531	167	375	208	0.928571	0.554667
GCA_021461655.1-Ani_CM038289.1_i000_007393	193	416	223	0.995536	0.369205
GCA_015342445.1-Pla_JACEFO010001626.1_i000_016311	177	396	219	0.977679	0.387611
GCA_003666305.1-Pro_QUTI01028117.1_i000_009245	210	429	219	0.977679	0.411654
GCA_003550305.1-Fun_QKYT01000132.1_i000_002742	182	402	220	0.982143	0.327869
GCA_003546785.1-Pro_QUTF01009318.1_i000_003622	210	429	219	0.977679	0.407063
GCA_001598015.1-Pla_KV014877.1_i000_037096	188	412	224	1	0.433269
GCA_008931885.1-Fun_VCHE01000070.1_i000_011052	193	418	225	1.00446	0.439453
GCA_012971845.1-Fun_QCYV01000241.1_i000_008589	193	418	225	1.00446	0.439453
GCA_003546545.1-Pro_QUTB01004123.1_i000_004218	210	429	219	0.977679	0.409346
GCA_003546585.1-Pro_QUTD01004685.1_i000_005136	210	429	219	0.977679	0.409346
GCA_003546605.1-Pro_QUTA01006754.1_i000_009163	210	429	219	0.977679	0.409346
GCA_003546625.1-Pro_QUTC01005989.1_i000_007798	210	429	219	0.977679	0.409346
GCA_003546805.1-Pro_QUTE01008924.1_i000_005019	210	429	219	0.977679	0.409346
GCA_001600855.1-Fun_BCLC01000009.1_i000_005022	192	402	210	0.9375	0.391061
GCA_005549215.1-Pla_SSTE01006842.1_i000_009961	189	413	224	1	0.30982
GCA_005549225.1-Pla_SSTD01018043.1_i000_033161	189	413	224	1	0.30982
GCA_905250055.1-Ani_CAJNOF010000347.1_i000_026524	186	411	225	1.00446	0.483871
GCA_905250075.1-Ani_CAJNOP010000695.1_i000_049515	186	411	225	1.00446	0.483871
GCA_905331525.1-Ani_CAJNZF010000415.1_i000_023053	186	411	225	1.00446	0.483871
GCA_905332315.1-Ani_CAJOBV010002178.1_i000_017925	186	411	225	1.00446	0.483871
GCA_000340665.1-Pla_CM003606.1_i000_008502	177	396	219	0.977679	0.393178
GCA_905250075.1-Ani_CAJNOP010000694.1_i000_049497	186	411	225	1.00446	0.483871
GCA_905331505.1-Ani_CAJNYZ010000448.1_i000_023989	186	411	225	1.00446	0.483871
GCA_905331515.1-Ani_CAJNZC010000757.1_i000_027795	186	411	225	1.00446	0.483871
GCA_905332295.1-Ani_CAJOBT010007500.1_i000_027220	186	411	225	1.00446	0.483871
GCA_902728155.2-Pla_CACVBM020001240.1_i000_028376	177	395	218	0.973214	0.409006
GCA_003546565.1-Pro_QUSZ01005658.1_i000_006924	210	429	219	0.977679	0.409346
GCA_016984155.1-Ani_JAAWVP010002545.1_i000_004070	186	411	225	1.00446	0.385935
GCA_021218885.1-Ani_JAIQCD010002027.1_i000_004591	179	397	218	0.973214	0.412098
GCA_905182975.1-Pro_CAJJDM010000001.1_i000_000139	188	410	222	0.991071	0.457732
GCA_016984175.1-Ani_JAAWVO010039273.1_i000_006950	225	450	225	1.00446	0.472689
GCA_000503235.1-Fun_KI628572.1_i000_002795	193	418	225	1.00446	0.459184
GCA_001630335.1-Fun_KV417608.1_i000_019619	182	398	216	0.964286	0.373702
GCA_004369045.1-Fun_ML213504.1_i000_002276	180	399	219	0.977679	0.383538
GCA_019176455.1-Ani_CM032857.1_i000_005085	185	410	225	1.00446	0.396825
GCA_021525005.1-Fun_JAKEYE010000174.1_i000_004915	180	400	220	0.982143	0.392857
GCA_006368765.1-Ani_SKCS01000076.1_i000_009013	193	416	223	0.995536	0.369205
GCA_000342415.1-Pro_ACOU01000002.1_i000_002049	187	409	222	0.991071	0.431068
GCA_003194525.1-Pro_NBIV01000144.1_i000_007249	179	399	220	0.982143	0.39783
GCA_003958685.2-Pla_CP039347.1_i000_012201	177	396	219	0.977679	0.393885
GCA_013400375.1-Ani_VXBW01004873.1_i000_007732	115	340	225	1.00446	0.472689
GCA_900332095.2-Pla_OOIL02001381.1_i000_016626	177	396	219	0.977679	0.37372
GCA_003357145.1-Fun_NPIC01000011.1_i000_004475	193	418	225	1.00446	0.440313
GCA_021604985.1-Pla_BQKI01000082.1_i000_047128	177	397	220	0.982143	0.392157
GCA_004332605.1-Fun_RWJN01000020.1_i000_003175	182	403	221	0.986607	0.385689
GCA_016097755.1-Fun_JAAZWW010000010.1_i000_000110	250	475	225	1.00446	0.389948
GCA_016881025.1-Ani_JAESOR010000362.1_i000_012191	179	397	218	0.973214	0.411321
GCA_002994745.2-Pla_CM009588.1_i000_040165	188	412	224	1	0.407273
GCA_000183025.1-Fun_ABRE01013036.1_i000_006591	83	289	206	0.919643	0.501217
GCA_014533835.1-Ani_WJEC01008756.1_i000_019800	179	397	218	0.973214	0.411321
GCA_901343595.1-Ani_CABDUW010000761.1_i000_016942	179	397	218	0.973214	0.411321
GCA_000511025.2-Pla_CM002328.2_i000_018814	177	396	219	0.977679	0.382867
GCA_002215705.1-Fun_AMKS01000024.1_i000_002980	195	421	226	1.00893	0.393728
GCA_002222155.1-Fun_APKL01000265.1_i000_001835	195	421	226	1.00893	0.393728
GCA_002222385.1-Fun_AMKN01000067.1_i000_004994	195	421	226	1.00893	0.393728
GCA_021527035.1-Fun_JAKELG010000034.1_i000_006457	176	396	220	0.982143	0.394265
GCA_002120315.1-Fun_KZ111561.1_i000_006486	191	417	226	1.00893	0.444008
GCA_004115385.1-Pla_CM014060.1_i000_028826	752	971	219	0.977679	0.194494
GCA_013400755.1-Ani_VZTQ01002941.1_i000_002721	115	340	225	1.00446	0.482833
GCA_000149335.2-Fun_GG704911.1_i000_007899	190	416	226	1.00893	0.431298
GCA_000149895.1-Fun_DS028093.1_i000_010184	190	416	226	1.00893	0.431298
GCA_000150085.1-Fun_DS268233.1_i000_000528	190	416	226	1.00893	0.431298
GCA_004115165.2-Fun_RHJW02000001.1_i000_000778	190	416	226	1.00893	0.431298
GCA_013400055.1-Ani_VXBJ01003389.1_i000_006079	115	340	225	1.00446	0.463918
GCA_001644535.1-Fun_KV441638.1_i000_003141	192	416	224	1	0.432432
GCA_002847485.1-Fun_MSFM01000001.1_i000_000599	190	416	226	1.00893	0.438835
GCA_904845875.1-Pla_CAJGYO010000005.1_i000_019200	177	397	220	0.982143	0.388693
GCA_010015825.1-Fun_ML977311.1_i000_000993	192	417	225	1.00446	0.431862
GCA_018290095.1-Ani_CM031380.1_i000_007406	183	408	225	1.00446	0.406872
GCA_000151065.3-Fun_HF943548.1_i000_004765	192	418	226	1.00893	0.449304
GCA_900237765.1-Fun_UNSH01000056.1_i000_004399	192	418	226	1.00893	0.449304
GCA_000203815.1-Pro_GL883029.1_i000_011605	179	409	230	1.02679	0.378289
GCA_001185155.1-Pla_LFYR01000981.1_i000_006473	187	413	226	1.00893	0.384354
GCA_017366145.1-Fun_JAFJYG010000407.1_i000_009581	193	418	225	1.00446	0.438596
GCA_020726505.1-Fun_JAHLEZ010000002.1_i000_008576	193	418	225	1.00446	0.438596
GCA_021432625.1-Fun_MU270376.1_i000_010044	193	418	225	1.00446	0.438596
GCA_020746875.1-Fun_JAGTJL010000001.1_i000_000298	193	418	225	1.00446	0.436893
GCA_010094045.1-Fun_ML986692.1_i000_011273	192	417	225	1.00446	0.432692
GCA_905332035.1-Ani_CAJOAY010012102.1_i000_043381	116	341	225	1.00446	0.578406
GCA_001691835.3-Fun_JNHZ02000265.1_i000_005005	179	390	211	0.941964	0.383636
GCA_020747065.1-Fun_JAGMVK010000019.1_i000_006056	193	418	225	1.00446	0.439453
GCA_017357885.1-Fun_CP063406.1_i000_002776	193	418	225	1.00446	0.437743
GCA_002352805.1-Ani_KZ348470.1_i000_011721	220	438	218	0.973214	0.416031
GCA_004115385.1-Pla_CM014062.1_i000_032731	188	412	224	1	0.409506
GCA_002102565.1-Fun_NBSH01000004.1_i000_005075	195	419	224	1	0.38422
GCA_000004075.3-Pla_CM002922.2_i000_000068	189	413	224	1	0.405797
GCA_902728155.2-Pla_CACVBM020001495.1_i000_038961	188	412	224	1	0.452525
GCA_003061485.1-Pla_CM009757.1_i000_031511	177	397	220	0.982143	0.384615
GCA_003942215.1-Fun_RSCD01000001.1_i000_000265	192	402	210	0.9375	0.361446
GCA_022376555.1-Fun_WTXH01000045.1_i000_007274	180	400	220	0.982143	0.378657
GCA_015951145.1-Fun_MU167384.1_i000_011116	184	409	225	1.00446	0.450902
GCA_000410735.1-Fun_KE148157.1_i000_005809	195	418	223	0.995536	0.436399
GCA_013389845.1-Ani_VWPX01013435.1_i000_008859	115	340	225	1.00446	0.472689
GCA_000430065.1-Fun_ATCN01000010.1_i000_000034	144	377	233	1.04018	0.606771
GCA_900660405.1-Pro_CAACVS010000039.1_i000_001458	144	368	224	1	0.472574
GCA_000520115.1-Pro_KI913968.1_i000_008343	181	400	219	0.977679	0.44332
GCA_003546525.1-Pro_QUSY01000418.1_i000_005243	181	400	219	0.977679	0.44332
GCA_905221615.1-Pro_CAJNDT010003613.1_i000_028167	183	403	220	0.982143	0.338462
GCA_002870075.2-Pla_MU042616.1_i000_038098	188	412	224	1	0.415584
GCA_000827185.1-Fun_KN839835.1_i000_000723	183	405	222	0.991071	0.393617
GCA_000827425.1-Fun_KN822011.1_i000_003002	183	404	221	0.986607	0.389085
GCA_014898465.1-Fun_RCTA01000002.1_i000_001207	193	418	225	1.00446	0.438596
GCA_000418435.1-Fun_KE375131.1_i000_004724	192	418	226	1.00893	0.449304
GCA_900519115.1-Fun_LR026990.1_i000_004689	192	418	226	1.00893	0.449304
GCA_905067625.1-Fun_LR898474.1_i000_004394	192	418	226	1.00893	0.449304
GCA_004837865.1-Pla_CM017195.1_i000_021379	1078	1296	218	0.973214	0.146407
GCA_004794785.1-Ani_SJOL01005477.1_i000_003279	187	411	224	1	0.392982
GCA_021604985.1-Pla_BQKI01000015.1_i000_023547	177	397	220	0.982143	0.394265
GCA_013399115.1-Ani_VXAA01004774.1_i000_009032	115	340	225	1.00446	0.483871
GCA_002870075.2-Pla_CM022519.1_i000_006560	177	395	218	0.973214	0.380454
GCA_016771965.1-Pla_CM028702.1_i000_081148	188	412	224	1	0.429942
GCA_004786205.1-Fun_PQXM01000565.1_i000_009212	193	418	225	1.00446	0.438596
GCA_014898485.1-Fun_RCTC01000002.1_i000_001894	193	418	225	1.00446	0.438596
GCA_014898535.1-Fun_RCSX01000029.1_i000_009580	193	418	225	1.00446	0.438596
GCA_014898555.1-Fun_RCSY01000028.1_i000_007385	193	418	225	1.00446	0.438596
GCA_000227075.1-Fun_FQ790256.1_i000_001419	193	418	225	1.00446	0.438596
GCA_000349525.1-Fun_KB707850.1_i000_004695	193	418	225	1.00446	0.438596
GCA_004786125.1-Fun_PQXH01000089.1_i000_006985	193	418	225	1.00446	0.438596
GCA_004786145.1-Fun_PQXI01000085.1_i000_006192	193	418	225	1.00446	0.438596
GCA_004786225.1-Fun_PQXJ01000012.1_i000_000805	193	418	225	1.00446	0.438596
GCA_004786245.1-Fun_PQXK01000012.1_i000_001388	193	418	225	1.00446	0.438596
GCA_004916875.1-Fun_PQXL01000262.1_i000_007852	193	418	225	1.00446	0.438596
GCA_013461495.1-Fun_JABFCT010000004.1_i000_003843	193	418	225	1.00446	0.438596
GCA_014898285.1-Fun_RCSV01000016.1_i000_011408	193	418	225	1.00446	0.438596
GCA_014898425.1-Fun_RCSZ01000018.1_i000_011484	193	418	225	1.00446	0.438596
GCA_004379285.1-Fun_PHWZ01000019.1_i000_001139	193	418	225	1.00446	0.438596
GCA_014898295.1-Fun_RCSW01000022.1_i000_009523	193	418	225	1.00446	0.438596
GCA_004786275.1-Fun_PQXN01000295.1_i000_010362	193	418	225	1.00446	0.438596
GCA_013401215.1-Ani_VZUJ01084531.1_i000_007428	1	220	219	0.977679	0.616901
GCA_000143535.4-Fun_CP009806.1_i000_002022	193	418	225	1.00446	0.441176
GCA_013397455.1-Ani_VYZB01001053.1_i000_000528	115	340	225	1.00446	0.473684
GCA_002127325.2-Pla_CM007898.2_i000_034933	188	412	224	1	0.414048
GCA_004679275.1-Fun_SEOQ01000172.1_i000_003261	180	394	214	0.955357	0.29235
GCA_000977745.2-Fun_CP005265.2_i000_001988	111	345	234	1.04464	0.473684
GCA_002104935.1-Fun_MCGT01000004.1_i000_007311	184	409	225	1.00446	0.460123
GCA_013398795.1-Ani_WBNG01001737.1_i000_012168	115	340	225	1.00446	0.464876
GCA_017311265.1-Fun_JABTEF010000001.1_i000_000148	186	412	226	1.00893	0.444882
GCA_021605095.1-Ani_BPLR01001972.1_i000_007572	182	407	225	1.00446	0.406872
GCA_016808335.1-Pla_CM029053.1_i000_039043	177	397	220	0.982143	0.387324
GCA_012411365.1-Ani_CM022769.1_i000_016827	186	411	225	1.00446	0.450902
GCA_002873125.1-Fun_PGCI01000042.1_i000_004486	184	408	224	1	0.435798
GCA_002573605.1-Fun_PDNA01000056.1_i000_007667	190	416	226	1.00893	0.444882
GCA_003851025.1-Fun_BFAD01000002.1_i000_002066	180	399	219	0.977679	0.377586
GCA_000224885.2-Pro_KL998095.1_i000_004441	145	310	165	0.736607	0.517241
GCA_000003525.2-Fun_EQ999985.1_i000_009208	190	416	226	1.00893	0.440546
GCA_000151595.1-Fun_GG749464.1_i000_003407	190	416	226	1.00893	0.440546
GCA_022432515.1-Fun_JAJKLA010000043.1_i000_007646	191	417	226	1.00893	0.440546
GCA_000166155.1-Fun_GL538387.1_i000_003967	190	416	226	1.00893	0.440546
GCA_000583005.2-Pla_ASHM01017750.1_i000_022203	177	394	217	0.96875	0.395985
GCA_003046395.2-Pla_CM009690.2_i000_001507	177	397	220	0.982143	0.387324
GCA_003046395.2-Pla_CM009691.2_i000_007581	177	397	220	0.982143	0.386643
GCA_003046395.2-Pla_CM009691.2_i000_007582	177	397	220	0.982143	0.386643
GCA_001632375.1-Fun_KV425882.1_i000_000726	180	402	222	0.991071	0.37
GCA_002211085.2-Pla_CM008054.2_i000_031942	177	397	220	0.982143	0.385965
GCA_002211085.2-Pla_CM008054.2_i000_031949	177	397	220	0.982143	0.385965
GCA_003086735.1-Fun_MBFR01000069.1_i000_001994	186	410	224	1	0.447106
GCA_003061485.1-Pla_CM009757.1_i000_031509	177	397	220	0.982143	0.385965
GCA_000227095.3-Fun_BACD03000004.1_i000_006343	188	414	226	1.00893	0.451098
GCA_001661265.1-Fun_KV454254.1_i000_000578	188	414	226	1.00893	0.451098
GCA_000344655.2-Fun_KE504131.1_i000_002984	179	399	220	0.982143	0.385965
GCA_003260655.2-Pla_QGKV02000832.1_i000_043000	188	413	225	1.00446	0.445545
GCA_011799765.1-Pla_JAANDH010000459.1_i000_015158	187	412	225	1.00446	0.39823
GCA_000224805.2-Pro_KN039996.1_i000_005413	151	316	165	0.736607	0.507692
GCA_008704415.1-Fun_VXIS01000078.1_i000_011682	189	415	226	1.00893	0.421642
GCA_000988875.2-Fun_LCTV02000012.1_i000_001952	183	408	225	1.00446	0.442043
GCA_903632075.3-Ani_CAHIKZ030001046.1_i000_017296	180	399	219	0.977679	0.441532
GCA_013054445.1-Fun_JAAMPI010000139.1_i000_002661	193	418	225	1.00446	0.438596
GCA_003325415.1-Fun_PJQM01002968.1_i000_008120	185	410	225	1.00446	0.46875
GCA_905337355.1-Fun_CAJPDT010000003.1_i000_000737	191	417	226	1.00893	0.437984
GCA_000320785.2-Fun_KB722646.1_i000_002304	183	408	225	1.00446	0.441176
GCA_003234015.1-Fun_LK052940.1_i000_005383	183	408	225	1.00446	0.441176
GCA_003073295.1-Fun_KZ803344.1_i000_008594	184	405	221	0.986607	0.370184
GCA_001661425.1-Fun_KV453859.1_i000_004240	115	347	232	1.03571	0.446154
GCA_001702695.2-Fun_CM008293.1_i000_011528	193	419	226	1.00893	0.469854
GCA_012411365.1-Ani_CM022765.1_i000_013721	180	409	229	1.02232	0.40675
GCA_900624975.1-Ani_UYYA01004326.1_i000_009587	188	415	227	1.01339	0.479915
GCA_003573695.1-Pla_CM010721.1_i000_026643	188	412	224	1	0.422642
GCA_902728155.2-Pla_CACVBM020001884.1_i000_048681	1	108	107	0.477679	0.644578
GCA_020744335.1-Fun_JAHBOG010000012.1_i000_003984	193	419	226	1.00893	0.44227
GCA_000003225.1-Pro_CR940348.1_i000_001574	181	401	220	0.982143	0.443548
GCA_019157295.1-Fun_JAELUQ010000007.1_i000_015269	193	419	226	1.00893	0.44227
GCA_009771035.1-Pla_CM020017.1_i000_030241	177	395	218	0.973214	0.386525
GCA_010261695.1-Pla_CM021004.1_i000_014434	177	395	218	0.973214	0.386525
GCA_003713155.1-Pla_CP030983.1_i000_001672	188	412	224	1	0.4
GCA_013396615.1-Ani_VWZA01004294.1_i000_013103	115	340	225	1.00446	0.484914
GCA_003112345.1-Pla_PKPP01000085.1_i000_001739	177	396	219	0.977679	0.399635
GCA_900005825.1-Ani_CVRI01000055.1_i000_014187	186	411	225	1.00446	0.431862
GCA_008932095.1-Pla_CM018518.1_i000_032744	188	412	224	1	0.408759
GCA_003073865.1-Fun_KZ804111.1_i000_001994	193	418	225	1.00446	0.438596
GCA_018127125.1-Pla_CM030792.1_i000_014443	177	395	218	0.973214	0.394928
GCA_900659725.1-Ani_CAACVG010002643.1_i000_002226	188	413	225	1.00446	0.412844
GCA_000348985.1-Fun_HE978315.1_i000_000760	136	369	233	1.04018	0.473577
GCA_013400875.1-Ani_VZTV01113784.1_i000_009269	1	219	218	0.973214	0.622857
GCA_013396005.1-Fun_JAAOAO010000015.1_i000_000385	193	419	226	1.00893	0.44227
GCA_014839865.1-Fun_JABAYA010000158.1_i000_002104	186	411	225	1.00446	0.435203
GCA_001632445.1-Fun_KV424817.1_i000_016904	186	412	226	1.00893	0.428843
GCA_006547085.1-Pla_VIEB01001477.1_i000_042515	188	412	224	1	0.341985
GCA_009078355.1-Ani_CM018555.1_i000_012411	185	410	225	1.00446	0.396127
GCA_014170095.1-Ani_WKFB01000207.1_i000_008235	185	410	225	1.00446	0.458248
GCA_022496185.1-Fun_WTXG01000021.1_i000_004192	180	393	213	0.950893	0.375661
GCA_013401115.1-Ani_VZUG01035853.1_i000_012290	115	340	225	1.00446	0.478723
GCA_000259975.2-Fun_JH650830.1_i000_004551	193	419	226	1.00893	0.44227
GCA_003144125.1-Fun_KZ819189.1_i000_002012	189	413	224	1	0.380306
GCA_002117355.1-Fun_KZ110600.1_i000_007878	179	400	221	0.986607	0.388401
GCA_014925825.1-Fun_JACGCK010000398.1_i000_010658	182	405	223	0.995536	0.388502
GCA_902860255.1-Pla_LR794327.1_i000_020248	188	412	224	1	0.415584
GCA_014925825.1-Fun_JACGCK010000141.1_i000_003340	191	414	223	0.995536	0.382504
GCA_009193585.1-Fun_ML737573.1_i000_001462	190	416	226	1.00893	0.43295
GCA_009193665.1-Fun_ML735742.1_i000_006906	190	416	226	1.00893	0.43295
GCA_000260155.3-Fun_JH651399.1_i000_014226	193	419	226	1.00893	0.437137
GCA_000469725.3-Ani_LN902841.1_i000_002047	181	401	220	0.982143	0.501139
GCA_000271705.2-Fun_JH717907.1_i000_014530	193	419	226	1.00893	0.439689
GCA_003615185.1-Fun_MRDA01000028.1_i000_008121	193	419	226	1.00893	0.439689
GCA_003615085.1-Fun_CM010805.1_i000_011072	193	419	226	1.00893	0.44227
GCA_020796175.1-Fun_JAJGYP010000007.1_i000_017271	193	419	226	1.00893	0.44227
GCA_905250065.1-Ani_CAJNON010000184.1_i000_018806	217	442	225	1.00446	0.492341
GCA_015832375.1-Fun_JADOXO010000006.1_i000_008933	179	400	221	0.986607	0.388401
GCA_013399335.1-Ani_VZZT01009338.1_i000_013222	115	340	225	1.00446	0.478723
GCA_900618365.1-Ani_UYYF01004510.1_i000_007448	189	408	219	0.977679	0.446029
GCA_003427395.1-Pla_BFEA01000297.1_i000_019306	147	292	145	0.647321	0.256184
GCA_002865625.1-Fun_KZ613525.1_i000_014629	194	419	225	1.00446	0.439453
GCA_002994745.2-Pla_CM009584.1_i000_015273	180	400	220	0.982143	0.398551
GCA_022496185.1-Fun_WTXG01000015.1_i000_002459	185	412	227	1.01339	0.412727
GCA_019633405.1-Fun_WSTX01001920.1_i000_003196	181	401	220	0.982143	0.443548
GCA_008065275.1-Fun_QKWK01000007.1_i000_002738	196	421	225	1.00446	0.398936
GCA_009193445.1-Fun_ML743585.1_i000_007736	190	416	226	1.00893	0.43295
GCA_002104905.1-Fun_MCFE01000284.1_i000_006353	183	401	218	0.973214	0.437751
GCA_000375325.1-Pla_KB870810.1_i000_018745	45	259	214	0.955357	0.781022
GCA_900604375.1-Ani_UXSR01005197.1_i000_005462	181	400	219	0.977679	0.504608
GCA_013398195.1-Ani_VZSB01003474.1_i000_010187	115	340	225	1.00446	0.488069
GCA_013467495.1-Pla_CM025153.1_i000_018988	137	355	218	0.973214	0.440404
GCA_013676235.1-Pla_CM025499.1_i000_010142	177	396	219	0.977679	0.385563
GCA_011392555.1-Fun_QMFL01000026.1_i000_000366	190	416	226	1.00893	0.438835
GCA_000269785.2-Fun_AKHY01000110.1_i000_002542	190	416	226	1.00893	0.43295
GCA_000691885.1-Fun_AMCJ01000112.1_i000_005008	190	416	226	1.00893	0.43295
GCA_009176375.1-Fun_ML734594.1_i000_006507	190	416	226	1.00893	0.43295
GCA_000006275.3-Fun_AAIH03000072.1_i000_001360	190	416	226	1.00893	0.43295
GCA_000184455.3-Fun_BA000049.1_i000_000926	190	416	226	1.00893	0.43295
GCA_000952835.1-Fun_JZDT01000200.1_i000_000948	190	416	226	1.00893	0.43295
GCA_002007945.1-Fun_MKZY01000002.1_i000_001849	190	416	226	1.00893	0.43295
GCA_002443195.2-Fun_NWUI02000293.1_i000_003605	190	416	226	1.00893	0.43295
GCA_002443215.2-Fun_NWUG02001141.1_i000_005471	190	416	226	1.00893	0.43295
GCA_002456175.2-Fun_NWUH02000014.1_i000_006033	190	416	226	1.00893	0.43295
GCA_009017415.1-Fun_CP044619.1_i000_001325	190	416	226	1.00893	0.43295
GCA_014117465.1-Fun_CP059866.1_i000_000920	190	416	226	1.00893	0.43295
GCA_014117485.1-Fun_CP059858.1_i000_000995	190	416	226	1.00893	0.43295
GCA_002865645.1-Fun_KZ613740.1_i000_000471	194	419	225	1.00446	0.438596
GCA_013399015.1-Ani_VWZX01010411.1_i000_013225	115	340	225	1.00446	0.46875
GCA_003709025.1-Fun_QQZZ01000196.1_i000_004540	190	416	226	1.00893	0.430476
GCA_014784225.2-Fun_CP061804.2_i000_000992	190	416	226	1.00893	0.430476
GCA_015584085.1-Fun_MU151160.1_i000_006657	181	401	220	0.982143	0.37037
GCA_009176455.1-Fun_ML732799.1_i000_006710	190	416	226	1.00893	0.43295
GCA_004114815.1-Pla_SDOW01000333.1_i000_025709	177	394	217	0.96875	0.399632
GCA_905250035.1-Ani_CAJNOE010000247.1_i000_022149	186	411	225	1.00446	0.484914
GCA_905332045.1-Ani_CAJOBB010005135.1_i000_035414	186	411	225	1.00446	0.484914
GCA_009193485.1-Fun_ML738625.1_i000_005987	190	416	226	1.00893	0.43295
GCA_016808335.1-Pla_CM029054.1_i000_077691	177	397	220	0.982143	0.388693
GCA_905332015.1-Ani_CAJOAZ010001356.1_i000_018382	186	411	225	1.00446	0.484914
GCA_016808335.1-Pla_CM029054.1_i000_077690	177	397	220	0.982143	0.392857
GCA_000517465.1-Fun_AWNI01000004.1_i000_000751	189	412	223	0.995536	0.412963
GCA_003426965.1-Fun_QUQM01000007.1_i000_009918	190	416	226	1.00893	0.428843
GCA_004798825.1-Fun_SOSA01000040.1_i000_007714	190	416	226	1.00893	0.428843
GCA_009732865.1-Fun_ML769340.1_i000_012770	194	419	225	1.00446	0.437743
GCA_013368445.1-Fun_JAACJO010000001.1_i000_000941	181	404	223	0.995536	0.392606
GCA_016584205.1-Fun_PUHQ01000087.1_i000_006623	175	400	225	1.00446	0.443787
GCA_008638375.1-Pla_CM018035.1_i000_023293	188	412	224	1	0.523364
GCA_013396355.1-Ani_VWPS01000834.1_i000_013418	115	340	225	1.00446	0.459184
GCA_003713155.1-Pla_CP030993.1_i000_005046	188	412	224	1	0.4
GCA_004170445.1-Pla_CM014325.1_i000_005158	188	412	224	1	0.4
GCA_015731905.1-Pla_CM027663.1_i000_007313	199	417	218	0.973214	0.369492
GCA_020796205.1-Pla_CM036894.1_i000_009274	188	412	224	1	0.406534
GCA_003024255.1-Pla_CM009660.1_i000_007448	177	396	219	0.977679	0.385563
GCA_900074895.1-Fun_FJVC01000102.1_i000_006501	193	418	225	1.00446	0.439453
GCA_015956445.1-Fun_WIUZ02000010.1_i000_001756	185	411	226	1.00893	0.392361
GCA_900074885.1-Fun_FJUW01000022.1_i000_000483	193	418	225	1.00446	0.439453
GCA_900074905.1-Fun_FJUX01000034.1_i000_009156	193	418	225	1.00446	0.439453
GCA_013677255.1-Pla_CM025231.1_i000_024927	137	355	218	0.973214	0.439516
GCA_017311265.1-Fun_JABTEF010000019.1_i000_001223	180	399	219	0.977679	0.427734
GCA_017788925.1-Fun_JACEFK010000001.1_i000_001674	180	399	219	0.977679	0.427734
GCA_001605985.2-Pla_KZ503304.1_i000_022299	177	389	212	0.946429	0.401515
GCA_001204775.2-Fun_JNOM01000053.1_i000_003308	190	416	226	1.00893	0.43295
GCA_009176395.1-Fun_ML734289.1_i000_006119	190	416	226	1.00893	0.43295
GCA_009193645.1-Fun_ML736749.1_i000_002803	190	416	226	1.00893	0.43295
GCA_017499595.2-Fun_CM039001.1_i000_005147	182	404	222	0.991071	0.388792
GCA_019455425.1-Pla_CM033496.1_i000_031147	177	395	218	0.973214	0.387211
GCA_013677275.1-Pla_CM025257.1_i000_025503	137	355	218	0.973214	0.439516
GCA_002104905.1-Fun_MCFE01000020.1_i000_004262	183	401	218	0.973214	0.43513
GCA_003546025.1-Pla_QPKB01000011.1_i000_023296	177	398	221	0.986607	0.36711
GCA_013677235.1-Pla_CM025205.1_i000_026351	137	355	218	0.973214	0.439516
GCA_013677245.1-Pla_CM025218.1_i000_025407	137	355	218	0.973214	0.439516
GCA_005059875.1-Fun_MXAQ01000006.1_i000_005374	183	408	225	1.00446	0.436893
GCA_013677265.1-Pla_CM025244.1_i000_021502	137	355	218	0.973214	0.439516
GCA_020736575.1-Fun_JAGPYM010000003.1_i000_008318	193	419	226	1.00893	0.444882
GCA_002029285.1-Ani_LSYS01001717.1_i000_002668	154	379	225	1.00446	0.43021
GCA_008638375.1-Pla_CM018036.1_i000_024665	188	412	224	1	0.39646
GCA_013400215.1-Ani_VXBR01004868.1_i000_005286	117	341	224	1	0.479657
GCA_002847045.1-Fun_KZ559123.1_i000_002031	190	416	226	1.00893	0.438835
GCA_002127325.2-Pla_CM007896.2_i000_025906	177	395	218	0.973214	0.398537
GCA_022496215.1-Fun_WTXF01000087.1_i000_013082	180	400	220	0.982143	0.37931
GCA_002127325.2-Pla_CM007903.2_i000_055722	177	395	218	0.973214	0.396364
GCA_013368555.1-Fun_JAACJN010000015.1_i000_003588	210	417	207	0.924107	0.370304
GCA_015502575.1-Fun_JAAAUR010000358.1_i000_006899	1	200	199	0.888393	0.674576
GCA_012923435.1-Pla_JAATIP010000107.1_i000_006252	207	426	219	0.977679	0.370558
GCA_012923435.1-Pla_JAATIP010000370.1_i000_015244	207	426	219	0.977679	0.370558
GCA_013030025.1-Pla_JAATIQ010000184.1_i000_008220	207	426	219	0.977679	0.370558
GCA_013030025.1-Pla_JAATIQ010000392.1_i000_018591	207	426	219	0.977679	0.370558
GCA_018296245.1-Fun_JADFTV010000190.1_i000_006307	193	419	226	1.00893	0.44227
GCA_018296265.1-Fun_JADFTU010000186.1_i000_006269	193	419	226	1.00893	0.44227
GCA_018296285.1-Fun_JADFTT010000312.1_i000_008528	193	419	226	1.00893	0.44227
GCA_018296305.1-Fun_JADFTW010000177.1_i000_005087	193	419	226	1.00893	0.44227
GCA_018296325.1-Fun_JADFTY010000033.1_i000_001935	193	419	226	1.00893	0.44227
GCA_018296345.1-Fun_JADFTX010000265.1_i000_006632	193	419	226	1.00893	0.44227
GCA_000334475.1-Fun_DF196771.1_i000_000786	189	412	223	0.995536	0.383162
GCA_022160365.1-Fun_MU273527.1_i000_004134	186	413	227	1.01339	0.424299
GCA_003573695.1-Pla_CM010722.1_i000_029441	177	396	219	0.977679	0.398907
GCA_002762385.1-Pla_NKXS01001011.1_i000_006172	177	396	219	0.977679	0.373083
GCA_012184295.1-Fun_LDUD01000131.1_i000_003266	189	413	224	1	0.416357
GCA_002251995.2-Fun_NDIQ01000001.1_i000_000404	44	259	215	0.959821	0.678233
GCA_021223965.1-Ani_JAJJHZ010000276.1_i000_000605	202	426	224	1	0.442688
GCA_014362265.1-Pla_BJWL01000007.1_i000_010436	224	443	219	0.977679	0.404059
GCA_019915245.1-Fun_CM034120.1_i000_009854	193	419	226	1.00893	0.44227
GCA_001929475.1-Fun_LXFE01004217.1_i000_000720	104	330	226	1.00893	0.541966
GCA_002204255.1-Fun_MZNU01000050.1_i000_007503	192	418	226	1.00893	0.440546
GCA_003615115.1-Fun_MRCX01000011.1_i000_001242	193	419	226	1.00893	0.444882
GCA_020744455.1-Fun_JAHEWL010000007.1_i000_015248	193	419	226	1.00893	0.444882
GCA_000260175.2-Fun_JH657930.1_i000_006895	193	419	226	1.00893	0.44227
GCA_000260195.2-Fun_JH658282.1_i000_007459	193	419	226	1.00893	0.44227
GCA_000350365.1-Fun_KB726235.1_i000_001540	193	419	226	1.00893	0.44227
GCA_000149955.2-Fun_CM000597.1_i000_014868	193	419	226	1.00893	0.439689
GCA_000222805.1-Fun_AFQF01001995.1_i000_006538	193	419	226	1.00893	0.44227
GCA_000260075.2-Fun_JH650974.1_i000_010880	193	419	226	1.00893	0.44227
GCA_000260215.2-Fun_KK033188.1_i000_006283	193	419	226	1.00893	0.44227
GCA_000260235.2-Fun_JH658369.1_i000_005322	193	419	226	1.00893	0.44227
GCA_000260495.2-Fun_JH659333.1_i000_008547	193	419	226	1.00893	0.44227
GCA_000271745.2-Fun_JH717845.1_i000_010561	193	419	226	1.00893	0.44227
GCA_005930515.1-Fun_SRMI01000009.1_i000_015157	193	419	226	1.00893	0.44227
GCA_014154955.1-Fun_CM024368.1_i000_011926	193	419	226	1.00893	0.44227
GCA_018894095.1-Fun_RSAI01000012.1_i000_003851	193	419	226	1.00893	0.44227
GCA_019157275.1-Fun_JAELUR010000005.1_i000_014913	193	419	226	1.00893	0.44227
GCA_020744355.1-Fun_JAHEVI010000007.1_i000_014490	193	419	226	1.00893	0.44227
GCA_900096695.1-Fun_FMJY01000007.1_i000_004541	193	419	226	1.00893	0.44227
GCA_000350345.1-Fun_KB730332.1_i000_008896	193	419	226	1.00893	0.44227
GCA_002894225.1-Fun_MTQA01000070.1_i000_013243	193	419	226	1.00893	0.44227
GCA_003316975.2-Fun_CM010973.1_i000_009398	193	419	226	1.00893	0.44227
GCA_000747765.1-Fun_DF830072.1_i000_004246	189	412	223	0.995536	0.383162
GCA_900322835.1-Fun_OOIQ01000005.1_i000_002640	189	412	223	0.995536	0.383162
GCA_000342415.1-Pro_CP001669.1_i000_000585	179	400	221	0.986607	0.509217
GCA_001773325.1-Fun_LXJU01000008.1_i000_005411	190	416	226	1.00893	0.438835
GCA_020744415.1-Fun_JAGMWT010000001.1_i000_000389	189	414	225	1.00446	0.436047
GCA_019155715.1-Pro_JAGDFM010000180.1_i000_003804	181	400	219	0.977679	0.440644
GCA_021399465.1-Fun_JAJTUS010000010.1_i000_000723	194	419	225	1.00446	0.438596
GCA_021399475.1-Fun_JAJTUR010000008.1_i000_015794	194	419	225	1.00446	0.438596
GCA_000787975.1-Pla_JRRC01180008.1_i000_011168	177	395	218	0.973214	0.39781
GCA_002850765.1-Fun_KZ559547.1_i000_005311	190	416	226	1.00893	0.445759
GCA_006352295.1-Fun_SOZI01000030.1_i000_004379	183	408	225	1.00446	0.412088
GCA_000230375.1-Fun_FP929133.1_i000_008458	192	416	224	1	0.432432
GCA_002928715.1-Pla_KZ665826.1_i000_022905	177	395	218	0.973214	0.409774
GCA_004379715.1-Fun_ML213591.1_i000_001221	182	402	220	0.982143	0.389381
GCA_003046395.2-Pla_CM009690.2_i000_001506	177	397	220	0.982143	0.353698
GCA_016771965.1-Pla_CM028693.1_i000_034188	177	395	218	0.973214	0.407477
GCA_021014935.1-Fun_MU267593.1_i000_000652	183	405	222	0.991071	0.38676
GCA_001654015.2-Ani_LSRL02000004.1_i000_001272	186	410	224	1	0.448898
GCA_008632915.2-Pla_AP019302.1_i000_017760	77	296	219	0.977679	0.492135
GCA_000832265.1-Fun_KN840461.1_i000_003070	179	399	220	0.982143	0.392157
GCA_015501535.1-Fun_JADNRW010000019.1_i000_007806	180	398	218	0.973214	0.385841
GCA_000146915.2-Fun_CH445345.1_i000_004275	192	416	224	1	0.432432
GCA_016801405.1-Fun_CP069034.1_i000_011420	192	416	224	1	0.432432
GCA_020557385.1-Fun_JAIRDT010000020.1_i000_010189	192	416	224	1	0.432432
GCA_020567955.1-Fun_JAIRGA010000020.1_i000_009943	192	416	224	1	0.432432
GCA_020568045.1-Fun_JAIRGB010000017.1_i000_007832	192	416	224	1	0.432432
GCA_020568055.1-Fun_JAIRGC010000039.1_i000_012287	192	416	224	1	0.432432
GCA_020568205.1-Fun_JAIRGE010000019.1_i000_010353	192	416	224	1	0.432432
GCA_020568325.1-Fun_JAIRDU010000017.1_i000_009583	192	416	224	1	0.432432
GCA_020568415.1-Fun_JAIRDV010000017.1_i000_008248	192	416	224	1	0.432432
GCA_020568465.1-Fun_JAIRDW010000020.1_i000_011921	192	416	224	1	0.432432
GCA_020568635.1-Fun_JAIRDX010000021.1_i000_011517	192	416	224	1	0.432432
GCA_020568765.1-Fun_JAIRDY010000020.1_i000_011453	192	416	224	1	0.432432
GCA_020568775.1-Fun_JAIRGG010000020.1_i000_008685	192	416	224	1	0.432432
GCA_020568935.1-Fun_JAIRGH010000036.1_i000_014683	192	416	224	1	0.432432
GCA_020568945.1-Fun_JAIRDZ010000017.1_i000_009058	192	416	224	1	0.432432
GCA_020569145.1-Fun_JAIREA010000001.1_i000_000919	192	416	224	1	0.432432
GCA_020569235.1-Fun_JAIREB010000011.1_i000_007438	192	416	224	1	0.432432
GCA_020569285.1-Fun_JAIREC010000041.1_i000_015384	192	416	224	1	0.432432
GCA_020569485.1-Fun_JAIRGI010000021.1_i000_011464	192	416	224	1	0.432432
GCA_020569495.1-Fun_JAIRED010000003.1_i000_002408	192	416	224	1	0.432432
GCA_020570975.1-Fun_JAIRGT010000019.1_i000_010584	192	416	224	1	0.432432
GCA_020571295.1-Fun_JAIRGU010000037.1_i000_015106	192	416	224	1	0.432432
GCA_020571325.1-Fun_JAIREN010000036.1_i000_013482	192	416	224	1	0.432432
GCA_020571545.1-Fun_JAIREO010000020.1_i000_009850	192	416	224	1	0.432432
GCA_020571815.1-Fun_JAIRGX010000021.1_i000_009108	192	416	224	1	0.432432
GCA_020571885.1-Fun_JAIRGY010000041.1_i000_014718	192	416	224	1	0.432432
GCA_020572205.1-Fun_JAIREQ010000041.1_i000_015338	192	416	224	1	0.432432
GCA_020572305.1-Fun_JAIRHC010000017.1_i000_007951	192	416	224	1	0.432432
GCA_020572315.1-Fun_JAIRHB010000023.1_i000_012678	192	416	224	1	0.432432
GCA_020572985.1-Fun_JAIRER010000013.1_i000_006589	192	416	224	1	0.432432
GCA_020572995.1-Fun_JAIRES010000044.1_i000_014975	192	416	224	1	0.432432
GCA_020573275.1-Fun_JAIRHK010000020.1_i000_009376	192	416	224	1	0.432432
GCA_020573285.1-Fun_JAIRHL010000038.1_i000_015226	192	416	224	1	0.432432
GCA_020573325.1-Fun_JAIRET010000048.1_i000_017032	192	416	224	1	0.432432
GCA_020573495.1-Fun_JAIRHN010000044.1_i000_014048	192	416	224	1	0.432432
GCA_020573595.1-Fun_JAIRHO010000023.1_i000_010571	192	416	224	1	0.432432
GCA_020573605.1-Fun_JAIRHP010000014.1_i000_006356	192	416	224	1	0.432432
GCA_020573625.1-Fun_JAIRHQ010000017.1_i000_008629	192	416	224	1	0.432432
GCA_020574055.1-Fun_JAIRHS010000043.1_i000_014879	192	416	224	1	0.432432
GCA_020574085.1-Fun_JAIRHT010000017.1_i000_010680	192	416	224	1	0.432432
GCA_020574115.1-Fun_JAIRHU010000020.1_i000_009139	192	416	224	1	0.432432
GCA_020574145.1-Fun_JAIREW010000020.1_i000_013111	192	416	224	1	0.432432
GCA_020574265.1-Fun_JAIREY010000009.1_i000_005883	192	416	224	1	0.432432
GCA_020574295.1-Fun_JAIRHV010000023.1_i000_011628	192	416	224	1	0.432432
GCA_020574345.1-Fun_JAIREZ010000014.1_i000_009075	192	416	224	1	0.432432
GCA_020574365.1-Fun_JAIRHW010000017.1_i000_008880	192	416	224	1	0.432432
GCA_020574375.1-Fun_JAIRFA010000015.1_i000_009247	192	416	224	1	0.432432
GCA_020574385.1-Fun_JAIRFB010000018.1_i000_008864	192	416	224	1	0.432432
GCA_020574405.1-Fun_JAIRHY010000035.1_i000_014022	192	416	224	1	0.432432
GCA_020574595.1-Fun_JAIRHX010000041.1_i000_015474	192	416	224	1	0.432432
GCA_020574715.1-Fun_JAIRFC010000019.1_i000_010187	192	416	224	1	0.432432
GCA_020574725.1-Fun_JAIRFD010000022.1_i000_011952	192	416	224	1	0.432432
GCA_020574755.1-Fun_JAIRIA010000036.1_i000_013399	192	416	224	1	0.432432
GCA_020574825.1-Fun_JAIRIB010000036.1_i000_015466	192	416	224	1	0.432432
GCA_020574875.1-Fun_JAIRIC010000014.1_i000_008194	192	416	224	1	0.432432
GCA_020575035.1-Fun_JAIRFE010000017.1_i000_009685	192	416	224	1	0.432432
GCA_020575105.1-Fun_JAIRID010000018.1_i000_009752	192	416	224	1	0.432432
GCA_020575195.1-Fun_JAIRIE010000019.1_i000_008352	192	416	224	1	0.432432
GCA_020575285.1-Fun_JAIRIF010000018.1_i000_007475	192	416	224	1	0.432432
GCA_020575355.1-Fun_JAIRIH010000039.1_i000_015259	192	416	224	1	0.432432
GCA_020575375.1-Fun_JAIRIG010000013.1_i000_007215	192	416	224	1	0.432432
GCA_020575405.1-Fun_JAIRII010000021.1_i000_011082	192	416	224	1	0.432432
GCA_020575445.1-Fun_JAIRIJ010000036.1_i000_012846	192	416	224	1	0.432432
GCA_020575485.1-Fun_JAIRIK010000025.1_i000_011084	192	416	224	1	0.432432
GCA_020575615.1-Fun_JAIRIL010000026.1_i000_010123	192	416	224	1	0.432432
GCA_020575775.1-Fun_JAIRIN010000036.1_i000_013383	192	416	224	1	0.432432
GCA_020575955.1-Fun_JAIRIO010000016.1_i000_006209	192	416	224	1	0.432432
GCA_020575975.1-Fun_JAIRFF010000016.1_i000_007456	192	416	224	1	0.432432
GCA_020576185.1-Fun_JAIRIQ010000013.1_i000_007429	192	416	224	1	0.432432
GCA_020576195.1-Fun_JAIRFG010000062.1_i000_016727	192	416	224	1	0.432432
GCA_020576365.1-Fun_JAIRFI010000072.1_i000_016661	192	416	224	1	0.432432
GCA_020577795.1-Fun_JAIRFH010000066.1_i000_016785	192	416	224	1	0.432432
GCA_020577805.1-Fun_JAIRFJ010000068.1_i000_016670	192	416	224	1	0.432432
GCA_020577855.1-Fun_JAIRFK010000022.1_i000_009501	192	416	224	1	0.432432
GCA_020577905.1-Fun_JAIRFL010000045.1_i000_014506	192	416	224	1	0.432432
GCA_020577915.1-Fun_JAIRFM010000071.1_i000_016499	192	416	224	1	0.432432
GCA_020578075.1-Fun_JAIRFO010000073.1_i000_016830	192	416	224	1	0.432432
GCA_020578085.1-Fun_JAIRFN010000066.1_i000_016517	192	416	224	1	0.432432
GCA_020578095.1-Fun_JAIRFP010000073.1_i000_016462	192	416	224	1	0.432432
GCA_020578105.1-Fun_JAIRFQ010000070.1_i000_016728	192	416	224	1	0.432432
GCA_020578115.1-Fun_JAIRFR010000036.1_i000_012518	192	416	224	1	0.432432
GCA_020578205.1-Fun_JAIRFS010000062.1_i000_016735	192	416	224	1	0.432432
GCA_020578265.1-Fun_JAIRIR010000022.1_i000_010076	192	416	224	1	0.432432
GCA_020578295.1-Fun_JAIRIT010000037.1_i000_015399	192	416	224	1	0.432432
GCA_020578315.1-Fun_JAIRIS010000046.1_i000_015188	192	416	224	1	0.432432
GCA_020578375.1-Fun_JAIRFT010000022.1_i000_012192	192	416	224	1	0.432432
GCA_020578445.1-Fun_JAIRIU010000021.1_i000_009233	192	416	224	1	0.432432
GCA_020578515.1-Fun_JAIRIV010000013.1_i000_006959	192	416	224	1	0.432432
GCA_020578585.1-Fun_JAIRIW010000017.1_i000_009310	192	416	224	1	0.432432
GCA_020578615.1-Fun_JAIRIX010000062.1_i000_017116	192	416	224	1	0.432432
GCA_020579815.1-Fun_JAIRIZ010000019.1_i000_011885	192	416	224	1	0.432432
GCA_020579825.1-Fun_JAIRIY010000020.1_i000_008271	192	416	224	1	0.432432
GCA_020579835.1-Fun_JAIRJA010000032.1_i000_012777	192	416	224	1	0.432432
GCA_020579845.1-Fun_JAIRJB010000019.1_i000_009547	192	416	224	1	0.432432
GCA_020579855.1-Fun_JAIRFU010000018.1_i000_008841	192	416	224	1	0.432432
GCA_020580075.1-Fun_JAIRJC010000015.1_i000_008018	192	416	224	1	0.432432
GCA_020580085.1-Fun_JAIRJD010000037.1_i000_014128	192	416	224	1	0.432432
GCA_020580115.1-Fun_JAIRFV010000061.1_i000_017085	192	416	224	1	0.432432
GCA_020580145.1-Fun_JAIRJE010000016.1_i000_007912	192	416	224	1	0.432432
GCA_020580155.1-Fun_JAIRJF010000015.1_i000_009272	192	416	224	1	0.432432
GCA_020580305.1-Fun_JAIRJG010000064.1_i000_016963	192	416	224	1	0.432432
GCA_020580415.1-Fun_JAIRFW010000016.1_i000_008429	192	416	224	1	0.432432
GCA_020580425.1-Fun_JAIRJH010000031.1_i000_012608	192	416	224	1	0.432432
GCA_020580655.1-Fun_JAIRFX010000041.1_i000_015065	192	416	224	1	0.432432
GCA_020580665.1-Fun_JAIRFY010000018.1_i000_010404	192	416	224	1	0.432432
GCA_020580725.1-Fun_JAIRJJ010000040.1_i000_015333	192	416	224	1	0.432432
GCA_020580775.1-Fun_JAIRJL010000038.1_i000_010674	192	416	224	1	0.432432
GCA_020580905.1-Fun_JAIRFZ010000021.1_i000_010269	192	416	224	1	0.432432
GCA_020581045.1-Fun_JAIRJM010000042.1_i000_014947	192	416	224	1	0.432432
GCA_020581155.1-Fun_JAIRJN010000016.1_i000_006705	192	416	224	1	0.432432
GCA_020581165.1-Fun_JAIRJO010000018.1_i000_008535	192	416	224	1	0.432432
GCA_020581275.1-Fun_JAIRJP010000035.1_i000_011952	192	416	224	1	0.432432
GCA_020744175.1-Fun_JAGTJP010000068.1_i000_011885	187	411	224	1	0.422642
GCA_000350255.1-Fun_CAOJ01000692.1_i000_000525	180	403	223	0.995536	0.419173
GCA_007646595.3-Ani_VBQZ03000001.1_i000_000208	179	397	218	0.973214	0.151179
GCA_004369085.1-Fun_ML210247.1_i000_008769	180	403	223	0.995536	0.393298
GCA_020568095.1-Fun_JAIRGD010000022.1_i000_011775	192	416	224	1	0.432432
GCA_020568705.1-Fun_JAIRGF010000083.1_i000_017141	192	416	224	1	0.432432
GCA_020569685.1-Fun_JAIRGK010000058.1_i000_017259	192	416	224	1	0.432432
GCA_020569895.1-Fun_JAIRGL010000022.1_i000_011341	192	416	224	1	0.432432
GCA_020569895.1-Fun_JAIRGL010000022.1_i000_011350	192	416	224	1	0.432432
GCA_020569945.1-Fun_JAIREF010000042.1_i000_015055	192	416	224	1	0.432432
GCA_020570015.1-Fun_JAIREG010000036.1_i000_013947	192	416	224	1	0.432432
GCA_020570045.1-Fun_JAIREI010000042.1_i000_016165	192	416	224	1	0.432432
GCA_020570345.1-Fun_JAIRGM010000006.1_i000_003928	192	416	224	1	0.432432
GCA_020570355.1-Fun_JAIREH010000021.1_i000_009116	192	416	224	1	0.432432
GCA_020570395.1-Fun_JAIRGN010000059.1_i000_017117	192	416	224	1	0.432432
GCA_020570405.1-Fun_JAIREJ010000032.1_i000_014561	192	416	224	1	0.432432
GCA_020570415.1-Fun_JAIRGO010000032.1_i000_015418	192	416	224	1	0.432432
GCA_020570525.1-Fun_JAIREK010000045.1_i000_015523	192	416	224	1	0.432432
GCA_020570635.1-Fun_JAIRGP010000016.1_i000_008313	192	416	224	1	0.432432
GCA_020570685.1-Fun_JAIRGQ010000042.1_i000_016272	192	416	224	1	0.432432
GCA_020570735.1-Fun_JAIRGR010000044.1_i000_015757	192	416	224	1	0.432432
GCA_020570935.1-Fun_JAIREL010000020.1_i000_011837	192	416	224	1	0.432432
GCA_020570965.1-Fun_JAIRGS010000024.1_i000_011312	192	416	224	1	0.432432
GCA_020571265.1-Fun_JAIREM010000042.1_i000_015485	192	416	224	1	0.432432
GCA_020571575.1-Fun_JAIRGV010000050.1_i000_014434	192	416	224	1	0.432432
GCA_020571605.1-Fun_JAIRGW010000048.1_i000_013465	192	416	224	1	0.432432
GCA_020571895.1-Fun_JAIREP010000040.1_i000_015783	192	416	224	1	0.432432
GCA_020571965.1-Fun_JAIRGZ010000043.1_i000_015185	192	416	224	1	0.432432
GCA_020572075.1-Fun_JAIRHA010000063.1_i000_016484	192	416	224	1	0.432432
GCA_020572345.1-Fun_JAIRHD010000044.1_i000_016471	192	416	224	1	0.432432
GCA_020572395.1-Fun_JAIRHG010000018.1_i000_008652	192	416	224	1	0.432432
GCA_020572635.1-Fun_JAIRHE010000022.1_i000_011506	192	416	224	1	0.432432
GCA_020572645.1-Fun_JAIRHF010000023.1_i000_009677	192	416	224	1	0.432432
GCA_020572675.1-Fun_JAIRHH010000095.1_i000_016141	192	416	224	1	0.432432
GCA_020572945.1-Fun_JAIRHJ010000023.1_i000_010872	192	416	224	1	0.432432
GCA_020572955.1-Fun_JAIRHI010000016.1_i000_008557	192	416	224	1	0.432432
GCA_020573315.1-Fun_JAIRHM010000070.1_i000_017041	192	416	224	1	0.432432
GCA_020573725.1-Fun_JAIREU010000070.1_i000_017239	192	416	224	1	0.432432
GCA_020573765.1-Fun_JAIREV010000067.1_i000_017015	192	416	224	1	0.432432
GCA_020573915.1-Fun_JAIRHR010000018.1_i000_008521	192	416	224	1	0.432432
GCA_020574155.1-Fun_JAIREX010000017.1_i000_010128	192	416	224	1	0.432432
GCA_020574615.1-Fun_JAIRHZ010000017.1_i000_005884	192	416	224	1	0.432432
GCA_020575645.1-Fun_JAIRIM010000035.1_i000_013606	192	416	224	1	0.432432
GCA_020575995.1-Fun_JAIRIP010000018.1_i000_009493	192	416	224	1	0.432432
GCA_020580485.1-Fun_JAIRJI010000003.1_i000_002172	192	416	224	1	0.432432
GCA_020580695.1-Fun_JAIRJK010000019.1_i000_009059	192	416	224	1	0.432432
GCA_900162835.1-Fun_LT795059.1_i000_003178	189	409	220	0.982143	0.400729
GCA_000230245.1-Fun_FQ311471.1_i000_002758	189	409	220	0.982143	0.400729
GCA_900332095.2-Pla_OOIL02002240.1_i000_023324	177	395	218	0.973214	0.387211
GCA_004679265.1-Fun_SEKV01000283.1_i000_004657	179	401	222	0.991071	0.391534
GCA_022264815.1-Fun_JADCUA010000001.1_i000_000228	179	401	222	0.991071	0.391534
GCA_002102565.1-Fun_NBSH01000003.1_i000_004395	188	402	214	0.955357	0.365812
GCA_009735665.1-Ani_MQTX01000096.1_i000_003741	201	428	227	1.01339	0.441634
GCA_000510995.2-Pla_KQ152610.1_i000_011454	185	409	224	1	0.405063
GCA_021527775.1-Fun_JAKEYF010000017.1_i000_004705	205	425	220	0.982143	0.375427
GCA_022160305.1-Fun_MU277187.1_i000_000719	180	388	208	0.928571	0.364273
GCA_000326865.1-Ani_KB096742.1_i000_011094	180	399	219	0.977679	0.298772
GCA_002104905.1-Fun_MCFE01000429.1_i000_009529	183	401	218	0.973214	0.427451
GCA_022343325.1-Fun_JACTNT010000010.1_i000_001817	192	416	224	1	0.432432
GCA_014898415.1-Fun_RCTD01000003.1_i000_001474	192	418	226	1.00893	0.437984
GCA_008694065.1-Fun_VYXO01000004.1_i000_006447	191	416	225	1.00446	0.447316
GCA_000149865.1-Fun_DS022311.1_i000_001318	182	400	218	0.973214	0.434263
GCA_006547085.1-Pla_VIEB01001941.1_i000_044239	177	396	219	0.977679	0.396022
GCA_004115385.1-Pla_CM014052.1_i000_008794	177	396	219	0.977679	0.396022
GCA_016098045.1-Fun_JAAAIW010000431.1_i000_007277	185	410	225	1.00446	0.465839
GCA_000188695.1-Pro_GL832967.1_i000_005713	188	412	224	1	0.432432
GCA_020809275.1-Ani_SDOV01000004.1_i000_004446	188	416	228	1.01786	0.45509
GCA_002286715.1-Fun_NSJX01000001.1_i000_000158	180	394	214	0.955357	0.379433
GCA_021613535.1-Ani_CP075494.1_i000_024696	186	411	225	1.00446	0.482833
GCA_000002945.2-Fun_CU329670.1_i000_000343	180	400	220	0.982143	0.433071
GCA_000836295.1-Fun_KN847547.1_i000_005781	192	417	225	1.00446	0.442043
GCA_003019875.1-Fun_KZ679017.1_i000_008468	192	418	226	1.00893	0.443137
GCA_019633595.1-Fun_WSUI01000010.1_i000_000107	181	401	220	0.982143	0.381282
GCA_905219545.1-Fun_CAJMWQ010000964.1_i000_003054	180	403	223	0.995536	0.386482
GCA_002870075.2-Pla_CM022518.1_i000_000967	188	412	224	1	0.419476
GCA_010015745.1-Fun_ML978287.1_i000_012123	192	416	224	1	0.434109
GCA_000182175.1-Fun_ABSV01000946.1_i000_001728	45	279	234	1.04464	0.659155
GCA_002865655.1-Fun_KZ613943.1_i000_006728	201	426	225	1.00446	0.431862
GCA_013398335.1-Ani_VZSH01000544.1_i000_010935	115	339	224	1	0.475584
GCA_021365295.1-Fun_JAJTIW010000019.1_i000_004310	192	418	226	1.00893	0.441406
GCA_905332325.1-Ani_CAJOBW010002841.1_i000_013102	5	188	183	0.816964	0.717647
GCA_905331525.1-Ani_CAJNZF010000980.1_i000_028153	12	198	186	0.830357	0.701887
GCA_012184315.1-Fun_LDDX01000033.1_i000_010075	189	413	224	1	0.414048
GCA_905250095.1-Ani_CAJNOR010000129.1_i000_003399	186	411	225	1.00446	0.482833
GCA_000149245.3-Fun_CP003825.1_i000_003480	195	421	226	1.00893	0.396491
GCA_002215765.1-Fun_AMLA01000196.1_i000_001579	195	421	226	1.00893	0.396491
GCA_002215775.1-Fun_AMLG01000072.1_i000_005347	195	421	226	1.00893	0.396491
GCA_002215825.1-Fun_AMLK01000050.1_i000_003548	195	421	226	1.00893	0.396491
GCA_002215885.1-Fun_AMKM01000017.1_i000_002100	195	421	226	1.00893	0.396491
GCA_002216725.1-Fun_CP022326.1_i000_003480	195	421	226	1.00893	0.396491
GCA_002220445.1-Fun_AMLJ01000135.1_i000_001003	195	421	226	1.00893	0.396491
GCA_002221985.1-Fun_APKI01000157.1_i000_001057	195	421	226	1.00893	0.396491
GCA_002222015.1-Fun_APKO01000211.1_i000_001897	195	421	226	1.00893	0.396491
GCA_002222025.1-Fun_APKS01000245.1_i000_001944	195	421	226	1.00893	0.396491
GCA_002222095.1-Fun_APKP01000238.1_i000_002126	195	421	226	1.00893	0.396491
GCA_002222115.1-Fun_APKR01000236.1_i000_001779	195	421	226	1.00893	0.396491
GCA_002222135.1-Fun_APKK01000201.1_i000_001638	195	421	226	1.00893	0.396491
GCA_002222145.1-Fun_APKQ01000192.1_i000_001418	195	421	226	1.00893	0.396491
GCA_002222165.1-Fun_APKT01000191.1_i000_001515	195	421	226	1.00893	0.396491
GCA_002222215.1-Fun_APKH01000154.1_i000_000994	195	421	226	1.00893	0.396491
GCA_002222225.1-Fun_AMLE01000330.1_i000_002802	195	421	226	1.00893	0.396491
GCA_002222245.1-Fun_APKJ01000170.1_i000_001280	195	421	226	1.00893	0.396491
GCA_002222255.1-Fun_AMLH01000225.1_i000_002671	195	421	226	1.00893	0.396491
GCA_002222295.1-Fun_AMLB01000223.1_i000_002544	195	421	226	1.00893	0.396491
GCA_002222315.1-Fun_AMKY01000040.1_i000_002866	195	421	226	1.00893	0.396491
GCA_002222325.1-Fun_AMKT01000049.1_i000_003996	195	421	226	1.00893	0.396491
GCA_002222335.1-Fun_AMKU01000016.1_i000_002278	195	421	226	1.00893	0.396491
GCA_002222375.1-Fun_AMLI01000018.1_i000_001524	195	421	226	1.00893	0.396491
GCA_002222395.1-Fun_AMLD01000203.1_i000_002109	195	421	226	1.00893	0.396491
GCA_002222405.1-Fun_AMLC01000068.1_i000_004934	195	421	226	1.00893	0.396491
GCA_002222455.1-Fun_AMKZ01000193.1_i000_001763	195	421	226	1.00893	0.396491
GCA_002224005.1-Fun_AMLF01000025.1_i000_002159	195	421	226	1.00893	0.396491
GCA_003942205.1-Fun_RSCE01000014.1_i000_002857	196	421	225	1.00446	0.403226
GCA_021904315.1-Pla_CM038907.1_i000_001088	177	396	219	0.977679	0.378893
GCA_000327365.1-Pla_CM001752.1_i000_037167	177	395	218	0.973214	0.386525
GCA_007990325.1-Pla_CM017713.1_i000_077123	177	395	218	0.973214	0.386525
GCA_008761655.1-Pla_CM018227.1_i000_071686	177	395	218	0.973214	0.386525
GCA_007990485.1-Pla_CM017635.1_i000_077232	177	395	218	0.973214	0.385841
GCA_007990455.1-Pla_CM017661.1_i000_073609	177	395	218	0.973214	0.385841
GCA_007990345.1-Pla_CM017687.1_i000_074155	177	395	218	0.973214	0.385841
GCA_001750085.1-Pro_KV784353.1_i000_000251	188	412	224	1	0.431599
GCA_007026445.1-Fun_VDMD01000002.1_i000_006137	185	394	209	0.933036	0.355442
GCA_006013705.1-Pla_RXGB01000505.1_i000_002890	177	395	218	0.973214	0.424125
GCA_013396415.1-Ani_VWPT01000470.1_i000_009874	115	340	225	1.00446	0.484914
GCA_002222465.1-Fun_AMKV01000018.1_i000_001851	195	421	226	1.00893	0.395105
GCA_022453505.1-Fun_JAJLYR010000007.1_i000_010514	191	416	225	1.00446	0.439453
GCA_000203795.1-Fun_GL882890.1_i000_006566	182	400	218	0.973214	0.420849
GCA_000695605.1-Pla_KK785030.1_i000_017192	119	343	224	1	0.455285
GCA_011058905.1-Fun_SWKU01000007.1_i000_010551	192	416	224	1	0.432432
GCA_020726485.1-Fun_JAHEWH010000007.1_i000_016107	193	418	225	1.00446	0.439453
GCA_003614725.1-Fun_ML005319.1_i000_003207	186	410	224	1	0.512586
GCA_011745845.1-Pla_VYZY01001217.1_i000_006207	97	251	154	0.6875	0.4
GCA_011745865.1-Pla_VYZZ01009424.1_i000_030809	97	251	154	0.6875	0.4
GCA_000004825.1-Pro_GL290998.1_i000_009029	181	404	223	0.995536	0.360841
GCA_016984155.1-Ani_JAAWVP010005833.1_i000_008513	122	325	203	0.90625	0.60597
GCA_004153795.2-Pla_SDRB02004289.1_i000_007890	177	396	219	0.977679	0.384211
GCA_013368495.1-Ani_LUCH01006601.1_i000_009254	198	422	224	1	0.382253
GCA_001005745.2-Ani_JARO02001644.1_i000_005520	187	411	224	1	0.397163
GCA_010015785.1-Fun_ML978740.1_i000_007833	192	417	225	1.00446	0.432692
GCA_013396255.1-Fun_JAAOAY010000041.1_i000_001666	604	830	226	1.00893	0.245119
GCA_000488995.1-Fun_AWSO01001070.1_i000_013086	185	410	225	1.00446	0.422932
GCA_903819125.2-Fun_LR813489.2_i000_002058	111	344	233	1.04018	0.47166
GCA_000292625.1-Fun_JH795855.1_i000_000528	178	387	209	0.933036	0.348915
GCA_001949185.1-Ani_BDGG01000001.1_i000_002652	186	410	224	1	0.449799
GCA_005393395.2-Pla_CM016626.1_i000_033565	177	395	218	0.973214	0.385841
GCA_002217545.1-Fun_APKM01000257.1_i000_002074	195	421	226	1.00893	0.393728
GCA_002220035.1-Fun_AMKW01000268.1_i000_002271	195	421	226	1.00893	0.393728
GCA_900323505.1-Fun_OOIN01000012.1_i000_006302	189	412	223	0.995536	0.383162
GCA_009792415.2-Pro_VHLK02000076.1_i000_003579	72	303	231	1.03125	0.552632
GCA_000478725.1-Pla_KI517748.1_i000_022163	188	412	224	1	0.456212
GCA_000149555.1-Fun_CM000584.1_i000_011376	253	479	226	1.00893	0.395797
GCA_000751015.1-Pla_LK033562.1_i000_048885	188	413	225	1.00446	0.445545
GCA_003260695.2-Pla_QGKY02000089.1_i000_002887	188	413	225	1.00446	0.445545
GCA_001661175.1-Pla_LSRQ01001480.1_i000_008472	148	372	224	1	0.436647
GCA_016771965.1-Pla_CM028695.1_i000_041507	188	413	225	1.00446	0.445545
GCA_002215835.1-Fun_AMKP01000017.1_i000_001802	195	421	226	1.00893	0.393728
GCA_021029105.1-Fun_JAEVFJ010000004.1_i000_007440	179	399	220	0.982143	0.390071
GCA_001974825.1-Pla_AWUE01012331.1_i000_003904	100	237	137	0.611607	0.503676
GCA_001974825.1-Pla_AWUE01012331.1_i000_003904	220	272	52	0.232143	0.191176
GCA_002215755.1-Fun_NKHW01000054.1_i000_005152	195	421	226	1.00893	0.393728
GCA_002222475.1-Fun_AMKO01000023.1_i000_002481	195	421	226	1.00893	0.393728
GCA_002234625.1-Fun_AMKQ01000024.1_i000_003217	195	421	226	1.00893	0.393728
GCA_002220045.1-Fun_NKHY01000053.1_i000_005237	195	421	226	1.00893	0.393728
GCA_002873275.1-Fun_PGCJ01000110.1_i000_007786	184	408	224	1	0.319088
GCA_002105095.1-Fun_MCFJ01000003.1_i000_006932	191	417	226	1.00893	0.439689
GCA_903189775.1-Fun_CAEVNN010000066.1_i000_003377	188	409	221	0.986607	0.377133
GCA_000142905.1-Pro_GL349439.1_i000_001757	184	403	219	0.977679	0.421154
GCA_021223765.1-Ani_JAJJHM010012723.1_i000_009275	186	410	224	1	0.452525
GCA_000004515.5-Pla_CM000844.4_i000_028492	177	396	219	0.977679	0.397459
GCA_000722935.2-Pla_KN646098.1_i000_009242	177	396	219	0.977679	0.397459
GCA_004193775.2-Pla_CM014367.1_i000_029644	177	396	219	0.977679	0.397459
GCA_012273815.2-Pla_CM022569.2_i000_030737	177	396	219	0.977679	0.397459
GCA_014282095.1-Pla_CM024923.1_i000_031343	177	396	219	0.977679	0.397459
GCA_014282145.1-Pla_CM024943.1_i000_030802	177	396	219	0.977679	0.397459
GCA_020569505.1-Fun_JAIREE010000031.1_i000_013676	192	416	224	1	0.432432
GCA_020569515.1-Fun_JAIRGJ010000017.1_i000_009668	192	416	224	1	0.432432
GCA_003711585.2-Ani_CM011652.2_i000_002496	185	410	225	1.00446	0.398936
GCA_002215855.1-Fun_AMKX01000237.1_i000_001697	195	421	226	1.00893	0.391003
GCA_900323505.1-Fun_OOIN01000011.1_i000_005949	189	412	223	0.995536	0.383162
GCA_000975585.2-Fun_CP005196.2_i000_001986	111	345	234	1.04464	0.473684
GCA_022343315.1-Fun_JACTNS010000046.1_i000_010273	221	445	224	1	0.409506
GCA_001023045.1-Fun_JRVF01000498.1_i000_008328	193	419	226	1.00893	0.44227
GCA_900096645.1-Fun_FMJU01000013.1_i000_002818	193	419	226	1.00893	0.44227
GCA_900096685.1-Fun_FMSM01000015.1_i000_011173	193	419	226	1.00893	0.44227
GCA_916381525.1-Ani_CAKAEH010002025.1_i000_010127	189	412	223	0.995536	0.377327
GCA_013399495.1-Ani_VXAM01001555.1_i000_012983	115	340	225	1.00446	0.478723
GCA_010093685.1-Fun_MU006224.1_i000_006665	192	416	224	1	0.429942
GCA_900096605.1-Fun_FMJS01000015.1_i000_008173	193	419	226	1.00893	0.44227
GCA_900096625.1-Fun_FMJX01000016.1_i000_012617	193	419	226	1.00893	0.44227
GCA_900096705.1-Fun_FMJT01000015.1_i000_005513	193	419	226	1.00893	0.44227
GCA_000832345.2-Fun_LN679103.1_i000_000379	180	403	223	0.995536	0.391916
GCA_001890905.1-Fun_KV878978.1_i000_006050	190	416	226	1.00893	0.434615
GCA_015956445.1-Fun_WIUZ02000019.1_i000_005176	185	411	226	1.00893	0.397887
GCA_001443705.1-Ani_LJIG01022687.1_i000_007695	36	261	225	1.00446	0.66568
GCA_014773175.1-Ani_VXCM01000848.1_i000_006789	185	410	225	1.00446	0.387931
GCA_900044065.1-Fun_FCQH01000016.1_i000_015530	193	419	226	1.00893	0.44227
GCA_900096505.1-Fun_FMSL01000015.1_i000_002309	193	419	226	1.00893	0.44227
GCA_001023035.1-Fun_JRVG01000060.1_i000_010107	193	419	226	1.00893	0.44227
GCA_001023065.1-Fun_JRVH01002322.1_i000_007739	193	419	226	1.00893	0.44227
GCA_003615215.1-Fun_MRDB01000055.1_i000_011644	193	419	226	1.00893	0.44227
GCA_017309875.1-Fun_PKMG01000089.1_i000_009288	193	419	226	1.00893	0.44227
GCA_900029915.1-Fun_FCQG01000012.1_i000_011251	193	419	226	1.00893	0.44227
GCA_900067095.1-Fun_FJOF01000005.1_i000_008270	193	419	226	1.00893	0.44227
GCA_900079805.1-Fun_HF679029.1_i000_010299	193	419	226	1.00893	0.44227
GCA_900096615.1-Fun_FMJV01000016.1_i000_004262	193	419	226	1.00893	0.44227
GCA_900096635.1-Fun_FMJW01000007.1_i000_004946	193	419	226	1.00893	0.44227
GCA_000697645.1-Fun_KL142383.1_i000_011877	182	405	223	0.995536	0.386482
GCA_003184695.1-Fun_KZ825360.1_i000_007921	190	416	226	1.00893	0.434615
GCA_003184765.1-Fun_KZ824978.1_i000_008776	190	416	226	1.00893	0.434615
GCA_003184825.1-Fun_KZ824636.1_i000_004220	190	416	226	1.00893	0.434615
GCA_020497155.1-Pla_CM035717.1_i000_031004	185	404	219	0.977679	0.391771
GCA_013467465.1-Pla_CM025166.1_i000_023866	137	355	218	0.973214	0.439516
GCA_001186125.1-Pro_KQ242554.1_i000_009410	1	93	92	0.410714	0.884615
GCA_015178975.1-Fun_WHVD01000003.1_i000_008066	180	394	214	0.955357	0.373473
GCA_000315625.1-Pro_JH993025.1_i000_014343	189	414	225	1.00446	0.465839
GCA_021223865.1-Ani_JAJJHT010014123.1_i000_007475	186	410	224	1	0.452525
GCA_000005115.1-Ani_CH902617.1_i000_013312	186	410	224	1	0.452525
GCA_014904845.1-Fun_MU119272.1_i000_010374	192	417	225	1.00446	0.436893
GCA_000695605.1-Pla_KK785393.1_i000_022384	67	286	219	0.977679	0.496599
GCA_001865875.1-Pla_CM007367.1_i000_010798	177	395	218	0.973214	0.392086
GCA_001040885.1-Ani_LN609529.1_i000_006913	176	397	221	0.986607	0.480435
GCA_004119915.2-Ani_CM014082.1_i000_004968	185	410	225	1.00446	0.394046
GCA_900537255.1-Ani_UPTC01002875.1_i000_008523	189	412	223	0.995536	0.386482
GCA_001661325.1-Fun_KV454301.1_i000_006681	191	416	225	1.00446	0.510204
GCA_000688135.1-Ani_JARK01000186.1_i000_003061	188	414	226	1.00893	0.444008
GCA_001692735.1-Fun_KV745422.1_i000_011741	189	414	225	1.00446	0.40395
GCA_015852605.2-Pla_CM027574.2_i000_009828	739	957	218	0.973214	0.19395
GCA_021525025.1-Fun_JAKELI010000098.1_i000_015864	185	410	225	1.00446	0.420561
GCA_000708835.1-Pla_DF236966.1_i000_014890	188	413	225	1.00446	0.423729
GCA_015039355.1-Fun_MU134386.1_i000_008834	180	401	221	0.986607	0.385017
GCA_905330665.1-Ani_HG994582.1_i000_002696	167	392	225	1.00446	0.460123
GCA_000149385.1-Fun_CM000044.1_i000_003055	195	421	226	1.00893	0.386986
GCA_001970955.1-Pro_MPUH01001899.1_i000_010000	81	296	215	0.959821	0.495392
GCA_000523435.1-Fun_KI964537.1_i000_000064	192	416	224	1	0.432432
GCA_016618385.1-Ani_JABFOP010000764.1_i000_014149	199	424	225	1.00446	0.397527
GCA_015178925.1-Fun_WHVC01000046.1_i000_009380	185	410	225	1.00446	0.415129
GCA_010261695.1-Pla_CM020996.1_i000_000207	177	395	218	0.973214	0.389982
GCA_002215745.1-Fun_NKHX01000049.1_i000_004700	233	459	226	1.00893	0.369281
GCA_020379485.1-Pla_CM035458.1_i000_053706	213	438	225	1.00446	0.415896
GCA_011503125.2-Fun_WWBZ02000022.1_i000_006471	192	417	225	1.00446	0.431034
GCA_009771035.1-Pla_CM019999.1_i000_000227	177	395	218	0.973214	0.3879
GCA_003184745.1-Fun_KZ821753.1_i000_010632	190	416	226	1.00893	0.524362
GCA_000827475.1-Fun_KN819330.1_i000_004353	185	411	226	1.00893	0.413163
GCA_000402015.1-Ani_KE124808.1_i000_002266	188	414	226	1.00893	0.44227
GCA_013396205.1-Fun_JAAOAN010000475.1_i000_011870	604	830	226	1.00893	0.245119
GCA_900073065.1-Fun_FJOG01000026.1_i000_003705	192	417	225	1.00446	0.437743
GCA_000189635.1-Pro_GG662547.1_i000_018264	188	410	222	0.991071	0.435294
GCA_018127085.1-Fun_CM030720.1_i000_000021	186	411	225	1.00446	0.422139
GCA_002897195.1-Pla_BDQV01000067.1_i000_013123	188	412	224	1	0.405063
GCA_003336725.1-Ani_JOJR01000009.1_i000_001750	188	414	226	1.00893	0.443137
GCA_013364935.1-Fun_JABEVY010000219.1_i000_008860	604	830	226	1.00893	0.245119
GCA_013396075.1-Fun_JAAOAV010000003.1_i000_000782	604	830	226	1.00893	0.245119
GCA_013758895.1-Fun_JAAOAI010000107.1_i000_002477	604	830	226	1.00893	0.245119
GCA_013396015.1-Fun_JAAOAM010000442.1_i000_013149	604	830	226	1.00893	0.245119
GCA_001466705.1-Fun_LATX01001400.1_i000_005433	166	371	205	0.915179	0.377532
GCA_000149845.2-Fun_KE651166.1_i000_000248	186	412	226	1.00893	0.456566
GCA_015849285.1-Fun_JAAAHZ010000511.1_i000_007447	186	394	208	0.928571	0.527919
GCA_018857265.1-Fun_JABAJZ010000029.1_i000_000683	97	317	220	0.982143	0.453608
GCA_001633215.2-Pla_KV775879.1_i000_010044	170	388	218	0.973214	0.392793
GCA_001661175.1-Pla_LSRQ01004843.1_i000_017538	188	412	224	1	0.405063
GCA_016618355.2-Fun_JADGIP010001448.1_i000_008697	183	406	223	0.995536	0.387153
GCA_003018175.1-Ani_PYGN01001265.1_i000_021671	182	399	217	0.96875	0.376083
GCA_000733195.1-Pla_CM002871.1_i000_005311	173	398	225	1.00446	0.460123
GCA_000346465.2-Pla_CM007656.1_i000_021071	177	396	219	0.977679	0.406308
GCA_000262585.1-Ani_JH668484.1_i000_007849	57	275	218	0.973214	0.488789
GCA_902201215.1-Pla_LR694011.1_i000_020438	177	396	219	0.977679	0.406308
GCA_020747015.1-Fun_JAGTJM010000096.1_i000_014245	192	416	224	1	0.429119
GCA_020424065.1-Pla_CM035465.1_i000_000456	177	396	219	0.977679	0.406308
GCA_903112645.1-Pla_CAEKDK010000006.1_i000_023826	177	396	219	0.977679	0.406308
GCA_903114435.1-Pla_CAEKKB010000006.1_i000_024063	177	396	219	0.977679	0.406308
GCA_000091045.1-Fun_AE017345.1_i000_003118	195	421	226	1.00893	0.386986
GCA_001876935.1-Pla_CM007385.1_i000_011558	188	412	224	1	0.401434
GCA_022201065.1-Pla_CM039172.1_i000_006791	188	412	224	1	0.399287
GCA_021613535.1-Ani_CP075495.1_i000_009024	186	411	225	1.00446	0.469729
GCA_015179035.1-Fun_WHUY01000017.1_i000_002379	190	414	224	1	0.419476
GCA_000934395.1-Fun_KN882061.1_i000_008828	183	396	213	0.950893	0.409615
GCA_002897195.1-Pla_BDQV01000151.1_i000_017638	177	396	219	0.977679	0.398182
GCA_003788615.2-Fun_ML121559.1_i000_008487	190	414	224	1	0.424242
GCA_019112545.1-Fun_MU250536.1_i000_007602	142	368	226	1.00893	0.464066
GCA_019297735.1-Ani_CM033239.1_i000_007835	180	398	218	0.973214	0.405959
GCA_013396035.1-Fun_JAAOAS010000020.1_i000_001016	610	836	226	1.00893	0.243534
GCA_000292625.1-Fun_JH795860.1_i000_003712	188	412	224	1	0.411009
GCA_012274485.2-Pla_MU106767.1_i000_039496	188	412	224	1	0.427481
GCA_015039405.1-Fun_WJDU01000007.1_i000_014622	178	390	212	0.946429	0.392593
GCA_904066235.2-Ani_CAJFCV020000005.1_i000_011705	188	412	224	1	0.452525
GCA_904067135.1-Ani_CAJFDI010000005.1_i000_011705	188	412	224	1	0.452525
GCA_013400935.1-Ani_VZTY01017724.1_i000_006400	115	340	225	1.00446	0.46875
GCA_000493195.1-Pla_KI536661.1_i000_006452	188	412	224	1	0.398577
GCA_010093925.1-Fun_ML994749.1_i000_020892	192	416	224	1	0.417132
GCA_010076225.1-Ani_VUKV01005381.1_i000_006161	115	340	225	1.00446	0.480769
GCA_010076325.1-Ani_VUKW01001545.1_i000_002094	115	340	225	1.00446	0.480769
GCA_010082375.1-Ani_VULI01002180.1_i000_001704	115	340	225	1.00446	0.480769
GCA_012932015.1-Fun_JAADJF010000031.1_i000_001398	193	419	226	1.00893	0.44227
GCA_015039395.1-Fun_MU132144.1_i000_003015	180	403	223	0.995536	0.392606
GCA_000488995.1-Fun_AWSO01000361.1_i000_007277	181	386	205	0.915179	0.367384
GCA_903994135.1-Ani_CAJEWN010000048.1_i000_009965	238	456	218	0.973214	0.364548
GCA_014905175.1-Ani_CM026523.1_i000_006144	160	378	218	0.973214	0.399267
GCA_000478725.1-Pla_KI517809.1_i000_022847	188	412	224	1	0.425856
GCA_010080425.1-Ani_VULF01007608.1_i000_006901	115	340	225	1.00446	0.479744
GCA_010085355.1-Ani_VULL01001874.1_i000_012311	115	340	225	1.00446	0.479744
GCA_001460835.1-Pro_CYKH01001149.1_i000_008397	102	326	224	1	0.629213
GCA_018859375.1-Ani_JAHGAV010000159.1_i000_011284	184	409	225	1.00446	0.423729
GCA_000005245.1-Ani_CH940650.1_i000_010142	186	410	224	1	0.449799
GCA_905250015.1-Ani_CAJNOM010000335.1_i000_034856	186	411	225	1.00446	0.484914
GCA_905250115.1-Ani_CAJNOI010000054.1_i000_013428	186	411	225	1.00446	0.484914
GCA_021223845.1-Ani_JAJJHU010011684.1_i000_010237	186	410	224	1	0.452525
GCA_000147175.1-Ani_GL445031.1_i000_014780	178	391	213	0.950893	0.315556
GCA_905252715.1-Ani_CAJNOU010001209.1_i000_019350	63	267	204	0.910714	0.755556
GCA_000260735.1-Fun_DG000043.1_i000_002112	111	345	234	1.04464	0.473684
GCA_000975675.2-Fun_CP005228.2_i000_001960	111	345	234	1.04464	0.473684
GCA_000976005.2-Fun_CP005205.2_i000_001992	111	345	234	1.04464	0.473684
GCA_000976065.2-Fun_CP005207.2_i000_002002	111	345	234	1.04464	0.473684
GCA_000976755.2-Fun_CP005232.2_i000_001990	111	345	234	1.04464	0.473684
GCA_000976785.2-Fun_CP005233.2_i000_001960	111	345	234	1.04464	0.473684
GCA_000976815.3-Fun_CP005234.1_i000_001967	111	345	234	1.04464	0.473684
GCA_000976995.2-Fun_CP005240.2_i000_002002	111	345	234	1.04464	0.473684
GCA_000977115.3-Fun_CP005244.1_i000_001982	111	345	234	1.04464	0.473684
GCA_000977505.2-Fun_CP005257.2_i000_001975	111	345	234	1.04464	0.473684
GCA_000977535.2-Fun_CP005258.2_i000_001956	111	345	234	1.04464	0.473684
GCA_000977595.2-Fun_CP005260.2_i000_001970	111	345	234	1.04464	0.473684
GCA_000977625.2-Fun_CP005261.2_i000_001973	111	345	234	1.04464	0.473684
GCA_000977655.2-Fun_CP005262.2_i000_001991	111	345	234	1.04464	0.473684
GCA_000977775.3-Fun_CP005266.2_i000_001974	111	345	234	1.04464	0.473684
GCA_000977835.2-Fun_CP005268.2_i000_002004	111	345	234	1.04464	0.473684
GCA_000977895.2-Fun_CP005270.2_i000_001962	111	345	234	1.04464	0.473684
GCA_000977925.2-Fun_CP005271.2_i000_001922	111	345	234	1.04464	0.473684
GCA_000978015.2-Fun_CP005274.1_i000_001980	111	345	234	1.04464	0.473684
GCA_000978135.2-Fun_CP005278.2_i000_001969	111	345	234	1.04464	0.473684
GCA_000978255.2-Fun_CP005282.2_i000_001987	111	345	234	1.04464	0.473684
GCA_000978315.2-Fun_CP005284.1_i000_001963	111	345	234	1.04464	0.473684
GCA_000978345.2-Fun_CP005285.2_i000_001941	111	345	234	1.04464	0.473684
GCA_002335645.1-Fun_BEGW01000003.1_i000_002115	111	345	234	1.04464	0.473684
GCA_014132375.1-Fun_BLZP01000003.1_i000_001465	111	345	234	1.04464	0.473684
GCA_014905575.1-Fun_BNHH01000140.1_i000_004743	111	345	234	1.04464	0.473684
GCA_014132395.1-Fun_BLZQ01000002.1_i000_000917	111	345	234	1.04464	0.473684
GCA_001890725.1-Fun_KV878210.1_i000_003049	190	416	226	1.00893	0.435453
GCA_002906115.4-Pla_PKMF03008894.1_i000_030126	188	412	224	1	0.412523
GCA_013400975.1-Ani_WBMZ01003497.1_i000_002907	115	340	225	1.00446	0.470711
GCA_006461475.1-Ani_SUNJ01000903.1_i000_000701	187	410	223	0.995536	0.381849
GCA_001008285.1-Fun_LCZI01001656.1_i000_009102	190	416	226	1.00893	0.444008
GCA_000005175.1-Ani_CH933806.1_i000_012621	186	410	224	1	0.448898
GCA_004786265.1-Fun_PQXO01000142.1_i000_003810	193	418	225	1.00446	0.438596
GCA_004379255.2-Pla_CM031477.1_i000_017060	188	412	224	1	0.502242
GCA_000208925.2-Pro_DS571281.1_i000_002940	179	403	224	1	0.494481
GCA_000338855.1-Pro_KB445484.1_i000_007257	179	403	224	1	0.494481
GCA_000344925.1-Pro_KB610852.1_i000_003512	179	403	224	1	0.494481
GCA_000346345.1-Pro_KB637333.1_i000_001223	179	403	224	1	0.494481
GCA_000365475.1-Pro_KB823713.1_i000_002525	179	403	224	1	0.494481
GCA_001662325.1-Pro_BDEQ01000001.1_i000_005364	179	403	224	1	0.494481
GCA_002156985.1-Ani_KZ149934.1_i000_010169	180	398	218	0.973214	0.405204
GCA_002572855.1-Fun_PDND01000012.1_i000_000944	190	416	226	1.00893	0.444008
GCA_015680905.1-Pla_CM027382.1_i000_025117	189	413	224	1	0.385542
GCA_015832365.1-Ani_JACWZX010000172.1_i000_002516	180	398	218	0.973214	0.405959
GCA_014904945.1-Fun_MU127426.1_i000_005251	183	406	223	0.995536	0.390543
GCA_000149985.1-Fun_DS231620.1_i000_005423	192	416	224	1	0.432432
GCA_003171515.3-Fun_CM025804.1_i000_014511	192	416	224	1	0.432432
GCA_003171545.1-Fun_NQWZ01000008.1_i000_000586	192	416	224	1	0.432432
GCA_003231325.2-Fun_CM034232.1_i000_013650	192	416	224	1	0.432432
GCA_003231345.1-Fun_MVBI01000012.1_i000_001044	192	416	224	1	0.432432
GCA_003231355.1-Fun_MVBG01000021.1_i000_001718	192	416	224	1	0.432432
GCA_003231365.1-Fun_MVBH01000017.1_i000_001249	192	416	224	1	0.432432
GCA_003231415.2-Fun_CM025823.1_i000_012499	192	416	224	1	0.432432
GCA_003231425.1-Fun_NRDI01000003.1_i000_000212	192	416	224	1	0.432432
GCA_008692205.1-Fun_SAXQ01000010.1_i000_012297	192	416	224	1	0.432432
GCA_902728155.2-Pla_CACVBM020001240.1_i000_028375	177	395	218	0.973214	0.391382
GCA_019721115.1-Ani_CM033908.1_i000_018348	217	442	225	1.00446	0.381356
GCA_013401445.1-Pla_CM023879.1_i000_013885	177	396	219	0.977679	0.383538
GCA_000787975.1-Pla_JRRC01118436.1_i000_008017	177	395	218	0.973214	0.3879
GCA_000787975.1-Pla_JRRC01118436.1_i000_008018	177	395	218	0.973214	0.3879
GCA_001298625.1-Fun_CM003588.1_i000_001946	111	344	233	1.04018	0.47166
GCA_011022315.1-Fun_CP049004.1_i000_007539	111	344	233	1.04018	0.47166
GCA_008761655.1-Pla_CM018214.1_i000_068988	177	395	218	0.973214	0.3879
GCA_007990325.1-Pla_CM017700.1_i000_074273	177	395	218	0.973214	0.389286
GCA_001643675.2-Pro_LSRY02000014.1_i000_002410	184	409	225	1.00446	0.426136
GCA_009363875.1-Pla_CM018685.1_i000_033063	177	395	218	0.973214	0.417625
GCA_013368295.1-Fun_JAACJJ010000028.1_i000_001232	178	400	222	0.991071	0.238967
GCA_000150505.2-Fun_KE503206.1_i000_001200	180	400	220	0.982143	0.433925
GCA_007990345.1-Pla_CM017674.1_i000_035417	177	395	218	0.973214	0.3879
GCA_010093585.1-Fun_MU001788.1_i000_002974	192	416	224	1	0.429119
GCA_002174775.1-Pla_MVGT01000779.1_i000_002974	188	412	224	1	0.408015
GCA_007990455.1-Pla_CM017648.1_i000_070831	177	395	218	0.973214	0.387211
GCA_015025155.1-Fun_WITN01000029.1_i000_008469	158	366	208	0.928571	0.39619
GCA_000003515.2-Fun_CH476618.1_i000_006666	190	416	226	1.00893	0.44227
GCA_007990485.1-Pla_CM017622.1_i000_074346	177	395	218	0.973214	0.387211
GCA_003182015.1-Fun_PYWC01000062.1_i000_007090	198	424	226	1.00893	0.416206
GCA_903994135.1-Ani_CAJEWN010000477.1_i000_033853	146	364	218	0.973214	0.434263
GCA_000344685.1-Fun_KB469303.1_i000_006758	185	411	226	1.00893	0.420857
GCA_000385595.1-Fun_KB916521.1_i000_007267	188	413	225	1.00446	0.433526
GCA_003604175.2-Ani_CM030369.1_i000_005363	180	400	220	0.982143	0.49217
GCA_010015735.1-Fun_ML978074.1_i000_011175	191	415	224	1	0.444444
GCA_022160305.1-Fun_MU277225.1_i000_009772	185	410	225	1.00446	0.40395
GCA_902806795.1-Ani_CADCXV010000446.1_i000_002262	183	407	224	1	0.498886
GCA_000150055.1-Fun_DS268109.1_i000_007920	190	416	226	1.00893	0.426415
GCA_000151335.1-Fun_ACFW01000049.1_i000_000392	190	416	226	1.00893	0.426415
GCA_000170175.2-Fun_GL636496.1_i000_006642	190	416	226	1.00893	0.431298
GCA_018416015.1-Fun_CP075068.1_i000_001297	190	416	226	1.00893	0.431298
GCA_021442195.1-Pla_CM038197.1_i000_006480	188	412	224	1	0.377104
GCA_012274485.2-Pla_MU108389.1_i000_046498	188	412	224	1	0.432432
GCA_015844325.1-Fun_VCAU01000136.1_i000_002332	190	416	226	1.00893	0.444008
GCA_905337345.1-Fun_CAJPDS010000025.1_i000_004393	191	417	226	1.00893	0.437137
GCA_000003195.3-Pla_CM000762.3_i000_014436	177	396	219	0.977679	0.385563
GCA_002914805.1-Pla_JXTB01000014.1_i000_002969	188	413	225	1.00446	0.412088
GCA_902728155.2-Pla_CACVBM020000222.1_i000_003492	188	412	224	1	0.445328
GCA_001477535.1-Fun_LFWA01000015.1_i000_001303	184	403	219	0.977679	0.426901
GCA_022376435.1-Fun_JABYQE010000010.1_i000_000454	180	400	220	0.982143	0.377358
GCA_015952705.1-Pla_CM027682.1_i000_014741	177	396	219	0.977679	0.384211
GCA_000977955.2-Fun_CP005272.2_i000_001897	111	345	234	1.04464	0.473684
GCA_018107945.1-Pla_JACEIK010000032.1_i000_001520	177	395	218	0.973214	0.394928
GCA_001278385.1-Fun_LGAV01000003.1_i000_002040	192	410	218	0.973214	0.40824
GCA_900074735.1-Fun_LT598476.1_i000_004468	96	321	225	1.00446	0.518433
GCA_902729315.2-Pla_LR746274.1_i000_015220	188	412	224	1	0.408015
GCA_019202805.1-Pla_CM032902.1_i000_011915	188	412	224	1	0.448898
GCA_010085335.1-Ani_VULH01025065.1_i000_007708	115	340	225	1.00446	0.479744
GCA_000977265.3-Fun_CP005249.1_i000_001982	111	345	234	1.04464	0.473684
GCA_000182315.2-Fun_ACFL01000396.1_i000_000606	111	345	234	1.04464	0.473684
GCA_000977445.2-Fun_CP005255.2_i000_001980	111	345	234	1.04464	0.473684
GCA_000977565.2-Fun_CP005259.1_i000_001941	111	345	234	1.04464	0.473684
GCA_905220325.1-Fun_HG994146.1_i000_002085	111	345	234	1.04464	0.473684
GCA_011022315.1-Fun_CP048988.1_i000_002005	111	345	234	1.04464	0.473684
GCA_000976335.2-Fun_CP005216.2_i000_001989	111	345	234	1.04464	0.473684
GCA_000977025.2-Fun_CP005241.1_i000_001976	111	345	234	1.04464	0.473684
GCA_000975975.3-Fun_CP005204.2_i000_001981	111	345	234	1.04464	0.473684
GCA_000977295.2-Fun_CP005250.2_i000_001969	111	345	234	1.04464	0.473684
GCA_000002715.1-Fun_DS027056.1_i000_003277	190	416	226	1.00893	0.438835
GCA_022201045.1-Pla_CM039163.1_i000_006190	188	412	224	1	0.364228
GCA_905250015.1-Ani_CAJNOM010000291.1_i000_032503	186	411	225	1.00446	0.484914
GCA_000187875.1-Ani_GL732609.1_i000_018958	189	414	225	1.00446	0.398936
GCA_003184845.1-Fun_KZ824444.1_i000_006700	190	416	226	1.00893	0.427221
GCA_002271895.2-Pla_CM008442.1_i000_030440	177	394	217	0.96875	0.390991
GCA_003573695.1-Pla_CM010722.1_i000_031309	188	412	224	1	0.419476
GCA_001531365.1-Pla_CM009735.1_i000_007460	231	456	225	1.00446	0.383305
GCA_022496205.1-Fun_WTXD01000052.1_i000_009683	180	401	221	0.986607	0.389085
GCA_001277935.1-Ani_CP012526.1_i000_009657	186	410	224	1	0.448
GCA_900622495.1-Ani_UYWX01020434.1_i000_007999	1661	1885	224	1	0.110182
GCA_000769215.1-Fun_JPYM01000010.1_i000_001628	193	418	225	1.00446	0.438596
GCA_018282135.1-Fun_JAGPUO010000012.1_i000_001978	193	418	225	1.00446	0.438596
GCA_020744115.1-Fun_JAGMVH010000001.1_i000_002104	193	418	225	1.00446	0.438596
GCA_000190195.1-Fun_CM001084.1_i000_001321	111	345	234	1.04464	0.473684
GCA_010093945.1-Fun_ML993996.1_i000_005137	192	417	225	1.00446	0.427757
GCA_014282345.1-Pla_CM024978.1_i000_030613	338	557	219	0.977679	0.307584
GCA_003589665.1-Fun_MVGC01000364.1_i000_007819	169	395	226	1.00893	0.44227
GCA_004918325.1-Fun_SPNW01000022.1_i000_001348	178	400	222	0.991071	0.418079
GCA_002738505.1-Pla_KZ305020.1_i000_003254	177	395	218	0.973214	0.377816
GCA_001632375.1-Fun_KV425893.1_i000_003008	186	410	224	1	0.440079
GCA_017365405.1-Fun_JAFJYH010000066.1_i000_005444	193	418	225	1.00446	0.439453
GCA_014282035.1-Pla_CM024843.1_i000_019340	326	545	219	0.977679	0.312857
GCA_021224005.1-Ani_JAJJHY010008598.1_i000_008514	186	410	224	1	0.453441
GCA_003032435.1-Pla_KZ772700.1_i000_006280	177	396	219	0.977679	0.408582
GCA_009936355.2-Pla_AP019867.1_i000_002957	177	396	219	0.977679	0.408582
GCA_000985935.1-Fun_CVMT01000002.1_i000_002663	190	416	226	1.00893	0.444882
GCA_000976965.3-Fun_CP005239.1_i000_001947	111	345	234	1.04464	0.473684
GCA_002914845.1-Pla_JXTC01000273.1_i000_025308	188	412	224	1	0.410256
GCA_006981975.1-Fun_SPUL01000012.1_i000_007475	192	418	226	1.00893	0.447525
GCA_006981985.1-Fun_SPUK01000013.1_i000_008240	192	418	226	1.00893	0.447525
GCA_009733165.1-Ani_CM019151.1_i000_010764	184	409	225	1.00446	0.452716
GCA_014904975.1-Fun_MU127787.1_i000_001541	181	391	210	0.9375	0.375671
GCA_014080715.1-Pla_JACERP010000028.1_i000_009148	187	411	224	1	0.450704
GCA_019669835.1-Fun_MU251683.1_i000_009466	193	418	225	1.00446	0.433526
GCA_905220315.1-Fun_LR999878.1_i000_002090	111	345	234	1.04464	0.473684
GCA_020921065.1-Pla_CM037159.1_i000_024284	270	488	218	0.973214	0.334869
GCA_022160335.1-Fun_MU274903.1_i000_002557	183	399	216	0.964286	0.384342
GCA_000146045.2-Fun_BK006941.2_i000_002201	111	345	234	1.04464	0.473684
GCA_000149365.1-Fun_CH408044.1_i000_004116	111	345	234	1.04464	0.473684
GCA_000181435.1-Fun_AAFW02000102.1_i000_001930	111	345	234	1.04464	0.473684
GCA_000218975.1-Fun_FN393070.1_i000_002215	111	345	234	1.04464	0.473684
GCA_000269885.1-Fun_CM001528.1_i000_001994	111	345	234	1.04464	0.473684
GCA_000568005.1-Fun_CM002410.1_i000_001909	111	345	234	1.04464	0.473684
GCA_000568055.1-Fun_CM002428.1_i000_001764	111	345	234	1.04464	0.473684
GCA_000568295.1-Fun_CM002338.1_i000_001348	111	345	234	1.04464	0.473684
GCA_000568365.1-Fun_CM002444.1_i000_001872	111	345	234	1.04464	0.473684
GCA_000662435.2-Fun_CP005226.2_i000_001997	111	345	234	1.04464	0.473684
GCA_000975615.2-Fun_CP005197.2_i000_001953	111	345	234	1.04464	0.473684
GCA_000975645.3-Fun_CP004105.2_i000_001957	111	345	234	1.04464	0.473684
GCA_000975705.2-Fun_CP005229.1_i000_001990	111	345	234	1.04464	0.473684
GCA_000975735.4-Fun_CP005194.2_i000_001984	111	345	234	1.04464	0.473684
GCA_000975795.2-Fun_CP005198.2_i000_001952	111	345	234	1.04464	0.473684
GCA_000975885.2-Fun_CP005201.2_i000_001937	111	345	234	1.04464	0.473684
GCA_000975915.2-Fun_CP005202.2_i000_001944	111	345	234	1.04464	0.473684
GCA_000975945.2-Fun_CP005203.2_i000_001962	111	345	234	1.04464	0.473684
GCA_000976035.2-Fun_CP005206.2_i000_001922	111	345	234	1.04464	0.473684
GCA_000976125.2-Fun_CP005209.1_i000_001977	111	345	234	1.04464	0.473684
GCA_000976155.4-Fun_CP005210.2_i000_001972	111	345	234	1.04464	0.473684
GCA_000976185.2-Fun_CP005211.2_i000_002002	111	345	234	1.04464	0.473684
GCA_000976245.2-Fun_CP005213.2_i000_001959	111	345	234	1.04464	0.473684
GCA_000976275.4-Fun_CP005214.2_i000_001964	111	345	234	1.04464	0.473684
GCA_000976305.2-Fun_CP005215.2_i000_001992	111	345	234	1.04464	0.473684
GCA_000976365.2-Fun_CP005217.2_i000_001993	111	345	234	1.04464	0.473684
GCA_000976395.2-Fun_CP005218.2_i000_001985	111	345	234	1.04464	0.473684
GCA_000976425.2-Fun_CP005219.1_i000_001992	111	345	234	1.04464	0.473684
GCA_000976455.3-Fun_CP005220.2_i000_001995	111	345	234	1.04464	0.473684
GCA_000976485.2-Fun_CP005221.2_i000_001956	111	345	234	1.04464	0.473684
GCA_000976515.2-Fun_CP005222.2_i000_001982	111	345	234	1.04464	0.473684
GCA_000976545.2-Fun_CP005223.2_i000_001989	111	345	234	1.04464	0.473684
GCA_000976575.4-Fun_CP005224.2_i000_001995	111	345	234	1.04464	0.473684
GCA_000976605.3-Fun_CP005225.2_i000_001893	111	345	234	1.04464	0.473684
GCA_000976665.2-Fun_CP005227.2_i000_001987	111	345	234	1.04464	0.473684
GCA_000976695.3-Fun_CP005230.2_i000_001866	111	345	234	1.04464	0.473684
GCA_000976725.3-Fun_CP005231.2_i000_001978	111	345	234	1.04464	0.473684
GCA_000976845.3-Fun_CP005235.2_i000_001936	111	345	234	1.04464	0.473684
GCA_000976875.3-Fun_CP005236.2_i000_001943	111	345	234	1.04464	0.473684
GCA_000976935.2-Fun_CP005238.2_i000_001984	111	345	234	1.04464	0.473684
GCA_000977085.2-Fun_CP005243.2_i000_001992	111	345	234	1.04464	0.473684
GCA_000977145.2-Fun_CP005245.2_i000_001991	111	345	234	1.04464	0.473684
GCA_000977175.3-Fun_CP005246.2_i000_001949	111	345	234	1.04464	0.473684
GCA_000977205.2-Fun_CP005247.2_i000_001979	111	345	234	1.04464	0.473684
GCA_000977235.2-Fun_CP005248.2_i000_001990	111	345	234	1.04464	0.473684
GCA_000977325.2-Fun_CP005251.2_i000_001984	111	345	234	1.04464	0.473684
GCA_000977355.3-Fun_CP005252.2_i000_001990	111	345	234	1.04464	0.473684
GCA_000977385.2-Fun_CP005253.2_i000_001976	111	345	234	1.04464	0.473684
GCA_000977415.2-Fun_CP005254.1_i000_001981	111	345	234	1.04464	0.473684
GCA_000977475.3-Fun_CP005256.2_i000_001983	111	345	234	1.04464	0.473684
GCA_000977685.2-Fun_CP005263.2_i000_001992	111	345	234	1.04464	0.473684
GCA_000977715.4-Fun_CP005264.1_i000_001982	111	345	234	1.04464	0.473684
GCA_000977805.2-Fun_CP005267.2_i000_001949	111	345	234	1.04464	0.473684
GCA_000977985.2-Fun_CP005273.2_i000_001921	111	345	234	1.04464	0.473684
GCA_000978045.2-Fun_CP005275.2_i000_001929	111	345	234	1.04464	0.473684
GCA_000978075.3-Fun_CP005276.2_i000_001973	111	345	234	1.04464	0.473684
GCA_000978165.2-Fun_CP005279.1_i000_001991	111	345	234	1.04464	0.473684
GCA_000978195.2-Fun_CP005280.2_i000_001991	111	345	234	1.04464	0.473684
GCA_001298375.2-Fun_CM003543.1_i000_001837	111	345	234	1.04464	0.473684
GCA_001413975.1-Fun_CM003562.1_i000_002052	111	345	234	1.04464	0.473684
GCA_002571405.2-Fun_CP046087.1_i000_002154	111	345	234	1.04464	0.473684
GCA_002804325.1-Fun_PEJR01000135.1_i000_000792	111	345	234	1.04464	0.473684
GCA_003046695.1-Fun_PTEP01000009.1_i000_005211	111	345	234	1.04464	0.473684
GCA_003046745.1-Fun_PTER01000009.1_i000_005275	111	345	234	1.04464	0.473684
GCA_010356925.1-Fun_CM021133.1_i000_002137	111	345	234	1.04464	0.473684
GCA_010356935.1-Fun_CM021117.1_i000_002118	111	345	234	1.04464	0.473684
GCA_016858165.1-Fun_CM029095.1_i000_002150	111	345	234	1.04464	0.473684
GCA_016858175.1-Fun_CM029079.1_i000_002122	111	345	234	1.04464	0.473684
GCA_000975765.2-Fun_CP005195.2_i000_001967	111	345	234	1.04464	0.473684
GCA_000975855.3-Fun_CP005200.2_i000_001967	111	345	234	1.04464	0.473684
GCA_009014655.1-Fun_BKZN01000080.1_i000_004340	111	345	234	1.04464	0.473684
GCA_009761265.1-Ani_VOSG01000099.1_i000_003673	212	437	225	1.00446	0.427757
GCA_902713445.1-Pla_LR743780.1_i000_006038	177	395	218	0.973214	0.381786
GCA_000344635.1-Fun_KB468113.1_i000_008656	179	389	210	0.9375	0.37234
GCA_015502485.1-Fun_JAAAUO010001309.1_i000_002024	3	194	191	0.852679	0.694545
GCA_000493195.1-Pla_KI536726.1_i000_011035	177	396	219	0.977679	0.396739
GCA_000507485.3-Fun_KI669547.1_i000_001050	191	413	222	0.991071	0.373737
GCA_015476325.1-Pro_JADAQX010000103.1_i000_000812	182	401	219	0.977679	0.497727
GCA_009176345.1-Fun_ML732309.1_i000_009516	190	416	226	1.00893	0.426415
GCA_921882275.1-Ani_OV170226.1_i000_007099	180	400	220	0.982143	0.389381
GCA_910591605.1-Ani_CAJVCH010551648.1_i000_039335	209	433	224	1	0.4375
GCA_003184685.1-Fun_KZ825527.1_i000_007314	190	416	226	1.00893	0.434615
GCA_003184705.1-Fun_KZ825132.1_i000_005209	190	416	226	1.00893	0.434615
GCA_001306435.1-Fun_LKCW01000448.1_i000_009074	193	419	226	1.00893	0.443137
GCA_016508695.1-Fun_VNKQ01000013.1_i000_001873	194	419	225	1.00446	0.439453
GCA_006542485.1-Fun_VIFY01000041.1_i000_005619	191	417	226	1.00893	0.427221
GCA_002120305.1-Fun_KZ112508.1_i000_006590	191	417	226	1.00893	0.473795
GCA_016758785.1-Fun_JABBWO010000003.1_i000_006308	183	405	222	0.991071	0.389474
GCA_003184785.1-Fun_KZ824830.1_i000_009569	190	416	226	1.00893	0.434615
GCA_004329165.1-Pla_QUWT01000781.1_i000_030570	188	412	224	1	0.404332
GCA_022376555.1-Fun_WTXH01000016.1_i000_002754	185	410	225	1.00446	0.418216
GCA_014905175.1-Ani_CM026522.1_i000_003189	187	411	224	1	0.503371
GCA_014805685.1-Ani_CM025899.1_i000_012987	237	461	224	1	0.372712
GCA_009732945.1-Pro_QXFU01000229.1_i000_005394	222	445	223	0.995536	0.410681
GCA_009733145.1-Pro_QXFT01000217.1_i000_005298	222	445	223	0.995536	0.410681
GCA_011823955.1-Ani_JAAKFY010000005.1_i000_008075	225	431	206	0.919643	0.456763
GCA_000149925.1-Fun_DS178276.1_i000_010345	184	408	224	1	0.403604
GCA_008520325.1-Fun_VDEP01000005.1_i000_001497	184	408	224	1	0.403604
GCA_008520325.1-Fun_VDEP01000206.1_i000_015048	184	408	224	1	0.403604
GCA_008522505.1-Fun_VSWC01000184.1_i000_033802	184	408	224	1	0.403604
GCA_000004155.2-Fun_KE546988.1_i000_001011	180	400	220	0.982143	0.433071
GCA_900618365.1-Ani_UYYF01004286.1_i000_004367	180	395	215	0.959821	0.442387
GCA_008522505.1-Fun_VSWC01000016.1_i000_005594	184	408	224	1	0.403604
GCA_918797485.1-Pro_CAKKNE010000002.1_i000_005754	180	403	223	0.995536	0.447791
GCA_003290485.1-Fun_CP030252.1_i000_001092	195	408	213	0.950893	0.396648
GCA_009835175.1-Pro_VJMJ01000322.1_i000_018511	187	411	224	1	0.46281
GCA_021527685.1-Pro_JAJGMV010000283.1_i000_006486	187	411	224	1	0.46281
GCA_021527745.1-Pro_JAJNML010000595.1_i000_005764	187	411	224	1	0.46281
GCA_003691605.1-Fun_CP033149.1_i000_001263	195	408	213	0.950893	0.396648
GCA_002571385.1-Ani_LSMT01000306.1_i000_014349	169	417	248	1.10714	0.27464
GCA_900618015.1-Ani_UZAK01032657.1_i000_007958	199	422	223	0.995536	0.359098
GCA_902825445.1-Ani_CADEBC010000532.1_i000_011397	180	398	218	0.973214	0.403704
GCA_902825455.1-Ani_CADEBD010000288.1_i000_005260	180	398	218	0.973214	0.403704
GCA_004369045.1-Fun_ML213509.1_i000_005298	185	411	226	1.00893	0.440546
GCA_001600855.1-Fun_BCLC01000014.1_i000_007234	200	425	225	1.00446	0.380711
GCA_000827325.1-Fun_KN832876.1_i000_007610	192	418	226	1.00893	0.450199
GCA_000763605.2-Pla_JRKL02000009.1_i000_000193	188	412	224	1	0.411765
GCA_003713155.1-Pla_CP030985.1_i000_013751	177	396	219	0.977679	0.396022
GCA_004170445.1-Pla_CM014317.1_i000_017496	177	396	219	0.977679	0.396022
GCA_022201065.1-Pla_CM039176.1_i000_021453	177	396	219	0.977679	0.378238
GCA_022201045.1-Pla_CM039167.1_i000_021240	177	396	219	0.977679	0.376289
GCA_000338995.1-Fun_KB445638.1_i000_002074	192	416	224	1	0.432432
GCA_013416765.1-Fun_WNKQ01000021.1_i000_009756	192	416	224	1	0.432432
GCA_006547085.1-Pla_VIEB01000374.1_i000_021230	188	412	224	1	0.375209
GCA_003713155.1-Pla_CP030995.1_i000_018478	177	396	219	0.977679	0.396022
GCA_004170445.1-Pla_CM014327.1_i000_022450	177	396	219	0.977679	0.396022
GCA_003615165.1-Fun_MRCZ01000008.1_i000_016169	583	809	226	1.00893	0.250832
GCA_004141715.1-Fun_MQTW01000073.1_i000_017746	583	809	226	1.00893	0.250832
GCA_014133895.1-Fun_CP059252.1_i000_004116	103	332	229	1.02232	0.514607
GCA_903994135.1-Ani_CAJEWN010000027.1_i000_006543	191	415	224	1	0.448
GCA_013085055.1-Fun_CP052045.1_i000_012758	583	809	226	1.00893	0.25
GCA_003615075.1-Fun_MRCW01000124.1_i000_002061	583	809	226	1.00893	0.250832
GCA_003615095.1-Fun_MRCV01000028.1_i000_009049	583	809	226	1.00893	0.250832
GCA_003615155.1-Fun_MRCY01000036.1_i000_010037	583	809	226	1.00893	0.250832
GCA_013363075.1-Fun_JAAFOW010001048.1_i000_006447	583	809	226	1.00893	0.250832
GCA_001654555.2-Fun_LUFC02000778.1_i000_009398	604	830	226	1.00893	0.245119
GCA_015951145.1-Fun_MU167246.1_i000_005047	186	393	207	0.924107	0.362522
GCA_021556725.1-Ani_CM038615.1_i000_005935	188	413	225	1.00446	0.396127
GCA_014282085.1-Pla_CM024903.1_i000_004214	177	393	216	0.964286	0.529412
GCA_002120335.1-Fun_KZ111286.1_i000_011699	191	416	225	1.00446	0.441176
GCA_000816745.1-Ani_KN726880.1_i000_002663	270	496	226	1.00893	0.35703
GCA_000507465.3-Fun_KV700054.1_i000_007802	191	413	222	0.991071	0.373737
GCA_000507885.2-Fun_KV700091.1_i000_006205	191	413	222	0.991071	0.373737
GCA_013266265.1-Fun_JABFAK010000213.1_i000_004489	240	466	226	1.00893	0.402135
GCA_000524195.1-Ani_APAU02000027.1_i000_006954	190	415	225	1.00446	0.394737
GCA_012274485.2-Pla_MU106336.1_i000_033685	188	412	224	1	0.439216
GCA_001194135.1-Ani_KQ415811.1_i000_000692	180	399	219	0.977679	0.436255
GCA_001633215.2-Pla_KV774602.1_i000_005602	188	412	224	1	0.410256
GCA_014281905.1-Fun_JACBAD010001921.1_i000_003285	190	416	226	1.00893	0.437984
GCA_014281935.1-Fun_JACBAF010001944.1_i000_005662	190	416	226	1.00893	0.437984
GCA_002307675.1-Fun_KZ293418.1_i000_004317	185	411	226	1.00893	0.438835
GCA_001298345.1-Ani_KQ459584.1_i000_007633	180	398	218	0.973214	0.400735
GCA_000507365.1-Ani_KI658197.1_i000_003884	188	414	226	1.00893	0.502222
GCA_002794465.1-Fun_MTSL01000126.1_i000_002687	179	397	218	0.973214	0.401473
GCA_021442195.1-Pla_CM038194.1_i000_001168	177	396	219	0.977679	0.378893
GCA_000512255.2-Pla_CM008457.1_i000_007871	67	285	218	0.973214	0.5058
GCA_013395995.1-Fun_JAAOAR010000163.1_i000_003569	604	830	226	1.00893	0.245119
GCA_000512585.2-Fun_KI894018.1_i000_000114	180	402	222	0.991071	0.3821
GCA_019112545.1-Fun_MU250535.1_i000_007362	180	387	207	0.924107	0.380515
GCA_001298355.1-Ani_KQ460644.1_i000_007927	180	398	218	0.973214	0.400735
GCA_019633495.1-Fun_WSUD01005379.1_i000_012260	181	401	220	0.982143	0.514019
GCA_022376515.1-Fun_WTXI01000003.1_i000_007698	185	410	225	1.00446	0.415896
GCA_013396195.1-Fun_JAAQRI010000035.1_i000_001968	610	836	226	1.00893	0.243534
GCA_006013705.1-Pla_RXGB01003189.1_i000_013120	182	400	218	0.973214	0.394213
GCA_003788595.2-Fun_ML120431.1_i000_011317	190	415	225	1.00446	0.422932
GCA_001263195.1-Fun_KQ412567.1_i000_005537	182	397	215	0.959821	0.404896
GCA_000263155.2-Pla_CM003536.1_i000_032498	177	396	219	0.977679	0.386243
GCA_000441915.1-Pla_KE527363.1_i000_001907	187	413	226	1.00893	0.455645
GCA_903986555.1-Ani_CAJDYZ010004582.1_i000_002242	138	356	218	0.973214	0.405204
GCA_013396025.1-Fun_JAAOAQ010000217.1_i000_006224	604	830	226	1.00893	0.245119
GCA_000263155.2-Pla_CM003536.1_i000_032497	177	396	219	0.977679	0.385563
GCA_005286985.1-Pla_CM016560.1_i000_036421	177	396	219	0.977679	0.385563
GCA_000507425.3-Fun_KV700187.1_i000_003130	193	413	220	0.982143	0.366667
GCA_003999625.1-Ani_CM012441.1_i000_003845	212	437	225	1.00446	0.360577
GCA_005286985.1-Pla_CM016560.1_i000_036422	177	396	219	0.977679	0.385563
GCA_002072345.1-Fun_MDYN01000009.1_i000_003891	190	416	226	1.00893	0.441406
GCA_001651215.1-Pro_LXWW01000238.1_i000_003709	530	755	225	1.00446	0.271739
GCA_007646595.3-Ani_VBQZ03000024.1_i000_006199	1084	1309	225	1.00446	0.150602
GCA_021527665.1-Pro_JAJNMJ010000417.1_i000_004355	187	411	224	1	0.46281
GCA_021527805.1-Pro_JAJNMK010001306.1_i000_010957	187	411	224	1	0.46281
GCA_001641455.1-Pla_LVLJ01000678.1_i000_008966	275	494	219	0.977679	0.345426
GCA_016906575.1-Fun_CP059626.1_i000_015608	180	403	223	0.995536	0.38918
GCA_002049455.2-Pro_KV919330.1_i000_011351	194	413	219	0.977679	0.385563
GCA_021527785.1-Pro_JAJATU010002635.1_i000_005094	187	411	224	1	0.461856
GCA_021527785.1-Pro_JAJATU010003571.1_i000_007942	187	411	224	1	0.461856
GCA_018258275.1-Pla_CM031114.1_i000_048431	177	395	218	0.973214	0.39781
GCA_903819145.2-Fun_LR813523.2_i000_002080	111	345	234	1.04464	0.473684
GCA_022376545.1-Fun_WTXJ01000001.1_i000_000417	185	410	225	1.00446	0.412844
GCA_002307695.1-Fun_KZ293649.1_i000_006725	185	411	226	1.00893	0.42803
GCA_000835395.1-Fun_KN846951.1_i000_002564	190	416	226	1.00893	0.438835
GCA_019828565.1-Pro_JAHDYR010000005.1_i000_001427	184	415	231	1.03125	0.452055
GCA_002307675.1-Fun_KZ293421.1_i000_006310	180	387	207	0.924107	0.365724
GCA_000005425.2-Pla_AP008209.2_i000_008774	177	396	219	0.977679	0.385563
GCA_000149285.1-Pla_CM000140.1_i000_010322	177	396	219	0.977679	0.385563
GCA_001433935.1-Pla_AP014959.1_i000_012746	177	396	219	0.977679	0.385563
GCA_001696595.2-Fun_MBFL02000072.1_i000_011333	192	418	226	1.00893	0.428843
GCA_004007595.1-Pla_CM012943.1_i000_010154	177	396	219	0.977679	0.385563
GCA_009797565.1-Pla_CM020523.1_i000_010560	177	396	219	0.977679	0.385563
GCA_002307695.1-Fun_KZ293645.1_i000_002026	180	387	207	0.924107	0.365724
GCA_900157425.1-Fun_FUEG01000008.1_i000_006380	185	411	226	1.00893	0.425612
GCA_000493195.1-Pla_KI536799.1_i000_013728	177	396	219	0.977679	0.397459
GCA_022201045.1-Pla_CM039165.1_i000_014212	177	396	219	0.977679	0.397459
GCA_000510995.2-Pla_KQ155649.1_i000_012562	177	396	219	0.977679	0.395307
GCA_903819175.2-Fun_LR813591.2_i000_002079	111	344	233	1.04018	0.47166
GCA_000005425.2-Pla_AP008209.2_i000_008773	177	396	219	0.977679	0.393885
GCA_000504015.1-Pla_KI632182.1_i000_022543	188	412	224	1	0.431599
GCA_003203535.1-Pla_BDRX01000061.1_i000_007900	189	414	225	1.00446	0.459184
GCA_003614145.1-Fun_KZ987821.1_i000_000975	187	410	223	0.995536	0.472458
GCA_900622535.1-Ani_UYWW01012289.1_i000_011148	189	412	223	0.995536	0.377327
GCA_001329695.1-Fun_KQ474079.1_i000_003763	183	408	225	1.00446	0.436047
GCA_017607575.1-Fun_JABAJY010000011.1_i000_000631	195	409	214	0.955357	0.367698
GCA_013305595.1-Fun_QQZN01000065.1_i000_004256	192	417	225	1.00446	0.443787
GCA_013365075.1-Fun_QQZL01000353.1_i000_003226	192	417	225	1.00446	0.443787
GCA_000004655.2-Pla_CM000128.1_i000_011103	177	396	219	0.977679	0.385563
GCA_001433935.1-Pla_AP014959.1_i000_012745	177	396	219	0.977679	0.385563
GCA_004007595.1-Pla_CM012943.1_i000_010153	177	396	219	0.977679	0.385563
GCA_009797565.1-Pla_CM020523.1_i000_010559	177	396	219	0.977679	0.385563
GCA_020746845.1-Fun_JAGPNJ010000002.1_i000_005265	180	403	223	0.995536	0.390543
GCA_000975825.2-Fun_CP005199.1_i000_001990	111	345	234	1.04464	0.473684
GCA_000978285.2-Fun_CP005283.2_i000_001909	111	345	234	1.04464	0.473684
GCA_003046715.1-Fun_PTEQ01000152.1_i000_001435	111	345	234	1.04464	0.473684
GCA_000750745.1-Fun_JPJV01001888.1_i000_004763	150	290	140	0.625	0.482759
GCA_000221225.1-Fun_GL988040.1_i000_001786	195	419	224	1	0.428298
GCA_016906575.1-Fun_CP059610.1_i000_000738	180	403	223	0.995536	0.38918
GCA_001402995.1-Fun_CCBN010000017.1_i000_005592	192	417	225	1.00446	0.449102
GCA_014596635.1-Fun_QQZJ01000091.1_i000_005044	192	417	225	1.00446	0.449102
GCA_013365045.1-Fun_QQZM01000044.1_i000_003225	192	417	225	1.00446	0.443787
GCA_013365065.1-Fun_QQZO01000033.1_i000_002935	192	417	225	1.00446	0.443787
GCA_013365125.1-Fun_QQZK01000134.1_i000_000890	192	417	225	1.00446	0.443787
GCA_900180425.1-Fun_FXLY01000002.1_i000_001080	127	361	234	1.04464	0.48954
GCA_002763495.2-Ani_JXXN02001935.1_i000_005341	542	765	223	0.995536	0.237487
GCA_001913855.2-Fun_MLYV02000095.1_i000_001301	183	399	216	0.964286	0.381625
GCA_000298775.1-Fun_JH921443.1_i000_006757	193	418	225	1.00446	0.437743
GCA_002897195.1-Pla_BDQV01000255.1_i000_020647	219	438	219	0.977679	0.339009
GCA_000005975.1-Ani_CM000160.2_i000_013040	186	410	224	1	0.450704
GCA_000523455.1-Fun_KI963929.1_i000_001758	192	416	224	1	0.432432
GCA_002317995.1-Fun_MVNX01000116.1_i000_009314	193	418	225	1.00446	0.437743
GCA_002946425.1-Fun_NJPT01000052.1_i000_006068	203	429	226	1.00893	0.440546
GCA_018296085.1-Fun_JACKQM010000443.1_i000_000480	182	396	214	0.955357	0.376098
GCA_018296165.1-Fun_JACKQL010014159.1_i000_013083	182	396	214	0.955357	0.376098
GCA_019279435.1-Pla_JAAALK010000286.1_i000_009423	177	395	218	0.973214	0.373288
GCA_004918925.1-Fun_SPRP01000083.1_i000_004066	186	411	225	1.00446	0.411335
GCA_010085365.1-Ani_VULK01000172.1_i000_003442	1	220	219	0.977679	0.627507
GCA_000002775.3-Pla_CM009301.1_i000_029045	188	412	224	1	0.406534
GCA_000330505.1-Pro_KB207085.1_i000_010113	181	399	218	0.973214	0.407477
GCA_000827315.1-Fun_KN832989.1_i000_008608	184	406	222	0.991071	0.403636
GCA_015852375.1-Fun_JAAAIF010000039.1_i000_006608	1	184	183	0.816964	0.677778
GCA_015501585.1-Fun_JADNRY010000006.1_i000_018269	182	390	208	0.928571	0.367491
GCA_014805555.1-Fun_SBIQ01000017.1_i000_000455	154	376	222	0.991071	0.540146
GCA_021365275.1-Fun_JAJTIY010000006.1_i000_014123	191	417	226	1.00893	0.445759
GCA_018446385.1-Pla_CM031521.1_i000_050230	188	412	224	1	0.387543
GCA_000976095.2-Fun_CP005208.2_i000_001987	111	345	234	1.04464	0.473684
GCA_010015705.1-Fun_ML977170.1_i000_008558	192	416	224	1	0.415584
GCA_902705455.1-Pla_CACSHJ010000089.1_i000_012445	188	412	224	1	0.448898
GCA_013389905.1-Ani_WEKW01009522.1_i000_003658	1	217	216	0.964286	0.617143
GCA_003185045.1-Pla_CM009906.1_i000_001490	302	521	219	0.977679	0.103546
GCA_000310025.1-Pro_FN649749.1_i000_009588	181	401	220	0.982143	0.39356
GCA_015852605.2-Pla_CM027581.2_i000_021753	188	412	224	1	0.406534
GCA_002946385.1-Fun_NJPR01000025.1_i000_004903	192	418	226	1.00893	0.450199
GCA_000271645.1-Fun_JH711535.1_i000_005211	196	421	225	1.00446	0.381356
GCA_002946415.1-Fun_NJPS01000045.1_i000_004768	192	418	226	1.00893	0.450199
GCA_013781345.1-Fun_JAAOAJ010000251.1_i000_006278	604	830	226	1.00893	0.245119
GCA_004379255.2-Pla_CM031475.1_i000_011604	149	367	218	0.973214	0.416031
GCA_014904935.1-Fun_MU123695.1_i000_000039	183	405	222	0.991071	0.388792
GCA_905231925.1-Pro_CAJNJV010007243.1_i000_008346	180	400	220	0.982143	0.426357
GCA_013396175.1-Fun_JAAOAK010000288.1_i000_009312	604	830	226	1.00893	0.245119
GCA_020091625.1-Fun_JAGYZC010000003.1_i000_005599	182	396	214	0.955357	0.363946
GCA_021556665.1-Fun_JAKFGG010000294.1_i000_015460	172	392	220	0.982143	0.446247
GCA_005223365.2-Pla_SPHZ02000012.1_i000_038429	188	412	224	1	0.406534
GCA_000414095.2-Pla_KE345144.1_i000_016352	188	412	224	1	0.409506
GCA_000320605.2-Fun_KB445792.1_i000_001920	180	402	222	0.991071	0.495536
GCA_008629635.1-Fun_NQVO01000034.1_i000_005646	191	411	220	0.982143	0.370995
GCA_000504015.1-Pla_KI632154.1_i000_021909	203	421	218	0.973214	0.383128
GCA_003073855.1-Fun_KZ805800.1_i000_017065	192	416	224	1	0.446215
GCA_002269645.1-Ani_NIVC01000337.1_i000_009579	187	407	220	0.982143	0.40367
GCA_002269645.1-Ani_NIVC01004176.1_i000_046565	187	407	220	0.982143	0.40367
GCA_013401445.1-Pla_CM023873.1_i000_006973	177	396	219	0.977679	0.382867
GCA_905219655.1-Fun_CAJMXA010003889.1_i000_008149	180	403	223	0.995536	0.391916
GCA_001636725.1-Fun_AZHB01000019.1_i000_003798	192	417	225	1.00446	0.446429
GCA_009728645.1-Fun_WJSL01000012.1_i000_008832	192	416	224	1	0.432432
GCA_009728655.1-Fun_WJSN01000011.1_i000_009219	192	416	224	1	0.432432
GCA_900231935.2-Fun_OCTF02000010.1_i000_009218	192	416	224	1	0.432432
GCA_021014945.1-Fun_MU266335.1_i000_001346	183	405	222	0.991071	0.385417
GCA_001625215.1-Pla_CM004279.1_i000_007321	177	396	219	0.977679	0.38968
GCA_000697665.1-Fun_KL197709.1_i000_001133	180	397	217	0.96875	0.376736
GCA_003184525.1-Fun_MSFK01000013.1_i000_001958	190	416	226	1.00893	0.429658
GCA_007994515.1-Fun_VMNF01000012.1_i000_002144	626	852	226	1.00893	0.239407
GCA_000715545.1-Ani_KL596804.1_i000_009728	187	411	224	1	0.392982
GCA_003194525.1-Pro_NBIV01000102.1_i000_006130	187	412	225	1.00446	0.425331
GCA_019828595.1-Pro_JAHQRK010000029.1_i000_010511	187	411	224	1	0.461856
GCA_012274485.2-Pla_MU106686.1_i000_038574	188	412	224	1	0.433269
GCA_002081595.1-Pro_JNBR01000094.1_i000_002569	186	410	224	1	0.460905
GCA_019511825.2-Pla_QFCC02000007.1_i000_034900	177	395	218	0.973214	0.395644
GCA_019512045.2-Pla_QIYW02000010.1_i000_002519	177	395	218	0.973214	0.394928
GCA_006535985.1-Fun_QEAO01000017.1_i000_003307	186	410	224	1	0.439216
GCA_009728635.1-Fun_WJSK01000011.1_i000_009442	192	416	224	1	0.429942
GCA_009728665.1-Fun_WJSO01000011.1_i000_009568	192	416	224	1	0.429942
GCA_009728675.1-Fun_WJSM01000010.1_i000_008816	192	416	224	1	0.429942
GCA_900232045.3-Fun_HG992986.1_i000_009983	192	416	224	1	0.429942
GCA_016628085.1-Fun_JABBWB010000001.1_i000_000059	183	405	222	0.991071	0.408088
GCA_000230625.1-Fun_JH226131.1_i000_002598	189	415	226	1.00893	0.436293
GCA_902439185.1-Ani_CABPRJ010000972.1_i000_007104	187	411	224	1	0.482759
GCA_000150705.2-Fun_KN294015.1_i000_007208	190	416	226	1.00893	0.433781
GCA_021904315.1-Pla_CM038910.1_i000_006348	188	412	224	1	0.376471
GCA_005784505.1-Ani_VCAZ01000019.1_i000_000590	885	1110	225	1.00446	0.178855
GCA_019511825.2-Pla_QFCC02000009.1_i000_038220	177	395	218	0.973214	0.396364
GCA_001659605.2-Pla_CM004400.2_i000_024905	188	412	224	1	0.405063
GCA_000699445.3-Ani_CM039142.1_i000_000034	206	429	223	0.995536	0.355096
GCA_008369825.1-Ani_CM017898.1_i000_005263	184	409	225	1.00446	0.422932
GCA_003070745.1-Fun_NESQ01000232.1_i000_004805	189	415	226	1.00893	0.413919
GCA_905219635.1-Fun_CAJMWY010003974.1_i000_006724	200	316	116	0.517857	0.0888889
GCA_905219635.1-Fun_CAJMWY010003974.1_i000_006724	311	446	135	0.602679	0.103448
GCA_001634645.1-Fun_CM004300.1_i000_002323	111	345	234	1.04464	0.473684
GCA_902651935.1-Pla_CACRSJ010000106.1_i000_012613	188	412	224	1	0.448898
GCA_014905375.1-Pla_BMAC01000476.1_i000_018616	177	397	220	0.982143	0.419847
GCA_015502465.1-Fun_JAAAUP010000158.1_i000_002542	1	204	203	0.90625	0.654839
GCA_000507465.3-Fun_KI669472.1_i000_000550	196	421	225	1.00446	0.395431
GCA_000507485.3-Fun_KI669550.1_i000_003440	196	421	225	1.00446	0.395431
GCA_000507885.2-Fun_KI669463.1_i000_004617	196	421	225	1.00446	0.395431
GCA_018282025.1-Fun_JABCKI010000590.1_i000_004791	19	238	219	0.977679	0.544776
GCA_019044685.2-Pla_JAGTXX020000015.1_i000_008438	178	398	220	0.982143	0.444444
GCA_019202925.1-Pla_JAHPZM010000006.1_i000_002493	178	398	220	0.982143	0.444444
GCA_002317995.1-Fun_MVNX01000056.1_i000_005993	193	418	225	1.00446	0.437743
GCA_903819155.2-Fun_LR813506.2_i000_002079	111	345	234	1.04464	0.473684
GCA_022478985.1-Fun_JAKSZP010017703.1_i000_005018	180	395	215	0.959821	0.402622
GCA_015852605.2-Pla_CM027582.2_i000_022719	177	395	218	0.973214	0.389286
GCA_013305495.1-Fun_JABUBV010000001.1_i000_000704	192	418	226	1.00893	0.444882
GCA_021527775.1-Fun_JAKEYF010000083.1_i000_016343	185	410	225	1.00446	0.415129
GCA_020310875.1-Pla_CM035429.1_i000_021897	177	396	219	0.977679	0.442424
GCA_000002775.3-Pla_CM009302.1_i000_029900	177	395	218	0.973214	0.388592
GCA_001990785.1-Ani_KV894095.1_i000_005564	211	435	224	1	0.377104
GCA_019924265.1-Fun_JAHFXL010000027.1_i000_003252	907	1133	226	1.00893	0.182848
GCA_020496765.1-Pla_CM035632.1_i000_045252	177	395	218	0.973214	0.386525
GCA_000512565.2-Fun_KI894037.1_i000_008090	190	410	220	0.982143	0.367279
GCA_013398775.1-Ani_VZSX01000316.1_i000_007716	115	340	225	1.00446	0.482833
GCA_000300595.1-Fun_JH930469.1_i000_002589	185	404	219	0.977679	0.391071
GCA_019973155.1-Fun_BPQB01000001.1_i000_000823	183	403	220	0.982143	0.399274
GCA_006369765.1-Pro_RRYP01003083.1_i000_004097	182	403	221	0.986607	0.488938
GCA_022496195.1-Fun_WTXC01000024.1_i000_005186	185	410	225	1.00446	0.414365
GCA_018404265.1-Fun_BOPL01000003.1_i000_003505	190	416	226	1.00893	0.437984
GCA_009193465.1-Fun_ML742033.1_i000_001345	190	416	226	1.00893	0.520737
GCA_000827495.1-Fun_KN817556.1_i000_008611	182	403	221	0.986607	0.388401
GCA_018397855.1-Fun_JAGFBS010000016.1_i000_003335	182	405	223	0.995536	0.38918
GCA_002049455.2-Pro_KV918798.1_i000_002430	201	426	225	1.00446	0.409091
GCA_002269645.1-Ani_NIVC01000915.1_i000_019979	187	407	220	0.982143	0.404412
GCA_910393935.1-Fun_CAJSTJ010000022.1_i000_000449	193	419	226	1.00893	0.444008
GCA_004303085.2-Pla_SDAM02000099.1_i000_007736	177	395	218	0.973214	0.394928
GCA_009663095.1-Fun_CP023095.1_i000_009514	569	795	226	1.00893	0.254791
GCA_009663115.1-Fun_CP023107.1_i000_009549	569	795	226	1.00893	0.254791
GCA_009663055.1-Fun_CP023083.1_i000_009542	569	795	226	1.00893	0.254791
GCA_000257125.1-Pro_JH929511.1_i000_005390	179	403	224	1	0.494481
GCA_002284615.2-Pla_MU069898.1_i000_010437	206	367	161	0.71875	0.346237
GCA_017309865.1-Fun_PKMH01000079.1_i000_003996	569	795	226	1.00893	0.254791
GCA_020744515.1-Fun_JAGPXF010000001.1_i000_002113	196	421	225	1.00446	0.436047
GCA_020744495.1-Fun_JAGTJS010000013.1_i000_003653	193	419	226	1.00893	0.44227
GCA_003958945.1-Ani_QMKO01002801.1_i000_008532	199	422	223	0.995536	0.362602
GCA_015178975.1-Fun_WHVD01000063.1_i000_012546	189	415	226	1.00893	0.43295
GCA_015679545.1-Fun_JAAAUZ010000549.1_i000_006188	1	200	199	0.888393	0.676871
GCA_003290285.1-Fun_PKMI01000001.1_i000_001169	569	795	226	1.00893	0.254791
GCA_007735645.1-Fun_CP042190.1_i000_004033	192	416	224	1	0.440079
GCA_000504015.1-Pla_KI632154.1_i000_021910	177	395	218	0.973214	0.394213
GCA_000313545.1-Fun_CAFZ01000111.1_i000_006864	184	404	220	0.982143	0.374787
GCA_019702505.1-Fun_JAANER010000003.1_i000_005989	192	416	224	1	0.434951
GCA_000005215.1-Ani_CH480815.1_i000_015283	186	410	224	1	0.451613
GCA_000259055.1-Ani_CM000364.1_i000_011278	186	410	224	1	0.451613
GCA_000754195.3-Ani_CM002913.1_i000_010530	186	410	224	1	0.451613
GCA_910890315.1-Fun_CAJVGD010000005.1_i000_002568	184	404	220	0.982143	0.374787
GCA_014904835.1-Fun_MU120898.1_i000_000543	183	390	207	0.924107	0.362522
GCA_900199415.2-Ani_FZQP02000471.1_i000_002367	180	398	218	0.973214	0.402957
GCA_014338405.1-Ani_JTDE01005187.1_i000_008359	148	372	224	1	0.416357
GCA_000188695.1-Pro_GL832979.1_i000_008947	182	400	218	0.973214	0.422481
GCA_000005135.1-Ani_CH954182.1_i000_001686	186	410	224	1	0.450704
GCA_000004655.2-Pla_CM000128.1_i000_011104	266	485	219	0.977679	0.333333
GCA_003946995.1-Fun_NKCK01000014.1_i000_003130	193	419	226	1.00893	0.482906
GCA_003184635.1-Fun_KZ826341.1_i000_005254	190	416	226	1.00893	0.429658
GCA_000149845.2-Fun_KE651166.1_i000_001134	179	399	220	0.982143	0.441767
GCA_001972305.1-Pla_BDDD01000624.1_i000_011734	187	411	224	1	0.428298
GCA_000375325.1-Pla_KB870805.1_i000_004276	210	435	225	1.00446	0.413603
GCA_907166805.1-Fun_CAJRGZ010000015.1_i000_002465	192	416	224	1	0.435798
GCA_001865875.1-Pla_CM007373.1_i000_020017	177	395	218	0.973214	0.392086
GCA_905252715.1-Ani_CAJNOU010000172.1_i000_005572	186	410	224	1	0.473573
GCA_905332105.1-Ani_CAJOBE010002614.1_i000_016891	186	410	224	1	0.473573
GCA_005298045.1-Fun_SWBT01000134.1_i000_000563	183	401	218	0.973214	0.378472
GCA_021223895.1-Ani_JAJJHX010008117.1_i000_007862	186	410	224	1	0.451613
GCA_902206195.3-Pla_CABITT030000004.1_i000_010543	187	412	225	1.00446	0.475687
GCA_021223745.1-Ani_JAJJHO010001233.1_i000_001929	186	410	224	1	0.451613
GCA_905250875.1-Ani_CAJNOO010002441.1_i000_027956	186	410	224	1	0.473573
GCA_905332085.1-Ani_CAJOAX010001945.1_i000_015973	186	410	224	1	0.473573
GCA_905251635.1-Ani_CAJNOT010000243.1_i000_007789	186	410	224	1	0.473573
GCA_905332095.1-Ani_CAJOBD010005525.1_i000_028111	186	410	224	1	0.473573
GCA_901677955.1-Fun_CABFJX010000279.1_i000_007444	604	830	226	1.00893	0.245119
GCA_901677965.1-Fun_CABFJW010000474.1_i000_013240	604	830	226	1.00893	0.245119
GCA_902702945.1-Fun_CACRXN010000163.1_i000_002011	604	830	226	1.00893	0.245119
GCA_903819195.2-Fun_LR813608.2_i000_002050	111	345	234	1.04464	0.473684
GCA_018446385.1-Pla_CM031520.1_i000_046330	188	412	224	1	0.345146
GCA_000320585.2-Fun_KI925456.1_i000_003899	180	397	217	0.96875	0.386121
GCA_000512605.2-Fun_KI894013.1_i000_005423	190	402	212	0.946429	0.355109
GCA_903994135.1-Ani_CAJEWN010001068.1_i000_044049	191	415	224	1	0.448
GCA_013396165.1-Fun_JAAQPF010000609.1_i000_011398	604	830	226	1.00893	0.245119
GCA_003260635.2-Pla_QGKW02002005.1_i000_025081	1	101	100	0.446429	0.395257
GCA_002105065.1-Fun_MCFC01000001.1_i000_000281	196	421	225	1.00446	0.528169
GCA_004522655.2-Fun_SNSC02000024.1_i000_010819	192	416	224	1	0.440079
GCA_004522665.1-Fun_SNSD01000024.1_i000_010594	192	416	224	1	0.440079
GCA_019616915.1-Fun_WSTI01007731.1_i000_007952	41	264	223	0.995536	0.518605
GCA_003012295.1-Fun_PXXK01000011.1_i000_000697	193	419	226	1.00893	0.444008
GCA_020744385.1-Fun_JAHBOO010000005.1_i000_009642	193	419	226	1.00893	0.444008
GCA_902459845.2-Pro_CABPSV020000652.1_i000_003348	181	401	220	0.982143	0.44
GCA_001632505.1-Ani_LRGB01001361.1_i000_009748	189	414	225	1.00446	0.396825
GCA_017309895.1-Fun_PKMJ01000010.1_i000_011025	614	840	226	1.00893	0.242489
GCA_910591965.1-Fun_CAJVPY010000221.1_i000_000901	184	409	225	1.00446	0.409091
GCA_021525015.1-Fun_JAKELH010000020.1_i000_006870	185	412	227	1.01339	0.411978
GCA_004126415.1-Fun_SDEE01000023.1_i000_005713	180	406	226	1.00893	0.385666
GCA_000469055.2-Fun_AVOT02006647.1_i000_021809	184	408	224	1	0.390244
GCA_002120325.1-Fun_KZ112965.1_i000_009551	191	416	225	1.00446	0.444664
GCA_013396185.1-Fun_JAAQPE010000359.1_i000_009920	1501	1727	226	1.00893	0.124244
GCA_903819205.2-Fun_LR813557.2_i000_002050	111	345	234	1.04464	0.473684
GCA_021605075.1-Ani_BPLQ01011019.1_i000_038085	190	411	221	0.986607	0.396057
GCA_008638375.1-Pla_CM018033.1_i000_019791	177	396	219	0.977679	0.381533
GCA_001974825.1-Pla_AWUE01015212.1_i000_011807	177	395	218	0.973214	0.462845
GCA_900618005.1-Ani_UYRS01018678.1_i000_007747	188	413	225	1.00446	0.394046
GCA_900624965.1-Ani_UYYB01022778.1_i000_006867	7	232	225	1.00446	0.889328
GCA_001572055.1-Fun_LPVP01000010.1_i000_006279	192	416	224	1	0.434951
GCA_001642055.1-Fun_KV441471.1_i000_002351	192	416	224	1	0.434951
GCA_003574525.1-Fun_QPFE01000108.1_i000_006652	192	416	224	1	0.434951
GCA_004154735.1-Fun_PDXE01000002.1_i000_003690	192	416	224	1	0.434951
GCA_004154745.1-Fun_PDXA01000038.1_i000_007657	192	416	224	1	0.434951
GCA_004154755.1-Fun_PDXD01000001.1_i000_001434	192	416	224	1	0.434951
GCA_004154815.1-Fun_PEJP01000032.1_i000_006438	192	416	224	1	0.434951
GCA_004154835.1-Fun_PDUP01000001.1_i000_000560	192	416	224	1	0.434951
GCA_004154845.1-Fun_PDXH01000001.1_i000_001442	192	416	224	1	0.434951
GCA_004156015.1-Fun_PDXB01000003.1_i000_006745	192	416	224	1	0.434951
GCA_004156025.2-Fun_PDWZ02000009.1_i000_012813	192	416	224	1	0.434951
GCA_004156035.1-Fun_PDXC01000008.1_i000_012078	192	416	224	1	0.434951
GCA_004168565.1-Fun_PDXF01000014.1_i000_002846	192	416	224	1	0.434951
GCA_004155955.1-Fun_PDWY01000004.1_i000_007941	192	416	224	1	0.434951
GCA_015484515.1-Fun_MU154528.1_i000_002267	167	387	220	0.982143	0.391459
GCA_000388065.2-Pro_KB932209.1_i000_004859	183	407	224	1	0.451613
GCA_000442015.1-Fun_KE560826.1_i000_001611	19	238	219	0.977679	0.638484
GCA_003614725.1-Fun_ML005899.1_i000_004879	19	238	219	0.977679	0.638484
GCA_020736535.1-Fun_JAHBNJ010000003.1_i000_006136	192	416	224	1	0.434109
GCA_013036055.1-Fun_JAAABM010000001.1_i000_002603	192	416	224	1	0.434951
GCA_000143925.2-Ani_GL379851.1_i000_013115	152	379	227	1.01339	0.502212
GCA_015584075.1-Fun_MU150255.1_i000_005724	181	401	220	0.982143	0.382609
GCA_003614695.1-Fun_ML004430.1_i000_000443	181	401	220	0.982143	0.42065
GCA_001882365.1-Fun_LVVM01006558.1_i000_013935	183	403	220	0.982143	0.386643
GCA_005239225.1-Pla_RCHU01000026.1_i000_014024	177	395	218	0.973214	0.387211
GCA_000359705.1-Fun_KB908504.1_i000_002590	192	416	224	1	0.446215
GCA_911649665.1-Fun_CAJVRL010000038.1_i000_002292	193	417	224	1	0.441815
GCA_018804465.1-Pla_CM031992.1_i000_008328	177	395	218	0.973214	0.387211
GCA_019616345.1-Fun_WSTH01003284.1_i000_013979	172	395	223	0.995536	0.242919
GCA_004154765.1-Fun_PDXG01000001.1_i000_000227	192	416	224	1	0.434951
GCA_903994135.1-Ani_CAJEWN010000143.1_i000_018843	174	392	218	0.973214	0.40824
GCA_014281895.1-Fun_JACBAE010001174.1_i000_003961	190	416	226	1.00893	0.437984
GCA_014281915.1-Fun_JACBAG010001878.1_i000_007388	190	416	226	1.00893	0.437984
GCA_019677325.2-Fun_CM033830.1_i000_009114	174	394	220	0.982143	0.386643
GCA_003710015.1-Ani_REGN01002165.1_i000_015435	189	413	224	1	0.438356
GCA_000281045.1-Pro_JH767175.1_i000_011757	187	410	223	0.995536	0.459794
GCA_011745845.1-Pla_VYZY01001524.1_i000_007646	177	395	218	0.973214	0.394213
GCA_020744175.1-Fun_JAGTJP010000014.1_i000_002798	180	405	225	1.00446	0.35828
GCA_904859935.1-Fun_CAJHEQ010000504.1_i000_004585	196	421	225	1.00446	0.380711
SUSP008.0722.00001.C001_00355	156	379	223	0.995536	0.543902
GCA_018855395.1-Fun_JABAJW010017966.1_i000_012224	248	467	219	0.977679	0.346519
GCA_014466165.1-Fun_JACETU010000003.1_i000_005371	182	402	220	0.982143	0.381944
GCA_000190255.1-Fun_CM001116.1_i000_001277	1	234	233	1.04018	0.608355
GCA_020796215.1-Pla_CM036787.1_i000_013976	177	396	219	0.977679	0.391071
GCA_000787575.2-Pro_DF837595.1_i000_002966	182	401	219	0.977679	0.338485
GCA_902602495.3-Pro_CACKRE030005273.1_i000_025461	181	401	220	0.982143	0.385289
GCA_002352805.1-Ani_KZ347291.1_i000_009833	19	246	227	1.01339	0.502212
GCA_001185155.1-Pla_LFYR01000981.1_i000_006472	188	413	225	1.00446	0.385935
GCA_009887335.1-Ani_SGJC01004914.1_i000_006274	1	83	82	0.366071	0.334694
GCA_000002825.1-Pro_DS113257.1_i000_051258	40	261	221	0.986607	0.624294
GCA_001630345.1-Fun_KV417284.1_i000_005401	188	413	225	1.00446	0.436893
GCA_003184585.1-Fun_KZ821257.1_i000_008135	190	416	226	1.00893	0.434615
GCA_900617895.1-Ani_UZAF01019705.1_i000_016628	188	415	227	1.01339	0.451292
GCA_003957675.1-Fun_MIKF01000034.1_i000_009525	193	419	226	1.00893	0.440546
GCA_000715545.1-Ani_KL596729.1_i000_007155	180	400	220	0.982143	0.49217
GCA_001990785.1-Ani_KV898249.1_i000_007859	180	400	220	0.982143	0.49217
GCA_003698175.1-Fun_NKUJ01000014.1_i000_002797	193	419	226	1.00893	0.441406
GCA_003947005.1-Fun_NKCL01000042.1_i000_010274	193	419	226	1.00893	0.441406
GCA_003947015.1-Fun_NKCJ01000046.1_i000_010161	193	419	226	1.00893	0.441406
GCA_000827465.1-Fun_KN822974.1_i000_004606	181	401	220	0.982143	0.380623
GCA_020875875.1-Pla_CM037017.1_i000_008893	188	413	225	1.00446	0.397527
GCA_021223915.1-Ani_JAJJHS010005105.1_i000_005138	186	410	224	1	0.451613
GCA_019447015.1-Ani_JAACNH010000372.1_i000_018695	121	337	216	0.964286	0.64095
GCA_020744255.1-Fun_JAGTJQ010000006.1_i000_011792	191	417	226	1.00893	0.441406
GCA_021223725.1-Ani_JAJJHN010003777.1_i000_006465	185	409	224	1	0.452525
GCA_021605075.1-Ani_BPLQ01002810.1_i000_009613	180	401	221	0.986607	0.481481
GCA_003076615.3-Ani_NJHN03000029.1_i000_012981	188	415	227	1.01339	0.442495
GCA_014180765.2-Pla_MUAA02000017.1_i000_003989	177	396	219	0.977679	0.408582
GCA_004786185.1-Ani_CM015716.1_i000_005258	185	410	225	1.00446	0.396127
GCA_018804465.1-Pla_CM031993.1_i000_009469	196	414	218	0.973214	0.373928
GCA_000697685.1-Fun_KL198007.1_i000_004713	182	402	220	0.982143	0.414313
GCA_010093595.1-Fun_MU003695.1_i000_003861	190	415	225	1.00446	0.428571
GCA_014851425.1-Pla_CM026263.1_i000_008824	214	438	224	1	0.390244
GCA_021223805.1-Ani_JAJJHR010002627.1_i000_006113	186	410	224	1	0.451613
GCA_015852385.1-Fun_JAAAIE010000340.1_i000_006073	1	201	200	0.892857	0.638978
GCA_000978105.2-Fun_CP005277.2_i000_001957	111	345	234	1.04464	0.473684
GCA_000978225.2-Fun_CP005281.2_i000_001997	111	345	234	1.04464	0.473684
GCA_000977055.3-Fun_CP005242.2_i000_001989	111	345	234	1.04464	0.473684
GCA_903994135.1-Ani_CAJEWN010000315.1_i000_028393	191	415	224	1	0.448
GCA_015484465.1-Fun_MU155198.1_i000_006385	182	405	223	0.995536	0.391228
GCA_013397755.1-Ani_VZTF01008428.1_i000_012194	61	291	230	1.02679	0.546318
GCA_015501595.1-Fun_JADNRX010000005.1_i000_020243	180	391	211	0.941964	0.380866
GCA_007726485.1-Pla_RWGY01000191.1_i000_034418	177	395	218	0.973214	0.394928
GCA_009363875.1-Pla_CM018683.1_i000_029768	177	395	218	0.973214	0.270807
GCA_003184865.1-Fun_KZ824292.1_i000_006972	190	416	226	1.00893	0.434615
GCA_013398315.1-Ani_VZSG01002345.1_i000_013059	1	219	218	0.973214	0.619318
GCA_013266175.1-Fun_JABFAI010000273.1_i000_009914	604	830	226	1.00893	0.245119
GCA_019176425.1-Ani_CM032878.1_i000_005797	186	411	225	1.00446	0.364668
GCA_012979565.1-Fun_SJDA01000003.1_i000_005808	182	402	220	0.982143	0.381282
GCA_012980525.1-Fun_SJKE01000003.1_i000_005127	182	402	220	0.982143	0.381282
GCA_008065275.1-Fun_QKWK01000006.1_i000_002545	188	399	211	0.941964	0.387156
GCA_012980535.1-Fun_SJKF01000003.1_i000_005620	182	402	220	0.982143	0.381282
GCA_021223935.1-Ani_JAJJHV010008987.1_i000_011770	186	410	224	1	0.450704
GCA_016808415.1-Fun_JAAWWR010000008.1_i000_007773	190	416	226	1.00893	0.441406
GCA_000442015.1-Fun_KE561071.1_i000_003939	610	834	224	1	0.247514
GCA_009014675.2-Fun_BKZM02000001.1_i000_000662	190	416	226	1.00893	0.441406
GCA_009932835.1-Fun_BLJY01000001.1_i000_000742	190	416	226	1.00893	0.441406
GCA_000149615.1-Fun_CH476595.1_i000_009067	190	416	226	1.00893	0.441406
GCA_004117975.1-Fun_SDIL01000011.1_i000_000718	196	421	225	1.00446	0.381356
GCA_009193565.1-Fun_ML739191.1_i000_006040	190	416	226	1.00893	0.43295
GCA_011800875.2-Fun_JRHT02000116.1_i000_001944	183	405	222	0.991071	0.412639
GCA_003813185.1-Fun_ML122055.1_i000_008449	179	402	223	0.995536	0.396092
GCA_003813205.1-Fun_ML122260.1_i000_005575	179	402	223	0.995536	0.396092
GCA_002081575.1-Pro_JNBS01001845.1_i000_007282	186	411	225	1.00446	0.462012
GCA_905329745.1-Ani_CAJNSZ010000961.1_i000_031179	184	409	225	1.00446	0.474684
GCA_905330235.1-Ani_CAJNUA010000648.1_i000_026981	184	409	225	1.00446	0.474684
GCA_905330535.1-Ani_CAJNVN010001576.1_i000_032649	184	409	225	1.00446	0.474684
GCA_905332165.1-Ani_CAJOBK010002700.1_i000_018927	184	409	225	1.00446	0.474684
GCA_905332175.1-Ani_CAJOBL010003294.1_i000_015826	184	409	225	1.00446	0.474684
GCA_905332185.1-Ani_CAJOBM010005502.1_i000_022081	184	409	225	1.00446	0.474684
GCA_905332225.1-Ani_CAJOBN010003807.1_i000_015867	184	409	225	1.00446	0.474684
GCA_001651475.1-Pla_CM004361.1_i000_012322	188	412	224	1	0.448898
GCA_019202795.1-Pla_CM032915.1_i000_012395	188	412	224	1	0.448898
GCA_012184355.1-Fun_LDUC01000503.1_i000_000176	189	413	224	1	0.405063
GCA_002271885.2-Pla_CM008454.1_i000_028334	177	390	213	0.950893	0.536524
GCA_000976215.2-Fun_CP005212.2_i000_001964	111	345	234	1.04464	0.473684
GCA_000976905.2-Fun_CP005237.2_i000_001956	111	345	234	1.04464	0.473684
GCA_000977865.2-Fun_CP005269.1_i000_001959	111	345	234	1.04464	0.473684
GCA_903819135.2-Fun_LR813540.2_i000_002092	111	345	234	1.04464	0.473684
GCA_000150475.2-Fun_KN305546.1_i000_007639	190	416	226	1.00893	0.43295
GCA_902713445.1-Pla_LR743793.1_i000_020954	404	622	218	0.973214	0.278061
GCA_006536005.1-Fun_QEAQ01000022.1_i000_002271	186	409	223	0.995536	0.44334
GCA_021223825.1-Ani_JAJJHQ010008452.1_i000_007538	186	410	224	1	0.449799
GCA_014338405.1-Ani_JTDE01016553.1_i000_010566	180	399	219	0.977679	0.481319
GCA_905249995.1-Ani_CAJNOK010005501.1_i000_013279	175	401	226	1.00893	0.40942
GCA_905250885.1-Ani_CAJNOQ010006477.1_i000_020474	175	401	226	1.00893	0.40942
GCA_905332065.1-Ani_CAJOBC010006477.1_i000_020471	175	401	226	1.00893	0.40942
GCA_905332075.1-Ani_CAJOBA010005507.1_i000_013282	175	401	226	1.00893	0.40942
GCA_902705455.1-Pla_CACSHJ010000096.1_i000_023325	148	367	219	0.977679	0.509302
GCA_002135145.1-Ani_MUJZ01047101.1_i000_009806	148	342	194	0.866071	0.567251
GCA_000827255.1-Fun_KN835230.1_i000_006933	183	405	222	0.991071	0.412639
GCA_000151545.2-Pro_KK583298.1_i000_014807	187	410	223	0.995536	0.458848
GCA_001713645.1-Fun_LZYO01000050.1_i000_005896	190	416	226	1.00893	0.43295
GCA_001713695.1-Fun_LYUC01000062.1_i000_006531	190	416	226	1.00893	0.43295
GCA_000150735.2-Fun_KN275962.1_i000_004948	190	416	226	1.00893	0.43295
GCA_002760635.1-Fun_AYKW01000001.1_i000_000384	177	398	221	0.986607	0.390459
GCA_019845555.1-Pla_CM034081.1_i000_013277	188	412	224	1	0.406534
GCA_000151545.2-Pro_KK583265.1_i000_013168	187	410	223	0.995536	0.461698
GCA_905219575.1-Fun_CAJMWT010002493.1_i000_004373	180	403	223	0.995536	0.390543
GCA_015039465.1-Fun_MU130533.1_i000_014008	182	403	221	0.986607	0.384348
GCA_005784505.1-Ani_VCAZ01000017.1_i000_004721	180	394	214	0.955357	0.382143
GCA_019202795.1-Pla_CM032917.1_i000_022957	146	365	219	0.977679	0.493243
GCA_020184695.1-Pro_JAANOX010000258.1_i000_009850	181	400	219	0.977679	0.475054
GCA_020186115.1-Pro_WSYJ01000092.1_i000_004350	181	400	219	0.977679	0.475054
GCA_014871385.1-Pla_CM026433.1_i000_029980	188	413	225	1.00446	0.387263
GCA_014871845.1-Pla_CM026445.1_i000_029117	188	413	225	1.00446	0.387263
GCA_011114355.1-Pla_CM022097.1_i000_016572	188	412	224	1	0.42344
GCA_005959815.1-Ani_QOCX01001997.1_i000_009374	180	397	217	0.96875	0.348315
GCA_000350225.2-Pro_HG001727.1_i000_005300	192	417	225	1.00446	0.448207
GCA_000524645.1-Fun_JATN01000322.1_i000_012543	180	401	221	0.986607	0.38704
GCA_000715385.1-Fun_AZST01000092.1_i000_003153	180	401	221	0.986607	0.38704
GCA_011745865.1-Pla_VYZZ01001516.1_i000_008008	177	395	218	0.973214	0.350482
GCA_016695475.1-Fun_MU172948.1_i000_007385	183	405	222	0.991071	0.390158
GCA_014466175.1-Ani_CM025340.1_i000_007336	186	411	225	1.00446	0.447316
GCA_008508345.1-Ani_QNGE01001779.1_i000_005684	180	399	219	0.977679	0.5
GCA_019279435.1-Pla_JAAALK010000079.1_i000_040354	188	412	224	1	0.410256
GCA_010093695.1-Fun_MU006303.1_i000_005860	192	416	224	1	0.432432
GCA_003731715.1-Ani_RJVU01035392.1_i000_007963	198	423	225	1.00446	0.402504
GCA_019677335.1-Fun_WSLM01002875.1_i000_011577	187	406	219	0.977679	0.515294
GCA_013235015.1-Ani_BGPR01005086.1_i000_097142	116	340	224	1	0.48172
GCA_000751015.1-Pla_LK032378.1_i000_029259	107	137	30	0.133929	0.071599
GCA_000751015.1-Pla_LK032378.1_i000_029259	134	186	52	0.232143	0.124105
GCA_000751015.1-Pla_LK032378.1_i000_029259	183	263	80	0.357143	0.190931
GCA_000182895.1-Fun_AACS02000005.1_i000_006077	180	405	225	1.00446	0.395431
GCA_016772295.1-Fun_JAAGWA010000005.1_i000_007463	180	405	225	1.00446	0.395431
GCA_020736505.1-Fun_JAHBNI010000004.1_i000_008288	192	416	224	1	0.434951
GCA_019202805.1-Pla_CM032904.1_i000_022285	146	365	219	0.977679	0.489933
GCA_010093805.1-Fun_ML996110.1_i000_003314	193	418	225	1.00446	0.449102
GCA_003614735.1-Fun_KZ992562.1_i000_002347	186	411	225	1.00446	0.452716
GCA_002271885.2-Pla_CM008451.1_i000_022537	177	390	213	0.950893	0.510791
GCA_002271895.2-Pla_CM008433.1_i000_006831	177	390	213	0.950893	0.510791
GCA_001078395.2-Fun_BBXM02000002.1_i000_002690	190	416	226	1.00893	0.437984
GCA_010723835.1-Fun_BLKC01000085.1_i000_008991	190	416	226	1.00893	0.437984
GCA_010724135.1-Fun_BLKE01000079.1_i000_004780	190	416	226	1.00893	0.437984
GCA_010724255.1-Fun_BLKF01000071.1_i000_007166	190	416	226	1.00893	0.437984
GCA_010724335.1-Fun_BLKG01000098.1_i000_007386	190	416	226	1.00893	0.437984
GCA_010724795.1-Fun_BLKK01000121.1_i000_005389	190	416	226	1.00893	0.437984
GCA_001625215.1-Pla_CM004278.1_i000_002660	177	396	219	0.977679	0.386926
GCA_014466195.1-Ani_CM025365.1_i000_006107	186	411	225	1.00446	0.447316
GCA_003946985.1-Fun_NKCI01000027.1_i000_007769	193	419	226	1.00893	0.438835
GCA_002276475.2-Fun_NCSK02000079.1_i000_007829	192	418	226	1.00893	0.43295
GCA_000143105.2-Fun_GL629767.1_i000_003363	195	418	223	0.995536	0.435547
GCA_014904835.1-Fun_MU120944.1_i000_005663	185	410	225	1.00446	0.409091
GCA_001659605.2-Pla_CM004394.2_i000_015360	177	396	219	0.977679	0.378238
GCA_015852435.1-Fun_JAAAIJ010001805.1_i000_003564	1	180	179	0.799107	0.665428
GCA_018857305.1-Fun_JABCKQ010017470.1_i000_006967	88	306	218	0.973214	0.461864
GCA_016647645.1-Fun_JABBWF010000027.1_i000_008370	183	405	222	0.991071	0.390158
GCA_001651475.1-Pla_CM004363.1_i000_022967	177	396	219	0.977679	0.477124
GCA_001511075.1-Fun_CDMC01000009.1_i000_010622	190	416	226	1.00893	0.443137
GCA_016647785.1-Fun_JABBWK010000015.1_i000_003858	183	405	222	0.991071	0.390158
GCA_904420315.1-Pla_LR881470.1_i000_019220	177	396	219	0.977679	0.477124
GCA_001266575.1-Ani_JTDY01001244.1_i000_005128	149	367	218	0.973214	0.392793
GCA_005498985.1-Fun_CM016686.1_i000_002042	189	412	223	0.995536	0.383162
GCA_001574975.1-Fun_KQ965752.1_i000_006061	182	400	218	0.973214	0.426614
GCA_000512565.2-Fun_KI894033.1_i000_005852	196	421	225	1.00446	0.389948
GCA_003016335.1-Fun_KZ678141.1_i000_013274	192	417	225	1.00446	0.432692
GCA_013396365.1-Ani_VWPP01001457.1_i000_002523	115	340	225	1.00446	0.46875
GCA_000511025.2-Pla_CM002325.2_i000_010953	185	409	224	1	0.431599
GCA_001907595.1-Fun_LFMY01000005.1_i000_006987	190	416	226	1.00893	0.439689
GCA_013368755.1-Fun_CP055899.1_i000_003578	190	416	226	1.00893	0.44227
GCA_016647685.1-Fun_JABBWJ010000036.1_i000_009428	183	405	222	0.991071	0.411874
GCA_003958685.2-Pla_CP039350.1_i000_019361	188	412	224	1	0.405063
GCA_003958685.2-Pla_CP039350.1_i000_019362	188	412	224	1	0.405063
GCA_000340665.1-Pla_CM003608.1_i000_009987	188	412	224	1	0.412523
GCA_006346445.1-Ani_VEVO01000011.1_i000_012956	185	410	225	1.00446	0.40395
GCA_016758755.1-Fun_JABBWM010000003.1_i000_007721	183	405	222	0.991071	0.39292
GCA_016695485.1-Fun_MU172310.1_i000_008926	183	405	222	0.991071	0.392226
GCA_021432605.1-Fun_MU271151.1_i000_008404	194	418	224	1	0.397163
GCA_006783055.1-Ani_VCRD01003279.1_i000_015753	178	404	226	1.00893	0.371711
GCA_010093535.1-Fun_MU003508.1_i000_007964	193	417	224	1	0.421846
GCA_000829775.1-Fun_DF933838.1_i000_002224	180	406	226	1.00893	0.454728
GCA_000149815.1-Fun_DS017020.1_i000_002455	190	415	225	1.00446	0.31337
GCA_014466185.1-Ani_CM025390.1_i000_006106	205	430	225	1.00446	0.431034
GCA_019633425.1-Fun_WSUB01000001.1_i000_000125	181	401	220	0.982143	0.381282
GCA_019633485.1-Fun_WSUC01000001.1_i000_000130	181	401	220	0.982143	0.381282
GCA_022432525.1-Fun_JAJKLB010000003.1_i000_005026	191	416	225	1.00446	0.447316
GCA_000770705.1-Fun_ANFO01001245.1_i000_010743	192	418	226	1.00893	0.44664
GCA_001682635.1-Fun_JRHA01000004.1_i000_005613	192	418	226	1.00893	0.44664
GCA_000151525.2-Fun_ADAS02000145.1_i000_010546	184	409	225	1.00446	0.449102
GCA_000280675.1-Fun_JH725199.1_i000_009308	192	418	226	1.00893	0.44664
GCA_010099065.1-Fun_PPTI01000004.1_i000_005777	192	418	226	1.00893	0.44664
GCA_003184545.1-Fun_MSFL01000001.1_i000_000551	190	416	226	1.00893	0.444008
GCA_004369175.1-Fun_QPFP01000001.1_i000_000701	185	411	226	1.00893	0.427221
GCA_003813205.1-Fun_ML122258.1_i000_004752	184	410	226	1.00893	0.419295
GCA_020499035.1-Fun_JAIBQD010000707.1_i000_008582	190	416	226	1.00893	0.5
GCA_020499245.1-Fun_JAIBQI010001268.1_i000_001241	190	416	226	1.00893	0.5
GCA_020499355.1-Fun_JAIBQU010000892.1_i000_009266	190	416	226	1.00893	0.5
GCA_020500235.1-Fun_JAIBSM010000244.1_i000_004348	190	416	226	1.00893	0.5
GCA_020501355.1-Fun_JAIBUQ010000493.1_i000_006949	190	416	226	1.00893	0.5
GCA_020502385.1-Fun_JAIBWO010001019.1_i000_000205	190	416	226	1.00893	0.5
GCA_001263375.1-Fun_LAVV01006537.1_i000_005274	184	409	225	1.00446	0.439453
GCA_008508345.1-Ani_QNGE01001009.1_i000_003868	185	409	224	1	0.390244
GCA_002871155.1-Fun_MRVG01000002.1_i000_004450	192	418	226	1.00893	0.44664
GCA_001633215.2-Pla_KV784030.1_i000_026367	177	396	219	0.977679	0.384211
GCA_004369135.1-Fun_ML179189.1_i000_012844	185	411	226	1.00893	0.413163
GCA_001191545.1-Fun_LGLR01000248.1_i000_008635	192	416	224	1	0.178771
GCA_003268335.1-Fun_QGDH01000045.1_i000_005849	192	416	224	1	0.178771
GCA_005125345.1-Ani_RWIC01000160.1_i000_005484	184	409	225	1.00446	0.475687
GCA_016628565.1-Fun_JABBWD010000009.1_i000_014653	182	404	222	0.991071	0.382759
GCA_003335185.2-Ani_QKKF02012754.1_i000_006020	186	411	225	1.00446	0.449102
GCA_002966975.2-Pla_PJQY01003962.1_i000_040657	188	412	224	1	0.406534
GCA_000827395.1-Fun_KN824839.1_i000_000865	185	411	226	1.00893	0.40942
GCA_000827315.1-Fun_KN833001.1_i000_011473	142	368	226	1.00893	0.466942
GCA_015342795.1-Ani_CM027194.1_i000_019323	184	408	224	1	0.402154
GCA_002105105.1-Fun_MCFI01000019.1_i000_002694	177	396	219	0.977679	0.41556
GCA_001865875.1-Pla_CM007361.1_i000_001412	188	414	226	1.00893	0.413919
GCA_002197005.1-Ani_CM008011.1_i000_002658	107	178	71	0.316964	0.39011
GCA_016767475.1-Fun_MU179310.1_i000_005984	182	404	222	0.991071	0.410351
GCA_022496205.1-Fun_WTXD01000024.1_i000_005126	185	410	225	1.00446	0.41744
GCA_000934395.1-Fun_KN881650.1_i000_002554	185	411	226	1.00893	0.415441
GCA_003061485.1-Pla_CM009757.1_i000_031499	188	412	224	1	0.407273
GCA_003184645.1-Fun_KZ825942.1_i000_008662	190	416	226	1.00893	0.451098
GCA_002211085.2-Pla_CM008054.2_i000_031930	188	412	224	1	0.407273
GCA_003046395.2-Pla_CM009690.2_i000_001519	188	412	224	1	0.406534
GCA_003046395.2-Pla_CM009691.2_i000_007572	188	412	224	1	0.406534
GCA_905337325.1-Fun_CAJPDR010000008.1_i000_000554	192	418	226	1.00893	0.436293
GCA_017301755.1-Fun_CP054545.1_i000_002808	186	412	226	1.00893	0.406475
GCA_016808335.1-Pla_CM029054.1_i000_077679	188	412	224	1	0.406534
GCA_003813185.1-Fun_ML122048.1_i000_005209	184	410	226	1.00893	0.400709
GCA_000507425.3-Fun_KV700276.1_i000_007081	196	421	225	1.00446	0.393357
GCA_000827265.1-Fun_KN834816.1_i000_017306	167	374	207	0.924107	0.370968
GCA_003635345.1-Fun_QVQW01000020.1_i000_003150	194	418	224	1	0.398577
GCA_007726485.1-Pla_RWGY01000830.1_i000_053878	276	494	218	0.973214	0.334356
GCA_016808335.1-Pla_CM029053.1_i000_039027	188	412	224	1	0.406534
GCA_000149035.1-Fun_GG697349.1_i000_005562	193	419	226	1.00893	0.451098
GCA_022376465.1-Fun_JACDTU010000008.1_i000_011464	178	398	220	0.982143	0.388693
GCA_000349005.2-Fun_AFWA02000014.1_i000_001189	186	412	226	1.00893	0.429658
GCA_008795845.1-Ani_SGJD01002597.1_i000_012621	224	449	225	1.00446	0.426136
GCA_000695605.1-Pla_KK785075.1_i000_018297	22	241	219	0.977679	0.55303
GCA_002234965.2-Fun_NKHV02000049.1_i000_006652	190	416	226	1.00893	0.440546
GCA_002234975.2-Fun_NIDN02000023.1_i000_003960	190	416	226	1.00893	0.440546
GCA_016800925.1-Fun_JABCPU010000062.1_i000_015897	183	405	222	0.991071	0.388792
GCA_000765035.1-Fun_CCBP010000125.1_i000_006059	198	412	214	0.955357	0.362712
GCA_002922495.1-Fun_PJQD01000023.1_i000_002469	183	408	225	1.00446	0.432692
GCA_001445615.2-Fun_BCLY01000004.1_i000_001814	190	416	226	1.00893	0.437984
GCA_012432095.1-Ani_CM022805.1_i000_020803	185	410	225	1.00446	0.415129
GCA_013396295.1-Fun_JAAGWQ010000124.1_i000_006660	192	418	226	1.00893	0.443137
GCA_010723975.1-Fun_BLKD01000005.1_i000_001287	190	416	226	1.00893	0.437984
GCA_010724455.1-Fun_BLKH01000025.1_i000_004840	190	416	226	1.00893	0.437984
GCA_010724575.1-Fun_BLKI01000025.1_i000_004974	190	416	226	1.00893	0.437984
GCA_010724635.1-Fun_BLKJ01000007.1_i000_002108	190	416	226	1.00893	0.437984
GCA_012656335.1-Fun_JAAAPU010000178.1_i000_002607	190	416	226	1.00893	0.437984
GCA_012656375.1-Fun_JAAAPT010000112.1_i000_000547	190	416	226	1.00893	0.437984
GCA_012656395.1-Fun_JAAAPS010000115.1_i000_000621	190	416	226	1.00893	0.437984
GCA_012656435.1-Fun_JAAAPP010000118.1_i000_000763	190	416	226	1.00893	0.437984
GCA_012656445.1-Fun_JAAAPR010000124.1_i000_001063	190	416	226	1.00893	0.437984
GCA_012656455.1-Fun_JAAAPQ010000119.1_i000_000739	190	416	226	1.00893	0.437984
GCA_008009225.1-Pla_CM017762.1_i000_003100	177	396	219	0.977679	0.498861
GCA_015501605.1-Fun_JADNRZ010000001.1_i000_000375	181	402	221	0.986607	0.396057
GCA_004802725.1-Fun_SGPM01000003.1_i000_004743	177	397	220	0.982143	0.223124
GCA_905250015.1-Ani_CAJNOM010000084.1_i000_015392	186	411	225	1.00446	0.471698
GCA_905250115.1-Ani_CAJNOI010000035.1_i000_010268	186	411	225	1.00446	0.471698
GCA_000507405.3-Fun_KI669492.1_i000_000176	196	421	225	1.00446	0.399645
GCA_905250015.1-Ani_CAJNOM010000115.1_i000_018989	186	411	225	1.00446	0.471698
GCA_905250045.1-Ani_CAJNOG010000070.1_i000_009744	186	411	225	1.00446	0.471698
GCA_905250065.1-Ani_CAJNON010000108.1_i000_013366	186	411	225	1.00446	0.471698
GCA_905332015.1-Ani_CAJOAZ010000812.1_i000_013380	186	411	225	1.00446	0.471698
GCA_905332035.1-Ani_CAJOAY010001781.1_i000_023388	186	411	225	1.00446	0.471698
GCA_905250035.1-Ani_CAJNOE010000082.1_i000_011011	186	411	225	1.00446	0.471698
GCA_905332045.1-Ani_CAJOBB010000016.1_i000_000671	186	411	225	1.00446	0.471698
GCA_012923435.1-Pla_JAATIP010000288.1_i000_016794	188	412	224	1	0.416357
GCA_013030025.1-Pla_JAATIQ010000041.1_i000_021181	188	412	224	1	0.416357
GCA_910591945.1-Fun_CAJVPL010001979.1_i000_008788	177	395	218	0.973214	0.494331
GCA_003573695.1-Pla_CM010719.1_i000_017292	187	411	224	1	0.414815
GCA_001718145.1-Ani_LJIJ01000007.1_i000_000352	187	411	224	1	0.453441
GCA_016098085.1-Fun_JAAAIX010000014.1_i000_001814	2	191	189	0.84375	0.694853
GCA_013398855.1-Ani_VZTA01001344.1_i000_000790	114	339	225	1.00446	0.630252
GCA_022376535.1-Fun_JAJJKD010000086.1_i000_011115	191	417	226	1.00893	0.438835
GCA_016647625.1-Fun_JABBWH010000084.1_i000_015868	182	404	222	0.991071	0.390158
GCA_014461115.1-Fun_JACAZE010000006.1_i000_004747	181	401	220	0.982143	0.383275
GCA_010458925.1-Pla_CM021236.1_i000_026665	188	412	224	1	0.34891
GCA_004794785.1-Ani_SJOL01007241.1_i000_007018	180	400	220	0.982143	0.235546
GCA_009771035.1-Pla_CM020005.1_i000_011697	188	414	226	1.00893	0.410909
GCA_010261695.1-Pla_CM021009.1_i000_023897	188	414	226	1.00893	0.410909
GCA_013339905.1-Ani_CM023498.1_i000_002847	214	439	225	1.00446	0.374376
GCA_001642005.1-Ani_LWCA01000064.1_i000_007115	179	394	215	0.959821	0.467391
GCA_900604375.1-Ani_UXSR01005617.1_i000_008966	1456	1680	224	1	0.121872
GCA_000441935.1-Fun_KE525461.1_i000_001427	189	413	224	1	0.414815
GCA_018340605.1-Fun_BHVY01000004.1_i000_006082	190	416	226	1.00893	0.437984
GCA_905338405.1-Ani_CAJPEX010000049.1_i000_000570	970	1196	226	1.00893	0.171602
GCA_017552425.1-Pla_CM029800.1_i000_004116	188	412	224	1	0.405063
GCA_000512585.2-Fun_KI894023.1_i000_006530	196	421	225	1.00446	0.426945
GCA_017552425.1-Pla_CM029810.1_i000_021541	188	412	224	1	0.404332
GCA_000512255.2-Pla_CM008466.1_i000_030161	177	394	217	0.96875	0.390991
GCA_910592245.1-Fun_CAJVQB010016525.1_i000_019632	184	409	225	1.00446	0.442913
GCA_905332105.1-Ani_CAJOBE010013932.1_i000_034715	179	378	199	0.888393	0.526455
GCA_000142905.1-Pro_GL349446.1_i000_003455	185	408	223	0.995536	0.444223
GCA_905250005.1-Ani_CAJNOH010006068.1_i000_035257	186	410	224	1	0.473573
GCA_016647755.1-Fun_JABBWI010000056.1_i000_017177	182	404	222	0.991071	0.390158
GCA_000733215.1-Pla_KL662128.1_i000_003949	181	223	42	0.1875	0.0846774
GCA_000733215.1-Pla_KL662128.1_i000_003949	222	385	163	0.727679	0.328629
GCA_001286725.1-Fun_CYGV01001112.1_i000_003676	360	583	223	0.995536	0.296543
GCA_004802665.1-Fun_SGPJ01000076.1_i000_007535	183	399	216	0.964286	0.228089
GCA_000409485.1-Fun_KE145372.1_i000_012174	193	418	225	1.00446	0.433526
GCA_003666305.1-Pro_QUTI01025354.1_i000_007826	300	524	224	1	0.377104
GCA_900536885.1-Fun_UWZB01000734.1_i000_015465	180	399	219	0.977679	0.382199
GCA_016628075.1-Fun_JABBWC010000027.1_i000_007636	182	404	222	0.991071	0.389474
GCA_000146465.1-Fun_CP001945.1_i000_000523	156	377	221	0.986607	0.536408
GCA_000001985.1-Fun_DS995904.1_i000_002183	190	416	226	1.00893	0.445759
GCA_009556855.1-Fun_CP045654.1_i000_003311	190	416	226	1.00893	0.445759
GCA_009650675.1-Fun_CM018878.1_i000_008204	190	416	226	1.00893	0.445759
GCA_000611955.2-Ani_KK114435.1_i000_005994	182	407	225	1.00446	0.36645
GCA_004355905.1-Fun_RRCK01000007.1_i000_011231	195	419	224	1	0.436647
GCA_002849105.1-Fun_MSFO01000002.1_i000_005231	190	416	226	1.00893	0.435453
GCA_020500115.1-Fun_JAIBRV010000165.1_i000_002600	190	416	226	1.00893	0.43295
GCA_020503545.1-Fun_JAIBYK010000218.1_i000_003628	190	416	226	1.00893	0.43295
GCA_000002655.1-Fun_CM000171.1_i000_004036	190	416	226	1.00893	0.43295
GCA_000150145.1-Fun_DS499596.1_i000_005732	190	416	226	1.00893	0.43295
GCA_001029325.1-Fun_KQ087362.1_i000_003402	190	416	226	1.00893	0.43295
GCA_002234955.1-Fun_NKHT01000250.1_i000_004237	190	416	226	1.00893	0.43295
GCA_012656115.1-Fun_JAAAQC010000252.1_i000_003843	190	416	226	1.00893	0.43295
GCA_012656125.1-Fun_JAAAQD010000212.1_i000_003215	190	416	226	1.00893	0.43295
GCA_012656165.1-Fun_JAAAQB010000265.1_i000_003398	190	416	226	1.00893	0.43295
GCA_012656185.1-Fun_JAAAQA010000738.1_i000_007865	190	416	226	1.00893	0.43295
GCA_012656215.1-Fun_JAAAPZ010000249.1_i000_003505	190	416	226	1.00893	0.43295
GCA_020498755.1-Fun_JAIBPP010000189.1_i000_002520	190	416	226	1.00893	0.43295
GCA_020498765.1-Fun_JAIBPQ010000247.1_i000_004029	190	416	226	1.00893	0.43295
GCA_020498815.1-Fun_JAIBPS010000193.1_i000_003452	190	416	226	1.00893	0.43295
GCA_020498895.1-Fun_JAIBPU010000242.1_i000_003922	190	416	226	1.00893	0.43295
GCA_020498965.1-Fun_JAIBPZ010000137.1_i000_001629	190	416	226	1.00893	0.43295
GCA_020499005.1-Fun_JAIBQC010000314.1_i000_005565	190	416	226	1.00893	0.43295
GCA_020499015.1-Fun_JAIBQB010000173.1_i000_002918	190	416	226	1.00893	0.43295
GCA_020499045.1-Fun_JAIBQE010000264.1_i000_004367	190	416	226	1.00893	0.43295
GCA_020499115.1-Fun_JAIBQG010000203.1_i000_003555	190	416	226	1.00893	0.43295
GCA_020499185.1-Fun_JAIBQL010000226.1_i000_003904	190	416	226	1.00893	0.43295
GCA_020499195.1-Fun_JAIBQM010000223.1_i000_003784	190	416	226	1.00893	0.43295
GCA_020499225.1-Fun_JAIBQN010000210.1_i000_003617	190	416	226	1.00893	0.43295
GCA_020499325.1-Fun_JAIBQS010000209.1_i000_003501	190	416	226	1.00893	0.43295
GCA_020499335.1-Fun_JAIBQT010000151.1_i000_002064	190	416	226	1.00893	0.43295
GCA_020499405.1-Fun_JAIBQW010000185.1_i000_002757	190	416	226	1.00893	0.43295
GCA_020499415.1-Fun_JAIBQX010000189.1_i000_003059	190	416	226	1.00893	0.43295
GCA_020499455.1-Fun_JAIBQY010000186.1_i000_002764	190	416	226	1.00893	0.43295
GCA_020499485.1-Fun_JAIBRA010000198.1_i000_003226	190	416	226	1.00893	0.43295
GCA_020499495.1-Fun_JAIBRB010000144.1_i000_001660	190	416	226	1.00893	0.43295
GCA_020499505.1-Fun_JAIBRC010000202.1_i000_003475	190	416	226	1.00893	0.43295
GCA_020499645.1-Fun_JAIBRJ010000208.1_i000_003493	190	416	226	1.00893	0.43295
GCA_020499675.1-Fun_JAIBRZ010000072.1_i000_008113	190	416	226	1.00893	0.43295
GCA_020499685.1-Fun_JAIBSA010000155.1_i000_002269	190	416	226	1.00893	0.43295
GCA_020499755.1-Fun_JAIBSC010000024.1_i000_003789	190	416	226	1.00893	0.43295
GCA_020499775.1-Fun_JAIBSD010000016.1_i000_002347	190	416	226	1.00893	0.43295
GCA_020499805.1-Fun_JAIBSF010000160.1_i000_002490	190	416	226	1.00893	0.43295
GCA_020499815.1-Fun_JAIBSG010000077.1_i000_008217	190	416	226	1.00893	0.43295
GCA_020499825.1-Fun_JAIBSH010000149.1_i000_002215	190	416	226	1.00893	0.43295
GCA_020499865.1-Fun_JAIBSI010000163.1_i000_002398	190	416	226	1.00893	0.43295
GCA_020499885.1-Fun_JAIBRH010000190.1_i000_003085	190	416	226	1.00893	0.43295
GCA_020499905.1-Fun_JAIBRK010000175.1_i000_002880	190	416	226	1.00893	0.43295
GCA_020499915.1-Fun_JAIBRL010000024.1_i000_003998	190	416	226	1.00893	0.43295
GCA_020500085.1-Fun_JAIBRS010000151.1_i000_002199	190	416	226	1.00893	0.43295
GCA_020500185.1-Fun_JAIBSL010000048.1_i000_006243	190	416	226	1.00893	0.43295
GCA_020500285.1-Fun_JAIBSP010000142.1_i000_001865	190	416	226	1.00893	0.43295
GCA_020500295.1-Fun_JAIBSN010000128.1_i000_001507	190	416	226	1.00893	0.43295
GCA_020500355.1-Fun_JAIBSS010000145.1_i000_001975	190	416	226	1.00893	0.43295
GCA_020500365.1-Fun_JAIBSR010000143.1_i000_001996	190	416	226	1.00893	0.43295
GCA_020500385.1-Fun_JAIBST010000135.1_i000_001599	190	416	226	1.00893	0.43295
GCA_020500395.1-Fun_JAIBSU010000162.1_i000_002531	190	416	226	1.00893	0.43295
GCA_020500445.1-Fun_JAIBSV010000151.1_i000_002260	190	416	226	1.00893	0.43295
GCA_020500455.1-Fun_JAIBSW010000132.1_i000_001672	190	416	226	1.00893	0.43295
GCA_020500465.1-Fun_JAIBSY010000032.1_i000_004820	190	416	226	1.00893	0.43295
GCA_020500475.1-Fun_JAIBSX010000140.1_i000_001956	190	416	226	1.00893	0.43295
GCA_020500555.1-Fun_JAIBTD010000155.1_i000_002387	190	416	226	1.00893	0.43295
GCA_020500565.1-Fun_JAIBTE010000172.1_i000_002755	190	416	226	1.00893	0.43295
GCA_020500595.1-Fun_JAIBTF010000141.1_i000_001824	190	416	226	1.00893	0.43295
GCA_020500605.1-Fun_JAIBTG010000090.1_i000_009165	190	416	226	1.00893	0.43295
GCA_020500645.1-Fun_JAIBTH010000030.1_i000_004542	190	416	226	1.00893	0.43295
GCA_020500655.1-Fun_JAIBTI010000137.1_i000_001683	190	416	226	1.00893	0.43295
GCA_020500685.1-Fun_JAIBTJ010000155.1_i000_002326	190	416	226	1.00893	0.43295
GCA_020500695.1-Fun_JAIBTK010000161.1_i000_002394	190	416	226	1.00893	0.43295
GCA_020500705.1-Fun_JAIBTL010000072.1_i000_008100	190	416	226	1.00893	0.43295
GCA_020500785.1-Fun_JAIBTN010000075.1_i000_008207	190	416	226	1.00893	0.43295
GCA_020500805.1-Fun_JAIBTO010000071.1_i000_007864	190	416	226	1.00893	0.43295
GCA_020500815.1-Fun_JAIBTP010000128.1_i000_001447	190	416	226	1.00893	0.43295
GCA_020500845.1-Fun_JAIBTQ010000124.1_i000_001364	190	416	226	1.00893	0.43295
GCA_020500875.1-Fun_JAIBTR010000139.1_i000_001676	190	416	226	1.00893	0.43295
GCA_020500945.1-Fun_JAIBTV010000248.1_i000_004540	190	416	226	1.00893	0.43295
GCA_020501075.1-Fun_JAIBUB010000157.1_i000_002296	190	416	226	1.00893	0.43295
GCA_020501175.1-Fun_JAIBUH010000219.1_i000_003470	190	416	226	1.00893	0.43295
GCA_020501245.1-Fun_JAIBUK010000214.1_i000_003748	190	416	226	1.00893	0.43295
GCA_020501265.1-Fun_JAIBUM010000160.1_i000_002509	190	416	226	1.00893	0.43295
GCA_020501375.1-Fun_JAIBUR010000202.1_i000_003370	190	416	226	1.00893	0.43295
GCA_020501425.1-Fun_JAIBUT010000155.1_i000_002248	190	416	226	1.00893	0.43295
GCA_020501465.1-Fun_JAIBUV010000220.1_i000_003664	190	416	226	1.00893	0.43295
GCA_020501475.1-Fun_JAIBUX010000200.1_i000_003401	190	416	226	1.00893	0.43295
GCA_020501495.1-Fun_JAIBUW010000171.1_i000_002832	190	416	226	1.00893	0.43295
GCA_020501535.1-Fun_JAIBUY010000128.1_i000_001484	190	416	226	1.00893	0.43295
GCA_020501615.1-Fun_JAIBVD010000211.1_i000_003816	190	416	226	1.00893	0.43295
GCA_020501695.1-Fun_JAIBVG010000215.1_i000_003766	190	416	226	1.00893	0.43295
GCA_020501705.1-Fun_JAIBVI010000248.1_i000_004247	190	416	226	1.00893	0.43295
GCA_020501735.1-Fun_JAIBVJ010000216.1_i000_003763	190	416	226	1.00893	0.43295
GCA_020501765.1-Fun_JAIBVK010000193.1_i000_003168	190	416	226	1.00893	0.43295
GCA_020501785.1-Fun_JAIBVL010000279.1_i000_004796	190	416	226	1.00893	0.43295
GCA_020501835.1-Fun_JAIBVN010000231.1_i000_004104	190	416	226	1.00893	0.43295
GCA_020501875.1-Fun_JAIBVP010000055.1_i000_007394	190	416	226	1.00893	0.43295
GCA_020501905.1-Fun_JAIBVS010000182.1_i000_003384	190	416	226	1.00893	0.43295
GCA_020501935.1-Fun_JAIBVT010000072.1_i000_008166	190	416	226	1.00893	0.43295
GCA_020501995.1-Fun_JAIBVV010000215.1_i000_004453	190	416	226	1.00893	0.43295
GCA_020502045.1-Fun_JAIBVZ010000177.1_i000_002903	190	416	226	1.00893	0.43295
GCA_020502095.1-Fun_JAIBWA010000179.1_i000_002791	190	416	226	1.00893	0.43295
GCA_020502105.1-Fun_JAIBWB010000153.1_i000_002165	190	416	226	1.00893	0.43295
GCA_020502115.1-Fun_JAIBWC010000219.1_i000_003581	190	416	226	1.00893	0.43295
GCA_020502215.1-Fun_JAIBWG010000226.1_i000_003978	190	416	226	1.00893	0.43295
GCA_020502235.1-Fun_JAIBWJ010000211.1_i000_003848	190	416	226	1.00893	0.43295
GCA_020502245.1-Fun_JAIBWI010000209.1_i000_003475	190	416	226	1.00893	0.43295
GCA_020502335.1-Fun_JAIBWL010000072.1_i000_008315	190	416	226	1.00893	0.43295
GCA_020502365.1-Fun_JAIBWM010000225.1_i000_003795	190	416	226	1.00893	0.43295
GCA_020502435.1-Fun_JAIBWQ010000187.1_i000_002884	190	416	226	1.00893	0.43295
GCA_020502485.1-Fun_JAIBWS010000134.1_i000_001350	190	416	226	1.00893	0.43295
GCA_020502545.1-Fun_JAIBWV010000185.1_i000_002937	190	416	226	1.00893	0.43295
GCA_020502605.1-Fun_JAIBWY010000203.1_i000_003414	190	416	226	1.00893	0.43295
GCA_020502615.1-Fun_JAIBWZ010000186.1_i000_002862	190	416	226	1.00893	0.43295
GCA_020502675.1-Fun_JAIBXB010000210.1_i000_003520	190	416	226	1.00893	0.43295
GCA_020502695.1-Fun_JAIBXC010000019.1_i000_003279	190	416	226	1.00893	0.43295
GCA_020502725.1-Fun_JAIBXF010000195.1_i000_002894	190	416	226	1.00893	0.43295
GCA_020502985.1-Fun_JAIBXH010000249.1_i000_004212	190	416	226	1.00893	0.43295
GCA_020503055.1-Fun_JAIBXK010000403.1_i000_006418	190	416	226	1.00893	0.43295
GCA_020503085.1-Fun_JAIBXM010000222.1_i000_003525	190	416	226	1.00893	0.43295
GCA_020503105.1-Fun_JAIBXO010000229.1_i000_004031	190	416	226	1.00893	0.43295
GCA_020503175.1-Fun_JAIBXP010000188.1_i000_003061	190	416	226	1.00893	0.43295
GCA_020503185.1-Fun_JAIBXR010000186.1_i000_002911	190	416	226	1.00893	0.43295
GCA_020503245.1-Fun_JAIBXU010000198.1_i000_003059	190	416	226	1.00893	0.43295
GCA_020503265.1-Fun_JAIBXV010000188.1_i000_002801	190	416	226	1.00893	0.43295
GCA_020503275.1-Fun_JAIBXW010000221.1_i000_003629	190	416	226	1.00893	0.43295
GCA_020503295.1-Fun_JAIBXX010000304.1_i000_004154	190	416	226	1.00893	0.43295
GCA_020503305.1-Fun_JAIBXY010000177.1_i000_002623	190	416	226	1.00893	0.43295
GCA_020503345.1-Fun_JAIBXZ010000223.1_i000_003783	190	416	226	1.00893	0.43295
GCA_020503375.1-Fun_JAIBYB010000178.1_i000_002783	190	416	226	1.00893	0.43295
GCA_020503445.1-Fun_JAIBYF010000210.1_i000_003789	190	416	226	1.00893	0.43295
GCA_020503455.1-Fun_JAIBYD010000203.1_i000_003445	190	416	226	1.00893	0.43295
GCA_020503465.1-Fun_JAIBYG010000238.1_i000_003928	190	416	226	1.00893	0.43295
GCA_020503535.1-Fun_JAIBYI010000229.1_i000_003757	190	416	226	1.00893	0.43295
GCA_020503555.1-Fun_JAIBYJ010000246.1_i000_004184	190	416	226	1.00893	0.43295
GCA_020503565.1-Fun_JAIBYL010000223.1_i000_003596	190	416	226	1.00893	0.43295
GCA_020503595.1-Fun_JAIBYM010000220.1_i000_003840	190	416	226	1.00893	0.43295
GCA_020503665.1-Fun_JAIBYP010000225.1_i000_003724	190	416	226	1.00893	0.43295
GCA_020503705.1-Fun_JAIBYQ010000191.1_i000_003205	190	416	226	1.00893	0.43295
GCA_020503745.1-Fun_JAIBYU010000187.1_i000_003001	190	416	226	1.00893	0.43295
GCA_020503795.1-Fun_JAIBYX010000190.1_i000_003377	190	416	226	1.00893	0.43295
GCA_020503805.1-Fun_JAIBYW010000227.1_i000_003803	190	416	226	1.00893	0.43295
GCA_020503815.1-Fun_JAIBYV010000214.1_i000_003665	190	416	226	1.00893	0.43295
GCA_020503895.1-Fun_JAIBZA010000177.1_i000_002860	190	416	226	1.00893	0.43295
GCA_020503905.1-Fun_JAIBZB010000176.1_i000_002954	190	416	226	1.00893	0.43295
GCA_020503915.1-Fun_JAIBZC010000177.1_i000_002831	190	416	226	1.00893	0.43295
GCA_021605095.1-Ani_BPLR01013118.1_i000_049989	218	440	222	0.991071	0.435294
GCA_003546625.1-Pro_QUTC01008356.1_i000_011391	300	524	224	1	0.377104
GCA_007726485.1-Pla_CM017443.1_i000_024195	188	413	225	1.00446	0.414365
GCA_011766145.1-Pla_BLLF01000053.1_i000_001211	189	412	223	0.995536	0.447791
GCA_021605095.1-Ani_BPLR01019448.1_i000_074193	180	401	221	0.986607	0.440239
GCA_003546545.1-Pro_QUTB01005128.1_i000_006320	300	524	224	1	0.377104
GCA_003546585.1-Pro_QUTD01010901.1_i000_013188	300	524	224	1	0.377104
GCA_003546605.1-Pro_QUTA01000633.1_i000_000342	300	524	224	1	0.377104
GCA_003546805.1-Pro_QUTE01007990.1_i000_003918	300	524	224	1	0.377104
GCA_009761265.1-Ani_VOSG01000685.1_i000_008861	178	397	219	0.977679	0.455301
GCA_020499785.1-Fun_JAIBSE010000170.1_i000_002794	190	416	226	1.00893	0.430476
GCA_020499935.1-Fun_JAIBRM010000198.1_i000_003242	190	416	226	1.00893	0.430476
GCA_020501045.1-Fun_JAIBUA010000182.1_i000_002862	190	416	226	1.00893	0.430476
GCA_020510485.1-Fun_JAIBQR010000150.1_i000_002086	190	416	226	1.00893	0.430476
GCA_018854895.1-Fun_JABAJV010000084.1_i000_002056	182	401	219	0.977679	0.382867
GCA_014925785.1-Fun_WIQG01000069.1_i000_042975	187	413	226	1.00893	0.426415
GCA_011766145.1-Pla_BLLF01000353.1_i000_005333	137	347	210	0.9375	0.433884
GCA_020498725.1-Fun_JAIBPO010000177.1_i000_002725	190	416	226	1.00893	0.435453
GCA_020498735.1-Fun_JAIBPN010000193.1_i000_002856	190	416	226	1.00893	0.435453
GCA_020498745.1-Fun_JAIBPM010000215.1_i000_003571	190	416	226	1.00893	0.435453
GCA_020498905.1-Fun_JAIBPX010000047.1_i000_006500	190	416	226	1.00893	0.435453
GCA_020498945.1-Fun_JAIBPY010000162.1_i000_002471	190	416	226	1.00893	0.435453
GCA_020498985.1-Fun_JAIBQA010000156.1_i000_002264	190	416	226	1.00893	0.435453
GCA_020499075.1-Fun_JAIBQF010000193.1_i000_003113	190	416	226	1.00893	0.435453
GCA_020499135.1-Fun_JAIBQJ010000199.1_i000_003299	190	416	226	1.00893	0.435453
GCA_020499475.1-Fun_JAIBQZ010000194.1_i000_002875	190	416	226	1.00893	0.435453
GCA_020499565.1-Fun_JAIBRD010000196.1_i000_003089	190	416	226	1.00893	0.435453
GCA_020499585.1-Fun_JAIBRG010000223.1_i000_003838	190	416	226	1.00893	0.435453
GCA_020499695.1-Fun_JAIBRY010000160.1_i000_002507	190	416	226	1.00893	0.435453
GCA_020499715.1-Fun_JAIBSB010000151.1_i000_002341	190	416	226	1.00893	0.435453
GCA_020499975.1-Fun_JAIBRN010000173.1_i000_002856	190	416	226	1.00893	0.435453
GCA_020499985.1-Fun_JAIBRO010000048.1_i000_006413	190	416	226	1.00893	0.435453
GCA_020499995.1-Fun_JAIBRP010000175.1_i000_002912	190	416	226	1.00893	0.435453
GCA_020500025.1-Fun_JAIBRQ010000317.1_i000_004977	190	416	226	1.00893	0.435453
GCA_020500065.1-Fun_JAIBRT010000250.1_i000_004179	190	416	226	1.00893	0.435453
GCA_020500075.1-Fun_JAIBRR010000368.1_i000_005892	190	416	226	1.00893	0.435453
GCA_020500105.1-Fun_JAIBRU010000037.1_i000_005904	190	416	226	1.00893	0.435453
GCA_020500165.1-Fun_JAIBRW010000191.1_i000_003068	190	416	226	1.00893	0.435453
GCA_020500195.1-Fun_JAIBRX010000218.1_i000_003842	190	416	226	1.00893	0.435453
GCA_020500205.1-Fun_JAIBSJ010000010.1_i000_000360	190	416	226	1.00893	0.435453
GCA_020500275.1-Fun_JAIBSO010000167.1_i000_002610	190	416	226	1.00893	0.435453
GCA_020500485.1-Fun_JAIBSZ010000162.1_i000_002528	190	416	226	1.00893	0.435453
GCA_020500545.1-Fun_JAIBTC010000242.1_i000_003783	190	416	226	1.00893	0.435453
GCA_020500765.1-Fun_JAIBTA010000148.1_i000_001988	190	416	226	1.00893	0.435453
GCA_020500775.1-Fun_JAIBTM010000020.1_i000_003397	190	416	226	1.00893	0.435453
GCA_020500865.1-Fun_JAIBTS010000148.1_i000_002162	190	416	226	1.00893	0.435453
GCA_020500935.1-Fun_JAIBTU010000139.1_i000_001700	190	416	226	1.00893	0.435453
GCA_020500995.1-Fun_JAIBTY010000188.1_i000_002864	190	416	226	1.00893	0.435453
GCA_020501095.1-Fun_JAIBUC010000182.1_i000_002964	190	416	226	1.00893	0.435453
GCA_020501105.1-Fun_JAIBUE010000195.1_i000_003206	190	416	226	1.00893	0.435453
GCA_020501185.1-Fun_JAIBUI010000169.1_i000_002620	190	416	226	1.00893	0.435453
GCA_020501255.1-Fun_JAIBUO010000226.1_i000_003799	190	416	226	1.00893	0.435453
GCA_020501335.1-Fun_JAIBUN010000191.1_i000_003088	190	416	226	1.00893	0.435453
GCA_020501545.1-Fun_JAIBUZ010000198.1_i000_003017	190	416	226	1.00893	0.435453
GCA_020501555.1-Fun_JAIBVA010000191.1_i000_003022	190	416	226	1.00893	0.435453
GCA_020501575.1-Fun_JAIBVB010000184.1_i000_002974	190	416	226	1.00893	0.435453
GCA_020501605.1-Fun_JAIBVC010000046.1_i000_006424	190	416	226	1.00893	0.435453
GCA_020501645.1-Fun_JAIBVF010000173.1_i000_002749	190	416	226	1.00893	0.435453
GCA_020501715.1-Fun_JAIBVH010000186.1_i000_002886	190	416	226	1.00893	0.435453
GCA_020501805.1-Fun_JAIBVM010000180.1_i000_002788	190	416	226	1.00893	0.435453
GCA_020501885.1-Fun_JAIBVR010000171.1_i000_002631	190	416	226	1.00893	0.435453
GCA_020501895.1-Fun_JAIBVQ010000183.1_i000_002876	190	416	226	1.00893	0.435453
GCA_020502025.1-Fun_JAIBVX010000175.1_i000_002764	190	416	226	1.00893	0.435453
GCA_020502035.1-Fun_JAIBVY010000196.1_i000_003339	190	416	226	1.00893	0.435453
GCA_020502225.1-Fun_JAIBWH010000187.1_i000_002886	190	416	226	1.00893	0.435453
GCA_020502325.1-Fun_JAIBWK010000182.1_i000_002900	190	416	226	1.00893	0.435453
GCA_020502375.1-Fun_JAIBWN010000194.1_i000_003063	190	416	226	1.00893	0.435453
GCA_020502455.1-Fun_JAIBWR010000196.1_i000_003065	190	416	226	1.00893	0.435453
GCA_020502495.1-Fun_JAIBWT010000253.1_i000_004375	190	416	226	1.00893	0.435453
GCA_020502575.1-Fun_JAIBWW010000197.1_i000_003092	190	416	226	1.00893	0.435453
GCA_020502625.1-Fun_JAIBXA010000201.1_i000_003360	190	416	226	1.00893	0.435453
GCA_020502715.1-Fun_JAIBXE010000203.1_i000_003376	190	416	226	1.00893	0.435453
GCA_020502875.1-Fun_JAIBXG010000207.1_i000_003326	190	416	226	1.00893	0.435453
GCA_020503065.1-Fun_JAIBXL010000188.1_i000_003002	190	416	226	1.00893	0.435453
GCA_020503095.1-Fun_JAIBXN010000180.1_i000_002687	190	416	226	1.00893	0.435453
GCA_020503205.1-Fun_JAIBXS010000214.1_i000_003665	190	416	226	1.00893	0.435453
GCA_020503365.1-Fun_JAIBYA010000194.1_i000_003141	190	416	226	1.00893	0.435453
GCA_020503395.1-Fun_JAIBYC010000186.1_i000_002766	190	416	226	1.00893	0.435453
GCA_020503435.1-Fun_JAIBYE010000188.1_i000_002990	190	416	226	1.00893	0.435453
GCA_020503515.1-Fun_JAIBYH010000256.1_i000_004352	190	416	226	1.00893	0.435453
GCA_020503635.1-Fun_JAIBYN010000268.1_i000_004325	190	416	226	1.00893	0.435453
GCA_020503725.1-Fun_JAIBYS010000186.1_i000_002966	190	416	226	1.00893	0.435453
GCA_020503735.1-Fun_JAIBYT010000155.1_i000_002267	190	416	226	1.00893	0.435453
GCA_020503825.1-Fun_JAIBYY010000199.1_i000_003384	190	416	226	1.00893	0.435453
GCA_020503885.1-Fun_JAIBYZ010000171.1_i000_002931	190	416	226	1.00893	0.435453
GCA_003268315.1-Fun_QGDG01000036.1_i000_004578	192	416	224	1	0.156973
GCA_004837865.1-Pla_CM017196.1_i000_025187	188	412	224	1	0.401434
GCA_000731615.1-Fun_JHOI01000506.1_i000_002612	190	416	226	1.00893	0.43295
GCA_002234985.1-Fun_NKHS01000237.1_i000_003711	190	416	226	1.00893	0.43295
GCA_020498805.1-Fun_JAIBPR010000204.1_i000_003659	190	416	226	1.00893	0.43295
GCA_020498865.1-Fun_JAIBPV010000185.1_i000_003021	190	416	226	1.00893	0.43295
GCA_020498875.1-Fun_JAIBPW010000171.1_i000_002733	190	416	226	1.00893	0.43295
GCA_020498885.1-Fun_JAIBPT010000193.1_i000_002921	190	416	226	1.00893	0.43295
GCA_020499155.1-Fun_JAIBQK010000067.1_i000_007810	190	416	226	1.00893	0.43295
GCA_020499255.1-Fun_JAIBQP010000208.1_i000_003475	190	416	226	1.00893	0.43295
GCA_020499265.1-Fun_JAIBQO010000188.1_i000_003031	190	416	226	1.00893	0.43295
GCA_020499315.1-Fun_JAIBQQ010000124.1_i000_001127	190	416	226	1.00893	0.43295
GCA_020499395.1-Fun_JAIBQV010000274.1_i000_004695	190	416	226	1.00893	0.43295
GCA_020499575.1-Fun_JAIBRE010000230.1_i000_004073	190	416	226	1.00893	0.43295
GCA_020499595.1-Fun_JAIBRF010000210.1_i000_003578	190	416	226	1.00893	0.43295
GCA_020499605.1-Fun_JAIBRI010000040.1_i000_006222	190	416	226	1.00893	0.43295
GCA_020500215.1-Fun_JAIBSK010000105.1_i000_000571	190	416	226	1.00893	0.43295
GCA_020500305.1-Fun_JAIBSQ010000010.1_i000_000366	190	416	226	1.00893	0.43295
GCA_020500535.1-Fun_JAIBTB010000007.1_i000_008238	190	416	226	1.00893	0.43295
GCA_020500905.1-Fun_JAIBTT010000078.1_i000_008209	190	416	226	1.00893	0.43295
GCA_020500965.1-Fun_JAIBTW010000202.1_i000_003552	190	416	226	1.00893	0.43295
GCA_020500975.1-Fun_JAIBTX010000233.1_i000_003997	190	416	226	1.00893	0.43295
GCA_020501005.1-Fun_JAIBTZ010000159.1_i000_002385	190	416	226	1.00893	0.43295
GCA_020501115.1-Fun_JAIBUD010000224.1_i000_003610	190	416	226	1.00893	0.43295
GCA_020501135.1-Fun_JAIBUF010000238.1_i000_004129	190	416	226	1.00893	0.43295
GCA_020501145.1-Fun_JAIBUG010000201.1_i000_003287	190	416	226	1.00893	0.43295
GCA_020501235.1-Fun_JAIBUJ010000207.1_i000_003161	190	416	226	1.00893	0.43295
GCA_020501325.1-Fun_JAIBUL010000044.1_i000_006500	190	416	226	1.00893	0.43295
GCA_020501345.1-Fun_JAIBUP010000039.1_i000_006154	190	416	226	1.00893	0.43295
GCA_020501635.1-Fun_JAIBVE010000074.1_i000_008165	190	416	226	1.00893	0.43295
GCA_020501815.1-Fun_JAIBVO010000119.1_i000_001006	190	416	226	1.00893	0.43295
GCA_020501985.1-Fun_JAIBVU010000049.1_i000_006485	190	416	226	1.00893	0.43295
GCA_020502005.1-Fun_JAIBVW010000189.1_i000_003062	190	416	226	1.00893	0.43295
GCA_020502125.1-Fun_JAIBWD010000213.1_i000_003609	190	416	226	1.00893	0.43295
GCA_020502165.1-Fun_JAIBWE010000172.1_i000_002596	190	416	226	1.00893	0.43295
GCA_020502185.1-Fun_JAIBWF010000257.1_i000_004479	190	416	226	1.00893	0.43295
GCA_020502525.1-Fun_JAIBWU010000208.1_i000_003339	190	416	226	1.00893	0.43295
GCA_020502595.1-Fun_JAIBWX010000186.1_i000_002933	190	416	226	1.00893	0.43295
GCA_020502705.1-Fun_JAIBXD010000048.1_i000_007065	190	416	226	1.00893	0.43295
GCA_020502995.1-Fun_JAIBXI010000103.1_i000_000312	190	416	226	1.00893	0.43295
GCA_020503015.1-Fun_JAIBXJ010000261.1_i000_004529	190	416	226	1.00893	0.43295
GCA_020503195.1-Fun_JAIBXT010000219.1_i000_003622	190	416	226	1.00893	0.43295
GCA_020503645.1-Fun_JAIBYO010000177.1_i000_002594	190	416	226	1.00893	0.43295
GCA_020503715.1-Fun_JAIBYR010000107.1_i000_000412	190	416	226	1.00893	0.43295
GCA_020503935.1-Fun_JAIBZD010000198.1_i000_003178	190	416	226	1.00893	0.43295
GCA_001865875.1-Pla_CM007361.1_i000_001890	188	414	226	1.00893	0.418519
GCA_009809945.1-Fun_WTPW01002398.1_i000_023451	185	410	225	1.00446	0.439453
GCA_020501445.1-Fun_JAIBUU010000196.1_i000_003322	190	416	226	1.00893	0.430476
GCA_020502425.1-Fun_JAIBWP010000028.1_i000_004901	190	416	226	1.00893	0.430476
GCA_020503165.1-Fun_JAIBXQ010000119.1_i000_000945	190	416	226	1.00893	0.430476
GCA_021028975.1-Ani_CM037623.1_i000_020866	187	411	224	1	0.417132
GCA_001636735.1-Fun_AZHA01000002.1_i000_003015	192	418	226	1.00893	0.44664
GCA_000204055.1-Fun_GL883100.1_i000_004565	184	408	224	1	0.415584
GCA_000149405.2-Pro_CM000642.1_i000_004333	198	422	224	1	0.511416
GCA_020169585.1-Pla_CM034980.1_i000_017074	177	395	218	0.973214	0.402957
GCA_000149645.3-Fun_DS027690.1_i000_006225	190	416	226	1.00893	0.437984
GCA_016748045.1-Fun_WHVT01000010.1_i000_000299	190	416	226	1.00893	0.437984
GCA_018107945.1-Pla_JACEIK010009659.1_i000_047374	177	395	218	0.973214	0.391382
GCA_004337985.1-Fun_CM014987.1_i000_004988	195	419	224	1	0.436647
GCA_022376455.1-Fun_JACBKO010000004.1_i000_007804	169	390	221	0.986607	0.39254
GCA_003327735.1-Fun_QLNQ01000028.1_i000_006976	180	400	220	0.982143	0.42065
GCA_003186165.1-Ani_CP026248.1_i000_006261	273	498	225	1.00446	0.348837
GCA_904845305.1-Ani_CAJGYM010000005.1_i000_002776	188	414	226	1.00893	0.350388
GCA_000499845.1-Pla_CM002290.1_i000_008375	188	412	224	1	0.405063
GCA_000204055.1-Fun_GL883105.1_i000_006180	182	400	218	0.973214	0.405959
GCA_002847465.1-Fun_MSZS01000006.1_i000_009418	190	416	226	1.00893	0.437984
GCA_020501405.1-Fun_JAIBUS010000179.1_i000_002853	190	416	226	1.00893	0.420857
GCA_001633215.2-Pla_KV774956.1_i000_005785	188	413	225	1.00446	0.339367
GCA_003546785.1-Pro_QUTF01017631.1_i000_011736	240	464	224	1	0.419476
GCA_905332335.1-Ani_CAJOBX010027779.1_i000_029539	192	417	225	1.00446	0.365854
GCA_012656225.1-Fun_JAAAPY010000150.1_i000_002024	190	416	226	1.00893	0.435453
GCA_012656285.1-Fun_JAAAPX010000138.1_i000_001626	190	416	226	1.00893	0.435453
GCA_012656295.1-Fun_JAAAPW010000152.1_i000_002137	190	416	226	1.00893	0.435453
GCA_012656325.1-Fun_JAAAPV010000157.1_i000_002321	190	416	226	1.00893	0.435453
GCA_004681135.1-Fun_SFCI01000053.1_i000_008198	185	411	226	1.00893	0.429658
GCA_003546565.1-Pro_QUSZ01001903.1_i000_000162	240	464	224	1	0.419476
GCA_020497125.1-Ani_CM035637.1_i000_009358	184	408	224	1	0.359551
GCA_002217885.1-Pro_BDSP01000202.1_i000_011732	196	420	224	1	0.420263
GCA_020497125.1-Ani_CM035637.1_i000_009344	184	408	224	1	0.359551
GCA_905332375.1-Ani_CAJOBZ010000023.1_i000_008825	180	398	218	0.973214	0.37913
GCA_009733125.1-Pro_QXFY01000090.1_i000_003069	222	446	224	1	0.413284
GCA_000151355.1-Fun_GG698905.1_i000_005989	195	421	226	1.00893	0.438835
GCA_000512605.2-Fun_KI894010.1_i000_003554	196	421	225	1.00446	0.39823
GCA_009729455.1-Pro_QWGH01000002.1_i000_010785	222	446	224	1	0.413284
GCA_009732925.1-Pro_QXFW01000083.1_i000_002709	222	446	224	1	0.413284
GCA_009732985.1-Pro_QXGB01000100.1_i000_003415	222	446	224	1	0.413284
GCA_009733005.1-Pro_QXFX01000087.1_i000_002961	222	446	224	1	0.413284
GCA_009733025.1-Pro_QXGA01000082.1_i000_002771	222	446	224	1	0.413284
GCA_009733065.1-Pro_QXFZ01000097.1_i000_003338	222	446	224	1	0.413284
GCA_009733085.1-Pro_QXGD01000114.1_i000_003869	222	446	224	1	0.413284
GCA_009733105.1-Pro_QXGE01000089.1_i000_002962	222	446	224	1	0.413284
GCA_007990605.1-Fun_BJWK01000002.1_i000_001152	222	447	225	1.00446	0.411335
GCA_000304475.1-Fun_HE650831.1_i000_005060	123	355	232	1.03571	0.458498
GCA_015143295.1-Pla_CM026564.1_i000_020334	177	396	219	0.977679	0.408582
GCA_015584075.1-Fun_MU150248.1_i000_004692	185	411	226	1.00893	0.426415
GCA_014904895.1-Fun_MU124881.1_i000_001713	181	396	215	0.959821	0.368151
GCA_020744275.1-Fun_JAGTJR010000014.1_i000_003374	192	417	225	1.00446	0.431862
GCA_000302655.1-Fun_AHHD01000259.1_i000_005759	192	417	225	1.00446	0.431862
GCA_008787405.2-Ani_CM018479.1_i000_003742	184	409	225	1.00446	0.378151
GCA_008782695.1-Ani_CM018502.1_i000_012369	184	409	225	1.00446	0.378151
GCA_015179015.1-Fun_WHUW01000002.1_i000_006542	182	405	223	0.995536	0.42155
GCA_009732905.1-Pro_QXFV01000099.1_i000_002787	189	412	223	0.995536	0.437255
GCA_002237265.2-Fun_NKHU02000324.1_i000_005619	190	416	226	1.00893	0.434615
GCA_000814965.1-Fun_AZNG01000002.1_i000_005300	192	418	226	1.00893	0.444882
GCA_013426205.1-Fun_CP058933.1_i000_004487	192	418	226	1.00893	0.444882
GCA_018994105.1-Fun_JAFKAI010000157.1_i000_000038	1	224	223	0.995536	0.707937
GCA_003991915.1-Ani_RQTK01000327.1_i000_010621	250	475	225	1.00446	0.351562
GCA_015252655.1-Ani_JTDF01003074.1_i000_004390	187	409	222	0.991071	0.385417
GCA_014773135.1-Ani_JABEBT010000031.1_i000_005451	680	901	221	0.986607	0.22528
GCA_017524585.1-Ani_CM029831.1_i000_012196	184	409	225	1.00446	0.377517
GCA_016984135.1-Ani_JAAWVN010010170.1_i000_001998	160	385	225	1.00446	0.409091
GCA_000280035.2-Fun_CP003521.1_i000_000499	156	378	222	0.991071	0.53753
GCA_019049425.1-Fun_JAHMUF010000022.1_i000_002593	190	415	225	1.00446	0.45
GCA_011745845.1-Pla_VYZY01004802.1_i000_020380	177	394	217	0.96875	0.354575
GCA_011745865.1-Pla_VYZZ01015044.1_i000_035277	177	394	217	0.96875	0.354575
GCA_003546825.1-Pro_QUTH01002137.1_i000_003370	323	547	224	1	0.363047
GCA_014235925.1-Fun_VUJX01000023.1_i000_007798	193	419	226	1.00893	0.447525
GCA_000478725.1-Pla_KI517408.1_i000_006945	188	412	224	1	0.444444
GCA_000326105.1-Fun_AGVY01000023.1_i000_001853	111	345	234	1.04464	0.473684
GCA_001908125.1-Fun_MNBE01000071.1_i000_011380	190	416	226	1.00893	0.45749
GCA_900618435.1-Ani_UYSU01036901.1_i000_011909	177	396	219	0.977679	0.491031
GCA_000208925.2-Pro_DS571525.1_i000_000733	180	401	221	0.986607	0.439364
GCA_000338855.1-Pro_KB444678.1_i000_003916	180	401	221	0.986607	0.439364
GCA_000346345.1-Pro_KB638334.1_i000_005078	180	401	221	0.986607	0.439364
GCA_000365475.1-Pro_KB823384.1_i000_001362	180	401	221	0.986607	0.439364
GCA_001662325.1-Pro_BDEQ01000001.1_i000_007640	180	401	221	0.986607	0.439364
GCA_013368375.1-Fun_JAACJP010000044.1_i000_009554	182	403	221	0.986607	0.387719
GCA_002197585.2-Pro_MZMZ02001573.1_i000_002493	300	524	224	1	0.377104
GCA_003546765.1-Pro_QUTG01002041.1_i000_002876	300	524	224	1	0.377104
GCA_000183805.3-Ani_JH712151.1_i000_006221	189	412	223	0.995536	0.391916
GCA_020169535.1-Pla_CM034992.1_i000_018237	177	395	218	0.973214	0.405204
GCA_020169555.1-Pla_CM035016.1_i000_017149	177	395	218	0.973214	0.405204
GCA_017911155.1-Fun_JAEFCI010007658.1_i000_004872	186	412	226	1.00893	0.403571
GCA_000002495.2-Fun_CM001233.1_i000_006991	195	419	224	1	0.435798
GCA_020921065.1-Pla_CM037157.1_i000_018645	225	443	218	0.973214	0.362729
GCA_911693285.1-Fun_CAJVRM010000049.1_i000_001960	193	417	224	1	0.442688
GCA_022179045.1-Fun_BPPX01000026.1_i000_010281	193	419	226	1.00893	0.51954
GCA_010458925.1-Pla_CM021241.1_i000_040262	188	412	224	1	0.295515
GCA_000226115.1-Fun_CP003011.1_i000_006056	195	419	224	1	0.425856
GCA_019722365.1-Pla_JADFUC010000501.1_i000_013405	1	93	92	0.410714	0.968421
GCA_003550325.1-Fun_QKWP01002296.1_i000_027110	185	410	225	1.00446	0.439453
GCA_004337975.1-Fun_RRCJ01000002.1_i000_004346	195	419	224	1	0.435798
GCA_010093605.1-Fun_MU004183.1_i000_002613	190	415	225	1.00446	0.431034
GCA_001676915.1-Ani_KV584939.1_i000_000856	125	349	224	1	0.489083
GCA_000292585.1-Fun_JH793314.1_i000_004896	195	419	224	1	0.435798
GCA_000292605.1-Fun_JH795505.1_i000_010247	195	419	224	1	0.435798
GCA_004346965.1-Fun_CP034206.1_i000_006719	195	419	224	1	0.435798
GCA_021442365.1-Fun_PHFK01000001.1_i000_001843	195	419	224	1	0.435798
GCA_021845515.1-Fun_VIDS01000006.1_i000_009928	195	419	224	1	0.435798
GCA_018857285.1-Fun_JABAKA010024084.1_i000_013246	195	415	220	0.982143	0.378657
GCA_905250095.1-Ani_CAJNOR010000023.1_i000_000805	186	410	224	1	0.503371
GCA_000226545.1-Fun_CU633459.1_i000_007031	195	419	224	1	0.4375
GCA_900290415.1-Fun_LR026968.1_i000_006929	195	419	224	1	0.4375
GCA_021365335.1-Fun_JAJTIZ010000016.1_i000_003835	192	416	224	1	0.432432
GCA_019722365.1-Pla_JADFUC010000388.1_i000_022221	177	395	218	0.973214	0.394213
GCA_003351075.1-Fun_QFBF01000015.1_i000_002673	192	416	224	1	0.442688
GCA_009769405.1-Fun_WNWR01000005.1_i000_000295	192	416	224	1	0.442688
GCA_009769425.1-Fun_WNWS01000010.1_i000_000723	192	416	224	1	0.442688
GCA_009769445.1-Fun_WNWQ01000796.1_i000_008118	192	416	224	1	0.442688
GCA_001605315.2-Fun_LUEZ02000079.1_i000_013380	181	401	220	0.982143	0.380623
GCA_000145635.1-Fun_GL385395.1_i000_002515	195	419	224	1	0.430769
GCA_014925795.1-Fun_WIQF01000090.1_i000_017715	182	405	223	0.995536	0.390543
GCA_000507405.3-Fun_KI669498.1_i000_002679	193	413	220	0.982143	0.366667
GCA_010015615.1-Fun_ML976617.1_i000_008935	192	416	224	1	0.433269
GCA_020169575.1-Pla_CM035004.1_i000_016971	177	395	218	0.973214	0.402957
GCA_020497155.1-Pla_CM035713.1_i000_018523	188	412	224	1	0.32
GCA_910592215.1-Fun_CAJVPN010000071.1_i000_000968	185	412	227	1.01339	0.548309
GCA_910592255.1-Fun_CAJVPO010002354.1_i000_009951	185	412	227	1.01339	0.548309
GCA_019633535.1-Fun_WSUE01000003.1_i000_007410	181	402	221	0.986607	0.373311
GCA_019633545.1-Fun_WSUF01000035.1_i000_008077	181	402	221	0.986607	0.373311
GCA_001563735.1-Fun_KQ963224.1_i000_011160	181	404	223	0.995536	0.416045
GCA_015039435.1-Fun_MU130777.1_i000_004168	182	405	223	0.995536	0.38918
GCA_000804445.1-Fun_AZHE01000011.1_i000_001528	192	418	226	1.00893	0.443137
GCA_022264855.1-Fun_JABYQU010000014.1_i000_002154	179	401	222	0.991071	0.396429
GCA_004917965.1-Fun_SPRO01000084.1_i000_004088	186	411	225	1.00446	0.411335
GCA_004918665.1-Fun_SPRB01000088.1_i000_004095	186	411	225	1.00446	0.411335
GCA_004918795.1-Fun_SPRH01000090.1_i000_004104	186	411	225	1.00446	0.411335
GCA_004919005.1-Fun_SPRX01000090.1_i000_004133	186	411	225	1.00446	0.411335
GCA_004918075.1-Fun_SPRL01000079.1_i000_004021	186	411	225	1.00446	0.411335
GCA_004918605.1-Fun_SPRK01000089.1_i000_004126	186	411	225	1.00446	0.411335
GCA_004918725.1-Fun_SPRT01000102.1_i000_000473	186	411	225	1.00446	0.411335
GCA_004918905.1-Fun_SPRC01000082.1_i000_004061	186	411	225	1.00446	0.411335
GCA_004918755.1-Fun_SPOI01000053.1_i000_003254	178	399	221	0.986607	0.412313
GCA_000400465.1-Fun_KE007228.1_i000_001430	178	399	221	0.986607	0.412313
GCA_004917845.1-Fun_SPOB01000015.1_i000_000826	178	399	221	0.986607	0.412313
GCA_004917865.1-Fun_SPOD01000021.1_i000_001453	178	399	221	0.986607	0.412313
GCA_004917895.1-Fun_SPOH01000018.1_i000_001066	178	399	221	0.986607	0.412313
GCA_004918015.1-Fun_SPOC01000016.1_i000_000861	178	399	221	0.986607	0.412313
GCA_004918065.1-Fun_SPOQ01000017.1_i000_000961	178	399	221	0.986607	0.412313
GCA_004918235.1-Fun_SPOE01000019.1_i000_001151	178	399	221	0.986607	0.412313
GCA_004918315.1-Fun_SPNX01000017.1_i000_000907	178	399	221	0.986607	0.412313
GCA_004918345.1-Fun_SPOA01000015.1_i000_000799	178	399	221	0.986607	0.412313
GCA_004918445.1-Fun_SPOG01000015.1_i000_000784	178	399	221	0.986607	0.412313
GCA_004918455.1-Fun_SPOF01000018.1_i000_001097	178	399	221	0.986607	0.412313
GCA_004918895.1-Fun_SPOR01000015.1_i000_000741	178	399	221	0.986607	0.412313
GCA_000498715.1-Pro_AHGT01000054.1_i000_003609	185	412	227	1.01339	0.367909
GCA_000263375.1-Fun_JH668230.1_i000_002489	186	411	225	1.00446	0.413603
GCA_004918525.1-Fun_SPRF01000088.1_i000_004130	186	411	225	1.00446	0.413603
GCA_004918995.1-Fun_SPRY01000090.1_i000_004128	186	411	225	1.00446	0.413603
GCA_001659605.2-Pla_CM004392.2_i000_011925	188	412	224	1	0.418692
GCA_002763495.2-Ani_JXXN02001140.1_i000_003706	162	382	220	0.982143	0.528846
GCA_001027345.1-Fun_KQ087177.1_i000_000126	186	409	223	0.995536	0.411439
GCA_008065305.1-Fun_QKWL01000001.1_i000_001383	186	409	223	0.995536	0.411439
GCA_000002865.1-Pro_CH991567.1_i000_002214	190	415	225	1.00446	0.446429
GCA_004917705.1-Fun_QZBK01000373.1_i000_006010	192	417	225	1.00446	0.427757
GCA_019677355.1-Fun_WSLN01000095.1_i000_001629	180	403	223	0.995536	0.166791
GCA_001865875.1-Pla_CM007372.1_i000_019233	188	414	226	1.00893	0.414679
GCA_021365285.1-Fun_JAJTJA010000010.1_i000_001832	190	416	226	1.00893	0.439689
GCA_000827395.1-Fun_KN824833.1_i000_000614	183	390	207	0.924107	0.361888
GCA_004918335.1-Fun_SPNZ01000017.1_i000_001033	178	399	221	0.986607	0.412313
GCA_010405425.1-Fun_MU005578.1_i000_006408	192	416	224	1	0.429942
GCA_015731905.1-Pla_CM027670.1_i000_019029	286	510	224	1	0.346749
GCA_000004515.5-Pla_CM000840.4_i000_016670	188	412	224	1	0.405797
GCA_000722935.2-Pla_KN643148.1_i000_004532	188	412	224	1	0.405797
GCA_004193775.2-Pla_CM014363.1_i000_017439	188	412	224	1	0.405797
GCA_014282095.1-Pla_CM024919.1_i000_018535	188	412	224	1	0.405797
GCA_012273815.2-Pla_CM022565.2_i000_017960	188	412	224	1	0.405797
GCA_004918915.1-Fun_SPRN01000087.1_i000_004095	186	411	225	1.00446	0.411335
GCA_000612305.1-Pla_KK198763.1_i000_034143	188	412	224	1	0.403604
GCA_000002435.2-Pro_CM018793.1_i000_004076	185	412	227	1.01339	0.37031
GCA_003024175.1-Pro_MDYQ01000025.1_i000_008132	185	404	219	0.977679	0.217262
GCA_902201215.1-Pla_LR694010.1_i000_016192	188	412	224	1	0.408015
GCA_013396095.1-Fun_JAAQRM010000093.1_i000_002916	1241	1467	226	1.00893	0.144965
GCA_000325965.1-Fun_ADVV01000036.1_i000_001343	111	345	234	1.04464	0.473684
GCA_000835515.1-Fun_KN847340.1_i000_008925	190	416	226	1.00893	0.437137
GCA_019202805.1-Pla_CM032905.1_i000_030474	188	413	225	1.00446	0.429389
GCA_905216605.1-Pla_LR999451.1_i000_003716	188	413	225	1.00446	0.429389
GCA_019202795.1-Pla_CM032918.1_i000_030449	188	413	225	1.00446	0.429389
GCA_016647745.1-Fun_JABBWE010000048.1_i000_010582	183	405	222	0.991071	0.389474
GCA_903114435.1-Pla_CAEKKB010000005.1_i000_019005	188	412	224	1	0.406534
GCA_020424065.1-Pla_CM035471.1_i000_023448	188	412	224	1	0.406534
GCA_903112645.1-Pla_CAEKDK010000005.1_i000_019166	188	412	224	1	0.406534
GCA_003942145.1-Ani_QXTE01000420.1_i000_018151	189	413	224	1	0.41791
GCA_004802705.1-Fun_SGPL01000348.1_i000_005329	185	411	226	1.00893	0.312155
GCA_000149865.1-Fun_DS022300.1_i000_007570	187	410	223	0.995536	0.43301
GCA_005223365.2-Pla_SPHZ02000007.1_i000_024863	188	412	224	1	0.405063
GCA_004918305.1-Fun_SPOM01000019.1_i000_001147	178	399	221	0.986607	0.412313
GCA_004918405.1-Fun_SPOO01000019.1_i000_001146	178	399	221	0.986607	0.412313
GCA_004918655.1-Fun_SPOP01000019.1_i000_001152	178	399	221	0.986607	0.412313
GCA_004918735.1-Fun_SPON01000019.1_i000_001148	178	399	221	0.986607	0.412313
GCA_004918745.1-Fun_SPOJ01000015.1_i000_000733	178	399	221	0.986607	0.412313
GCA_004918885.1-Fun_SPNY01000019.1_i000_001147	178	399	221	0.986607	0.412313
GCA_000346045.2-Ani_KB632263.1_i000_008234	183	408	225	1.00446	0.418994
GCA_019632275.1-Fun_WSTT01000155.1_i000_002267	181	401	220	0.982143	0.370995
GCA_019632285.1-Fun_WSTV01000113.1_i000_000640	181	401	220	0.982143	0.370995
GCA_000203795.1-Fun_GL882879.1_i000_000712	188	411	223	0.995536	0.432171
GCA_000355655.1-Ani_KB741211.1_i000_010531	183	408	225	1.00446	0.418216
GCA_020169535.1-Pla_CM034996.1_i000_030004	177	395	218	0.973214	0.39781
GCA_020169555.1-Pla_CM035020.1_i000_029298	177	395	218	0.973214	0.39781
GCA_020169585.1-Pla_CM034984.1_i000_029421	177	395	218	0.973214	0.39781
GCA_007726485.1-Pla_RWGY01000913.1_i000_054621	188	412	224	1	0.405797
GCA_016758775.1-Fun_JABBWN010000013.1_i000_002665	182	404	222	0.991071	0.388792
GCA_001636795.1-Fun_AZHF01000009.1_i000_010661	192	418	226	1.00893	0.445759
GCA_900080155.1-Fun_LT558122.1_i000_003529	187	410	223	0.995536	0.386482
GCA_900519155.1-Fun_ULHB01000115.1_i000_004658	187	410	223	0.995536	0.386482
GCA_004379255.2-Pla_CM031472.1_i000_002090	177	395	218	0.973214	0.451346
GCA_003713155.1-Pla_CP030987.1_i000_033255	188	412	224	1	0.414815
GCA_003713155.1-Pla_CP030997.1_i000_036699	188	412	224	1	0.414815
GCA_004170445.1-Pla_CM014319.1_i000_030343	188	412	224	1	0.414815
GCA_001592805.2-Fun_CP051142.1_i000_005999	192	416	224	1	0.399287
GCA_900343105.1-Fun_OUUZ01000013.1_i000_006844	195	419	224	1	0.426667
GCA_003316985.1-Fun_QKXC01000066.1_i000_010254	657	883	226	1.00893	0.232271
GCA_009805615.1-Ani_VIIS01000371.1_i000_004552	185	409	224	1	0.435798
GCA_000346465.2-Pla_CM007655.1_i000_016779	188	412	224	1	0.408015
GCA_905337335.1-Fun_CAJPDQ010000012.1_i000_004141	191	416	225	1.00446	0.442913
GCA_007726485.1-Pla_CM017442.1_i000_016449	188	412	224	1	0.405063
GCA_013358455.1-Pla_JABWDY010022764.1_i000_017010	188	412	224	1	0.4
GCA_020310875.1-Pla_CM035435.1_i000_027147	177	396	219	0.977679	0.439759
GCA_022160275.1-Fun_MU275844.1_i000_001498	180	400	220	0.982143	0.374787
GCA_001541205.1-Fun_KQ954465.1_i000_000379	183	408	225	1.00446	0.436047
GCA_902713445.1-Pla_LR743777.1_i000_000910	188	412	224	1	0.408015
GCA_015501075.1-Fun_JADNYJ010000097.1_i000_016285	186	412	226	1.00893	0.435453
GCA_008629635.1-Fun_NQVO01000022.1_i000_004487	194	419	225	1.00446	0.397527
GCA_019512145.1-Ani_WNYA01001492.1_i000_021686	43	267	224	1	0.575835
GCA_010015725.1-Fun_ML977589.1_i000_007873	192	417	225	1.00446	0.436893
GCA_014282345.1-Pla_CM024974.1_i000_018001	221	445	224	1	0.383562
GCA_022264835.1-Fun_JAIFHY010000016.1_i000_003538	183	401	218	0.973214	0.385159
GCA_021524915.1-Fun_JAKELL010000039.1_i000_007316	185	412	227	1.01339	0.417279
GCA_014282035.1-Pla_CM024839.1_i000_006697	221	445	224	1	0.382906
GCA_014282145.1-Pla_CM024939.1_i000_018132	221	445	224	1	0.382906
GCA_019633555.1-Fun_WSUG01000082.1_i000_013751	181	401	220	0.982143	0.371622
GCA_904066225.2-Ani_CAJFCW020000005.1_i000_011335	188	412	224	1	0.449799
GCA_904067145.1-Ani_CAJFDH010000005.1_i000_011335	188	412	224	1	0.449799
GCA_014362265.1-Pla_BJWL01000026.1_i000_037217	188	412	224	1	0.398577
GCA_014925845.1-Fun_JACGCL010000006.1_i000_010837	192	417	225	1.00446	0.413603
GCA_900660405.1-Pro_CAACVS010000006.1_i000_000381	189	422	233	1.04018	0.455078
GCA_000412655.1-Ani_KE164236.1_i000_015172	1	50	49	0.21875	0.281609
GCA_000004555.3-Ani_FR847121.2_i000_015363	188	415	227	1.01339	0.467078
GCA_000827475.1-Fun_KN819325.1_i000_001796	183	390	207	0.924107	0.361888
GCA_014058105.1-Pla_JACGCM010001129.1_i000_003844	188	412	224	1	0.409506
GCA_001625265.1-Fun_LFIV01000024.1_i000_005595	193	419	226	1.00893	0.444008
GCA_001855235.1-Fun_KV842202.1_i000_011565	193	419	226	1.00893	0.444008
GCA_021527035.1-Fun_JAKELG010000005.1_i000_008264	164	387	223	0.995536	0.463617
GCA_001983315.1-Fun_MQVN01000058.1_i000_003968	111	345	234	1.04464	0.473684
GCA_003546025.1-Pla_QPKB01000006.1_i000_015042	187	412	225	1.00446	0.39823
GCA_003370565.1-Pla_QJKJ01014244.1_i000_050117	119	343	224	1	0.501119
GCA_009176365.1-Fun_ML733125.1_i000_011515	190	416	226	1.00893	0.435453
GCA_009193605.1-Fun_ML735276.1_i000_008137	190	416	226	1.00893	0.435453
GCA_013421405.2-Fun_SPNV01000206.1_i000_004341	190	416	226	1.00893	0.435453
GCA_013266165.1-Fun_JAAGWP010000370.1_i000_008554	192	418	226	1.00893	0.440546
GCA_916381525.1-Ani_CAKAEH010001936.1_i000_009715	177	392	215	0.959821	0.444215
GCA_010015605.1-Fun_ML975244.1_i000_000232	192	416	224	1	0.434951
GCA_003024255.1-Pla_CM009679.1_i000_029205	188	412	224	1	0.398577
GCA_013841205.1-Ani_JACDQY010000208.1_i000_004989	186	411	225	1.00446	0.455466
GCA_014905175.1-Ani_CM026524.1_i000_007941	187	411	224	1	0.443564
GCA_002290385.1-Ani_KZ288253.1_i000_004062	189	414	225	1.00446	0.452716
GCA_905183005.1-Pro_CAJJDO010000007.1_i000_003624	181	400	219	0.977679	0.467949
GCA_002104995.1-Fun_MCFD01000002.1_i000_004742	185	409	224	1	0.482759
GCA_000934385.1-Fun_KN880481.1_i000_004857	186	412	226	1.00893	0.42803
GCA_015342795.1-Ani_CM027194.1_i000_017986	180	399	219	0.977679	0.461053
GCA_021052385.1-Fun_JAIFAB010000019.1_i000_003182	191	413	222	0.991071	0.388112
GCA_918697745.1-Ani_CAKKLH010000103.1_i000_005170	1319	1544	225	1.00446	0.11646
GCA_017499595.2-Fun_CM039003.1_i000_007221	186	412	226	1.00893	0.424015
GCA_022201065.1-Pla_CM039174.1_i000_014556	177	396	219	0.977679	0.38968
GCA_020921065.1-Pla_CM037159.1_i000_024963	188	412	224	1	0.402154
GCA_000286035.1-Fun_CAGI01000177.1_i000_002229	189	412	223	0.995536	0.383821
GCA_900519145.1-Fun_ULHA01000028.1_i000_004900	189	412	223	0.995536	0.383821
GCA_003344405.1-Ani_NOWV01000064.1_i000_010030	185	410	225	1.00446	0.420561
GCA_000281125.4-Ani_AKHW03001223.1_i000_004688	184	408	224	1	0.414048
GCA_011947395.2-Fun_JAATWM020000046.1_i000_009411	209	435	226	1.00893	0.431298
GCA_015252655.1-Ani_JTDF01000650.1_i000_001330	180	399	219	0.977679	0.5
GCA_900242705.1-Fun_OEYX01000118.1_i000_008242	189	412	223	0.995536	0.384483
GCA_000002995.5-Ani_CAAKNF010000193.1_i000_003707	189	412	223	0.995536	0.37291
GCA_001890105.1-Fun_KV878336.1_i000_000979	190	416	226	1.00893	0.435453
GCA_000150275.1-Ani_DS985248.1_i000_004291	184	409	225	1.00446	0.414365
GCA_003367725.1-Fun_KZ857388.1_i000_004444	179	403	224	1	0.397869
GCA_009078335.1-Pla_CM018584.1_i000_019471	177	395	218	0.973214	0.389982
GCA_008360955.1-Ani_LUCM01005583.1_i000_005751	176	395	219	0.977679	0.509302
GCA_902728155.2-Pla_CACVBM020001055.1_i000_014595	188	412	224	1	0.445328
GCA_905219625.1-Fun_CAJMWX010001047.1_i000_004468	180	403	223	0.995536	0.16997
GCA_009761285.1-Ani_VYZN01000023.1_i000_007186	188	412	224	1	0.478632
GCA_004369055.1-Fun_ML211227.1_i000_009154	179	403	224	1	0.397163
GCA_000264905.1-Fun_JH687395.1_i000_011378	185	411	226	1.00893	0.429658
GCA_014858505.1-Pla_CM026419.1_i000_026330	188	412	224	1	0.403604
GCA_008704595.1-Fun_SWFT01000067.1_i000_000044	112	336	224	1	0.52093
GCA_019343175.1-Ani_JAFNEN010000228.1_i000_018675	186	411	225	1.00446	0.40107
GCA_014904985.1-Fun_MU129007.1_i000_010283	191	416	225	1.00446	0.399645
GCA_000803305.1-Ani_JPKZ01022854.1_i000_018488	215	433	218	0.973214	0.386525
GCA_016584205.1-Fun_PUHQ01000127.1_i000_001102	161	381	220	0.982143	0.414313
GCA_001896365.1-Fun_MIKG01000002.1_i000_004415	190	416	226	1.00893	0.450199
GCA_900242695.1-Fun_OHJM01000009.1_i000_001762	189	412	223	0.995536	0.385147
GCA_001879085.1-Pla_CM007397.1_i000_008263	177	395	218	0.973214	0.391382
GCA_001541205.1-Fun_KQ954509.1_i000_005253	176	396	220	0.982143	0.410448
GCA_015501055.1-Fun_JADNYV010000002.1_i000_006721	187	413	226	1.00893	0.427221
GCA_004917975.1-Fun_SPRM01000083.1_i000_004071	186	411	225	1.00446	0.413603
GCA_004918005.1-Fun_SPRU01000089.1_i000_004116	186	411	225	1.00446	0.413603
GCA_004918515.1-Fun_SPRA01000087.1_i000_004115	186	411	225	1.00446	0.413603
GCA_004918635.1-Fun_SPRD01000084.1_i000_004095	186	411	225	1.00446	0.413603
GCA_004918645.1-Fun_SPRE01000085.1_i000_004128	186	411	225	1.00446	0.413603
GCA_004918805.1-Fun_SPRR01000083.1_i000_004082	186	411	225	1.00446	0.413603
GCA_004918985.1-Fun_SPRS01000083.1_i000_004075	186	411	225	1.00446	0.413603
GCA_000237345.1-Fun_HE576756.1_i000_003586	128	360	232	1.03571	0.484342
GCA_004369135.1-Fun_ML179102.1_i000_008180	183	395	212	0.946429	0.372583
GCA_903986555.1-Ani_CAJDYZ010012019.1_i000_009062	185	410	225	1.00446	0.457317
GCA_005059875.1-Fun_MXAQ01000010.1_i000_000474	176	396	220	0.982143	0.40293
GCA_001636745.1-Fun_AZHC01000008.1_i000_008140	192	418	226	1.00893	0.445759
GCA_007866325.1-Fun_SBHS01000002.1_i000_002961	192	418	226	1.00893	0.445759
GCA_019511825.2-Pla_QFCC02000011.1_i000_005607	178	396	218	0.973214	0.392086
GCA_019512045.2-Pla_QIYW02000007.1_i000_017135	178	396	218	0.973214	0.392086
GCA_004303085.2-Pla_SDAM02000098.1_i000_007693	178	396	218	0.973214	0.392086
GCA_019511825.2-Pla_QFCC02000018.1_i000_018629	178	396	218	0.973214	0.391382
GCA_000193285.1-Fun_GL876976.1_i000_009849	195	419	224	1	0.429119
GCA_011392495.1-Fun_QMIJ01000008.1_i000_011108	190	416	226	1.00893	0.2825
GCA_002382835.1-Fun_NPFJ01000066.1_i000_009528	190	416	226	1.00893	0.2825
GCA_002382855.1-Fun_NPFK01000057.1_i000_008772	190	416	226	1.00893	0.2825
GCA_001632435.1-Fun_KV423997.1_i000_007698	178	387	209	0.933036	0.3466
GCA_015501065.1-Fun_JADNYI010000004.1_i000_012243	185	411	226	1.00893	0.42243
GCA_000004655.2-Pla_CM000128.1_i000_011117	188	412	224	1	0.405797
GCA_003521335.2-Ani_QWLN02016365.1_i000_015111	335	560	225	1.00446	0.301609
GCA_000005425.2-Pla_AP008209.2_i000_008783	188	412	224	1	0.405797
GCA_000149285.1-Pla_CM000140.1_i000_010334	188	412	224	1	0.405797
GCA_001433935.1-Pla_AP014959.1_i000_012757	188	412	224	1	0.405797
GCA_009797565.1-Pla_CM020523.1_i000_010571	188	412	224	1	0.405797
GCA_001883825.1-Fun_LGRN01000097.1_i000_008862	190	416	226	1.00893	0.440546
GCA_020744135.1-Fun_JAGMVI010000004.1_i000_012200	193	419	226	1.00893	0.444882
GCA_014595675.1-Ani_WVUK01000062.1_i000_003726	188	412	224	1	0.434951
GCA_019425555.1-Fun_MXQG01000002.1_i000_004328	193	419	226	1.00893	0.444008
GCA_900007375.1-Fun_LN649231.1_i000_013192	193	419	226	1.00893	0.444008
GCA_001625285.1-Fun_LFIW01001979.1_i000_004877	252	478	226	1.00893	0.397887
GCA_000760515.2-Fun_JMKJ01000555.1_i000_002572	189	416	227	1.01339	0.335303
GCA_018994065.1-Fun_JAFKAH010000442.1_i000_011577	265	388	123	0.549107	0.155499
GCA_018994065.1-Fun_JAFKAH010000442.1_i000_011577	544	752	208	0.928571	0.262958
GCA_000986665.1-Fun_JYKN01002707.1_i000_003786	190	416	226	1.00893	0.441406
GCA_000263155.2-Pla_CM003536.1_i000_032481	188	413	225	1.00446	0.407609
GCA_005286985.1-Pla_CM016560.1_i000_036405	188	413	225	1.00446	0.407609
GCA_004794745.1-Ani_QBLH01002196.1_i000_008584	185	412	227	1.01339	0.469008
GCA_001653215.1-Fun_LUKN01001547.1_i000_004330	192	418	226	1.00893	0.449304
GCA_002217885.1-Pro_BDSP01000022.1_i000_011906	196	420	224	1	0.420263
GCA_905338395.1-Ani_CAJPEW010007199.1_i000_011650	428	653	225	1.00446	0.265643
GCA_009194965.1-Fun_VSMA01000022.1_i000_010256	193	418	225	1.00446	0.446429
GCA_903819635.1-Fun_CAIJEN010000001.1_i000_001338	178	404	226	1.00893	0.44227
GCA_003427395.1-Pla_BFEA01000001.1_i000_000147	195	420	225	1.00446	0.412844
GCA_000218685.1-Fun_GL945431.1_i000_003302	182	403	221	0.986607	0.390459
GCA_000218725.1-Fun_GL945477.1_i000_003166	182	403	221	0.986607	0.390459
GCA_006937295.1-Pla_VIBQ01000012.1_i000_022253	192	417	225	1.00446	0.431862
GCA_017311285.1-Fun_JABTEG010000003.1_i000_000894	180	399	219	0.977679	0.429412
GCA_015657495.1-Fun_MU157917.1_i000_012352	180	400	220	0.982143	0.372881
GCA_004007595.1-Pla_CM012943.1_i000_010163	188	412	224	1	0.39646
GCA_018994065.1-Fun_JAFKAH010000493.1_i000_019019	177	403	226	1.00893	0.45749
GCA_013368315.1-Fun_JAACJM010000098.1_i000_011853	183	395	212	0.946429	0.373898
GCA_001078535.1-Pro_CAIX01000074.1_i000_005364	189	418	229	1.02232	0.451677
GCA_009078325.1-Fun_SSOP01000008.1_i000_008545	436	659	223	0.995536	0.136225
GCA_009194965.1-Fun_VSMA01000018.1_i000_007112	193	418	225	1.00446	0.423729
GCA_018691285.1-Pla_CM031891.1_i000_017167	189	413	224	1	0.405063
GCA_018855915.1-Fun_JABCKO010015891.1_i000_007461	182	402	220	0.982143	0.386643
GCA_021604985.1-Pla_BQKI01000084.1_i000_048992	188	412	224	1	0.408015
GCA_002762385.1-Pla_NKXS01000445.1_i000_003025	188	412	224	1	0.493392
GCA_001268165.1-Fun_CVQI01037273.1_i000_020156	164	390	226	1.00893	0.495614
GCA_014851425.1-Pla_CM026262.1_i000_006674	188	412	224	1	0.405797
GCA_002938355.1-Fun_NHTK01001074.1_i000_002927	181	403	222	0.991071	0.397138
GCA_003072535.2-Pro_CP056069.1_i000_000625	151	375	224	1	0.429942
GCA_002211085.2-Pla_CM008054.2_i000_031950	182	402	220	0.982143	0.386643
GCA_006368765.1-Ani_SKCS01000391.1_i000_005375	180	400	220	0.982143	0.509259
GCA_021461655.1-Ani_CM038284.1_i000_003659	180	400	220	0.982143	0.509259
GCA_000149755.2-Pro_JH159152.1_i000_005247	188	412	224	1	0.433269
GCA_002846915.2-Fun_MSFN02000010.1_i000_002107	204	430	226	1.00893	0.429658
GCA_002003505.1-Fun_BDMC01000021.1_i000_007091	191	416	225	1.00446	0.439453
GCA_001566295.1-Fun_KQ964253.1_i000_007461	191	417	226	1.00893	0.436293
GCA_900618025.1-Ani_UZAG01016476.1_i000_008374	267	490	223	0.995536	0.33234
GCA_018994065.1-Fun_JAFKAH010000377.1_i000_008572	147	373	226	1.00893	0.487069
GCA_000003125.1-Fun_EQ962654.1_i000_003426	190	416	226	1.00893	0.447525
GCA_013368325.1-Fun_JAACJK010000225.1_i000_009868	185	411	226	1.00893	0.421642
GCA_014904975.1-Fun_MU127926.1_i000_014042	185	410	225	1.00446	0.405405
GCA_000750115.1-Fun_JPOX01000026.1_i000_006410	190	416	226	1.00893	0.289744
GCA_001625215.1-Pla_CM004283.1_i000_020979	188	412	224	1	0.402154
GCA_003693665.1-Fun_QQSL01000086.1_i000_005475	182	411	229	1.02232	0.369952
GCA_001270105.1-Ani_LHQP01028177.1_i000_036250	185	410	225	1.00446	0.410584
GCA_000187405.1-Fun_GL698478.1_i000_001945	192	418	226	1.00893	0.440546
GCA_019434415.1-Fun_JAGRQK010000025.1_i000_008809	192	418	226	1.00893	0.440546
GCA_001278385.1-Fun_LGAV01000001.1_i000_000705	190	414	224	1	0.432432
GCA_905219615.1-Fun_CAJMWW010000092.1_i000_003775	180	403	223	0.995536	0.173947
GCA_001879275.1-Fun_KV875100.1_i000_009260	194	418	224	1	0.430769
GCA_003434825.1-Pla_CM010630.1_i000_011395	188	413	225	1.00446	0.445545
GCA_001187945.1-Ani_JRES01001511.1_i000_003568	180	397	217	0.96875	0.418112
GCA_002873125.1-Fun_PGCI01000037.1_i000_004167	214	435	221	0.986607	0.368333
GCA_003367725.1-Fun_KZ857387.1_i000_004245	184	410	226	1.00893	0.402135
GCA_905250885.1-Ani_CAJNOQ010000118.1_i000_001289	195	421	226	1.00893	0.458418
GCA_905332065.1-Ani_CAJOBC010000118.1_i000_001289	195	421	226	1.00893	0.458418
GCA_905249995.1-Ani_CAJNOK010000224.1_i000_001255	195	421	226	1.00893	0.458418
GCA_905332075.1-Ani_CAJOBA010000224.1_i000_001256	195	421	226	1.00893	0.458418
GCA_000828355.1-Ani_JXLN01015549.1_i000_008983	223	447	224	1	0.407273
GCA_000349305.2-Fun_HE999550.1_i000_003311	194	401	207	0.924107	0.384758
GCA_022264835.1-Fun_JAIFHY010000039.1_i000_010513	184	408	224	1	0.418692
GCA_003434825.1-Pla_CM010629.1_i000_007482	177	395	218	0.973214	0.411321
GCA_916720795.1-Ani_CAKASE010000058.1_i000_007862	180	398	218	0.973214	0.398537
GCA_020736565.1-Fun_JAHBOF010000004.1_i000_017203	180	404	224	1	0.387543
GCA_017639395.1-Pla_CM029880.1_i000_011324	177	395	218	0.973214	0.411321
GCA_905250125.1-Ani_CAJNOL010000629.1_i000_021335	451	675	224	1	0.303523
GCA_000275845.1-Fun_JH719404.1_i000_004652	179	400	221	0.986607	0.389771
GCA_004307905.1-Fun_ML145099.1_i000_004999	179	400	221	0.986607	0.389771
GCA_004307915.1-Fun_ML143826.1_i000_000371	179	400	221	0.986607	0.389771
GCA_004307925.1-Fun_ML143396.1_i000_004007	179	400	221	0.986607	0.389771
GCA_001268145.1-Fun_CVQH01021674.1_i000_013261	193	419	226	1.00893	0.443137
GCA_016647635.1-Fun_JABBWG010000066.1_i000_013882	182	404	222	0.991071	0.390845
GCA_003724135.2-Fun_RBVV01000080.1_i000_008561	193	419	226	1.00893	0.443137
GCA_001625215.1-Pla_CM004282.1_i000_015916	186	410	224	1	0.402154
GCA_016695465.1-Fun_MU178012.1_i000_013810	182	404	222	0.991071	0.388792
GCA_018804465.1-Pla_CM031991.1_i000_007718	188	412	224	1	0.407273
GCA_018804465.1-Pla_CM031990.1_i000_006725	188	412	224	1	0.406534
GCA_002818225.1-Fun_KZ454987.1_i000_000596	190	415	225	1.00446	0.431034
GCA_000333075.3-Pro_AOFI03000023.1_i000_004331	189	413	224	1	0.439216
GCA_000785725.3-Pro_JPWU03000003.1_i000_004691	189	413	224	1	0.439216
GCA_000785735.3-Pro_JPWV03000001.1_i000_000029	189	413	224	1	0.439216
GCA_001707905.2-Pro_MAYM02001079.1_i000_000557	189	413	224	1	0.439216
GCA_001712715.2-Pro_MBDN02000003.1_i000_004774	189	413	224	1	0.439216
GCA_000005925.1-Ani_CH964272.1_i000_012053	186	410	224	1	0.446215
GCA_001483705.1-Ani_KQ762400.1_i000_007066	160	385	225	1.00446	0.480769
GCA_003144205.1-Fun_KZ819604.1_i000_004947	192	415	223	0.995536	0.404719
GCA_013397865.1-Ani_VZTI01003155.1_i000_007266	115	322	207	0.924107	0.448052
GCA_000836115.1-Fun_KN847498.1_i000_009408	190	416	226	1.00893	0.437137
GCA_001712645.2-Pro_MBAD02000670.1_i000_008813	189	413	224	1	0.439216
GCA_001712705.2-Pro_MBDO02000001.1_i000_000031	189	413	224	1	0.439216
GCA_004917255.1-Fun_QZAM01000406.1_i000_007238	196	421	225	1.00446	0.424528
GCA_910591765.1-Fun_CAJVPS010002306.1_i000_006537	182	400	218	0.973214	0.489888
GCA_010799875.2-Ani_VXIV02003450.1_i000_023533	179	386	207	0.924107	0.396552
GCA_006783085.1-Fun_PUHP01000917.1_i000_007962	193	419	226	1.00893	0.443137
GCA_009835225.1-Ani_VUJU01006400.1_i000_020330	188	412	224	1	0.478632
GCA_000313795.2-Fun_CACQ02005684.1_i000_011117	193	419	226	1.00893	0.443137
GCA_001672515.1-Fun_CM004461.1_i000_012004	193	419	226	1.00893	0.443137
GCA_004920355.1-Fun_MWPZ01000007.1_i000_011565	193	419	226	1.00893	0.443137
GCA_003942205.1-Fun_RSCE01000004.1_i000_006559	188	400	212	0.946429	0.38061
GCA_013235015.1-Ani_BGPR01007109.1_i000_109662	252	472	220	0.982143	0.406654
GCA_000004255.1-Pla_GL348713.1_i000_005085	188	413	225	1.00446	0.431034
GCA_016745375.1-Ani_WIOS01000030.1_i000_014443	185	409	224	1	0.409506
GCA_010356995.1-Fun_ML996696.1_i000_005810	192	416	224	1	0.422642
GCA_020004445.1-Ani_JAATJV010179054.1_i000_003071	183	408	225	1.00446	0.376884
GCA_019632265.1-Fun_WSTU01000123.1_i000_000950	398	618	220	0.982143	0.271605
GCA_005350895.1-Fun_PJEX01000392.1_i000_009814	193	419	226	1.00893	0.44227
GCA_004917385.1-Fun_QZAV01000440.1_i000_007326	205	430	225	1.00446	0.41744
GCA_013396695.1-Ani_VWZD01005403.1_i000_005568	166	392	226	1.00893	0.411658
GCA_019804575.1-Fun_JAHQZX010000618.1_i000_003987	190	416	226	1.00893	0.528037
GCA_014282245.1-Pla_CM024960.1_i000_019360	238	463	225	1.00446	0.369458
GCA_016584345.1-Fun_JABCPV010000121.1_i000_001940	182	404	222	0.991071	0.392226
GCA_900412535.3-Pla_LS974618.2_i000_009803	177	395	218	0.973214	0.389982
GCA_905183005.1-Pro_CAJJDO010000006.1_i000_003302	181	401	220	0.982143	0.470085
GCA_003073295.1-Fun_KZ803330.1_i000_007625	186	411	225	1.00446	0.423729
GCA_015883425.1-Ani_JADDUC010000099.1_i000_014231	60	271	211	0.941964	0.582873
GCA_002092935.1-Fun_KZ084109.1_i000_007114	179	399	220	0.982143	0.385965
GCA_002938375.1-Fun_NHYD01003173.1_i000_011876	182	404	222	0.991071	0.386087
GCA_000247585.2-Pro_KI669562.1_i000_002039	189	413	224	1	0.432432
GCA_000365505.1-Pro_ANIZ01001094.1_i000_006558	189	413	224	1	0.432432
GCA_000365525.1-Pro_ANJA01001214.1_i000_006614	189	413	224	1	0.432432
GCA_000365545.1-Pro_ANIX01001325.1_i000_006574	189	413	224	1	0.432432
GCA_000367145.1-Pro_ANIY01001385.1_i000_006601	189	413	224	1	0.432432
GCA_000509465.1-Pro_KI685665.1_i000_006446	189	413	224	1	0.432432
GCA_000509485.1-Pro_KI672232.1_i000_006394	189	413	224	1	0.432432
GCA_000509505.1-Pro_KI678944.1_i000_006250	189	413	224	1	0.432432
GCA_000509525.1-Pro_KI692195.1_i000_006364	189	413	224	1	0.432432
GCA_905319865.3-Ani_CAJNRD030001114.1_i000_000941	54	278	224	1	0.61708
GCA_013368075.1-Ani_JABVZV010002352.1_i000_017437	187	411	224	1	0.46473
GCA_000002985.3-Ani_BX284605.5_i000_014692	188	415	227	1.01339	0.467078
GCA_000143565.1-Fun_DS547115.1_i000_006928	182	404	222	0.991071	0.426923
GCA_001651475.1-Pla_CM004359.1_i000_004603	188	413	225	1.00446	0.431034
GCA_019202795.1-Pla_CM032913.1_i000_004558	188	413	225	1.00446	0.431034
GCA_019202805.1-Pla_CM032900.1_i000_004434	188	413	225	1.00446	0.431034
GCA_902651935.1-Pla_CACRSJ010000104.1_i000_004753	188	413	225	1.00446	0.431034
GCA_902705455.1-Pla_CACSHJ010000087.1_i000_004640	188	413	225	1.00446	0.431034
GCA_015342415.1-Fun_JACYCE010000055.1_i000_001615	180	403	223	0.995536	0.164212
GCA_009771035.1-Pla_CM020010.1_i000_019464	188	414	226	1.00893	0.420074
GCA_010261695.1-Pla_CM021014.1_i000_032347	188	414	226	1.00893	0.420074
GCA_019155715.1-Pro_JAGDFM010000022.1_i000_005153	189	413	224	1	0.439216
GCA_001483015.1-Pro_LNFO01005730.1_i000_015074	189	413	224	1	0.432432
GCA_000365145.2-Fun_KB822711.1_i000_001248	182	402	220	0.982143	0.355987
GCA_018691715.1-Pro_JAFJYM010000034.1_i000_009879	189	413	224	1	0.432432
GCA_910591925.1-Fun_CAJVPW010006173.1_i000_005784	184	409	225	1.00446	0.439453
GCA_900622545.1-Ani_UYWY01023112.1_i000_015788	177	395	218	0.973214	0.421663
GCA_000585565.1-Fun_AMGY01000001.1_i000_000770	189	415	226	1.00893	0.436293
GCA_004917115.1-Fun_QZAI01000155.1_i000_000842	192	417	225	1.00446	0.427757
GCA_002738505.1-Pla_KZ305028.1_i000_008574	188	412	224	1	0.397869
GCA_004917925.1-Fun_SPRI01000081.1_i000_004061	186	411	225	1.00446	0.409091
GCA_004917935.1-Fun_SPRJ01000088.1_i000_004135	186	411	225	1.00446	0.409091
GCA_004918025.1-Fun_SPRV01000019.1_i000_001228	186	411	225	1.00446	0.409091
GCA_004918485.1-Fun_SPRQ01000079.1_i000_003957	186	411	225	1.00446	0.409091
GCA_004918835.1-Fun_SPRW01000084.1_i000_004072	186	411	225	1.00446	0.409091
GCA_000002425.2-Pla_CM009331.1_i000_020448	188	413	225	1.00446	0.381356
GCA_013423385.1-Fun_BLZA01000030.1_i000_004968	194	415	221	0.986607	0.370184
GCA_004802725.1-Fun_SGPM01000022.1_i000_003354	189	415	226	1.00893	0.417745
GCA_008636005.1-Pla_BKCP01006848.1_i000_019555	216	440	224	1	0.404332
GCA_015342435.1-Fun_JACYCD010000048.1_i000_001649	180	403	223	0.995536	0.159857
THSP010.0722.00001.C001_01040	147	366	219	0.977679	0.528986
GCA_005959815.1-Ani_QOCX01000122.1_i000_003944	185	409	224	1	0.446215
GCA_004918155.1-Fun_SPRG01000085.1_i000_004127	186	411	225	1.00446	0.406872
GCA_900149145.1-Fun_LT671823.1_i000_002051	242	449	207	0.924107	0.353242
GCA_900624975.1-Ani_UYYA01004026.1_i000_007285	184	383	199	0.888393	0.423404
GCA_004917445.1-Fun_QZBB01000161.1_i000_002754	196	421	225	1.00446	0.424528
GCA_004917525.1-Fun_QZBG01000646.1_i000_008509	196	421	225	1.00446	0.424528
GCA_004917755.1-Fun_QZBO01000432.1_i000_007512	196	421	225	1.00446	0.424528
GCA_004379255.2-Pla_CM031474.1_i000_008471	253	471	218	0.973214	0.346582
GCA_004917555.1-Fun_QZBJ01000167.1_i000_002882	196	421	225	1.00446	0.424528
GCA_004917815.1-Fun_QZBQ01000389.1_i000_007128	196	421	225	1.00446	0.424528
GCA_019176425.1-Ani_CM032880.1_i000_007576	185	410	225	1.00446	0.377517
GCA_000220395.1-Pro_GL984172.1_i000_005701	179	399	220	0.982143	0.479303
GCA_014898675.1-Fun_JACXVL010000009.1_i000_021849	185	410	225	1.00446	0.425331
GCA_004917105.1-Fun_QZAF01000595.1_i000_007858	205	430	225	1.00446	0.41744
GCA_004918245.1-Fun_QZBX01000131.1_i000_001977	205	430	225	1.00446	0.41744
GCA_002892995.1-Fun_PHNU01000158.1_i000_001973	193	419	226	1.00893	0.443137
GCA_002893045.1-Fun_PHNX01000154.1_i000_001806	193	419	226	1.00893	0.443137
GCA_003320035.1-Fun_CM010353.1_i000_009074	193	419	226	1.00893	0.443137
GCA_004109745.1-Fun_CM014047.1_i000_006397	193	419	226	1.00893	0.443137
GCA_011066465.2-Fun_MU009611.1_i000_008913	193	419	226	1.00893	0.443137
GCA_018994095.1-Fun_JAEMWZ010000018.1_i000_003861	193	419	226	1.00893	0.443137
GCA_903819485.1-Fun_CAIJDU010000008.1_i000_006634	172	397	225	1.00446	0.457317
GCA_903819465.1-Fun_CAIJDR010000007.1_i000_004987	172	397	225	1.00446	0.457317
GCA_004918215.1-Fun_QZBP01000922.1_i000_010021	205	430	225	1.00446	0.41744
GCA_000150675.2-Fun_DS572697.1_i000_008504	193	419	226	1.00893	0.44227
GCA_002892985.1-Fun_MPSH01000018.1_i000_002804	193	419	226	1.00893	0.44227
GCA_002893025.1-Fun_PHNV01000131.1_i000_001148	193	419	226	1.00893	0.44227
GCA_011066485.2-Fun_MU009762.1_i000_001692	193	419	226	1.00893	0.44227
GCA_020726535.1-Fun_JAHEWJ010000019.1_i000_004623	193	419	226	1.00893	0.44227
GCA_000751015.1-Pla_LK033097.1_i000_045211	177	395	218	0.973214	0.410546
GCA_905219655.1-Fun_CAJMXA010003564.1_i000_006009	187	413	226	1.00893	0.401421
GCA_903819115.1-Fun_CAIJCR010000005.1_i000_004373	179	403	224	1	0.448898
GCA_903819455.1-Fun_CAIJDQ010000017.1_i000_007611	179	403	224	1	0.448898
GCA_001970855.1-Fun_LSSN01002050.1_i000_005829	184	402	218	0.973214	0.418426
GCA_001970855.1-Fun_LSSN01002767.1_i000_007273	184	402	218	0.973214	0.418426
GCA_004917685.1-Fun_QZBI01000449.1_i000_007259	192	417	225	1.00446	0.428571
GCA_001742945.1-Pla_DF974092.1_i000_033964	188	412	224	1	0.431599
GCA_004837865.1-Pla_CM017192.1_i000_012187	188	412	224	1	0.402878
GCA_001190045.1-Pla_CM003375.1_i000_012097	188	412	224	1	0.405797
GCA_004320505.1-Pla_AP015040.1_i000_020857	188	412	224	1	0.405797
GCA_016808095.1-Pla_CM028995.1_i000_025841	188	412	224	1	0.405797
GCA_000334495.1-Ani_KB364366.1_i000_017357	130	355	225	1.00446	0.416667
GCA_015179125.1-Fun_WHVA01000155.1_i000_003299	180	401	221	0.986607	0.39115
GCA_003324165.2-Pro_PYSW02000005.1_i000_002126	183	413	230	1.02679	0.389171
GCA_900625125.1-Ani_UYYG01001165.1_i000_004734	160	379	219	0.977679	0.52518
GCA_001642395.1-Fun_LTDL01000021.1_i000_002027	173	388	215	0.959821	0.52439
GCA_000835555.1-Fun_KN847480.1_i000_008125	190	416	226	1.00893	0.439689
GCA_016628065.1-Fun_JABBWA010000004.1_i000_012601	182	404	222	0.991071	0.388792
GCA_000721785.1-Fun_KL584994.1_i000_009146	192	417	225	1.00446	0.427757
GCA_004917135.1-Fun_QZAJ01000332.1_i000_004992	192	417	225	1.00446	0.427757
GCA_004917155.1-Fun_QZAG01000783.1_i000_009371	192	417	225	1.00446	0.427757
GCA_004917165.1-Fun_QZAK01000395.1_i000_007154	192	417	225	1.00446	0.427757
GCA_004917185.1-Fun_QZAL01000130.1_i000_001526	192	417	225	1.00446	0.427757
GCA_004917205.1-Fun_QZAN01000144.1_i000_002244	192	417	225	1.00446	0.427757
GCA_004917225.1-Fun_QZAH01000622.1_i000_008105	192	417	225	1.00446	0.427757
GCA_004917275.1-Fun_QZAO01000368.1_i000_005769	192	417	225	1.00446	0.427757
GCA_004917305.1-Fun_QZAP01000690.1_i000_008606	192	417	225	1.00446	0.427757
GCA_004917375.1-Fun_QZAT01000131.1_i000_001769	192	417	225	1.00446	0.427757
GCA_004917415.1-Fun_QZAX01000950.1_i000_010379	192	417	225	1.00446	0.427757
GCA_004917425.1-Fun_QZAZ01000345.1_i000_005668	192	417	225	1.00446	0.427757
GCA_004917435.1-Fun_QZBA01000411.1_i000_007592	192	417	225	1.00446	0.427757
GCA_004917595.1-Fun_QZAQ01000450.1_i000_007338	192	417	225	1.00446	0.427757
GCA_004917605.1-Fun_QZAU01000669.1_i000_008442	192	417	225	1.00446	0.427757
GCA_004917615.1-Fun_QZAY01000302.1_i000_005613	192	417	225	1.00446	0.427757
GCA_004917665.1-Fun_QZBH01000181.1_i000_002419	192	417	225	1.00446	0.427757
GCA_004917795.1-Fun_QZBL01000670.1_i000_008415	192	417	225	1.00446	0.427757
GCA_004918105.1-Fun_QZBS01000526.1_i000_007709	192	417	225	1.00446	0.427757
GCA_004918115.1-Fun_QZBT01000146.1_i000_002174	192	417	225	1.00446	0.427757
GCA_004918145.1-Fun_QZBV01000081.1_i000_009826	192	417	225	1.00446	0.427757
GCA_004918165.1-Fun_QZBW01000530.1_i000_008078	192	417	225	1.00446	0.427757
GCA_004918195.1-Fun_QZCA01000467.1_i000_007773	192	417	225	1.00446	0.427757
GCA_004918535.1-Fun_QZBU01000221.1_i000_001250	192	417	225	1.00446	0.427757
GCA_004918575.1-Fun_QZBY01001024.1_i000_000264	192	417	225	1.00446	0.427757
GCA_015251385.1-Fun_JADGIM010000023.1_i000_004328	192	417	225	1.00446	0.427757
GCA_002938375.1-Fun_NHYD01003948.1_i000_000988	186	412	226	1.00893	0.427221
GCA_004917355.1-Fun_QZAS01000023.1_i000_004175	192	417	225	1.00446	0.425331
GCA_000697705.1-Fun_KL198034.1_i000_006982	186	410	224	1	0.471579
GCA_004918275.1-Fun_QZBR01000077.1_i000_009378	192	417	225	1.00446	0.427757
GCA_004917335.1-Fun_QZAR01000152.1_i000_002329	192	417	225	1.00446	0.427757
GCA_000740895.1-Pro_AP011946.1_i000_000714	185	409	224	1	0.389565
GCA_008692635.1-Ani_VOAJ01003607.1_i000_008119	115	340	225	1.00446	0.426136
GCA_905330805.1-Ani_CAJNWK010000004.1_i000_002939	835	1060	225	1.00446	0.2
GCA_004369055.1-Fun_ML211043.1_i000_004495	184	410	226	1.00893	0.4
GCA_000263155.2-Pla_CM003529.1_i000_008020	242	467	225	1.00446	0.373134
GCA_001477545.1-Fun_LFVZ01000017.1_i000_001600	180	399	219	0.977679	0.427734
GCA_004155935.1-Fun_QJNV01000458.1_i000_008470	191	417	226	1.00893	0.44227
GCA_021365345.1-Fun_JAAZTN010000006.1_i000_008990	632	857	225	1.00446	0.21327
GCA_005286985.1-Pla_CM016553.1_i000_008960	242	467	225	1.00446	0.373134
GCA_016618375.1-Pro_JADEVP010000007.1_i000_020224	189	413	224	1	0.436647
GCA_905219605.1-Fun_CAJMWV010007781.1_i000_008199	180	401	221	0.986607	0.157072
THSP010.0722.00002.C001_01037	147	366	219	0.977679	0.528986
GCA_013358835.1-Ani_JABSTQ010010062.1_i000_015920	205	430	225	1.00446	0.502232
GCA_016984195.1-Ani_JAAWVQ010037269.1_i000_003792	160	385	225	1.00446	0.424528
GCA_019044685.2-Pla_JAGTXX020000006.1_i000_003369	184	408	224	1	0.461856
GCA_019044685.2-Pla_JAGTXX020000013.1_i000_007198	184	408	224	1	0.461856
GCA_019202925.1-Pla_JAHPZM010000016.1_i000_007432	184	408	224	1	0.461856
GCA_004917625.1-Fun_QZBC01000516.1_i000_007930	201	426	225	1.00446	0.420561
GCA_004119895.1-Ani_SCEB01005903.1_i000_009552	186	411	225	1.00446	0.405405
GCA_018360045.1-Fun_SRPN01000283.1_i000_003478	192	417	225	1.00446	0.522042
GCA_000181695.1-Fun_AAYY01000001.1_i000_003873	195	404	209	0.933036	0.382084
GCA_001970865.1-Fun_LSSM01004810.1_i000_008480	184	402	218	0.973214	0.413662
GCA_905182975.1-Pro_CAJJDM010000008.1_i000_003368	181	401	220	0.982143	0.470085
GCA_000296195.2-Pro_AGNL01048377.1_i000_032492	240	464	224	1	0.389565
GCA_000142945.1-Pro_DS028124.1_i000_012897	189	413	224	1	0.435798
GCA_905219595.1-Fun_CAJMWU010002351.1_i000_004783	180	401	221	0.986607	0.157072
GCA_004918415.1-Fun_SPOL01000012.1_i000_000456	178	399	221	0.986607	0.412313
GCA_004918625.1-Fun_SPOK01000013.1_i000_000550	178	399	221	0.986607	0.412313
GCA_021605075.1-Ani_BPLQ01006072.1_i000_021157	177	399	222	0.991071	0.473348
GCA_008124465.1-Pla_CM017875.1_i000_006869	187	412	225	1.00446	0.401786
GCA_900618015.1-Ani_UZAK01034133.1_i000_010657	116	337	221	0.986607	0.598916
GCA_014905825.1-Fun_JACGCN010000002.1_i000_005541	182	400	218	0.973214	0.378472
GCA_018282005.1-Fun_JABCKV010000044.1_i000_003564	235	454	219	0.977679	0.352657
GCA_003952965.2-Pla_CM025852.1_i000_012865	188	412	224	1	0.406534
GCA_019632295.1-Fun_WSTZ01000011.1_i000_000630	181	401	220	0.982143	0.385289
GCA_019633455.1-Fun_WSUA01000009.1_i000_012365	181	401	220	0.982143	0.385289
GCA_014839935.1-Fun_QTSX01033277.1_i000_017997	174	391	217	0.96875	0.525424
GCA_000004515.5-Pla_CM000850.4_i000_043996	188	412	224	1	0.408015
GCA_004193775.2-Pla_CM014373.1_i000_045672	188	412	224	1	0.408015
GCA_012273815.2-Pla_CM022575.2_i000_047120	188	412	224	1	0.408015
GCA_014282035.1-Pla_CM024849.1_i000_035995	188	412	224	1	0.408015
GCA_014282085.1-Pla_CM024909.1_i000_020553	188	412	224	1	0.408015
GCA_014282095.1-Pla_CM024929.1_i000_047831	188	412	224	1	0.408015
GCA_014282145.1-Pla_CM024949.1_i000_047252	188	412	224	1	0.408015
GCA_014282345.1-Pla_CM024984.1_i000_047053	188	412	224	1	0.408015
GCA_020497155.1-Pla_CM035723.1_i000_047561	188	412	224	1	0.408015
GCA_005239225.1-Pla_RCHU01001198.1_i000_006959	188	412	224	1	0.406534
GCA_000349385.1-Fun_KB706938.1_i000_007823	191	417	226	1.00893	0.441406
GCA_001574975.1-Fun_KQ965742.1_i000_004064	181	413	232	1.03571	0.495726
GCA_004917825.1-Fun_QZBZ01000451.1_i000_007707	192	417	225	1.00446	0.425331
GCA_014839935.1-Fun_QTSX01003481.1_i000_002867	68	285	217	0.96875	0.560724
GCA_000241205.2-Fun_BABT02000028.1_i000_005914	183	408	225	1.00446	0.412088
GCA_000708205.1-Fun_KL411544.1_i000_002406	183	408	225	1.00446	0.412088
GCA_021901695.1-Fun_CM038884.1_i000_014349	184	408	224	1	0.440079
GCA_001045655.1-Ani_LBMM01000985.1_i000_002481	184	410	226	1.00893	0.461224
GCA_018258275.1-Pla_CM031110.1_i000_029394	162	380	218	0.973214	0.414449
GCA_905183005.1-Pro_CAJJDO010000015.1_i000_007369	181	401	220	0.982143	0.470085
GCA_000690575.1-Pla_AYPS01000055.1_i000_000237	180	400	220	0.982143	0.45738
GCA_008704605.1-Fun_SWFS01000211.1_i000_001170	188	415	227	1.01339	0.451292
GCA_014108255.1-Ani_JACAGC010000023.1_i000_010949	184	409	225	1.00446	0.377517
GCA_000165425.1-Pro_CT868668.1_i000_037037	181	401	220	0.982143	0.470085
GCA_900618425.1-Ani_UZAN01056734.1_i000_014104	177	400	223	0.995536	0.516204
GCA_020800215.1-Pro_JAICDV010000006.1_i000_007447	189	413	224	1	0.438356
GCA_020800235.1-Pro_JAICDX010000001.1_i000_000567	189	413	224	1	0.438356
GCA_000721755.1-Fun_KL584780.1_i000_009707	192	417	225	1.00446	0.428571
GCA_002286715.1-Fun_NSJX01000007.1_i000_012319	185	410	225	1.00446	0.420561
GCA_001937105.1-Fun_MPGH01000089.1_i000_009978	193	419	226	1.00893	0.44227
GCA_000325575.1-Ani_KB031072.1_i000_015328	204	429	225	1.00446	0.365854
GCA_019924995.1-Fun_JAHFYO010002209.1_i000_007619	132	358	226	1.00893	0.484979
GCA_004918505.1-Fun_QZCB01000266.1_i000_004021	192	417	225	1.00446	0.427757
GCA_017552425.1-Pla_CM029811.1_i000_022228	171	389	218	0.973214	0.394213
GCA_000091225.2-Fun_AL590444.1_i000_000587	156	378	222	0.991071	0.53753
GCA_001006345.1-Fun_LCWF01000196.1_i000_002701	140	366	226	1.00893	0.471816
GCA_000474925.1-Fun_KI440845.1_i000_003957	195	418	223	0.995536	0.426386
GCA_000961545.1-Fun_AXCR01000010.1_i000_008127	195	418	223	0.995536	0.426386
GCA_000696525.1-Pla_KK915213.1_i000_023813	177	396	219	0.977679	0.379549
GCA_001632345.1-Fun_KV429033.1_i000_000800	179	401	222	0.991071	0.38676
GCA_013368085.1-Ani_JABVZW010002413.1_i000_010881	187	411	224	1	0.460905
GCA_001445595.3-Fun_DF977537.1_i000_011586	191	417	226	1.00893	0.439689
GCA_018360065.1-Fun_SRPO01000086.1_i000_007413	192	417	225	1.00446	0.443787
GCA_001191645.1-Fun_AJIL01000182.1_i000_014178	184	408	224	1	0.440079
GCA_021901655.1-Fun_CM038902.1_i000_014109	184	408	224	1	0.440079
GCA_017552425.1-Pla_CM029811.1_i000_022221	177	395	218	0.973214	0.389982
GCA_003369625.1-Fun_PVWQ01000003.1_i000_006087	190	416	226	1.00893	0.443137
GCA_001658105.1-Fun_KV448223.1_i000_004818	201	420	219	0.977679	0.396022
GCA_002220415.3-Pla_CM022220.1_i000_049772	177	395	218	0.973214	0.377163
GCA_009746105.1-Pla_CM019264.1_i000_000550	188	413	225	1.00446	0.403226
GCA_015731905.1-Pla_CM027671.1_i000_019653	177	395	218	0.973214	0.389982
GCA_002897355.1-Pro_BEYU01000017.1_i000_002187	190	414	224	1	0.413284
GCA_900005705.1-Ani_HG973536.1_i000_001676	190	415	225	1.00446	0.409836
GCA_014898675.1-Fun_JACXVL010000065.1_i000_018464	185	410	225	1.00446	0.425331
GCA_000006295.1-Ani_DS235004.1_i000_010372	197	422	225	1.00446	0.461066
GCA_900090045.1-Pro_LT594630.1_i000_002264	186	409	223	0.995536	0.34255
GCA_900088575.1-Pro_FLQW01000692.1_i000_001243	186	409	223	0.995536	0.345736
GCA_001636675.1-Fun_AZGY01000015.1_i000_002589	192	417	225	1.00446	0.441176
GCA_002092935.1-Fun_KZ084150.1_i000_011318	184	410	226	1.00893	0.416206
GCA_000691945.2-Pro_FO082872.1_i000_001225	182	401	219	0.977679	0.51049
GCA_902806795.1-Ani_CADCXV010001472.1_i000_016199	184	402	218	0.973214	0.494331
GCA_000934385.1-Fun_KN880481.1_i000_004862	180	393	213	0.950893	0.385172
GCA_900412535.3-Pla_LS974619.2_i000_014195	188	413	225	1.00446	0.445545
GCA_000262585.1-Ani_JH668497.1_i000_008138	187	411	224	1	0.4859
GCA_014049915.1-Ani_JABVXQ010000010.1_i000_002291	184	409	225	1.00446	0.377517
GCA_000151685.2-Pla_EQ973773.1_i000_030072	188	412	224	1	0.401434
GCA_017639395.1-Pla_CM029881.1_i000_014820	188	413	225	1.00446	0.445545
GCA_019925215.1-Fun_JAHFYS010002931.1_i000_008133	146	372	226	1.00893	0.470833
GCA_001194135.1-Ani_KQ424913.1_i000_027064	190	413	223	0.995536	0.323188
GCA_000165365.1-Pro_AAGK01000001.1_i000_000718	185	407	222	0.991071	0.396429
GCA_000235995.2-Ani_KZ248735.1_i000_010609	180	398	218	0.973214	0.398537
GCA_004303085.2-Pla_SDAM02000105.1_i000_008585	188	412	224	1	0.430769
GCA_020379485.1-Pla_CM035448.1_i000_011265	193	418	225	1.00446	0.441176
GCA_004918325.1-Fun_SPNW01000006.1_i000_002874	186	411	225	1.00446	0.409836
GCA_001831195.1-Fun_MJBS01000015.1_i000_003101	193	419	226	1.00893	0.444882
GCA_016864795.1-Pro_RCMN01000542.1_i000_014963	189	413	224	1	0.435798
GCA_016864835.1-Pro_RCMM01000533.1_i000_015633	189	413	224	1	0.435798
GCA_016865085.1-Pro_RCMU01000453.1_i000_018333	189	413	224	1	0.435798
GCA_004115005.2-Pla_CM032144.1_i000_013987	189	413	224	1	0.405797
GCA_018691285.1-Pla_CM031890.1_i000_014818	189	413	224	1	0.405797
GCA_004917145.1-Fun_QZAE01000077.1_i000_009216	257	482	225	1.00446	0.380711
GCA_004917495.1-Fun_QZBE01000226.1_i000_004516	257	482	225	1.00446	0.380711
GCA_004917505.1-Fun_QZBF01000300.1_i000_004637	257	482	225	1.00446	0.380711
GCA_004917725.1-Fun_QZBM01000181.1_i000_002352	257	482	225	1.00446	0.380711
GCA_004917745.1-Fun_QZBN01000531.1_i000_007443	257	482	225	1.00446	0.380711
GCA_019512045.2-Pla_QIYW02000003.1_i000_009712	188	412	224	1	0.429942
GCA_021218885.1-Ani_MU269961.1_i000_008136	184	409	225	1.00446	0.378151
GCA_901343595.1-Ani_CABDUW010000015.1_i000_001135	184	409	225	1.00446	0.378151
GCA_000412655.1-Ani_KE163658.1_i000_011931	178	403	225	1.00446	0.382653
GCA_000372725.1-Pro_KB865021.1_i000_014419	189	414	225	1.00446	0.472689
GCA_003287315.1-Pro_MJFZ01000578.1_i000_018138	189	413	224	1	0.436647
GCA_016864665.1-Pro_RCMF01000529.1_i000_014674	189	413	224	1	0.436647
GCA_016864755.1-Pro_RCMH01000523.1_i000_015920	189	413	224	1	0.436647
GCA_004325045.1-Fun_PITJ01000859.1_i000_002293	157	380	223	0.995536	0.530952
GCA_013266185.1-Fun_JABEXW010000135.1_i000_002736	193	419	226	1.00893	0.439689
GCA_905332335.1-Ani_CAJOBX010001400.1_i000_002987	72	282	210	0.9375	0.744681
GCA_001742945.1-Pla_DF973172.1_i000_006519	177	394	217	0.96875	0.395985
GCA_019049445.1-Ani_JAHFVI010000047.1_i000_011663	187	411	224	1	0.453441
GCA_018282005.1-Fun_JABCKV010000119.1_i000_005429	186	411	225	1.00446	0.428571
GCA_014108235.1-Ani_JABWUV010000009.1_i000_020955	184	409	225	1.00446	0.378788
GCA_004153795.2-Pla_SDRB02012732.1_i000_027214	188	412	224	1	0.311544
GCA_927797965.1-Ani_OV696688.1_i000_006116	184	409	225	1.00446	0.377517
GCA_020137385.1-Fun_JACLAE010000014.1_i000_003111	189	415	226	1.00893	0.431298
GCA_011752425.2-Ani_CACVKT020009086.1_i000_052245	207	432	225	1.00446	0.415129
GCA_022376655.1-Fun_JAJJKE010000012.1_i000_001326	191	416	225	1.00446	0.442043
GCA_019722365.1-Pla_JADFUC010000514.1_i000_014680	177	395	218	0.973214	0.394928
GCA_020466585.1-Ani_JAFETG010000010.1_i000_003395	669	894	225	1.00446	0.219941
GCA_000327345.1-Ani_KB103138.1_i000_004177	190	415	225	1.00446	0.375
GCA_000006335.3-Fun_GG692397.1_i000_003005	180	400	220	0.982143	0.426357
GCA_017315405.1-Fun_JAFIQD010000003.1_i000_003589	180	400	220	0.982143	0.426357
GCA_000803125.3-Ani_CM016645.2_i000_014627	130	355	225	1.00446	0.415896
GCA_900618405.1-Ani_UYSL01000289.1_i000_000592	188	415	227	1.01339	0.451292
GCA_001268165.1-Fun_CVQI01035050.1_i000_017639	154	304	150	0.669643	0.436047
GCA_900000015.1-Pro_CCYD01003101.1_i000_015279	189	414	225	1.00446	0.436893
GCA_009733045.1-Pro_QXGC01000076.1_i000_002632	189	413	224	1	0.440079
GCA_900618445.1-Ani_UYSG01010926.1_i000_007315	178	400	222	0.991071	0.508009
GCA_902177915.1-Ani_CABIJS010000077.1_i000_002637	178	400	222	0.991071	0.508009
GCA_014282245.1-Pla_CM024964.1_i000_027521	97	222	125	0.558036	0.428082
GCA_900096595.1-Fun_FMSP01000008.1_i000_006085	229	453	224	1	0.380952
GCA_000011425.1-Fun_BN001306.1_i000_006707	190	416	226	1.00893	0.443137
GCA_900618405.1-Ani_UYSL01026587.1_i000_021556	188	415	227	1.01339	0.451292
GCA_020726575.1-Fun_JAGSXJ010000012.1_i000_001728	192	418	226	1.00893	0.445759
GCA_010015805.1-Fun_ML978125.1_i000_005724	192	417	225	1.00446	0.431862
GCA_905332125.1-Ani_CAJOBJ010002897.1_i000_008783	47	272	225	1.00446	0.669643
GCA_003086725.1-Fun_MBFT01000974.1_i000_006479	185	410	225	1.00446	0.426945
GCA_003097675.1-Fun_MBFU01000400.1_i000_004128	185	410	225	1.00446	0.426945
GCA_001563115.1-Fun_JEMN01001384.1_i000_010134	193	419	226	1.00893	0.444882
GCA_001563135.1-Fun_JFBX01000863.1_i000_012886	193	419	226	1.00893	0.444882
GCA_011075155.1-Fun_JAAJBS010000012.1_i000_012943	193	419	226	1.00893	0.444882
GCA_018906675.1-Fun_JAESDO010000008.1_i000_013416	193	419	226	1.00893	0.444882
GCA_018906765.1-Fun_JAESDN010000008.1_i000_013458	193	419	226	1.00893	0.444882
GCA_018907675.1-Fun_JAESDM010000008.1_i000_013643	193	419	226	1.00893	0.444882
GCA_016865095.1-Pro_RCMR01000137.1_i000_006687	189	413	224	1	0.435798
GCA_016880985.1-Pro_QOKR01000139.1_i000_003662	189	413	224	1	0.435798
GCA_022478865.1-Ani_JAHXPS010006170.1_i000_029983	189	413	224	1	0.422642
GCA_921294245.1-Ani_OV121135.1_i000_005082	187	411	224	1	0.4375
GCA_019924295.1-Fun_JAHFXI010002103.1_i000_007359	146	372	226	1.00893	0.470833
GCA_010583015.1-Fun_MU007058.1_i000_008922	192	416	224	1	0.422642
GCA_020466635.1-Ani_JAFETF010000011.1_i000_004827	680	905	225	1.00446	0.217391
GCA_001477545.1-Fun_LFVZ01000010.1_i000_000308	187	412	225	1.00446	0.396127
GCA_002920205.1-Fun_PKSM01000205.1_i000_010492	229	453	224	1	0.404332
GCA_022496225.1-Fun_WTXE01000115.1_i000_001444	180	417	237	1.05804	0.420213
GCA_018858115.1-Fun_JABCKT010000120.1_i000_003752	182	405	223	0.995536	0.390543
GCA_900245975.1-Ani_OUUW01000013.1_i000_011882	186	410	224	1	0.448
GCA_010183535.1-Ani_CM021148.1_i000_016301	188	415	227	1.01339	0.466119
GCA_000005195.1-Ani_CH479179.1_i000_015611	186	410	224	1	0.448
GCA_018687715.1-Pla_CM031819.1_i000_022576	188	412	224	1	0.407273
GCA_907166875.3-Ani_CAJRHG030000007.1_i000_012043	186	411	225	1.00446	0.458248
GCA_016808215.1-Pla_CM029006.1_i000_022280	188	412	224	1	0.406534
GCA_018689175.1-Pla_CM031851.1_i000_021256	188	412	224	1	0.406534
GCA_022453885.1-Ani_CP092624.1_i000_014149	819	1046	227	1.01339	0.203223
GCA_018688675.1-Pla_CM031835.1_i000_022350	188	412	224	1	0.406534
GCA_000814945.1-Fun_AZNE01000030.1_i000_006453	192	418	226	1.00893	0.444882
GCA_000721765.1-Fun_KL584722.1_i000_008909	191	417	226	1.00893	0.430476
GCA_019924955.1-Fun_JAHFYN010000012.1_i000_001331	191	417	226	1.00893	0.430476
GCA_000187425.2-Fun_ADNJ02000001.1_i000_000711	192	418	226	1.00893	0.444882
GCA_000426965.1-Fun_KE384719.1_i000_000729	192	418	226	1.00893	0.444882
GCA_000591435.1-Fun_JELW01000001.1_i000_001168	192	418	226	1.00893	0.444882
GCA_020102295.1-Fun_JACEFI010000004.1_i000_003156	192	418	226	1.00893	0.444882
GCA_000739145.1-Fun_JNNZ01000007.1_i000_000898	192	418	226	1.00893	0.444882
GCA_000814975.1-Fun_AZNF01000017.1_i000_003906	192	418	226	1.00893	0.444882
GCA_002760635.1-Fun_AYKW01000069.1_i000_015188	184	410	226	1.00893	0.4
GCA_019924115.1-Fun_JAHFXA010000249.1_i000_001956	191	417	226	1.00893	0.430476
GCA_019924135.1-Fun_JAHFXB010001946.1_i000_009163	191	417	226	1.00893	0.430476
GCA_019924155.1-Fun_JAHFXD010003486.1_i000_012202	191	417	226	1.00893	0.430476
GCA_019924195.1-Fun_JAHFXF010001879.1_i000_006415	191	417	226	1.00893	0.430476
GCA_019924215.1-Fun_JAHFXC010003486.1_i000_012019	191	417	226	1.00893	0.430476
GCA_019924275.1-Fun_JAHFXJ010003523.1_i000_012338	191	417	226	1.00893	0.430476
GCA_019924315.1-Fun_JAHFXH010003024.1_i000_011067	191	417	226	1.00893	0.430476
GCA_019924355.1-Fun_JAHFXO010000019.1_i000_001027	191	417	226	1.00893	0.430476
GCA_019924375.1-Fun_JAHFXM010000639.1_i000_004083	191	417	226	1.00893	0.430476
GCA_019924395.1-Fun_JAHFXN010003809.1_i000_012848	191	417	226	1.00893	0.430476
GCA_019924415.1-Fun_JAHFXV010000010.1_i000_009573	191	417	226	1.00893	0.430476
GCA_019924425.1-Fun_JAHFXT010000020.1_i000_002796	191	417	226	1.00893	0.430476
GCA_019924435.1-Fun_JAHFXP010002751.1_i000_010588	191	417	226	1.00893	0.430476
GCA_019924465.1-Fun_JAHFXQ010000002.1_i000_000387	191	417	226	1.00893	0.430476
GCA_019924485.1-Fun_JAHFXR010000002.1_i000_000372	191	417	226	1.00893	0.430476
GCA_019924535.1-Fun_JAHFXS010000002.1_i000_000379	191	417	226	1.00893	0.430476
GCA_019924575.1-Fun_JAHFXX010002772.1_i000_010662	191	417	226	1.00893	0.430476
GCA_019924615.1-Fun_JAHFXW010002773.1_i000_010781	191	417	226	1.00893	0.430476
GCA_019924655.1-Fun_JAHFXZ010003395.1_i000_012108	191	417	226	1.00893	0.430476
GCA_019924675.1-Fun_JAHFXY010002718.1_i000_010473	191	417	226	1.00893	0.430476
GCA_019924695.1-Fun_JAHFYA010001069.1_i000_005756	191	417	226	1.00893	0.430476
GCA_019924735.1-Fun_JAHFYD010002782.1_i000_010802	191	417	226	1.00893	0.430476
GCA_019924755.1-Fun_JAHFYB010003579.1_i000_012360	191	417	226	1.00893	0.430476
GCA_019924895.1-Fun_JAHFYM010001917.1_i000_006351	191	417	226	1.00893	0.430476
GCA_019924905.1-Fun_JAHFYL010003521.1_i000_012365	191	417	226	1.00893	0.430476
GCA_019925035.1-Fun_JAHFYQ010000014.1_i000_001776	191	417	226	1.00893	0.430476
GCA_019925055.1-Fun_JAHFYR010000027.1_i000_003903	191	417	226	1.00893	0.430476
GCA_019925775.1-Fun_JAHFYE010003242.1_i000_015049	191	417	226	1.00893	0.430476
GCA_000149515.1-Ani_DS268467.1_i000_014429	188	415	227	1.01339	0.466119
GCA_000814955.1-Fun_AZNH01000012.1_i000_001857	192	418	226	1.00893	0.445759
GCA_004329165.1-Pla_CM014734.1_i000_019461	188	412	224	1	0.404332
GCA_902728275.1-Fun_CACVBS010000073.1_i000_010494	183	391	208	0.928571	0.206965
GCA_005966545.1-Pro_SPLM01000072.1_i000_004081	189	413	224	1	0.452525
GCA_019924015.1-Fun_JAHFWZ010000016.1_i000_002409	191	417	226	1.00893	0.430476
GCA_019924175.1-Fun_JAHFXG010000028.1_i000_004307	191	417	226	1.00893	0.430476
GCA_019924555.1-Fun_JAHFXU010005025.1_i000_018156	191	417	226	1.00893	0.430476
GCA_019924715.1-Fun_JAHFYG010000043.1_i000_006450	191	417	226	1.00893	0.430476
GCA_019924725.1-Fun_JAHFYF010000040.1_i000_006147	191	417	226	1.00893	0.430476
GCA_019924775.1-Fun_JAHFYC010000551.1_i000_003082	191	417	226	1.00893	0.430476
GCA_019924815.1-Fun_JAHFYJ010000037.1_i000_005850	191	417	226	1.00893	0.430476
GCA_019924825.1-Fun_JAHFYH010000036.1_i000_005565	191	417	226	1.00893	0.430476
GCA_019924835.1-Fun_JAHFYI010000038.1_i000_006151	191	417	226	1.00893	0.430476
GCA_019925085.1-Fun_JAHFYT010000049.1_i000_006728	191	417	226	1.00893	0.430476
GCA_009887335.1-Ani_SGJC01008747.1_i000_007381	167	395	228	1.01786	0.548077
GCA_000004335.1-Ani_GL192628.1_i000_005781	184	409	225	1.00446	0.376884
GCA_016864715.1-Pro_RCMK01000514.1_i000_015422	231	455	224	1	0.402878
GCA_016864775.1-Pro_RCMO01000565.1_i000_016081	231	455	224	1	0.402878
GCA_016906365.1-Pro_RCMQ01000532.1_i000_014821	231	455	224	1	0.402878
GCA_008080495.1-Fun_CP023326.1_i000_001610	205	431	226	1.00893	0.418519
GCA_905146905.1-Ani_CAJHUB010000653.1_i000_002381	184	409	225	1.00446	0.376884
GCA_016864635.1-Pro_RCME01000512.1_i000_013582	231	455	224	1	0.403604
GCA_016864655.1-Pro_NHQK01000074.1_i000_025375	231	455	224	1	0.403604
GCA_016864695.1-Pro_RCMG01000531.1_i000_014862	231	455	224	1	0.403604
GCA_016864735.1-Pro_RCMI01000520.1_i000_014031	231	455	224	1	0.403604
GCA_016864815.1-Pro_RCML01000544.1_i000_014674	231	455	224	1	0.403604
GCA_016864855.1-Pro_RCMP01000532.1_i000_014494	231	455	224	1	0.403604
GCA_016865055.1-Pro_RCMV01000521.1_i000_013177	231	455	224	1	0.403604
GCA_016865075.1-Pro_RCMT01000566.1_i000_021033	231	455	224	1	0.403604
GCA_017309695.1-Pro_RCMJ01000557.1_i000_018980	231	455	224	1	0.403604
GCA_000225605.1-Fun_JH126399.1_i000_000486	205	431	226	1.00893	0.416206
GCA_021901655.1-Fun_CM038887.1_i000_001550	186	398	212	0.946429	0.370629
GCA_009835185.1-Pro_VJMH01000063.1_i000_000960	187	411	224	1	0.459016
GCA_900708865.1-Pro_CAADRA010000063.1_i000_000917	187	411	224	1	0.459016
GCA_000696525.1-Pla_KK914632.1_i000_015784	188	412	224	1	0.402878
GCA_001191645.1-Fun_AJIL01000063.1_i000_008551	186	398	212	0.946429	0.370629
GCA_021901695.1-Fun_CM038869.1_i000_001542	186	398	212	0.946429	0.370629
GCA_001305275.1-Fun_LHCL01000028.1_i000_004834	190	416	226	1.00893	0.445759
GCA_004917485.1-Fun_QZBD01000602.1_i000_008032	201	426	225	1.00446	0.420561
GCA_000263375.1-Fun_JH668242.1_i000_004223	178	400	222	0.991071	0.418079
GCA_004917935.1-Fun_SPRJ01000012.1_i000_000522	178	400	222	0.991071	0.418079
GCA_004917965.1-Fun_SPRO01000036.1_i000_002269	178	400	222	0.991071	0.418079
GCA_004918155.1-Fun_SPRG01000012.1_i000_000551	178	400	222	0.991071	0.418079
GCA_004918525.1-Fun_SPRF01000014.1_i000_000745	178	400	222	0.991071	0.418079
GCA_004918605.1-Fun_SPRK01000011.1_i000_000338	178	400	222	0.991071	0.418079
GCA_004918725.1-Fun_SPRT01000007.1_i000_003389	178	400	222	0.991071	0.418079
GCA_004918905.1-Fun_SPRC01000011.1_i000_000362	178	400	222	0.991071	0.418079
GCA_004918995.1-Fun_SPRY01000013.1_i000_000685	178	400	222	0.991071	0.418079
GCA_004919005.1-Fun_SPRX01000010.1_i000_004160	178	400	222	0.991071	0.418079
GCA_004917925.1-Fun_SPRI01000012.1_i000_000525	178	400	222	0.991071	0.418079
GCA_004917975.1-Fun_SPRM01000021.1_i000_001464	178	400	222	0.991071	0.418079
GCA_004918485.1-Fun_SPRQ01000013.1_i000_000628	178	400	222	0.991071	0.418079
GCA_004918635.1-Fun_SPRD01000011.1_i000_000359	178	400	222	0.991071	0.418079
GCA_004918645.1-Fun_SPRE01000011.1_i000_000346	178	400	222	0.991071	0.418079
GCA_004918665.1-Fun_SPRB01000009.1_i000_003937	178	400	222	0.991071	0.418079
GCA_004918795.1-Fun_SPRH01000009.1_i000_003940	178	400	222	0.991071	0.418079
GCA_004918805.1-Fun_SPRR01000010.1_i000_004169	178	400	222	0.991071	0.418079
GCA_004918835.1-Fun_SPRW01000011.1_i000_000415	178	400	222	0.991071	0.418079
GCA_004918915.1-Fun_SPRN01000017.1_i000_001080	178	400	222	0.991071	0.418079
GCA_004918925.1-Fun_SPRP01000011.1_i000_000455	178	400	222	0.991071	0.418079
GCA_004918985.1-Fun_SPRS01000010.1_i000_004167	178	400	222	0.991071	0.418079
GCA_014108245.1-Ani_JACAGB010000006.1_i000_016231	184	409	225	1.00446	0.382003
GCA_004918005.1-Fun_SPRU01000009.1_i000_003952	178	400	222	0.991071	0.418079
GCA_004918025.1-Fun_SPRV01000012.1_i000_000599	178	400	222	0.991071	0.418079
GCA_004918075.1-Fun_SPRL01000009.1_i000_004060	178	400	222	0.991071	0.418079
GCA_004918515.1-Fun_SPRA01000010.1_i000_004171	178	400	222	0.991071	0.418079
GCA_003958945.1-Ani_QMKO01002935.1_i000_008860	194	415	221	0.986607	0.494407
GCA_018873755.1-Pro_JAENGZ010000435.1_i000_012523	238	462	224	1	0.397869
GCA_000143185.1-Fun_GL377302.1_i000_001216	185	407	222	0.991071	0.380137
GCA_003144235.1-Fun_KZ819832.1_i000_002933	189	412	223	0.995536	0.386482
GCA_004325035.1-Fun_PIXR01000531.1_i000_001450	157	380	223	0.995536	0.530952
GCA_003444635.2-Fun_QOKS01000054.1_i000_010937	189	415	226	1.00893	0.430476
GCA_003790465.1-Fun_ML119113.1_i000_002324	189	415	226	1.00893	0.430476
GCA_000765035.1-Fun_CCBP010000057.1_i000_001807	184	410	226	1.00893	0.416206
GCA_000721775.1-Fun_KL584834.1_i000_005629	191	417	226	1.00893	0.430476
GCA_019925005.1-Fun_JAHFYP010000011.1_i000_001622	191	417	226	1.00893	0.430476
GCA_000582985.1-Fun_JARH01001073.1_i000_013458	193	419	226	1.00893	0.444882
GCA_001653235.2-Fun_CM008058.1_i000_007229	192	418	226	1.00893	0.441406
GCA_022160275.1-Fun_MU276211.1_i000_013926	185	411	226	1.00893	0.416206
GCA_016880175.1-Pro_RCMS01000518.1_i000_014013	231	455	224	1	0.402878
GCA_001675575.1-Ani_LZPO01117186.1_i000_023879	176	401	225	1.00446	0.388601
GCA_014621405.1-Fun_JAANBC010000032.1_i000_004619	193	419	226	1.00893	0.368078
GCA_011800145.1-Ani_JAAMPH010000036.1_i000_004409	184	409	225	1.00446	0.376884
GCA_019924025.1-Fun_JAHFWX010004734.1_i000_017516	191	417	226	1.00893	0.430476
GCA_015179125.1-Fun_WHVA01000176.1_i000_004185	189	414	225	1.00446	0.458248
GCA_900199415.2-Ani_FZQP02002537.1_i000_007590	187	411	224	1	0.489083
GCA_015342795.1-Ani_CM027194.1_i000_019322	183	407	224	1	0.414815
GCA_000365145.2-Fun_KB822711.1_i000_000227	190	416	226	1.00893	0.429658
GCA_002249905.1-Ani_NNAY01001214.1_i000_007587	208	432	224	1	0.431599
GCA_018873745.1-Pro_JAENGY010000410.1_i000_011561	238	462	224	1	0.397869
GCA_004011775.1-Fun_NAJM01000012.1_i000_001053	190	416	226	1.00893	0.433781
GCA_002220415.3-Pla_CM022215.1_i000_021034	173	397	224	1	0.483801
GCA_000385875.2-Fun_KK365226.1_i000_002721	148	390	242	1.08036	0.603491
GCA_000827195.1-Fun_KN838546.1_i000_002769	182	404	222	0.991071	0.127807
GCA_000147175.1-Ani_GL442192.1_i000_011234	158	384	226	1.00893	0.490239
GCA_001708105.1-Fun_CP014585.1_i000_002073	181	401	220	0.982143	0.422265
GCA_003290485.1-Fun_CP030252.1_i000_001519	190	414	224	1	0.435798
GCA_905115235.1-Ani_LR899013.1_i000_012865	185	410	225	1.00446	0.404676
GCA_905219545.1-Fun_CAJMWQ010001450.1_i000_006473	187	407	220	0.982143	0.398551
GCA_003691605.1-Fun_CP033149.1_i000_000865	190	414	224	1	0.435798
GCA_014108415.1-Ani_JACASF010000006.1_i000_017675	184	409	225	1.00446	0.376884
GCA_004325065.1-Fun_PITI01000495.1_i000_001859	157	380	223	0.995536	0.530952
GCA_004325075.1-Fun_PITK01000638.1_i000_002871	157	380	223	0.995536	0.530952
GCA_003024175.1-Pro_MDYQ01000061.1_i000_015489	1322	1546	224	1	0.132544
GCA_020875895.1-Ani_JNEY01000002.1_i000_001943	202	426	224	1	0.425856
GCA_905237085.1-Pro_CAJNNV010026698.1_i000_036425	1	207	206	0.919643	0.962617
GCA_905237095.1-Pro_CAJNNW010036238.1_i000_046558	1	207	206	0.919643	0.962617
GCA_001078035.1-Fun_LFTZ01000004.1_i000_000496	156	378	222	0.991071	0.53753
GCA_013487665.1-Pla_CM025186.1_i000_011019	64	290	226	1.00893	0.724359
GCA_900661375.1-Ani_CAAGRJ010027723.1_i000_015460	184	409	225	1.00446	0.376884
GCA_003014415.1-Fun_PYGM01000001.1_i000_000030	181	401	220	0.982143	0.421456
GCA_008275145.1-Fun_CP043442.1_i000_001750	181	401	220	0.982143	0.421456
GCA_000223135.1-Ani_JH000136.1_i000_004544	184	409	225	1.00446	0.380068
GCA_002926015.1-Pla_KZ648758.1_i000_026288	188	412	224	1	0.433269
GCA_000230795.1-Ani_CM001262.1_i000_008847	184	409	225	1.00446	0.378788
GCA_905332115.1-Ani_CAJOBH010003513.1_i000_011243	82	307	225	1.00446	0.606469
GCA_008124465.1-Pla_CM017887.1_i000_021000	92	317	225	1.00446	0.487013
GCA_013676235.1-Pla_CM025497.1_i000_004050	191	415	224	1	0.510251
GCA_008520325.1-Fun_VDEP01000173.1_i000_012855	186	400	214	0.955357	0.373473
GCA_008522505.1-Fun_VSWC01000066.1_i000_014831	186	400	214	0.955357	0.373473
GCA_019973955.1-Ani_BMAV01009158.1_i000_016230	182	406	224	1	0.403604
GCA_008520325.1-Fun_VDEP01000035.1_i000_002975	186	400	214	0.955357	0.372822
GCA_905331015.1-Ani_CAJNXB010004810.1_i000_027031	186	411	225	1.00446	0.473684
GCA_905331295.1-Ani_CAJNYD010001325.1_i000_010978	186	411	225	1.00446	0.473684
GCA_905331475.1-Ani_CAJNYU010000745.1_i000_007874	186	411	225	1.00446	0.473684
GCA_905331495.1-Ani_CAJNYV010003028.1_i000_017002	186	411	225	1.00446	0.473684
GCA_905332235.1-Ani_CAJOBO010000494.1_i000_009409	186	411	225	1.00446	0.473684
GCA_905332245.1-Ani_CAJOBP010000630.1_i000_006646	186	411	225	1.00446	0.473684
GCA_905332265.1-Ani_CAJOBQ010000976.1_i000_016166	186	411	225	1.00446	0.473684
GCA_905332285.1-Ani_CAJOBS010000393.1_i000_008310	186	411	225	1.00446	0.473684
GCA_003013715.2-Fun_CP043531.1_i000_000134	181	401	220	0.982143	0.419048
GCA_007168705.1-Fun_BGOX01000002.1_i000_002928	181	401	220	0.982143	0.419048
GCA_001189475.1-Fun_LGST01000039.1_i000_004051	181	401	220	0.982143	0.414313
GCA_002759435.2-Fun_PEKT02000004.1_i000_004475	181	401	220	0.982143	0.414313
GCA_019332045.1-Fun_CP076749.1_i000_001525	181	401	220	0.982143	0.414313
GCA_001373355.1-Fun_CENE01000003.1_i000_001089	209	433	224	1	0.410256
GCA_000448345.1-Ani_KE681346.1_i000_016822	192	417	225	1.00446	0.375
GCA_002775015.1-Fun_PGLS01000004.1_i000_000200	181	401	220	0.982143	0.416667
GCA_000328365.1-Ani_KB312061.1_i000_031002	180	399	219	0.977679	0.37372
GCA_016952305.1-Fun_CP064756.1_i000_010740	193	419	226	1.00893	0.447525
GCA_902713445.1-Pla_CACTIH010003849.1_i000_038381	188	412	224	1	0.408015
GCA_000303195.2-Fun_CM003200.1_i000_009110	193	419	226	1.00893	0.447525
GCA_001703955.2-Fun_CM004558.1_i000_008451	193	419	226	1.00893	0.447525
GCA_013364965.1-Fun_JAAMOD010000249.1_i000_007914	193	419	226	1.00893	0.447525
GCA_019455555.1-Ani_JAGFMF010011769.1_i000_011929	184	409	225	1.00446	0.379427
GCA_000240135.3-Fun_CM000576.1_i000_009874	193	419	226	1.00893	0.444882
GCA_000599445.1-Fun_CM002653.1_i000_009741	193	419	226	1.00893	0.444882
GCA_002352725.1-Fun_NQOC01000002.1_i000_002536	193	419	226	1.00893	0.444882
GCA_900044135.1-Fun_HG970334.1_i000_010421	193	419	226	1.00893	0.444882
GCA_900073075.1-Fun_LT222055.1_i000_010463	193	419	226	1.00893	0.444882
GCA_901446245.1-Fun_CABDWO010000179.1_i000_007024	193	419	226	1.00893	0.444882
GCA_905359455.1-Fun_CAJPII010000059.1_i000_005183	193	419	226	1.00893	0.444882
GCA_905359475.1-Fun_CAJPIG010000154.1_i000_006781	193	419	226	1.00893	0.444882
GCA_015852605.2-Pla_CM027584.2_i000_025632	188	412	224	1	0.405063
GCA_016809505.1-Fun_CP050673.1_i000_000135	181	401	220	0.982143	0.421456
GCA_017552425.1-Pla_CM029813.1_i000_025655	188	412	224	1	0.407273
GCA_001299255.1-Fun_LFJN01000006.1_i000_010266	182	399	217	0.96875	0.350565
GCA_014176215.1-Ani_JACASE010000012.1_i000_003808	184	409	225	1.00446	0.376884
GCA_007990325.1-Pla_CM017707.1_i000_037474	188	412	224	1	0.420263
GCA_008761655.1-Pla_CM018221.1_i000_034786	188	412	224	1	0.420263
GCA_012295175.1-Pro_WSZM01000106.1_i000_005303	189	413	224	1	0.436647
GCA_012552325.1-Pro_JAACNO010001745.1_i000_012838	189	413	224	1	0.436647
GCA_000300555.1-Fun_JH971387.1_i000_002894	181	404	223	0.995536	0.38918
GCA_014872705.1-Fun_CM026496.1_i000_005083	181	404	223	0.995536	0.38918
GCA_010015585.1-Fun_ML975149.1_i000_000911	191	416	225	1.00446	0.427757
GCA_910592055.1-Fun_CAJVPT010002334.1_i000_001922	190	385	195	0.870536	0.383858
GCA_000835505.1-Fun_KN847317.1_i000_001168	190	416	226	1.00893	0.437984
GCA_001890125.1-Fun_KV878127.1_i000_004260	191	416	225	1.00446	0.442043
GCA_007990485.1-Pla_CM017629.1_i000_037418	188	412	224	1	0.420263
GCA_013634535.1-Ani_JACDTQ010000823.1_i000_018682	200	425	225	1.00446	0.36645
GCA_000738915.1-Fun_AKIJ01000004.1_i000_001646	173	388	215	0.959821	0.519324
GCA_000697665.1-Fun_KL197711.1_i000_003188	185	411	226	1.00893	0.417745
GCA_019722365.1-Pla_JADFUC010000514.1_i000_014692	188	412	224	1	0.434109
GCA_000250695.1-Fun_JH604637.1_i000_001974	173	388	215	0.959821	0.519324
GCA_001983305.1-Fun_MPUK01000012.1_i000_004910	191	416	225	1.00446	0.441176
GCF_000001405.40-Hum_NC_000020.11_i000_017782	184	409	225	1.00446	0.378788
GCA_000002775.3-Pla_CM009304.1_i000_034238	188	412	224	1	0.405063
GCA_003205855.1-Fun_LK052893.1_i000_001764	191	416	225	1.00446	0.441176
GCA_000764455.1-Fun_JQFK01000031.1_i000_005161	115	335	220	0.982143	0.491071
GCA_002880775.3-Ani_CM009282.2_i000_016771	184	409	225	1.00446	0.378788
GCA_002880755.3-Ani_CM009258.2_i000_016830	184	409	225	1.00446	0.378788
GCA_000311805.2-Ani_KB017191.1_i000_012628	959	1184	225	1.00446	0.164234
GCA_022085475.1-Pla_JAIUZE010070098.1_i000_020414	177	395	218	0.973214	0.379791
GCA_014282095.1-Pla_CM024917.1_i000_012130	188	412	224	1	0.407273
GCA_014282345.1-Pla_CM024972.1_i000_011691	188	412	224	1	0.407273
GCA_009771035.1-Pla_CM020011.1_i000_020889	188	414	226	1.00893	0.420074
GCA_010261695.1-Pla_CM021002.1_i000_012088	188	414	226	1.00893	0.420074
GCA_001411555.2-Pla_CM023842.1_i000_003319	188	412	224	1	0.406534
GCA_019648995.1-Ani_BLXT01000981.1_i000_008959	187	412	225	1.00446	0.385935
GCA_001630345.1-Fun_KV417270.1_i000_001616	178	386	208	0.928571	0.345515
GCA_003012315.1-Fun_PXOF01000060.1_i000_004531	193	419	226	1.00893	0.444008
GCA_000827205.1-Fun_KN832564.1_i000_009480	185	410	225	1.00446	0.428571
GCA_018804465.1-Pla_CM031997.1_i000_014790	188	412	224	1	0.405063
GCA_013305805.1-Fun_QVQA01000014.1_i000_000789	192	417	225	1.00446	0.442043
GCA_004681135.1-Fun_SFCI01000750.1_i000_009681	180	391	211	0.941964	0.370175
GCA_022376455.1-Fun_JACBKO010000042.1_i000_008634	187	412	225	1.00446	0.390625
GCA_010093795.1-Fun_MU006561.1_i000_000223	194	419	225	1.00446	0.431862
GCA_019722365.1-Pla_JADFUC010002331.1_i000_021610	188	412	224	1	0.428298
GCA_018360275.1-Fun_SRQB01000254.1_i000_002856	186	411	225	1.00446	0.525701
GCA_001675295.1-Fun_LYXU01000003.1_i000_008893	193	419	226	1.00893	0.444008
GCA_019609905.1-Fun_CM033787.1_i000_009490	193	419	226	1.00893	0.444008
GCA_000722935.2-Pla_KN661865.1_i000_034998	188	412	224	1	0.408015
GCA_001661315.1-Fun_KV454410.1_i000_003234	190	415	225	1.00446	0.453629
GCA_000372725.1-Pro_KB866422.1_i000_023546	182	390	208	0.928571	0.533333
GCA_905219645.1-Fun_CAJMWZ010002098.1_i000_002423	181	401	220	0.982143	0.185654
GCA_018360755.1-Fun_SRQW01000233.1_i000_002739	192	417	225	1.00446	0.501114
GCA_016861865.1-Fun_AP024445.1_i000_005061	190	416	226	1.00893	0.449304
GCA_018804465.1-Pla_CM031996.1_i000_013742	188	412	224	1	0.430769
GCA_000027005.1-Fun_FN392322.1_i000_004349	181	401	220	0.982143	0.422265
GCA_000223565.1-Fun_FR839631.1_i000_004969	181	401	220	0.982143	0.422265
GCA_001708085.1-Fun_CP014711.1_i000_004331	181	401	220	0.982143	0.422265
GCA_001746955.1-Fun_CP014718.1_i000_004323	181	401	220	0.982143	0.422265
GCA_900235035.1-Fun_LT962479.1_i000_004954	181	401	220	0.982143	0.422265
GCA_005239225.1-Pla_RCHU01000353.1_i000_017569	188	412	224	1	0.405063
GCA_000004515.5-Pla_CM000838.3_i000_010658	188	412	224	1	0.407273
GCA_012273815.2-Pla_CM022563.2_i000_011583	188	412	224	1	0.407273
GCA_014282035.1-Pla_CM024837.1_i000_000438	188	412	224	1	0.407273
GCA_014282145.1-Pla_CM024937.1_i000_011798	188	412	224	1	0.407273
GCA_020497155.1-Pla_CM035711.1_i000_012123	188	412	224	1	0.407273
GCA_018687715.1-Pla_CM031820.1_i000_024969	188	412	224	1	0.407273
GCA_018689175.1-Pla_CM031852.1_i000_023588	188	412	224	1	0.407273
GCA_003704535.1-Pro_QLLG01000156.1_i000_000639	193	417	224	1	0.430769
GCA_003843895.1-Pro_QKXF01000083.1_i000_000849	193	417	224	1	0.430769
GCA_001605315.2-Fun_LUEZ02000096.1_i000_016437	185	411	226	1.00893	0.425612
GCA_021029105.1-Fun_JAEVFJ010000010.1_i000_000882	189	415	226	1.00893	0.435453
GCA_000333975.2-Fun_CAKM01000282.1_i000_000317	186	412	226	1.00893	0.42803
GCA_021491655.1-Pro_CP090800.1_i000_001343	193	417	224	1	0.431599
GCA_015501055.1-Fun_JADNYV010000002.1_i000_006724	180	390	210	0.9375	0.37702
GCA_001890725.1-Fun_KV878211.1_i000_004219	182	407	225	1.00446	0.390625
GCA_014462675.1-Fun_JACAZH010000011.1_i000_013342	181	405	224	1	0.389565
GCA_905183005.1-Pro_CAJJDO010000001.1_i000_000408	181	400	219	0.977679	0.467949
GCA_004155055.1-Fun_QJNZ01000079.1_i000_010424	191	417	226	1.00893	0.441406
GCA_000388065.2-Pro_KB932206.1_i000_003617	181	400	219	0.977679	0.489933
GCA_000426985.1-Fun_KE385535.1_i000_008173	192	418	226	1.00893	0.444882
GCA_000313525.1-Fun_HE796918.1_i000_001691	179	402	223	0.995536	0.393993
GCA_902713445.1-Pla_LR743787.1_i000_015363	188	412	224	1	0.398577
GCA_000722935.2-Pla_KN649024.1_i000_014752	188	412	224	1	0.407273
GCA_020004485.1-Ani_JAATJU010022319.1_i000_010799	282	507	225	1.00446	0.327988
GCA_022085475.1-Pla_JAIUZE010021015.1_i000_012945	186	410	224	1	0.417132
GCA_001447575.1-Ani_JYDT01000131.1_i000_009713	188	409	221	0.986607	0.200909
GCA_001187945.1-Ani_JRES01000310.1_i000_004217	186	410	224	1	0.446215
GCA_902713445.1-Pla_CACTIH010007391.1_i000_047634	188	412	224	1	0.398577
GCA_000166175.1-Fun_GL541645.1_i000_000526	183	408	225	1.00446	0.415129
GCA_002911725.1-Pro_NCKW01020427.1_i000_024003	189	413	224	1	0.458078
GCA_000151685.2-Pla_EQ973777.1_i000_027986	177	395	218	0.973214	0.37913
GCA_021029045.1-Pro_JAFCAI010000003.1_i000_007658	193	399	206	0.919643	0.419552
GCA_001983325.1-Fun_MQVM01000013.1_i000_002897	115	335	220	0.982143	0.491071
GCA_003054445.1-Fun_CP028773.1_i000_000807	115	335	220	0.982143	0.491071
GCA_001890705.1-Fun_KV878584.1_i000_004142	190	416	226	1.00893	0.444008
GCA_018360375.1-Fun_SRQE01000336.1_i000_003914	192	417	225	1.00446	0.501114
GCA_019968985.1-Pro_JAHYSF010000461.1_i000_002563	1	158	157	0.700893	0.80102
GCA_000836275.1-Fun_KN847524.1_i000_007448	190	416	226	1.00893	0.433781
GCA_002287475.2-Fun_CM008257.1_i000_007524	186	411	225	1.00446	0.404676
GCA_000005005.6-Pla_CM007648.1_i000_010253	116	323	207	0.924107	0.603499
GCA_001563125.1-Fun_JFFI01000791.1_i000_003781	193	419	226	1.00893	0.444882
GCA_019968955.1-Pro_JAHYSE010000488.1_i000_003456	1	158	157	0.700893	0.80102
GCA_000182665.1-Pro_ACVC01000192.1_i000_001409	185	412	227	1.01339	0.371522
GCA_001272555.1-Ani_KQ434777.1_i000_000500	160	385	225	1.00446	0.472689
GCA_021491975.1-Ani_CP090895.1_i000_014266	826	1053	227	1.01339	0.201957
GCA_002742825.1-Ani_CM008513.1_i000_019482	825	1052	227	1.01339	0.202137
GCA_000520115.1-Pro_KI914009.1_i000_013795	221	445	224	1	0.433269
GCA_001879085.1-Pla_MJEQ01000490.1_i000_017980	187	412	225	1.00446	0.410584
GCA_001477535.1-Fun_LFWA01000004.1_i000_002391	186	412	226	1.00893	0.407942
GCA_018127125.1-Pla_CM030795.1_i000_024232	188	413	225	1.00446	0.402504
GCA_018360215.1-Fun_SRPX01000059.1_i000_006291	192	417	225	1.00446	0.518433
GCA_007859695.1-Pla_CP031047.1_i000_007159	190	415	225	1.00446	0.459184
GCA_015476325.1-Pro_JADAQX010000149.1_i000_001421	214	433	219	0.977679	0.424419
GCA_902602495.3-Pro_CACKRE030000537.1_i000_004519	188	412	224	1	0.46281
GCA_905182975.1-Pro_CAJJDM010000003.1_i000_001292	181	400	219	0.977679	0.467949
GCA_000585585.1-Fun_AMWN01000002.1_i000_002115	189	415	226	1.00893	0.437137
GCA_000441915.1-Pla_KE528228.1_i000_003957	179	392	213	0.950893	0.543367
GCA_007026445.1-Fun_VDMD01000021.1_i000_006594	189	413	224	1	0.41791
GCA_020080835.1-Ani_CM034667.1_i000_014578	186	410	224	1	0.454361
GCA_020746995.1-Fun_JAGPXD010000003.1_i000_006459	192	418	226	1.00893	0.445759
GCA_004022145.1-Fun_RCNU01000002.1_i000_003869	190	415	225	1.00446	0.432692
GCA_018360765.1-Fun_SRQV01000004.1_i000_004691	192	417	225	1.00446	0.441176
GCA_000347355.1-Fun_CAGA01000003.1_i000_008027	192	417	225	1.00446	0.441176
GCA_018360675.1-Fun_SRQZ01000108.1_i000_000319	192	417	225	1.00446	0.441176
GCA_001444175.2-Ani_KQ562420.1_i000_008627	185	410	225	1.00446	0.447316
GCA_001444175.2-Ani_KQ571347.1_i000_016389	185	410	225	1.00446	0.447316
GCA_004369085.1-Fun_ML210163.1_i000_003373	186	411	225	1.00446	0.414365
GCA_001632435.1-Fun_KV424025.1_i000_009055	188	412	224	1	0.466667
GCA_013399515.1-Ani_VXAN01000965.1_i000_013425	115	317	202	0.901786	0.637224
GCA_900120095.1-Fun_FQNC01000018.1_i000_003714	203	427	224	1	0.394366
GCA_000005155.1-Ani_CH916374.1_i000_003737	186	410	224	1	0.449799
GCA_000219495.2-Pla_CM001220.2_i000_024503	188	412	224	1	0.427481
GCA_003473485.2-Pla_CM010651.1_i000_022820	188	412	224	1	0.427481
GCA_003086715.1-Fun_MBFS01002229.1_i000_005305	185	410	225	1.00446	0.412844
GCA_004154925.1-Fun_QJNS01000272.1_i000_005053	191	417	226	1.00893	0.44227
GCA_004154975.1-Fun_QJNW01000545.1_i000_008215	191	417	226	1.00893	0.44227
GCA_004155895.1-Fun_QJNT01000346.1_i000_006885	191	417	226	1.00893	0.44227
GCA_007844105.2-Pla_CM017585.2_i000_021260	188	412	224	1	0.426667
GCA_008636005.1-Pla_BKCP01008292.1_i000_024105	188	412	224	1	0.425856
GCA_001543975.1-Pro_JXTI01000106.1_i000_003308	185	411	226	1.00893	0.376667
GCA_001970855.1-Fun_LSSN01000030.1_i000_000247	185	410	225	1.00446	0.419776
GCA_001970855.1-Fun_LSSN01003273.1_i000_008011	185	410	225	1.00446	0.419776
GCA_019511825.2-Pla_QFCC02000016.1_i000_014131	188	412	224	1	0.429942
GCA_905332145.1-Ani_CAJOBF010001546.1_i000_013954	174	399	225	1.00446	0.485961
GCA_905332155.1-Ani_CAJOBG010001189.1_i000_009686	174	399	225	1.00446	0.485961
GCA_902713445.1-Pla_CACTIH010005898.1_i000_045243	188	412	224	1	0.405063
GCA_018924745.1-Fun_CM032185.1_i000_007515	185	411	226	1.00893	0.42243
GCA_001712635.2-Pro_MBAC02010849.1_i000_024699	181	406	225	1.00446	0.443787
GCA_000151525.2-Fun_ADAS02000057.1_i000_006824	186	398	212	0.946429	0.373239
GCA_015025155.1-Fun_WITN01000012.1_i000_001784	185	412	227	1.01339	0.414991
GCA_010724915.1-Fun_BLKL01000007.1_i000_001608	190	416	226	1.00893	0.437984
GCA_001970865.1-Fun_LSSM01002034.1_i000_004842	185	410	225	1.00446	0.431034
GCA_000181695.1-Fun_AAYY01000006.1_i000_002413	190	414	224	1	0.413284
GCA_001712635.2-Pro_MBAC02007786.1_i000_017789	181	406	225	1.00446	0.443787
GCA_019096205.1-Ani_CM032520.1_i000_016017	187	411	224	1	0.490153
GCA_905116875.3-Ani_CAJHNJ030000021.1_i000_006555	187	411	224	1	0.490153
GCA_019632295.1-Fun_WSTZ01000002.1_i000_003870	187	412	225	1.00446	0.415896
GCA_002926085.1-Fun_PKFP01000008.1_i000_000122	181	401	220	0.982143	0.43222
GCA_019332025.1-Fun_CP076661.1_i000_000117	181	401	220	0.982143	0.43222
GCA_013487665.1-Pla_CM025180.1_i000_000414	64	290	226	1.00893	0.724359
GCA_018360355.1-Fun_SRQC01000015.1_i000_001275	192	417	225	1.00446	0.436047
GCA_000149205.2-Fun_CH236922.1_i000_005759	161	387	226	1.00893	0.295039
GCA_910592205.1-Fun_CAJVPJ010000358.1_i000_003305	182	400	218	0.973214	0.293011
GCA_905261645.1-Ani_CAJNOV010005360.1_i000_012361	186	411	225	1.00446	0.473684
GCA_905273325.1-Ani_CAJNOW010013454.1_i000_024652	186	411	225	1.00446	0.473684
GCA_905319835.1-Ani_CAJNRE010007263.1_i000_015419	186	411	225	1.00446	0.473684
GCA_905321285.1-Ani_CAJNRF010009699.1_i000_022506	186	411	225	1.00446	0.473684
GCA_905321535.1-Ani_CAJNRG010005339.1_i000_013512	186	411	225	1.00446	0.473684
GCA_019633455.1-Fun_WSUA01001034.1_i000_000317	187	412	225	1.00446	0.425331
GCA_905250105.1-Ani_CAJNOC010001201.1_i000_008588	189	413	224	1	0.440945
GCA_021399455.1-Fun_JAJTUO010000017.1_i000_005991	165	391	226	1.00893	0.424812
GCA_012980525.1-Fun_SJKE01000001.1_i000_000604	186	412	226	1.00893	0.42243
GCA_012979565.1-Fun_SJDA01000004.1_i000_007460	186	412	226	1.00893	0.42243
GCA_001929475.1-Fun_LXFE01001034.1_i000_001783	179	400	221	0.986607	0.281888
GCA_019627755.1-Fun_WSTS01001496.1_i000_002119	19	244	225	1.00446	0.608108
GCA_013397245.1-Ani_VZTB01012745.1_i000_009242	115	331	216	0.964286	0.460554
GCA_000820885.1-Fun_CCBQ010000027.1_i000_002145	190	415	225	1.00446	0.437743
GCA_900576705.1-Ani_UXUI01000314.1_i000_000321	188	413	225	1.00446	0.410584
GCA_000417875.1-Fun_KE361644.1_i000_005868	192	415	223	0.995536	0.379252
GCA_900322975.1-Fun_OOIP01000010.1_i000_003977	192	415	223	0.995536	0.379252
GCA_003185045.1-Pla_CM009906.1_i000_002790	259	466	207	0.924107	0.444206
GCA_904420315.1-Pla_LR881466.1_i000_003869	1276	1501	225	1.00446	0.135298
GCA_000005005.6-Pla_CM000782.4_i000_024669	416	615	199	0.888393	0.323577
GCA_004931855.1-Fun_SELW01000121.1_i000_003724	181	400	219	0.977679	0.41635
GCA_001373355.1-Fun_CENE01000015.1_i000_002988	124	347	223	0.995536	0.489035
GCA_013398595.1-Ani_WBND01001521.1_i000_012538	115	317	202	0.901786	0.637224
GCA_001661415.1-Fun_KV453912.1_i000_002988	181	401	220	0.982143	0.425532
GCA_000293215.1-Fun_JH977558.1_i000_003065	183	394	211	0.941964	0.372792
GCA_013398405.1-Ani_VZSJ01039739.1_i000_012152	115	317	202	0.901786	0.637224
GCA_021605095.1-Ani_BPLR01020297.1_i000_077269	177	400	223	0.995536	0.474468
GCA_000299215.2-Fun_JH925093.1_i000_004666	183	394	211	0.941964	0.372792
GCA_018360325.1-Fun_SRQG01000035.1_i000_004592	192	417	225	1.00446	0.437743
GCA_015484465.1-Fun_MU155183.1_i000_005465	186	411	225	1.00446	0.420561
GCA_018688675.1-Pla_MU228986.1_i000_032954	188	412	224	1	0.407273
GCA_002837095.1-Pla_PGOL01003331.1_i000_037948	1	199	198	0.883929	0.564103
GCA_013467485.1-Pla_CM025277.1_i000_011146	65	290	225	1.00446	0.546117
GCA_002893035.1-Fun_PHNW01000098.1_i000_010244	193	419	226	1.00893	0.44227
GCA_015484515.1-Fun_MU154521.1_i000_000471	186	412	226	1.00893	0.42243
GCA_000182925.2-Fun_CM002242.1_i000_008898	195	419	224	1	0.429942
GCA_000786625.1-Fun_KN389638.1_i000_002239	195	419	224	1	0.429942
GCA_018360445.1-Fun_SRQK01000016.1_i000_001518	192	417	225	1.00446	0.440313
GCA_018360575.1-Fun_SRQL01000029.1_i000_003578	192	417	225	1.00446	0.440313
GCA_018360595.1-Fun_SRQJ01000122.1_i000_000779	192	417	225	1.00446	0.440313
GCA_007844105.2-Pla_CM017585.2_i000_019859	188	412	224	1	0.402154
GCA_003013735.1-Fun_PYFQ01000001.1_i000_001171	181	401	220	0.982143	0.43222
GCA_004011775.1-Fun_NAJM01000045.1_i000_007067	182	410	228	1.01786	0.365385
GCA_000836275.1-Fun_KN847521.1_i000_002855	182	410	228	1.01786	0.365385
GCA_008124465.1-Pla_VOII01113469.1_i000_027077	141	352	211	0.941964	0.38018
GCA_003144135.1-Fun_KZ819333.1_i000_005333	194	416	222	0.991071	0.389474
GCA_000182405.1-Pro_ACGJ01000646.1_i000_004000	185	411	226	1.00893	0.374172
GCA_000498735.1-Pro_AHHH01000086.1_i000_003554	185	411	226	1.00893	0.374172
GCA_000213175.1-Fun_GL891306.1_i000_005904	195	419	224	1	0.429942
GCA_000213195.1-Fun_GL891258.1_i000_009756	195	419	224	1	0.429942
GCA_000277815.3-Fun_CP002716.1_i000_000517	156	378	222	0.991071	0.53753
GCA_014466165.1-Fun_JACETU010000002.1_i000_003416	186	412	226	1.00893	0.421642
GCA_019677325.2-Fun_CM033826.1_i000_004983	186	412	226	1.00893	0.421642
GCA_012980535.1-Fun_SJKF01000002.1_i000_003775	223	449	226	1.00893	0.395105
GCA_000143565.1-Fun_DS547094.1_i000_014950	185	411	226	1.00893	0.462168
GCA_003144115.1-Fun_KZ819289.1_i000_002288	190	414	224	1	0.413284
GCA_014461125.1-Fun_JACAZG010000015.1_i000_011166	187	412	225	1.00446	0.418216
GCA_001720195.1-Fun_AWGK01000033.1_i000_004428	190	411	221	0.986607	0.389771
GCA_000504015.1-Pla_KI630265.1_i000_003621	188	412	224	1	0.430769
GCA_019155685.1-Pro_JAGDFL010000001.1_i000_000075	189	413	224	1	0.4375
GCA_013396525.1-Ani_VWYX01004174.1_i000_014050	1	71	70	0.3125	0.265152
GCA_013396525.1-Ani_VWYX01004174.1_i000_014050	76	246	170	0.758929	0.643939
GCA_006937295.1-Pla_CM017328.1_i000_018857	188	412	224	1	0.402878
GCA_000209125.2-Pro_DS550445.1_i000_001524	180	402	222	0.991071	0.430233
GCA_008761655.1-Pla_CM018222.1_i000_042113	177	390	213	0.950893	0.379679
GCA_001720245.1-Fun_AWGL01000001.1_i000_000012	190	411	221	0.986607	0.389771
GCA_000313545.1-Fun_CAFZ01000288.1_i000_003894	186	411	225	1.00446	0.427757
GCA_900618355.1-Ani_UZAD01000061.1_i000_000990	172	387	215	0.959821	0.455508
GCA_015731905.1-Pla_CM027673.1_i000_022752	226	450	224	1	0.379661
GCA_001630335.1-Fun_KV417571.1_i000_016137	185	410	225	1.00446	0.425331
GCA_000349305.2-Fun_HE999552.1_i000_000774	190	414	224	1	0.431599
GCA_900149145.1-Fun_LT671821.1_i000_000144	190	414	224	1	0.431599
GCA_013398055.1-Ani_VZRS01013060.1_i000_011346	115	317	202	0.901786	0.637224
GCA_000149405.2-Pro_CM000638.1_i000_000962	198	440	242	1.08036	0.456604
GCA_012184645.1-Fun_WYDC01000010.1_i000_000235	181	401	220	0.982143	0.422265
GCA_012184655.1-Fun_WYDD01000010.1_i000_000176	181	401	220	0.982143	0.422265
GCA_002938355.1-Fun_NHTK01000341.1_i000_000528	186	411	225	1.00446	0.413603
GCA_016647745.1-Fun_JABBWE010000014.1_i000_003297	185	411	226	1.00893	0.416974
GCA_002113885.2-Ani_NEDP02005386.1_i000_015374	188	413	225	1.00446	0.429389
GCA_022376465.1-Fun_JACDTU010000011.1_i000_001913	184	410	226	1.00893	0.414679
GCA_002082055.1-Ani_MTYJ01000054.1_i000_007880	186	410	224	1	0.447106
GCA_017788925.1-Fun_JACEFK010000002.1_i000_000017	186	406	220	0.982143	0.496614
GCA_900100905.1-Fun_FMWP01000012.1_i000_007935	203	427	224	1	0.397163
GCA_900102585.1-Fun_FMWQ01000021.1_i000_005497	203	427	224	1	0.397163
GCA_000400465.1-Fun_KE007233.1_i000_002795	186	411	225	1.00446	0.410584
GCA_004917845.1-Fun_SPOB01000026.1_i000_001760	186	411	225	1.00446	0.410584
GCA_004917865.1-Fun_SPOD01000010.1_i000_004022	186	411	225	1.00446	0.410584
GCA_004917895.1-Fun_SPOH01000007.1_i000_003357	186	411	225	1.00446	0.410584
GCA_004918015.1-Fun_SPOC01000007.1_i000_003336	186	411	225	1.00446	0.410584
GCA_004918065.1-Fun_SPOQ01000009.1_i000_003818	186	411	225	1.00446	0.410584
GCA_004918235.1-Fun_SPOE01000008.1_i000_003648	186	411	225	1.00446	0.410584
GCA_004918305.1-Fun_SPOM01000010.1_i000_004015	186	411	225	1.00446	0.410584
GCA_004918315.1-Fun_SPNX01000009.1_i000_003851	186	411	225	1.00446	0.410584
GCA_004918335.1-Fun_SPNZ01000012.1_i000_000327	186	411	225	1.00446	0.410584
GCA_004918345.1-Fun_SPOA01000026.1_i000_001743	186	411	225	1.00446	0.410584
GCA_004918405.1-Fun_SPOO01000010.1_i000_004021	186	411	225	1.00446	0.410584
GCA_004918415.1-Fun_SPOL01000008.1_i000_003590	186	411	225	1.00446	0.410584
GCA_004918445.1-Fun_SPOG01000006.1_i000_003049	186	411	225	1.00446	0.410584
GCA_004918455.1-Fun_SPOF01000008.1_i000_003605	186	411	225	1.00446	0.410584
GCA_004918625.1-Fun_SPOK01000008.1_i000_003612	186	411	225	1.00446	0.410584
GCA_004918655.1-Fun_SPOP01000010.1_i000_004012	186	411	225	1.00446	0.410584
GCA_004918735.1-Fun_SPON01000010.1_i000_004011	186	411	225	1.00446	0.410584
GCA_004918745.1-Fun_SPOJ01000008.1_i000_003557	186	411	225	1.00446	0.410584
GCA_004918755.1-Fun_SPOI01000316.1_i000_002430	186	411	225	1.00446	0.410584
GCA_004918885.1-Fun_SPNY01000010.1_i000_004023	186	411	225	1.00446	0.410584
GCA_004918895.1-Fun_SPOR01000007.1_i000_003417	186	411	225	1.00446	0.410584
GCA_014905825.1-Fun_JACGCN010000004.1_i000_010200	186	411	225	1.00446	0.423729
GCA_001953115.1-Fun_LSSL01004360.1_i000_006296	184	402	218	0.973214	0.424951
GCA_900537275.1-Ani_UYRX01000034.1_i000_003920	177	392	215	0.959821	0.444215
GCA_011074865.2-Fun_CP064812.1_i000_000811	91	315	224	1	0.491228
GCA_900074715.1-Fun_LT598478.1_i000_000679	189	415	226	1.00893	0.444882
GCA_000446055.1-Fun_AMYD01002021.1_i000_009031	202	428	226	1.00893	0.432122
GCA_000751015.1-Pla_LK032924.1_i000_043300	167	385	218	0.973214	0.415238
GCA_905219565.1-Fun_CAJMWR010002484.1_i000_004493	180	409	229	1.02232	0.398261
GCA_016584185.1-Fun_PUHS01000004.1_i000_003007	190	415	225	1.00446	0.438596
GCA_002926055.1-Fun_PKFO01000003.1_i000_001616	181	401	220	0.982143	0.419048
GCA_000497085.1-Fun_BAUL01000177.1_i000_003430	190	415	225	1.00446	0.433526
GCA_005406105.1-Fun_BIMX01000011.1_i000_002561	97	315	218	0.973214	0.493213
GCA_002895965.2-Ani_PIJE02001409.1_i000_022269	222	423	201	0.897321	0.475177
GCA_019096205.1-Ani_CM032498.1_i000_002521	180	397	217	0.96875	0.414914
GCA_902702965.1-Ani_CACRXP010000160.1_i000_009767	181	400	219	0.977679	0.502294
GCA_001969505.1-Fun_LSSK01000792.1_i000_001729	186	411	225	1.00446	0.436047
GCA_002895965.2-Ani_PIJE02009480.1_i000_032200	95	304	209	0.933036	0.48046
GCA_011800055.1-Fun_WVTB01000082.1_i000_013605	217	443	226	1.00893	0.420074
GCA_002895965.2-Ani_PIJE02002588.1_i000_026611	96	305	209	0.933036	0.476082
GCA_011947485.2-Fun_JAATWK020000022.1_i000_005792	202	428	226	1.00893	0.43295
GCA_000002995.5-Ani_CAAKNF010000194.1_i000_005543	177	392	215	0.959821	0.442387
GCA_002174775.1-Pla_MVGT01000438.1_i000_008851	117	342	225	1.00446	0.460123
GCA_013340265.1-Ani_BLKM01000294.1_i000_001734	197	422	225	1.00446	0.448207
GCA_001179505.1-Pro_CDMY01001052.1_i000_022846	185	411	226	1.00893	0.417745
GCA_014461135.1-Fun_JACAZF010000009.1_i000_010176	188	413	225	1.00446	0.435203
GCA_014925785.1-Fun_WIQG01000010.1_i000_001478	181	404	223	0.995536	0.388502
GCA_012977835.1-Fun_SDJM01000001.1_i000_000163	192	417	225	1.00446	0.408348
GCA_014462655.1-Fun_JACAZI010000021.1_i000_019537	187	413	226	1.00893	0.431298
GCA_000341285.1-Pro_KB454500.1_i000_002237	189	414	225	1.00446	0.426136
GCA_001245095.1-Fun_CDQK01000005.1_i000_003837	177	402	225	1.00446	0.452716
GCA_000816705.1-Ani_KN716616.1_i000_010916	188	422	234	1.04464	0.459725
GCA_007182795.1-Fun_VFLP01000065.1_i000_009274	190	411	221	0.986607	0.435897
GCA_008522505.1-Fun_VSWC01000053.1_i000_012529	186	400	214	0.955357	0.372822
GCA_905338385.1-Ani_CAJPEV010002676.1_i000_009854	181	390	209	0.933036	0.423077
GCA_902728275.1-Fun_CACVBS010000037.1_i000_004459	218	444	226	1.00893	0.394415
GCA_000697685.1-Fun_KL198006.1_i000_003666	186	412	226	1.00893	0.407942
GCA_003072545.2-Pro_CP056065.1_i000_000594	185	409	224	1	0.389565
GCA_001643675.2-Pro_LSRY02000049.1_i000_013256	170	393	223	0.995536	0.436399
GCA_018855915.1-Fun_JABCKO010023870.1_i000_011163	186	411	225	1.00446	0.428571
GCA_003185045.1-Pla_CM009907.1_i000_009895	116	325	209	0.933036	0.633333
GCA_000797535.1-Ani_KN538392.1_i000_005599	233	479	246	1.09821	0.359124
GCA_002222255.1-Fun_AMLH01000274.1_i000_003452	189	405	216	0.964286	0.380282
GCA_002222375.1-Fun_AMLI01000021.1_i000_002676	189	405	216	0.964286	0.380282
GCA_003693665.1-Fun_QQSL01000017.1_i000_001332	190	416	226	1.00893	0.437137
GCA_019650175.1-Pla_BNCO01000043.1_i000_008986	6	113	107	0.477679	0.336478
GCA_003709825.1-Fun_QQXN01000037.1_i000_003750	190	416	226	1.00893	0.43295
GCA_002847045.1-Fun_KZ559135.1_i000_004158	182	407	225	1.00446	0.390625
GCA_001661405.1-Fun_KV453938.1_i000_004868	191	416	225	1.00446	0.440313
GCA_014281875.1-Ani_CM024790.1_i000_001000	161	389	228	1.01786	0.416058
GCA_008403515.1-Pro_VFQX01000029.1_i000_004410	183	413	230	1.02679	0.398614
GCA_900059795.1-Pla_HG974431.1_i000_012236	188	412	224	1	0.4
GCA_900074745.1-Fun_LT598465.1_i000_002557	190	415	225	1.00446	0.442043
GCA_013677265.1-Pla_CM025238.1_i000_009673	118	343	225	1.00446	0.483871
GCA_000938715.1-Fun_LN736364.1_i000_002597	189	415	226	1.00893	0.445759
GCA_900618025.1-Ani_UZAG01016385.1_i000_008214	200	415	215	0.959821	0.422397
GCA_006535955.1-Fun_QEAN01000047.1_i000_001731	195	418	223	0.995536	0.480603
GCA_006536045.1-Fun_QEAM01000040.1_i000_001673	195	418	223	0.995536	0.480603
GCA_004000445.1-Ani_RSAL01000118.1_i000_008549	187	411	224	1	0.488017
GCA_905182985.1-Pro_CAJJDN010000008.1_i000_004311	181	401	220	0.982143	0.470085
GCA_010194725.1-Pro_WXXK01000183.1_i000_001275	159	383	224	1	0.233577
GCA_001447665.1-Ani_JYDP01000005.1_i000_001024	194	415	221	0.986607	0.197145
GCA_900005855.1-Pro_CVMV01000022.1_i000_004461	181	401	220	0.982143	0.472103
GCA_016772295.1-Fun_JAAGWA010000007.1_i000_009044	185	411	226	1.00893	0.40868
GCA_905332375.1-Ani_CAJOBZ010000012.1_i000_005967	187	411	224	1	0.488017
GCA_001447445.1-Ani_JYDU01000090.1_i000_010513	234	455	221	0.986607	0.193013
GCA_905182985.1-Pro_CAJJDN010000035.1_i000_015575	181	401	220	0.982143	0.470085
GCA_000469055.2-Fun_AVOT02000057.1_i000_000496	199	420	221	0.986607	0.381034
GCA_019456465.1-Fun_JAHXPR010000012.1_i000_005051	188	414	226	1.00893	0.440546
GCA_000764455.1-Fun_JQFK01000034.1_i000_005316	181	400	219	0.977679	0.421154
GCA_001983325.1-Fun_MQVM01000025.1_i000_004112	181	400	219	0.977679	0.421154
GCA_003112345.1-Pla_PKPP01006046.1_i000_039165	53	271	218	0.973214	0.637427
GCA_013390185.1-Fun_QPNB01000007.1_i000_010525	194	420	226	1.00893	0.44227
GCA_021432615.1-Fun_MU270215.1_i000_008316	194	420	226	1.00893	0.44227
GCA_013201755.1-Fun_QPMR01000004.1_i000_001586	194	420	226	1.00893	0.441406
GCA_013201765.1-Fun_QPMQ01000075.1_i000_005795	194	420	226	1.00893	0.441406
GCA_013201785.1-Fun_QPMP01000017.1_i000_006174	194	420	226	1.00893	0.441406
GCA_013201865.1-Fun_QPMU01000092.1_i000_014767	194	420	226	1.00893	0.441406
GCA_013390195.1-Fun_QPNA01000006.1_i000_009292	194	420	226	1.00893	0.441406
GCA_017301755.1-Fun_CP054537.1_i000_001277	180	399	219	0.977679	0.431102
GCA_001263275.1-Ani_KQ414578.1_i000_000218	161	385	224	1	0.484848
GCA_001447675.1-Ani_JYDR01000103.1_i000_007651	188	409	221	0.986607	0.202011
GCA_000319635.2-Fun_ANPB02000008.1_i000_013969	194	420	226	1.00893	0.440546
GCA_009771025.1-Fun_SSNE01000071.1_i000_016053	194	420	226	1.00893	0.440546
GCA_012932255.1-Fun_QLYQ01000598.1_i000_001569	194	420	226	1.00893	0.440546
GCA_013201745.1-Fun_QPMT01000008.1_i000_003695	194	420	226	1.00893	0.440546
GCA_013201795.1-Fun_QPMS01000009.1_i000_003949	194	420	226	1.00893	0.440546
GCA_013201875.1-Fun_QPMV01000186.1_i000_014616	194	420	226	1.00893	0.440546
GCA_013201905.1-Fun_QPMW01000160.1_i000_014886	194	420	226	1.00893	0.440546
GCA_013201925.1-Fun_QPMY01000079.1_i000_011070	194	420	226	1.00893	0.440546
GCA_013390205.1-Fun_QPMX01000006.1_i000_009544	194	420	226	1.00893	0.440546
GCA_001447725.1-Ani_JYDS01000166.1_i000_006482	188	409	221	0.986607	0.201642
GCA_003054445.1-Fun_CP028775.1_i000_002803	181	400	219	0.977679	0.418738
GCA_013397115.1-Ani_VWZW01006798.1_i000_011151	167	393	226	1.00893	0.44664
GCA_000182895.1-Fun_AACS02000008.1_i000_009038	185	411	226	1.00893	0.406475
GCA_004369125.1-Fun_ML178851.1_i000_010836	186	410	224	1	0.415584
GCA_014462655.1-Fun_JACAZI010000032.1_i000_022733	181	404	223	0.995536	0.387153
GCA_000300595.1-Fun_JH930476.1_i000_010308	185	411	226	1.00893	0.425612
GCA_019924995.1-Fun_JAHFYO010002206.1_i000_007617	131	357	226	1.00893	0.486022
GCA_009806415.1-Fun_WOWK01000093.1_i000_008614	202	428	226	1.00893	0.433781
GCA_001447645.1-Ani_JYDV01000091.1_i000_007525	188	409	221	0.986607	0.196619
GCA_000412225.2-Fun_CP006025.1_i000_003675	190	415	225	1.00446	0.434363
GCA_900618345.1-Ani_UZAJ01039856.1_i000_012462	177	392	215	0.959821	0.449791
GCA_009768925.2-Pro_VHIT02000022.1_i000_002453	83	312	229	1.02232	0.5363
GCA_900617975.1-Ani_UZAE01003656.1_i000_004751	178	400	222	0.991071	0.511521
GCA_003546525.1-Pro_QUSY01000528.1_i000_005946	672	896	224	1	0.231405
GCA_000005005.6-Pla_CM007647.1_i000_002812	384	591	207	0.924107	0.350254
THAD001.0722.00001.C001_00561	164	383	219	0.977679	0.51773
GCA_002738505.1-Pla_KZ305034.1_i000_012314	177	396	219	0.977679	0.387611
GCA_001417835.1-Fun_AP014603.1_i000_003215	190	415	225	1.00446	0.436047
GCA_001417885.1-Fun_AP012217.1_i000_003241	190	415	225	1.00446	0.436047
GCA_016758755.1-Fun_JABBWM010000035.1_i000_008725	185	411	226	1.00893	0.416974
GCA_022085475.1-Pla_JAIUZE010008707.1_i000_009796	186	410	224	1	0.402154
GCA_000149925.1-Fun_DS178318.1_i000_004036	242	456	214	0.955357	0.339683
GCA_001854445.2-Fun_CP015058.1_i000_003322	190	415	225	1.00446	0.436047
GCA_000835435.1-Fun_KN846959.1_i000_005848	190	416	226	1.00893	0.437137
GCA_020080795.1-Fun_JAGHQM010000551.1_i000_006891	182	400	218	0.973214	0.353896
GCA_002850765.1-Fun_KZ559502.1_i000_000941	182	407	225	1.00446	0.389948
GCA_010093515.1-Fun_MU001675.1_i000_003071	190	415	225	1.00446	0.442913
GCA_000327385.1-Ani_KB201977.1_i000_012730	184	408	224	1	0.433269
GCA_010799875.2-Ani_VXIV02001497.1_i000_014440	1020	1244	224	1	0.165558
GCA_900537255.1-Ani_UPTC01000195.1_i000_001951	177	393	216	0.964286	0.234273
GCA_902702955.1-Ani_CACRXO010000064.1_i000_006673	310	528	218	0.973214	0.389982
GCA_000230445.1-Ani_JH168482.1_i000_007067	184	409	225	1.00446	0.378151
GCA_018857305.1-Fun_JABCKQ010008830.1_i000_004404	186	411	225	1.00446	0.424528
GCA_000209225.1-Ani_DS469654.1_i000_011793	185	410	225	1.00446	0.418216
GCA_002006685.1-Fun_LYON01000028.1_i000_000402	187	410	223	0.995536	0.429672
GCA_020617195.1-Fun_JAFDOU010000559.1_i000_003786	187	410	223	0.995536	0.429672
GCA_020617715.1-Fun_JAFDOV010000522.1_i000_003137	187	410	223	0.995536	0.429672
GCA_020617725.1-Fun_JAFDOT010001149.1_i000_010238	187	410	223	0.995536	0.429672
GCA_020617735.1-Fun_JAFCIX010000060.1_i000_001340	187	410	223	0.995536	0.429672
GCA_021556675.1-Fun_JAKFGI010000015.1_i000_003469	187	410	223	0.995536	0.429672
GCA_000150955.2-Pro_CM000609.1_i000_003175	189	413	224	1	0.42344
GCA_020091625.1-Fun_JAGYZC010000004.1_i000_006969	186	411	225	1.00446	0.423729
GCA_002926015.1-Pla_KZ648039.1_i000_019066	188	413	225	1.00446	0.458248
GCA_001263195.1-Fun_KQ412861.1_i000_010400	186	411	225	1.00446	0.431034
GCA_000349005.2-Fun_AFWA02000006.1_i000_002962	180	399	219	0.977679	0.427734
GCA_000696135.1-Fun_JMSE01001045.1_i000_007124	193	413	220	0.982143	0.449898
GCA_014282415.2-Ani_JABDTM020022036.1_i000_006671	672	897	225	1.00446	0.230297
GCA_020137385.1-Fun_JACLAE010000003.1_i000_009515	181	404	223	0.995536	0.385147
GCA_016920775.1-Ani_JAFDOW010000699.1_i000_002093	184	408	224	1	0.452525
GCA_002166775.1-Fun_NHMM01000001.1_i000_000136	181	400	219	0.977679	0.413989
GCA_019623675.1-Fun_WSTN01000463.1_i000_008618	116	341	225	1.00446	0.481799
GCA_916720795.1-Ani_CAKASE010000062.1_i000_008717	187	411	224	1	0.490153
GCA_900162805.1-Fun_FUGC01000022.1_i000_001515	190	415	225	1.00446	0.436893
GCA_000530735.1-Fun_CBTC010000115.1_i000_008784	190	415	225	1.00446	0.436893
GCA_001984395.2-Fun_CP019503.1_i000_009382	190	415	225	1.00446	0.436893
GCA_002928715.1-Pla_KZ668476.1_i000_032802	188	413	225	1.00446	0.458248
GCA_014362265.1-Pla_BJWL01000016.1_i000_023612	188	412	224	1	0.400716
GCA_001659605.2-Pla_CM004395.2_i000_017501	177	396	219	0.977679	0.380208
GCA_000091025.4-Fun_AE016816.3_i000_000911	190	415	225	1.00446	0.409836
GCA_000968835.1-Fun_CP002707.1_i000_000910	190	415	225	1.00446	0.409836
GCA_002847485.1-Fun_MSFM01000001.1_i000_000810	182	407	225	1.00446	0.390625
GCA_009982845.1-Fun_JAADKB010000004.1_i000_005948	192	417	225	1.00446	0.420561
GCA_001640025.2-Fun_CP014500.1_i000_004208	187	422	235	1.04911	0.451056
GCA_021556665.1-Fun_JAKFGG010000066.1_i000_008964	204	427	223	0.995536	0.416045
GCA_000165425.1-Pro_CT868318.1_i000_023334	181	401	220	0.982143	0.470085
GCA_001272575.2-Fun_LAZP02000308.1_i000_003922	193	418	225	1.00446	0.446429
GCA_021176775.1-Fun_JAJEVK010000004.1_i000_006512	194	420	226	1.00893	0.443137
GCA_003444635.2-Fun_QOKS01000001.1_i000_000865	181	404	223	0.995536	0.383821
GCA_003790465.1-Fun_ML119144.1_i000_007622	181	404	223	0.995536	0.383821
GCA_905182995.1-Pro_CAJJDP010000010.1_i000_004383	181	401	220	0.982143	0.470085
GCA_000827195.1-Fun_KN838544.1_i000_002446	185	412	227	1.01339	0.423507
GCA_019623665.1-Fun_WSTM01000257.1_i000_005307	125	350	225	1.00446	0.472689
GCA_019627745.1-Fun_WSTR01000437.1_i000_008843	125	350	225	1.00446	0.472689
GCA_000696525.1-Pla_KK914488.1_i000_011807	177	395	218	0.973214	0.385841
GCA_000709125.1-Fun_AMGV01000003.1_i000_003643	193	418	225	1.00446	0.431862
GCA_020496765.1-Pla_CM035626.1_i000_019902	188	413	225	1.00446	0.420561
GCA_000530735.1-Fun_CBTC010000034.1_i000_003106	190	415	225	1.00446	0.436893
GCA_001984395.2-Fun_CP019498.1_i000_006643	190	415	225	1.00446	0.436893
GCA_016584165.1-Fun_PUHT01000053.1_i000_003917	190	415	225	1.00446	0.434363
GCA_900660285.1-Fun_CAACVR010000012.1_i000_002303	103	332	229	1.02232	0.465447
GCA_016584275.1-Fun_PUHV01000103.1_i000_000249	190	415	225	1.00446	0.429389
GCA_001659605.2-Pla_CM004400.2_i000_025907	177	395	218	0.973214	0.381786
ACMA004.0722.00001.C001_02297	153	376	223	0.995536	0.533493
GCA_003033665.1-Fun_PVEM01000004.1_i000_009568	581	807	226	1.00893	0.251951
GCA_016952355.1-Fun_CP064748.1_i000_004841	581	807	226	1.00893	0.251951
GCA_000222205.2-Fun_AEVR02000018.1_i000_000862	182	402	220	0.982143	0.40146
GCA_000787575.2-Pro_DF837575.1_i000_010272	64	289	225	1.00446	0.470711
GCA_016647785.1-Fun_JABBWK010000023.1_i000_006909	185	411	226	1.00893	0.416974
GCA_000320785.2-Fun_KB722667.1_i000_006524	182	403	221	0.986607	0.404022
GCA_003234015.1-Fun_LK052936.1_i000_008006	182	403	221	0.986607	0.404022
GCA_018688675.1-Pla_CM031836.1_i000_024701	188	412	224	1	0.408015
GCA_905182995.1-Pro_CAJJDP010000005.1_i000_001931	181	401	220	0.982143	0.470085
GCA_018342105.1-Ani_JAFIRS010000050.1_i000_001810	861	1085	224	1	0.187762
GCA_004154915.1-Fun_QJNU01000058.1_i000_008978	191	417	226	1.00893	0.437984
GCA_016758775.1-Fun_JABBWN010000015.1_i000_003840	185	411	226	1.00893	0.425612
GCA_002220415.3-Pla_CM022216.1_i000_027036	173	397	224	1	0.48172
GCA_000769155.2-Pro_JROU02000749.1_i000_002304	168	357	189	0.84375	0.394572
GCA_016647685.1-Fun_JABBWJ010000035.1_i000_009381	185	411	226	1.00893	0.416974
GCA_016647645.1-Fun_JABBWF010000069.1_i000_014150	185	411	226	1.00893	0.416974
GCA_007990605.1-Fun_BJWK01000006.1_i000_002642	182	402	220	0.982143	0.40146
GCA_001299255.1-Fun_LFJN01000004.1_i000_008097	191	416	225	1.00446	0.426136
GCA_018446385.1-Pla_CM031524.1_i000_061220	197	428	231	1.03125	0.364929
GCA_000988875.2-Fun_LCTV02000001.1_i000_000857	187	407	220	0.982143	0.39783
GCA_019924255.1-Fun_JAHFXK010001693.1_i000_005385	191	417	226	1.00893	0.430476
GCA_019924895.1-Fun_JAHFYM010001918.1_i000_006354	191	417	226	1.00893	0.430476
GCA_022376275.1-Fun_JAJNOH010000008.1_i000_013048	191	417	226	1.00893	0.437984
GCA_019968535.1-Ani_JAIFTH010000474.1_i000_002713	192	416	224	1	0.534606
GCA_007990485.1-Pla_CM017633.1_i000_062161	188	413	225	1.00446	0.422139
GCA_006461475.1-Ani_SUNJ01002279.1_i000_001845	180	411	231	1.03125	0.519101
GCA_013677275.1-Pla_CM025251.1_i000_011414	188	413	225	1.00446	0.420561
GCA_013677235.1-Pla_CM025199.1_i000_011824	188	413	225	1.00446	0.420561
GCA_013677245.1-Pla_CM025212.1_i000_011360	188	413	225	1.00446	0.420561
GCA_900106125.1-Fun_LT635764.1_i000_000127	181	401	220	0.982143	0.416667
GCA_000310025.1-Pro_FN649748.1_i000_009442	188	412	224	1	0.46281
GCA_000820605.1-Fun_AWTV01000004.1_i000_000725	195	418	223	0.995536	0.428846
GCA_007990345.1-Pla_CM017685.1_i000_065294	188	413	225	1.00446	0.419776
GCA_013511315.1-Pla_CM025264.1_i000_010371	188	413	225	1.00446	0.420561
GCA_007990325.1-Pla_CM017711.1_i000_062234	188	413	225	1.00446	0.419776
GCA_008761655.1-Pla_CM018225.1_i000_057651	188	413	225	1.00446	0.419776
GCA_007990455.1-Pla_CM017659.1_i000_059111	188	413	225	1.00446	0.418994
CAKO001.0722.00001.C001_01606	152	372	220	0.982143	0.575916
GCA_000787975.1-Pla_KN403932.1_i000_009385	188	413	225	1.00446	0.421348
GCA_902155815.1-Fun_CABFWN010000004.1_i000_003243	102	327	225	1.00446	0.471698
GCA_022478985.1-Fun_JAKSZP010013325.1_i000_003813	160	384	224	1	0.475584
GCA_021605075.1-Ani_BPLQ01010561.1_i000_036441	177	400	223	0.995536	0.474468
GCA_905116875.3-Ani_CAJHNJ030000025.1_i000_007504	180	397	217	0.96875	0.414914
GCA_008795845.1-Ani_SGJD01003122.1_i000_014127	29	62	33	0.147321	0.132
GCA_008795845.1-Ani_SGJD01003122.1_i000_014127	60	95	35	0.15625	0.14
GCA_001651985.1-Fun_LVYI01000004.1_i000_007084	190	416	226	1.00893	0.44664
GCA_000327365.1-Pla_CM001746.1_i000_016416	188	413	225	1.00446	0.421348
GCA_013467495.1-Pla_CM025147.1_i000_008457	188	413	225	1.00446	0.420561
GCA_007990345.1-Pla_CM017672.1_i000_027159	188	413	225	1.00446	0.420561
GCA_007990485.1-Pla_CM017620.1_i000_058210	188	413	225	1.00446	0.420561
GCA_007990455.1-Pla_CM017646.1_i000_055405	188	413	225	1.00446	0.421348
GCA_008761655.1-Pla_CM018212.1_i000_054042	188	413	225	1.00446	0.419776
GCA_900090005.1-Pro_LT594497.1_i000_001784	186	409	223	0.995536	0.335338
GCA_000347455.1-Pla_KD283606.1_i000_023315	118	342	224	1	0.477612
GCA_905116865.2-Ani_CAJHNH020001913.1_i000_010486	181	359	178	0.794643	0.495822
GCA_007990325.1-Pla_CM017698.1_i000_058275	188	413	225	1.00446	0.419776
GCA_003260635.2-Pla_QGKW02000717.1_i000_045385	177	395	218	0.973214	0.409774
GCA_002837095.1-Pla_PGOL01004226.1_i000_041541	188	412	224	1	0.402154
GCA_900411305.1-Pla_LS480641.1_i000_001123	164	388	224	1	0.434951
GCA_014176175.1-Fun_JABCYN010000057.1_i000_005344	102	327	225	1.00446	0.471698
GCA_905182995.1-Pro_CAJJDP010000014.1_i000_005608	181	400	219	0.977679	0.467949
GCA_900074755.1-Fun_LT598451.1_i000_001693	190	415	225	1.00446	0.444664
GCA_018446385.1-Pla_CM031512.1_i000_017039	188	410	222	0.991071	0.402904
GCA_019627725.1-Fun_WSTQ01000155.1_i000_002416	187	412	225	1.00446	0.418216
GCA_019627735.1-Fun_WSTP01000305.1_i000_006466	187	412	225	1.00446	0.418216
GCA_019633565.1-Fun_WSUH01000151.1_i000_002040	187	412	225	1.00446	0.418216
GCA_910592005.1-Fun_CAJVPP010004123.1_i000_011141	172	392	220	0.982143	0.332829
GCA_902829235.1-Ani_CADEPI010000128.1_i000_008781	185	409	224	1	0.447106
GCA_000836355.1-Fun_KN847938.1_i000_005368	188	407	219	0.977679	0.386243
GCA_000827495.1-Fun_KN817539.1_i000_006296	186	412	226	1.00893	0.425612
GCA_002220415.3-Pla_CM022216.1_i000_027037	188	412	224	1	0.415584
GCA_000743615.1-Ani_KN124706.1_i000_018070	1144	1369	225	1.00446	0.144509
GCA_004217705.1-Fun_CP034457.1_i000_001965	181	401	220	0.982143	0.434783
GCA_014905795.1-Fun_JACBPP010000004.1_i000_003748	181	401	220	0.982143	0.434783
GCA_013677265.1-Pla_CM025232.1_i000_000357	118	343	225	1.00446	0.504484
GCA_000003225.1-Pro_CR940347.1_i000_000480	185	406	221	0.986607	0.397482
GCA_000209125.2-Pro_DS548704.1_i000_006340	179	403	224	1	0.492308
GCA_021029035.1-Pro_JAFCAH010000001.1_i000_000298	147	346	199	0.888393	0.427957
GCA_011392555.1-Fun_QMFL01000026.1_i000_000226	182	406	224	1	0.392982
GCA_001411555.2-Pla_CM023849.1_i000_019922	188	413	225	1.00446	0.409836
GCA_905182995.1-Pro_CAJJDP010000006.1_i000_002430	181	400	219	0.977679	0.467949
GCA_001636715.1-Fun_AZGZ01000017.1_i000_001708	190	415	225	1.00446	0.436047
GCA_015501535.1-Fun_JADNRW010000015.1_i000_005434	185	410	225	1.00446	0.418994
GCA_000149385.1-Fun_CM000045.1_i000_003725	189	409	220	0.982143	0.389381
GCA_000350065.2-Fun_AMCV02000033.1_i000_010373	193	419	226	1.00893	0.447525
GCA_000091045.1-Fun_AE017346.1_i000_003332	189	409	220	0.982143	0.387324
GCA_000006515.1-Pro_DS989729.1_i000_002397	190	416	226	1.00893	0.462168
GCA_013467485.1-Pla_CM025271.1_i000_000420	188	413	225	1.00446	0.506757
GCA_000002945.2-Fun_CU329671.1_i000_002687	186	412	226	1.00893	0.454728
GCA_000687475.2-Fun_CP072756.1_i000_005213	192	417	225	1.00446	0.444664
GCA_004379715.1-Fun_ML213628.1_i000_010404	185	411	226	1.00893	0.424015
GCA_002215745.1-Fun_NKHX01000143.1_i000_001433	189	405	216	0.964286	0.380282
GCA_002215755.1-Fun_NKHW01000148.1_i000_001486	189	405	216	0.964286	0.380282
GCA_013677275.1-Pla_JABFAF010274546.1_i000_026101	118	343	225	1.00446	0.485961
GCA_002220415.3-Pla_CM022214.1_i000_014940	119	343	224	1	0.476596
GCA_021399455.1-Fun_JAJTUO010000005.1_i000_014404	182	391	209	0.933036	0.357877
GCA_001664035.1-Fun_LXTC01000004.1_i000_003875	181	401	220	0.982143	0.422265
GCA_004366825.1-Fun_QAPG01000071.1_i000_006307	203	429	226	1.00893	0.438835
GCA_004367215.1-Fun_RYZW01000034.1_i000_004623	203	429	226	1.00893	0.438835
GCA_002215855.1-Fun_AMKX01000293.1_i000_002495	189	405	216	0.964286	0.380282
GCA_002217545.1-Fun_APKM01000303.1_i000_002957	189	405	216	0.964286	0.380282
GCA_002220035.1-Fun_AMKW01000322.1_i000_003131	189	405	216	0.964286	0.380282
GCA_013235015.1-Ani_BGPR01003933.1_i000_088106	180	399	219	0.977679	0.462025
GCA_007990455.1-Pla_CM017642.1_i000_033104	188	413	225	1.00446	0.422139
GCA_002234625.1-Fun_AMKQ01000027.1_i000_003902	189	405	216	0.964286	0.380952
GCA_000149245.3-Fun_CP003826.1_i000_004164	189	405	216	0.964286	0.380282
GCA_002215705.1-Fun_AMKS01000031.1_i000_004912	189	405	216	0.964286	0.380282
GCA_002215765.1-Fun_AMLA01000241.1_i000_002318	189	405	216	0.964286	0.380282
GCA_002215775.1-Fun_AMLG01000081.1_i000_006028	189	405	216	0.964286	0.380282
GCA_002215825.1-Fun_AMLK01000055.1_i000_004229	189	405	216	0.964286	0.380282
GCA_002215835.1-Fun_AMKP01000031.1_i000_004691	189	405	216	0.964286	0.380282
GCA_002215885.1-Fun_AMKM01000019.1_i000_002851	189	405	216	0.964286	0.380282
GCA_002216725.1-Fun_CP022327.1_i000_004163	189	405	216	0.964286	0.380282
GCA_002220445.1-Fun_AMLJ01000158.1_i000_001676	189	405	216	0.964286	0.380282
GCA_002221985.1-Fun_APKI01000187.1_i000_001986	189	405	216	0.964286	0.380282
GCA_002222015.1-Fun_APKO01000253.1_i000_002626	189	405	216	0.964286	0.380282
GCA_002222025.1-Fun_APKS01000297.1_i000_002651	189	405	216	0.964286	0.380282
GCA_002222095.1-Fun_APKP01000289.1_i000_002808	189	405	216	0.964286	0.380282
GCA_002222115.1-Fun_APKR01000290.1_i000_002463	189	405	216	0.964286	0.380282
GCA_002222135.1-Fun_APKK01000254.1_i000_002318	189	405	216	0.964286	0.380282
GCA_002222145.1-Fun_APKQ01000236.1_i000_002144	189	405	216	0.964286	0.380282
GCA_002222155.1-Fun_APKL01000312.1_i000_002747	189	405	216	0.964286	0.380282
GCA_002222165.1-Fun_APKT01000232.1_i000_002222	189	405	216	0.964286	0.380282
GCA_002222215.1-Fun_APKH01000189.1_i000_001886	189	405	216	0.964286	0.380282
GCA_002222225.1-Fun_AMLE01000372.1_i000_003671	189	405	216	0.964286	0.380282
GCA_002222245.1-Fun_APKJ01000209.1_i000_001967	189	405	216	0.964286	0.380282
GCA_002222295.1-Fun_AMLB01000264.1_i000_003216	189	405	216	0.964286	0.380282
GCA_002222315.1-Fun_AMKY01000049.1_i000_003545	189	405	216	0.964286	0.380282
GCA_002222325.1-Fun_AMKT01000056.1_i000_004765	189	405	216	0.964286	0.380282
GCA_002222335.1-Fun_AMKU01000019.1_i000_003112	189	405	216	0.964286	0.380282
GCA_002222385.1-Fun_AMKN01000077.1_i000_005713	189	405	216	0.964286	0.380282
GCA_002222395.1-Fun_AMLD01000245.1_i000_002795	189	405	216	0.964286	0.380282
GCA_002222405.1-Fun_AMLC01000083.1_i000_005801	189	405	216	0.964286	0.380282
GCA_002222455.1-Fun_AMKZ01000232.1_i000_002448	189	405	216	0.964286	0.380282
GCA_002222475.1-Fun_AMKO01000027.1_i000_003155	189	405	216	0.964286	0.380282
GCA_002224005.1-Fun_AMLF01000028.1_i000_002839	189	405	216	0.964286	0.380282
GCA_002220045.1-Fun_NKHY01000073.1_i000_006290	189	405	216	0.964286	0.380282
GCA_014235945.1-Fun_WIGO01000163.1_i000_009941	193	419	226	1.00893	0.444008
GCA_005393395.2-Pla_CM016624.1_i000_022724	188	413	225	1.00446	0.420561
GCA_002222465.1-Fun_AMKV01000018.1_i000_002195	189	405	216	0.964286	0.380282
GCA_013053245.1-Fun_JAACJL010000030.1_i000_003513	186	411	225	1.00446	0.422932
GCA_014235955.1-Fun_WIGN01000086.1_i000_006299	193	419	226	1.00893	0.443137
GCA_016584305.1-Ani_JACEEZ010021476.1_i000_016482	183	408	225	1.00446	0.378151
GCA_015484485.1-Fun_MU156468.1_i000_004221	186	411	225	1.00446	0.422139
GCA_014462685.1-Ani_JAACXV010014356.1_i000_018485	183	408	225	1.00446	0.435203
GCA_004114815.1-Pla_SDOW01000647.1_i000_043151	189	413	224	1	0.408759
GCA_002220415.3-Pla_CM022213.1_i000_012991	188	412	224	1	0.408759
GCA_020496765.1-Pla_CM035620.1_i000_000674	188	413	225	1.00446	0.426136
GCA_004114815.1-Pla_SDOW01000331.1_i000_025669	188	412	224	1	0.409506
GCA_000347455.1-Pla_KD031761.1_i000_002501	188	412	224	1	0.408759
GCA_002220415.3-Pla_CM022211.1_i000_003714	188	412	224	1	0.408759
GCA_008704605.1-Fun_SWFS01000028.1_i000_005826	181	402	221	0.986607	0.428295
GCA_900231445.1-Pla_LT934111.1_i000_003536	188	412	224	1	0.408759
GCA_015501065.1-Fun_JADNYI010000050.1_i000_014032	182	402	220	0.982143	0.383275
GCA_002928715.1-Pla_KZ668752.1_i000_033525	118	343	225	1.00446	0.467775
GCA_003709865.1-Fun_QRBJ01000032.1_i000_002451	196	422	226	1.00893	0.355906
GCA_000956045.1-Fun_KQ030504.1_i000_002211	194	418	224	1	0.439216
GCA_000002415.2-Pro_CM000449.1_i000_001721	181	401	220	0.982143	0.45929
GCA_000320625.2-Pro_KQ234266.1_i000_002197	181	401	220	0.982143	0.45929
GCA_000320645.2-Pro_KQ234811.1_i000_002580	181	401	220	0.982143	0.45929
GCA_000320665.2-Pro_KQ235038.1_i000_002370	181	401	220	0.982143	0.45929
GCA_000320685.2-Pro_KQ235353.1_i000_002471	181	401	220	0.982143	0.45929
GCA_900093535.1-Pro_LT615263.1_i000_001833	181	401	220	0.982143	0.45929
GCA_900093545.1-Pro_LT615246.1_i000_001865	181	401	220	0.982143	0.45929
GCA_914969965.1-Pro_CAJZCX010000009.1_i000_003610	181	401	220	0.982143	0.45929
GCA_002220415.3-Pla_CM022212.1_i000_008328	188	412	224	1	0.408015
GCA_013115865.1-Pro_JABANO010023718.1_i000_018988	3	191	188	0.839286	0.661972
GCA_009650685.1-Fun_CM018860.1_i000_000430	188	404	216	0.964286	0.380952
GCA_900231445.1-Pla_LT934112.1_i000_007384	188	412	224	1	0.407273
GCA_904859935.1-Fun_CAJHEQ010000053.1_i000_001035	191	398	207	0.924107	0.22282
GCA_905071925.1-Ani_CAJHJT010000001.1_i000_003205	186	410	224	1	0.436647
GCA_000005505.4-Pla_CM000880.3_i000_002340	188	412	224	1	0.419476
GCA_900093555.2-Pro_LT635619.1_i000_001930	181	401	220	0.982143	0.45929
GCA_000149685.1-Fun_CH981532.1_i000_000392	188	413	225	1.00446	0.446429
GCA_000226095.1-Fun_CP003008.1_i000_008373	182	389	207	0.924107	0.340461
GCA_002220415.3-Pla_CM022215.1_i000_021035	188	412	224	1	0.414815
GCA_900231445.1-Pla_LT934114.1_i000_014421	188	412	224	1	0.414815
GCA_000832265.1-Fun_KN840509.1_i000_006068	185	411	226	1.00893	0.429658
GCA_014773135.1-Ani_JABEBT010000023.1_i000_004243	42	262	220	0.982143	0.2407
GCA_905331485.1-Ani_CAJNYT010002209.1_i000_014625	186	413	227	1.01339	0.475891
GCA_000185945.1-Fun_CP000291.1_i000_003921	188	407	219	0.977679	0.386243
GCA_000875815.1-Fun_KN849083.1_i000_006630	188	407	219	0.977679	0.386243
GCA_000835745.1-Fun_KN848565.1_i000_000470	187	406	219	0.977679	0.386926
GCA_018360365.1-Fun_SRQA01000310.1_i000_004006	192	417	225	1.00446	0.518433
GCA_000835815.1-Fun_KN848528.1_i000_002349	188	407	219	0.977679	0.386926
GCA_000836375.1-Fun_KN847903.1_i000_003464	187	406	219	0.977679	0.387611
GCA_000836455.1-Fun_KN848984.1_i000_005777	187	406	219	0.977679	0.387611
GCA_000875855.1-Fun_KN848925.1_i000_002582	187	406	219	0.977679	0.387611
GCA_000935105.1-Fun_KN905632.1_i000_005325	188	407	219	0.977679	0.386243
GCA_002762385.1-Pla_NKXS01000851.1_i000_005262	188	412	224	1	0.429119
GCA_000835765.1-Fun_KN848834.1_i000_002120	188	407	219	0.977679	0.386926
GCA_000836315.1-Fun_KN848137.1_i000_002366	188	407	219	0.977679	0.386926
GCA_000875795.1-Fun_KN848511.1_i000_003904	188	407	219	0.977679	0.386926
GCA_007990325.1-Pla_CM017694.1_i000_034728	188	413	225	1.00446	0.422139
GCA_004155915.1-Fun_QJOA01000125.1_i000_001345	191	417	226	1.00893	0.439689
GCA_000835755.1-Fun_KN848862.1_i000_003081	188	406	218	0.973214	0.38448
GCA_000965225.2-Fun_BBTG02000003.1_i000_000853	192	417	225	1.00446	0.437743
GCA_000504015.1-Pla_KI630401.1_i000_006110	2	158	156	0.696429	0.722222
GCA_000835475.1-Fun_KN847009.1_i000_012423	190	416	226	1.00893	0.433781
GCA_900576705.1-Ani_UXUI01007291.1_i000_001936	154	373	219	0.977679	0.469957
GCA_022496215.1-Fun_WTXF01000052.1_i000_009857	185	410	225	1.00446	0.412844
GCA_013399415.1-Ani_VWYJ01033730.1_i000_012636	107	309	202	0.901786	0.653722
GCA_000230815.1-Ani_CM001285.1_i000_008011	184	409	225	1.00446	0.378788
GCA_020921065.1-Pla_CM037152.1_i000_006282	150	374	224	1	0.529551
GCA_004155925.1-Fun_QJNX01000003.1_i000_005641	191	417	226	1.00893	0.439689
GCA_000855695.1-Fun_KN848894.1_i000_002603	188	399	211	0.941964	0.372134
GCA_013677235.1-Pla_CM025193.1_i000_000427	118	343	225	1.00446	0.485961
GCA_013677245.1-Pla_CM025206.1_i000_000410	118	343	225	1.00446	0.485961
GCA_000836335.1-Fun_KN847999.1_i000_006171	188	399	211	0.941964	0.372134
GCA_013400675.1-Ani_VYZR01003190.1_i000_000154	1	70	69	0.308036	0.260377
GCA_013400675.1-Ani_VYZR01003190.1_i000_000154	84	247	163	0.727679	0.615094
GCA_000003195.3-Pla_CM000760.3_i000_003887	188	413	225	1.00446	0.409091
GCA_015952705.1-Pla_CM027680.1_i000_003951	188	413	225	1.00446	0.409091
GCA_016771965.1-Pla_CM028697.1_i000_055240	189	407	218	0.973214	0.398537
GCA_018854895.1-Fun_JABAJV010008589.1_i000_009322	186	411	225	1.00446	0.423729
GCA_016647635.1-Fun_JABBWG010000317.1_i000_008627	185	411	226	1.00893	0.417745
GCA_014904935.1-Fun_MU123716.1_i000_004733	185	411	226	1.00893	0.419295
GCA_000004985.1-Pro_GG738885.1_i000_009377	183	413	230	1.02679	0.397237
GCA_000005505.4-Pla_CM000880.3_i000_004078	188	412	224	1	0.409506
GCA_000218685.1-Fun_GL945444.1_i000_012099	185	410	225	1.00446	0.415129
GCA_000218725.1-Fun_GL945490.1_i000_011613	185	410	225	1.00446	0.415129
GCA_019776745.2-Pla_CM034156.1_i000_036180	189	413	224	1	0.386207
GCA_000827355.1-Fun_KN831781.1_i000_008878	186	412	226	1.00893	0.424812
GCA_900231445.1-Pla_LT934113.1_i000_009081	188	412	224	1	0.415584
GCA_004359215.2-Pro_CM033803.1_i000_000951	209	433	224	1	0.419476
GCA_020536535.1-Pro_JAHLWZ010000680.1_i000_008610	180	398	218	0.973214	0.46383
THLI001.0722.00001.C001_02134	147	366	219	0.977679	0.528986
GCA_016695475.1-Fun_MU172964.1_i000_009027	185	411	226	1.00893	0.417745
GCA_004153795.2-Pla_SDRB02009349.1_i000_015640	188	415	227	1.01339	0.521839
GCA_000192795.1-Fun_GL877426.1_i000_001463	158	376	218	0.973214	0.547739
GCA_001630475.1-Fun_KV419411.1_i000_007113	186	411	225	1.00446	0.43021
GCA_016647625.1-Fun_JABBWH010000033.1_i000_010270	185	411	226	1.00893	0.416974
GCA_015342405.1-Fun_JACYCF010000002.1_i000_005346	183	412	229	1.02232	0.164275
GCA_001632355.1-Fun_KV428152.1_i000_009531	186	411	225	1.00446	0.43021
GCA_016628075.1-Fun_JABBWC010000097.1_i000_016448	185	411	226	1.00893	0.417745
GCA_022160315.1-Fun_MU275177.1_i000_003410	185	410	225	1.00446	0.402504
GCA_018342045.1-Fun_JAGEXW010000004.1_i000_000676	156	378	222	0.991071	0.53753
GCA_000005005.6-Pla_CM000785.4_i000_035391	188	413	225	1.00446	0.395431
GCA_000827335.1-Fun_KN831967.1_i000_009860	186	411	225	1.00446	0.429389
GCA_001447515.1-Pro_LDAU01000123.1_i000_012120	187	409	222	0.991071	0.428571
GCA_022539455.1-Pla_CM039723.1_i000_007323	187	412	225	1.00446	0.403226
GCA_005406065.1-Fun_BIMT01000023.1_i000_002699	181	401	220	0.982143	0.419048
GCA_001548555.1-Fun_CP014247.1_i000_003554	190	415	225	1.00446	0.413603
GCA_011032825.1-Fun_JAADJZ010000017.1_i000_004128	188	411	223	0.995536	0.450505
GCA_000149685.1-Fun_CH981530.1_i000_000779	181	402	221	0.986607	0.426641
GCA_003789085.1-Ani_QCYY01001401.1_i000_002979	210	435	225	1.00446	0.398936
GCA_008271595.1-Pro_SMMQ01002065.1_i000_008802	214	438	224	1	0.150235
GCA_013467465.1-Pla_CM025160.1_i000_010656	188	413	225	1.00446	0.421348
GCA_021962125.1-Ani_JAGDYQ010000002.1_i000_008185	187	412	225	1.00446	0.416667
GCA_009739505.2-Ani_CM019180.2_i000_007960	184	408	224	1	0.449799
GCA_008761655.1-Pla_CM018208.1_i000_032267	188	413	225	1.00446	0.422139
GCA_000787975.1-Pla_KN445061.1_i000_029055	188	413	225	1.00446	0.422139
GCA_000827255.1-Fun_KN835417.1_i000_011681	185	411	226	1.00893	0.417745
GCA_002095265.1-Pro_MBFZ01000024.1_i000_002761	183	401	218	0.973214	0.496583
GCA_007990345.1-Pla_CM017668.1_i000_016331	188	413	225	1.00446	0.422139
GCA_007990485.1-Pla_CM017616.1_i000_034699	188	413	225	1.00446	0.422139
GCA_013467495.1-Pla_CM025141.1_i000_000324	118	343	225	1.00446	0.485961
GCA_018282025.1-Fun_JABCKI010005741.1_i000_007046	186	411	225	1.00446	0.409836
GCA_011800875.2-Fun_JRHT02000123.1_i000_002561	185	411	226	1.00893	0.417745
GCA_013467465.1-Pla_CM025154.1_i000_000381	188	413	225	1.00446	0.422139
GCA_000327365.1-Pla_CM001740.1_i000_000611	188	413	225	1.00446	0.422139
GCA_013398375.1-Ani_VZSI01000027.1_i000_005814	115	192	77	0.34375	0.151277
GCA_013398375.1-Ani_VZSI01000027.1_i000_005814	196	366	170	0.758929	0.333988
GCA_001651435.1-Fun_LHPN01000001.1_i000_000825	190	416	226	1.00893	0.431298
GCA_010015655.1-Fun_ML976664.1_i000_003460	193	416	223	0.995536	0.429672
GCA_001661265.1-Fun_KV454258.1_i000_001980	182	403	221	0.986607	0.410781
GCA_005393395.2-Pla_CM016620.1_i000_013629	188	413	225	1.00446	0.422139
GCA_016647755.1-Fun_JABBWI010000069.1_i000_019051	185	411	226	1.00893	0.417745
GCA_000616965.1-Fun_KK210315.1_i000_008185	190	416	226	1.00893	0.433781
GCA_000151425.1-Fun_GG700648.1_i000_008043	190	416	226	1.00893	0.433781
GCA_000616765.1-Fun_KK204030.1_i000_008329	190	416	226	1.00893	0.433781
GCA_000616805.1-Fun_KK207410.1_i000_008289	190	416	226	1.00893	0.433781
GCA_000616825.1-Fun_KK207940.1_i000_008312	190	416	226	1.00893	0.433781
GCA_000616845.1-Fun_KK208477.1_i000_008264	190	416	226	1.00893	0.433781
GCA_000616865.1-Fun_KK208942.1_i000_008315	190	416	226	1.00893	0.433781
GCA_000616905.1-Fun_KK209464.1_i000_008313	190	416	226	1.00893	0.433781
GCA_000616945.1-Fun_KK209982.1_i000_008379	190	416	226	1.00893	0.433781
GCA_000616985.1-Fun_KK210834.1_i000_008464	190	416	226	1.00893	0.433781
GCA_000622995.1-Fun_AOLB01000342.1_i000_008307	190	416	226	1.00893	0.433781
GCA_000812105.1-Fun_JPGR01000037.1_i000_004593	190	416	226	1.00893	0.433781
GCA_001651445.1-Fun_LHPM01000018.1_i000_002454	190	416	226	1.00893	0.433781
GCA_904845875.1-Pla_CAJGYO010000002.1_i000_007187	188	413	225	1.00446	0.408348
GCA_003185045.1-Pla_NCVQ01000835.1_i000_037912	188	413	225	1.00446	0.452716
GCA_016628085.1-Fun_JABBWB010000022.1_i000_005702	185	411	226	1.00893	0.417745
GCA_007990455.1-Pla_CM017655.1_i000_035738	188	413	225	1.00446	0.422139
GCA_016695465.1-Fun_MU177919.1_i000_007237	185	411	226	1.00893	0.417745
GCA_000348985.1-Fun_HE978323.1_i000_004347	181	402	221	0.986607	0.421756
GCA_903819665.1-Fun_CAIJEO010000002.1_i000_000107	171	398	227	1.01339	0.448617
GCA_000026365.1-Fun_CU928175.1_i000_001800	97	315	218	0.973214	0.490991
GCA_021535285.1-Fun_JAKETS010000002.1_i000_001316	97	315	218	0.973214	0.490991
GCA_000348985.1-Fun_HE978320.1_i000_003575	181	401	220	0.982143	0.42065
GCA_000230595.3-Fun_AFBI03000003.1_i000_001981	150	210	60	0.267857	0.122951
GCA_000230595.3-Fun_AFBI03000003.1_i000_001981	225	449	224	1	0.459016
GCA_015178995.1-Fun_WHVE01000318.1_i000_006351	182	406	224	1	0.428298
GCA_000142905.1-Pro_GL349439.1_i000_001921	122	364	242	1.08036	0.517094
GCA_001972345.1-Fun_BDGX01000009.1_i000_001806	97	315	218	0.973214	0.490991
GCA_003185045.1-Pla_CM009906.1_i000_001505	188	413	225	1.00446	0.412844
GCA_020169585.1-Pla_CM034976.1_i000_003407	187	412	225	1.00446	0.406872
GCA_000611955.2-Ani_KK116973.1_i000_012887	14	237	223	0.995536	0.635328
GCA_014235935.1-Fun_WIGM01000187.1_i000_005969	193	419	226	1.00893	0.444008
GCA_018258275.1-Pla_CM031107.1_i000_011180	187	412	225	1.00446	0.406872
GCA_000005005.6-Pla_CM007647.1_i000_001556	188	413	225	1.00446	0.409836
GCA_000512255.2-Pla_AYRZ02000046.1_i000_031807	187	412	225	1.00446	0.408348
GCA_011745845.1-Pla_VYZY01004617.1_i000_019832	187	412	225	1.00446	0.408348
GCA_011745865.1-Pla_VYZZ01002252.1_i000_011268	187	412	225	1.00446	0.408348
GCA_002271895.2-Pla_MCIT02000034.1_i000_034471	187	412	225	1.00446	0.407609
GCA_000585535.1-Fun_AMGX01000044.1_i000_013138	190	416	226	1.00893	0.437137
GCA_003112345.1-Pla_PKPP01000210.1_i000_003687	177	395	218	0.973214	0.403704
GCA_013401315.1-Ani_VYZW01065067.1_i000_011622	115	317	202	0.901786	0.637224
GCA_020169555.1-Pla_CM035012.1_i000_003532	187	412	225	1.00446	0.406872
GCA_000344705.1-Fun_AOGT01002328.1_i000_005360	181	401	220	0.982143	0.423077
GCA_011114355.1-Pla_CM022100.1_i000_018288	177	394	217	0.96875	0.391697
GCA_907164705.1-Ani_CAJQZP010000541.1_i000_007765	186	411	225	1.00446	0.487013
GCA_000150955.2-Pro_CP001142.1_i000_001888	193	418	225	1.00446	0.441176
GCA_900074735.1-Fun_LT598476.1_i000_005013	189	415	226	1.00893	0.445759
GCA_902806785.1-Ani_CADCXU010022532.1_i000_015031	184	408	224	1	0.445328
GCA_000417875.1-Fun_KE361650.1_i000_006736	189	413	224	1	0.421846
GCA_900322975.1-Fun_OOIP01000020.1_i000_005950	189	413	224	1	0.421846
GCA_900622535.1-Ani_UYWW01012421.1_i000_011620	181	396	215	0.959821	0.438776
GCA_015179035.1-Fun_WHUY01000029.1_i000_004733	179	400	221	0.986607	0.39115
GCA_006013705.1-Pla_RXGB01000871.1_i000_004592	187	412	225	1.00446	0.406872
GCA_003709825.1-Fun_QQXN01000007.1_i000_005072	182	411	229	1.02232	0.367576
GCA_000142805.1-Fun_CU928180.1_i000_004456	190	415	225	1.00446	0.443787
GCA_000986645.1-Fun_JZBS01003033.1_i000_003001	190	404	214	0.955357	0.428
GCA_006386115.1-Pro_VFIW01000043.1_i000_010216	301	525	224	1	0.363636
GCA_019616915.1-Fun_WSTI01012352.1_i000_013312	20	240	220	0.982143	0.56701
GCA_003185045.1-Pla_CM009914.1_i000_034283	188	413	225	1.00446	0.398936
GCA_000180755.1-Ani_ADBV01000848.1_i000_002934	177	392	215	0.959821	0.450734
GCA_017639365.1-Fun_JAAQQX010000003.1_i000_002499	180	400	220	0.982143	0.427184
GCA_017639385.1-Fun_JAAQQW010000007.1_i000_005013	180	400	220	0.982143	0.427184
GCA_000026945.1-Fun_FM992695.1_i000_000850	190	415	225	1.00446	0.436047
GCA_000499545.1-Pro_HG677472.1_i000_007681	3	155	152	0.678571	0.974359
GCA_000271645.1-Fun_JH711544.1_i000_007655	191	398	207	0.924107	0.359375
GCA_001605985.2-Pla_KZ502134.1_i000_004917	187	412	225	1.00446	0.402504
GCA_022539455.1-Pla_CM039723.1_i000_007320	187	412	225	1.00446	0.402504
GCA_014904905.1-Fun_MU122092.1_i000_000122	182	406	224	1	0.426667
GCA_002900925.1-Fun_LN890539.1_i000_001212	190	415	225	1.00446	0.443787
GCA_905219595.1-Fun_CAJMWU010002645.1_i000_005072	187	407	220	0.982143	0.495495
GCA_018296085.1-Fun_JACKQM010000829.1_i000_000943	204	429	225	1.00446	0.409836
GCA_000827415.1-Fun_KN824311.1_i000_008788	99	323	224	1	0.484848
GCA_004307915.1-Fun_ML143900.1_i000_005438	184	410	226	1.00893	0.397188
GCA_013400495.1-Ani_WAAE01006651.1_i000_003588	115	191	76	0.339286	0.150198
GCA_013400495.1-Ani_WAAE01006651.1_i000_003588	197	366	169	0.754464	0.333992
GCA_016758785.1-Fun_JABBWO010000103.1_i000_001082	185	411	226	1.00893	0.415441
GCA_001298345.1-Ani_KQ459601.1_i000_012160	204	428	224	1	0.467641
GCA_004307905.1-Fun_ML145118.1_i000_007232	184	410	226	1.00893	0.395797
GCA_004307925.1-Fun_ML143409.1_i000_006067	184	410	226	1.00893	0.393043
GCA_905332055.1-Fun_CAJOAW010000116.1_i000_011126	1212	1438	226	1.00893	0.148003
GCA_004155945.1-Fun_QJNY01000123.1_i000_001186	191	417	226	1.00893	0.439689
GCA_020800285.1-Fun_JAGTJO010000008.1_i000_010214	195	419	224	1	0.425856
GCA_006381635.2-Pla_VEPZ02001604.1_i000_070522	188	413	225	1.00446	0.420561
GCA_016808215.1-Pla_CM029007.1_i000_024614	188	412	224	1	0.407273
GCA_015584085.1-Fun_MU151079.1_i000_003292	185	411	226	1.00893	0.415441
GCA_017607575.1-Fun_JABAJY010007836.1_i000_009574	186	411	225	1.00446	0.431034
SUTE001.0722.00002.C001_01026	155	377	222	0.991071	0.506849
SUTE001.0722.00001.C001_00980	155	377	222	0.991071	0.506849
GCA_000149515.1-Ani_DS268411.1_i000_027635	178	406	228	1.01786	0.461538
GCA_000227095.3-Fun_BACD03000034.1_i000_002326	243	464	221	0.986607	0.368948
GCA_003369625.1-Fun_PVWQ01000003.1_i000_006188	182	407	225	1.00446	0.387263
GCA_905332245.1-Ani_CAJOBP010006313.1_i000_025573	185	410	225	1.00446	0.466805
GCA_905332285.1-Ani_CAJOBS010000483.1_i000_009635	185	410	225	1.00446	0.466805
GCA_000151295.1-Fun_GG745341.1_i000_009948	183	404	221	0.986607	0.434185
GCA_003144245.1-Fun_KZ819663.1_i000_001862	194	416	222	0.991071	0.384083
GCA_910592205.1-Fun_CAJVPJ010002438.1_i000_008428	171	394	223	0.995536	0.398214
GCA_905331015.1-Ani_CAJNXB010004198.1_i000_024326	186	411	225	1.00446	0.465839
GCA_905331295.1-Ani_CAJNYD010001586.1_i000_013020	186	411	225	1.00446	0.465839
GCA_905331475.1-Ani_CAJNYU010000512.1_i000_006145	186	411	225	1.00446	0.465839
GCA_905331485.1-Ani_CAJNYT010003893.1_i000_023165	186	411	225	1.00446	0.465839
GCA_905331495.1-Ani_CAJNYV010005372.1_i000_029028	186	411	225	1.00446	0.465839
GCA_905332235.1-Ani_CAJOBO010000607.1_i000_010837	186	411	225	1.00446	0.465839
GCA_905332265.1-Ani_CAJOBQ010000660.1_i000_012787	186	411	225	1.00446	0.465839
GCA_905332275.1-Ani_CAJOBR010000466.1_i000_005583	186	411	225	1.00446	0.465839
GCA_000209185.1-Ani_DS231859.1_i000_015706	185	410	225	1.00446	0.446429
GCA_000392275.1-Fun_KB933036.1_i000_003208	195	418	223	0.995536	0.438976
GCA_905359465.1-Fun_CAJPIH010000691.1_i000_005558	1276	1502	226	1.00893	0.142049
GCA_905359485.1-Fun_CAJPIJ010000134.1_i000_006077	1276	1502	226	1.00893	0.142049
GCA_004355085.1-Fun_ML170159.1_i000_002742	186	411	225	1.00446	0.421348
GCA_905332025.1-Fun_CAJOAV010000106.1_i000_004321	1283	1509	226	1.00893	0.141427
GCA_900005765.1-Pro_LN835303.1_i000_001466	181	401	220	0.982143	0.472103
GCA_000151295.1-Fun_GG745339.1_i000_010889	183	404	221	0.986607	0.434185
GCA_004369065.1-Fun_ML208268.1_i000_003044	179	387	208	0.928571	0.354344
GCA_000026365.1-Fun_CU928178.1_i000_003746	190	415	225	1.00446	0.438596
GCA_001972345.1-Fun_BDGX01000021.1_i000_003862	190	415	225	1.00446	0.438596
GCA_021535285.1-Fun_JAKETS010000005.1_i000_003792	190	415	225	1.00446	0.438596
GCA_004332605.1-Fun_RWJN01000069.1_i000_010826	191	417	226	1.00893	0.415441
GCA_001661235.1-Fun_KV454001.1_i000_000069	188	413	225	1.00446	0.501114
GCA_008355005.1-Fun_NIDF01000028.1_i000_003939	189	407	218	0.973214	0.381119
GCA_016584345.1-Fun_JABCPV010000396.1_i000_010713	175	401	226	1.00893	0.423221
GCA_018296165.1-Fun_JACKQL010004559.1_i000_003792	204	429	225	1.00446	0.409836
GCA_001642005.1-Ani_LWCA01000021.1_i000_004091	188	411	223	0.995536	0.133055
GCA_001953115.1-Fun_LSSL01000584.1_i000_001611	186	410	224	1	0.404332
GCA_001720205.1-Fun_AWGJ01000004.1_i000_005354	189	407	218	0.973214	0.380454
GCA_001720235.1-Fun_MEKH01000004.1_i000_005306	189	407	218	0.973214	0.380454
GCA_013368295.1-Fun_JAACJJ010000033.1_i000_009701	186	412	226	1.00893	0.424812
GCA_000002525.1-Fun_CR382128.1_i000_000720	180	400	220	0.982143	0.427184
GCA_001761485.1-Fun_CP017554.1_i000_000970	180	400	220	0.982143	0.427184
GCA_003367845.1-Fun_KZ859396.1_i000_006190	180	400	220	0.982143	0.427184
GCA_003367865.1-Fun_KZ859073.1_i000_005664	180	400	220	0.982143	0.427184
GCA_003367925.1-Fun_KZ858407.1_i000_005823	180	400	220	0.982143	0.427184
GCA_003367945.1-Fun_KZ858148.1_i000_006190	180	400	220	0.982143	0.427184
GCA_003367965.1-Fun_KZ858828.1_i000_006497	180	400	220	0.982143	0.427184
GCA_003698155.1-Fun_PKSB01000001.1_i000_000043	180	400	220	0.982143	0.427184
GCA_009194645.1-Fun_ML736639.1_i000_005069	180	400	220	0.982143	0.427184
GCA_009372015.1-Fun_ML755995.1_i000_002573	180	400	220	0.982143	0.427184
GCA_014490615.1-Fun_CP061013.1_i000_000725	180	400	220	0.982143	0.427184
GCA_900537225.1-Fun_UTQH01000009.1_i000_006274	180	400	220	0.982143	0.427184
GCA_002166775.1-Fun_NHMM01000002.1_i000_001340	188	413	225	1.00446	0.46875
GCA_910592015.1-Fun_CAJVPK010000106.1_i000_002065	174	220	46	0.205357	0.0968421
GCA_910592015.1-Fun_CAJVPK010000106.1_i000_002065	211	377	166	0.741071	0.349474
GCA_002105105.1-Fun_MCFI01000019.1_i000_002564	187	413	226	1.00893	0.465021
GCA_019925795.1-Pla_CM034299.1_i000_002438	187	412	225	1.00446	0.411335
GCA_905250025.1-Ani_CAJNOJ010000153.1_i000_025643	185	408	223	0.995536	0.503386
GCA_000691765.2-Fun_KK667243.1_i000_006101	190	415	225	1.00446	0.441176
GCA_002271885.2-Pla_MLFT02000246.1_i000_031246	187	412	225	1.00446	0.408348
GCA_000344705.1-Fun_AOGT01000772.1_i000_001903	143	369	226	1.00893	0.490239
GCA_001040885.1-Ani_LN609529.1_i000_008532	187	412	225	1.00446	0.466805
GCA_900087985.1-Fun_LT576331.1_i000_004749	180	400	220	0.982143	0.42471
GCA_001661475.1-Fun_KV453842.1_i000_001975	190	415	225	1.00446	0.357711
GCA_001720155.1-Fun_AWGH01000043.1_i000_006006	189	407	218	0.973214	0.381119
GCA_000149445.2-Fun_CM000309.1_i000_005660	190	415	225	1.00446	0.436047
GCA_000182965.3-Fun_CP017630.1_i000_005946	190	415	225	1.00446	0.436047
GCA_000773725.1-Fun_AJIX01000058.1_i000_005536	190	415	225	1.00446	0.436047
GCA_000773735.1-Fun_AJIW01000068.1_i000_005850	190	415	225	1.00446	0.436047
GCA_000773745.1-Fun_AJIU01000044.1_i000_005151	190	415	225	1.00446	0.436047
GCA_000773805.1-Fun_AJIY01000044.1_i000_005318	190	415	225	1.00446	0.436047
GCA_000773825.1-Fun_AJJA01000048.1_i000_006112	190	415	225	1.00446	0.436047
GCA_000773845.1-Fun_AJIQ01000049.1_i000_004763	190	415	225	1.00446	0.436047
GCA_000774085.1-Fun_AJIT01000043.1_i000_005586	190	415	225	1.00446	0.436047
GCA_000775445.1-Fun_AJIV01000060.1_i000_005344	190	415	225	1.00446	0.436047
GCA_000775465.1-Fun_AJIZ01000050.1_i000_005522	190	415	225	1.00446	0.436047
GCA_000775505.1-Fun_AJJB01000055.1_i000_005210	190	415	225	1.00446	0.436047
GCA_000775525.1-Fun_AJJC01000050.1_i000_005207	190	415	225	1.00446	0.436047
GCA_000784495.1-Fun_AJJE01000045.1_i000_004612	190	415	225	1.00446	0.436047
GCA_000784505.1-Fun_AJJD01000038.1_i000_003241	190	415	225	1.00446	0.436047
GCA_000784515.1-Fun_JSXQ01000050.1_i000_004885	190	415	225	1.00446	0.436047
GCA_000784525.1-Fun_JSXP01000044.1_i000_005206	190	415	225	1.00446	0.436047
GCA_000784595.1-Fun_JPEV01000048.1_i000_005321	190	415	225	1.00446	0.436047
GCA_000784635.1-Fun_AJJF01000038.1_i000_005011	190	415	225	1.00446	0.436047
GCA_000784655.1-Fun_JTBX01000077.1_i000_006025	190	415	225	1.00446	0.436047
GCA_000784695.1-Fun_AJJG01000078.1_i000_000103	190	415	225	1.00446	0.436047
GCA_014049485.1-Fun_JABWAD010000052.1_i000_003858	190	415	225	1.00446	0.436047
GCA_000784615.1-Fun_JPEW01000069.1_i000_006211	190	415	225	1.00446	0.433526
GCA_017655625.1-Fun_JAEOAQ010000002.1_i000_001534	181	400	219	0.977679	0.423598
GCA_000773755.1-Fun_AJIS01000057.1_i000_006114	190	415	225	1.00446	0.433526
GCA_000784575.1-Fun_JSXR01000053.1_i000_005420	190	415	225	1.00446	0.436047
GCA_000835455.1-Fun_KN846971.1_i000_003867	190	416	226	1.00893	0.439689
GCA_001908125.1-Fun_MNBE01000708.1_i000_011353	182	406	224	1	0.392982
GCA_000956335.1-Pro_KQ001704.1_i000_004286	181	401	220	0.982143	0.464135
GCA_018857265.1-Fun_JABAJZ010000110.1_i000_001508	242	467	225	1.00446	0.383305
GCA_000002335.3-Ani_CM000284.3_i000_012856	186	411	225	1.00446	0.460123
GCA_000151265.1-Pla_GG663739.1_i000_006097	187	413	226	1.00893	0.465021
GCA_011009095.1-Ani_VTPC01000605.1_i000_001085	186	411	225	1.00446	0.432692
GCA_001865355.1-Pro_LRBS01000070.1_i000_002028	190	416	226	1.00893	0.462168
GCA_015499995.1-Fun_JADNRV010000297.1_i000_008719	123	349	226	1.00893	0.478814
GCA_015501605.1-Fun_JADNRZ010000009.1_i000_016978	186	411	225	1.00446	0.412844
GCA_003788615.2-Fun_ML121569.1_i000_009332	181	402	221	0.986607	0.385689
GCA_001661175.1-Pla_LSRQ01001521.1_i000_008628	177	375	198	0.883929	0.347979
GCA_900617795.1-Ani_CAAALY010036928.1_i000_011840	180	397	217	0.96875	0.537129
GCA_001642475.1-Fun_LVKK01000043.1_i000_007643	190	416	226	1.00893	0.439689
GCA_921882275.1-Ani_OV170222.1_i000_002633	186	411	225	1.00446	0.48913
GCA_000764455.1-Fun_JQFK01000005.1_i000_002900	188	413	225	1.00446	0.455466
GCA_003054445.1-Fun_CP028773.1_i000_000189	188	413	225	1.00446	0.455466
GCA_015679605.1-Fun_JAAAVE010000507.1_i000_007617	182	392	210	0.9375	0.421687
GCA_020310725.1-Fun_LGJB01000030.1_i000_011325	190	416	226	1.00893	0.439689
GCA_001983325.1-Fun_MQVM01000028.1_i000_004271	188	413	225	1.00446	0.452716
GCA_015679485.1-Fun_JAAAUY010001141.1_i000_000812	2	151	149	0.665179	0.620833
GCA_015039365.1-Fun_WION01000005.1_i000_011936	198	424	226	1.00893	0.42243
GCA_905221605.1-Pro_CAJNDS010002811.1_i000_034457	181	403	222	0.991071	0.442231
GCA_004367935.1-Fun_QAPF01000064.1_i000_004159	203	429	226	1.00893	0.438835
GCA_017635955.1-Fun_JAAQQV010000006.1_i000_006215	180	400	220	0.982143	0.42885
GCA_900106115.1-Fun_LT635758.1_i000_003161	181	401	220	0.982143	0.423892
GCA_904845875.1-Pla_CAJGYO010000001.1_i000_001788	188	413	225	1.00446	0.408348
GCA_000011425.1-Fun_BN001306.1_i000_006601	182	406	224	1	0.382253
GCA_000149205.2-Fun_CH236922.1_i000_005857	182	406	224	1	0.382253
GCA_018107945.1-Pla_JACEIK010000014.1_i000_000729	114	161	47	0.209821	0.142424
GCA_018107945.1-Pla_JACEIK010000014.1_i000_000729	167	246	79	0.352679	0.239394
GCA_018107945.1-Pla_JACEIK010000014.1_i000_000729	241	290	49	0.21875	0.148485
GCA_002079055.1-Fun_CP020248.1_i000_002026	111	345	234	1.04464	0.473684
GCA_001970955.1-Pro_MPUH01001582.1_i000_007305	186	409	223	0.995536	0.385147
GCA_000346795.1-Fun_KB644412.1_i000_005095	182	407	225	1.00446	0.394046
GCA_001048715.1-Fun_CDHK01000002.1_i000_002409	182	406	224	1	0.392982
GCA_013400615.1-Ani_VZTO01018817.1_i000_008911	115	193	78	0.348214	0.152344
GCA_013400615.1-Ani_VZTO01018817.1_i000_008911	202	367	165	0.736607	0.322266
STMA002.0722.00001.C001_01329	160	378	218	0.973214	0.533007
GCA_003546025.1-Pla_QPKB01000001.1_i000_002590	188	412	224	1	0.484848
GCA_013397325.1-Ani_VZTC01000119.1_i000_000136	115	330	215	0.959821	0.508274
GCA_015179025.1-Fun_WHUX01000010.1_i000_000454	181	402	221	0.986607	0.397482
GCA_001683735.1-Fun_LUGG01000010.1_i000_008224	180	393	213	0.950893	0.375
GCA_001717485.1-Fun_JXNT01000020.1_i000_005303	182	407	225	1.00446	0.385274
GCA_006352295.1-Fun_SOZI01000054.1_i000_005904	180	388	208	0.928571	0.371429
GCA_000151315.2-Pro_KE346370.1_i000_006583	198	422	224	1	0.446215
GCA_900537205.1-Ani_UYRW01000474.1_i000_002702	177	392	215	0.959821	0.444215
GCA_006381635.2-Pla_VEPZ02000320.1_i000_009481	188	413	225	1.00446	0.421348
GCA_900059795.1-Pla_HG974434.1_i000_018835	177	395	218	0.973214	0.516588
GCA_022376435.1-Fun_JABYQE010000012.1_i000_001393	186	411	225	1.00446	0.406137
GCA_008360955.1-Ani_LUCM01003720.1_i000_003894	109	331	222	0.991071	0.445783
GCA_008704595.1-Fun_SWFT01000027.1_i000_003311	180	401	221	0.986607	0.431641
GCA_005406105.1-Fun_BIMX01000022.1_i000_003823	190	415	225	1.00446	0.422932
GCA_002909625.1-Ani_PPHD01107353.1_i000_017066	60	263	203	0.90625	0.771863
GCA_000600275.1-Fun_KK088465.1_i000_009723	182	407	225	1.00446	0.385274
GCA_000827215.1-Fun_KN837079.1_i000_002959	189	413	224	1	0.434109
GCA_008690995.1-Pro_VRMN01000011.1_i000_004783	196	425	229	1.02232	0.428839
GCA_001773325.1-Fun_LXJU01000016.1_i000_007983	182	406	224	1	0.389565
GCA_015341985.1-Fun_JACYCC010000036.1_i000_001690	180	409	229	1.02232	0.16463
GCA_002891405.2-Ani_NEVH01013964.1_i000_009329	186	411	225	1.00446	0.460123
GCA_003814445.1-Fun_CP031385.1_i000_000644	192	418	226	1.00893	0.447525
GCA_001890805.1-Fun_KV878935.1_i000_011154	182	407	225	1.00446	0.385274
GCA_018360145.1-Fun_SRPY01000599.1_i000_006015	192	417	225	1.00446	0.418994
GCA_011392965.1-Ani_WNWW01000907.1_i000_009563	204	429	225	1.00446	0.442043
GCA_000775455.1-Fun_AJIR01000057.1_i000_005172	190	415	225	1.00446	0.436047
GCA_000389695.3-Fun_APWK03000132.1_i000_001316	193	419	226	1.00893	0.455645
GCA_000978885.1-Fun_LBBL01000146.1_i000_003005	193	419	226	1.00893	0.452906
GCA_014904945.1-Fun_MU127431.1_i000_007043	185	411	226	1.00893	0.416974
GCA_016906535.1-Fun_CP059662.1_i000_004745	187	407	220	0.982143	0.39783
GCA_015341985.1-Fun_JACYCC010000021.1_i000_005172	187	407	220	0.982143	0.39783
GCA_905219565.1-Fun_CAJMWR010004032.1_i000_007154	187	407	220	0.982143	0.39783
GCA_007990345.1-Pla_CM017681.1_i000_053816	188	413	225	1.00446	0.422139
GCA_000464535.1-Fun_KE721293.1_i000_006519	187	412	225	1.00446	0.433526
GCA_900323505.1-Fun_OOIN01000038.1_i000_011781	188	412	224	1	0.429942
GCA_015342415.1-Fun_JACYCE010000030.1_i000_005042	187	407	220	0.982143	0.39783
GCA_015342435.1-Fun_JACYCD010000023.1_i000_005152	187	407	220	0.982143	0.39783
GCA_018857285.1-Fun_JABAKA010008047.1_i000_005153	186	411	225	1.00446	0.426945
GCA_015499995.1-Fun_JADNRV010000131.1_i000_003043	186	412	226	1.00893	0.42243
GCA_016758765.1-Fun_JABBWL010000049.1_i000_014131	185	411	226	1.00893	0.417745
GCA_015499995.1-Fun_JADNRV010000053.1_i000_013587	186	412	226	1.00893	0.420857
GCA_000350225.2-Pro_HG002070.1_i000_000159	178	399	221	0.986607	0.384348
GCA_000226095.1-Fun_CP003006.1_i000_006713	195	419	224	1	0.433269
GCA_902829315.1-Ani_CADEPM010000001.1_i000_000793	188	415	227	1.01339	0.470954
GCA_000616785.1-Fun_KK204365.1_i000_002058	190	416	226	1.00893	0.433781
GCA_000622975.1-Fun_AOKY01000377.1_i000_005855	190	416	226	1.00893	0.433781
GCA_012182645.1-Fun_JAATJQ010000038.1_i000_004798	190	416	226	1.00893	0.433781
GCA_012182655.1-Fun_JAAQVJ010000039.1_i000_004845	190	416	226	1.00893	0.433781
GCA_019359935.1-Fun_JAADCK010000043.1_i000_005296	190	416	226	1.00893	0.433781
GCA_000599465.2-Ani_AWGT02010983.1_i000_016555	274	491	217	0.96875	0.388193
GCA_000243375.1-Fun_HE616744.1_i000_001742	189	415	226	1.00893	0.443137
GCA_014904855.1-Fun_MU118187.1_i000_010667	185	411	226	1.00893	0.391681
GCA_014905375.1-Pla_BMAC01000044.1_i000_003874	188	413	225	1.00446	0.432692
SUAC001.0722.00001.C001_01023	155	379	224	1	0.541063
GCA_008690995.1-Pro_VRMN01000003.1_i000_001667	182	403	221	0.986607	0.427466
GCA_001950575.1-Fun_BDGI01000126.1_i000_003008	181	401	220	0.982143	0.408922
GCA_902498895.1-Fun_CABVLU010000001.1_i000_000823	195	420	225	1.00446	0.447316
GCA_900157425.1-Fun_FUEG01000003.1_i000_014034	180	404	224	1	0.38422
GCA_001974825.1-Pla_AWUE01019747.1_i000_025601	188	413	225	1.00446	0.467775
GCA_021927905.1-Pro_BLLK01000038.1_i000_006554	190	414	224	1	0.440945
GCA_013400535.1-Ani_VZTL01044801.1_i000_006573	115	328	213	0.950893	0.435583
GCA_016861735.1-Fun_AP024417.1_i000_002127	182	407	225	1.00446	0.385935
GCA_001939145.1-Pro_LSRX01000595.1_i000_022641	277	499	222	0.991071	0.370618
GCA_019787685.1-Fun_JAHNUO010000004.1_i000_003427	186	411	225	1.00446	0.369458
GCA_020169535.1-Pla_CM034988.1_i000_003334	187	412	225	1.00446	0.406872
GCA_001974805.1-Pla_AWWV01009782.1_i000_010304	188	413	225	1.00446	0.416667
GCA_000151685.2-Pla_EQ974483.1_i000_007420	177	395	218	0.973214	0.390681
GCA_000236905.1-Fun_HE612861.1_i000_002689	190	415	225	1.00446	0.442043
ACHO003.0722.00001.C001_01468	153	375	222	0.991071	0.541463
GCA_905221635.1-Pro_CAJNDV010036218.1_i000_029836	281	503	222	0.991071	0.368159
GCA_010458925.1-Pla_CM021231.1_i000_011752	177	395	218	0.973214	0.420039
GCA_001661235.1-Fun_KV454006.1_i000_005007	181	397	216	0.964286	0.538653
GCA_000711695.1-Fun_JMSN01000014.1_i000_001592	186	400	214	0.955357	0.391941
ACAM001.0722.00001.C001_00372	153	375	222	0.991071	0.541463
GCA_004000155.1-Fun_RCSS01000356.1_i000_001513	148	389	241	1.07589	0.6025
GCA_000315875.1-Fun_HE681724.1_i000_004964	181	400	219	0.977679	0.467949
GCA_002072345.1-Fun_MDYN01000002.1_i000_000931	182	406	224	1	0.389565
GCA_018360255.1-Fun_SRPZ01000190.1_i000_002368	189	414	225	1.00446	0.497788
GCA_000002515.1-Fun_CR382124.1_i000_002472	190	415	225	1.00446	0.438596
GCA_000143185.1-Fun_GL377304.1_i000_005221	188	413	225	1.00446	0.415129
GCA_019154785.2-Pro_JAGRRH010000017.1_i000_007899	190	414	224	1	0.431599
GCA_019154785.2-Pro_JAGRRH010000007.1_i000_028487	190	414	224	1	0.431599
GCA_000151665.1-Pro_FN668689.1_i000_005352	191	416	225	1.00446	0.457317
GCA_000150035.1-Fun_DS480411.1_i000_002749	189	415	226	1.00893	0.444882
GCA_007993695.1-Fun_CP042458.1_i000_002830	190	415	225	1.00446	0.436047
GCA_013694445.1-Fun_CP059268.1_i000_001416	190	415	225	1.00446	0.437743
GCA_001329695.1-Fun_KQ474080.1_i000_004182	180	388	208	0.928571	0.370107
GCA_014462675.1-Fun_JACAZH010000009.1_i000_012244	187	413	226	1.00893	0.31831
GCA_001186125.1-Pro_KQ242173.1_i000_007347	187	410	223	0.995536	0.461698
GCA_905231915.1-Pro_CAJNJA010029808.1_i000_017893	214	436	222	0.991071	0.354633
GCA_006912115.1-Fun_VCMJ01007113.1_i000_005454	50	276	226	1.00893	0.631285
GCA_004011995.1-Pla_QGNW01000034.1_i000_013471	115	199	84	0.375	0.213198
GCA_004011995.1-Pla_QGNW01000034.1_i000_013471	192	244	52	0.232143	0.13198
GCA_004011995.1-Pla_QGNW01000034.1_i000_013471	237	262	25	0.111607	0.0634518
GCA_900618445.1-Ani_UYSG01001658.1_i000_004372	170	395	225	1.00446	0.442913
GCA_013399155.1-Ani_VWYG01000256.1_i000_000166	115	317	202	0.901786	0.637224
GCA_002251995.2-Fun_NDIQ01000022.1_i000_002829	180	403	223	0.995536	0.441584
GCA_000296195.2-Pro_AGNL01046624.1_i000_030321	87	335	248	1.10714	0.528785
GCA_014839935.1-Fun_QTSX01036436.1_i000_019014	184	408	224	1	0.457143
GCA_002916505.1-Fun_PKSG01001023.1_i000_005368	228	452	224	1	0.402154
GCA_003709865.1-Fun_QRBJ01000059.1_i000_004212	182	411	229	1.02232	0.3664
GCA_900242705.1-Fun_OEYX01000061.1_i000_004650	188	412	224	1	0.434109
GCA_003704095.1-Ani_RCHS01000010.1_i000_000012	208	433	225	1.00446	0.382653
GCA_000316135.1-Fun_JH993798.1_i000_000014	104	322	218	0.973214	0.621083
GCA_000151665.1-Pro_FN668683.1_i000_004713	217	442	225	1.00446	0.432692
GCA_009498055.1-Fun_CP038484.1_i000_000754	181	401	220	0.982143	0.427184
GCA_009498075.1-Fun_CP039550.1_i000_000423	181	401	220	0.982143	0.427184
GCA_009498095.1-Fun_CP039652.1_i000_000429	181	401	220	0.982143	0.427184
GCA_009498115.1-Fun_CP039660.1_i000_000429	181	401	220	0.982143	0.427184
GCA_009498135.1-Fun_CP039618.1_i000_000429	181	401	220	0.982143	0.427184
GCA_003675555.2-Fun_QOBI02000001.1_i000_000392	181	401	220	0.982143	0.42471
GCA_014636115.1-Fun_JAASFG010000001.1_i000_000714	181	401	220	0.982143	0.417457
GCA_000697945.4-Ani_ML763003.1_i000_004580	194	418	224	1	0.445328
GCA_000166005.1-Fun_GL534973.1_i000_005684	192	401	209	0.933036	0.521197
GCA_000003835.1-Fun_CH408076.1_i000_004256	181	401	220	0.982143	0.423892
GCA_002166775.1-Fun_NHMM01000007.1_i000_004033	115	335	220	0.982143	0.491071
GCA_015657495.1-Fun_MU157860.1_i000_008197	186	412	226	1.00893	0.42243
GCA_005406025.1-Ani_BGZK01000106.1_i000_013774	208	433	225	1.00446	0.462012
GCA_905261645.1-Ani_CAJNOV010003805.1_i000_009639	186	410	224	1	0.463768
GCA_905273325.1-Ani_CAJNOW010006254.1_i000_013478	186	410	224	1	0.463768
GCA_905319835.1-Ani_CAJNRE010016806.1_i000_030834	186	410	224	1	0.463768
GCA_905321285.1-Ani_CAJNRF010011753.1_i000_027001	186	410	224	1	0.463768
GCA_905321535.1-Ani_CAJNRG010019354.1_i000_037152	186	410	224	1	0.463768
GCA_905332145.1-Ani_CAJOBF010000497.1_i000_006318	186	410	224	1	0.463768
GCA_905332155.1-Ani_CAJOBG010000976.1_i000_008386	186	410	224	1	0.463768
GCA_018360205.1-Fun_SRPT01000465.1_i000_005116	192	417	225	1.00446	0.501114
GCA_003184645.1-Fun_KZ825825.1_i000_002801	182	407	225	1.00446	0.384615
GCA_000298355.1-Ani_JH880965.1_i000_005416	184	411	227	1.01339	0.379599
GCA_018360135.1-Fun_SRPV01000173.1_i000_002229	37	262	225	1.00446	0.797872
GCA_020736525.1-Fun_JAHBOE010000002.1_i000_005695	170	376	206	0.919643	0.347386
GCA_000836435.1-Fun_KN848086.1_i000_009667	190	416	226	1.00893	0.435453
GCA_001646985.1-Fun_LVCI01000106.1_i000_000533	190	416	226	1.00893	0.435453
GCA_900242695.1-Fun_OHJM01000005.1_i000_001593	188	412	224	1	0.434109
GCA_000241205.2-Fun_BABT02000090.1_i000_003663	192	400	208	0.928571	0.348993
GCA_000708205.1-Fun_KL411546.1_i000_003516	192	400	208	0.928571	0.348993
GCA_022264855.1-Fun_JABYQU010000024.1_i000_004739	185	411	226	1.00893	0.414679
GCA_019448385.1-Pro_JAGTXO010000041.1_i000_013767	191	416	225	1.00446	0.479744
GCA_000827485.1-Fun_KN818234.1_i000_005004	185	413	228	1.01786	0.409336
GCA_905178165.1-Pro_CAJINU010000059.1_i000_018751	183	407	224	1	0.470588
GCA_000002825.1-Pro_DS113312.1_i000_047741	183	408	225	1.00446	0.467775
GCA_905178155.1-Pro_CAJINV010000002.1_i000_006509	183	407	224	1	0.414048
GCA_000223845.4-Pro_KK211457.1_i000_001012	181	402	221	0.986607	0.505721
GCA_001970955.1-Pro_MPUH01000373.1_i000_017450	186	409	223	0.995536	0.380546
GCA_902085965.1-Fun_CABFNS010000823.1_i000_010787	193	417	224	1	0.356688
GCA_020796215.1-Pla_CM036791.1_i000_017996	188	421	233	1.04018	0.416071
GCA_003184545.1-Fun_MSFL01000001.1_i000_000105	182	407	225	1.00446	0.382003
GCA_000151505.1-Fun_ACYE01000336.1_i000_002305	239	453	214	0.955357	0.322775
GCA_015039465.1-Fun_MU130264.1_i000_006114	185	411	226	1.00893	0.424015
GCA_004126415.1-Fun_SDEE01000006.1_i000_011279	186	411	225	1.00446	0.414365
GCA_000026945.1-Fun_FM992693.1_i000_005086	181	401	220	0.982143	0.426357
GCA_003144235.1-Fun_KZ820032.1_i000_004939	190	414	224	1	0.421846
GCA_000835555.1-Fun_KN847479.1_i000_006748	182	409	227	1.01339	0.353033
GCA_001673695.2-Fun_LYUB02000010.1_i000_003396	181	401	220	0.982143	0.42471
GCA_013396415.1-Ani_VWPT01000008.1_i000_012172	184	418	234	1.04464	0.480493
GCA_902006505.2-Fun_CABFNO020001538.1_i000_013685	193	417	224	1	0.359551
GCA_000286035.1-Fun_CAGI01000137.1_i000_006239	188	412	224	1	0.434109
GCA_900519145.1-Fun_ULHA01000031.1_i000_005610	188	412	224	1	0.434109
GCA_019973975.1-Ani_BMAO01019030.1_i000_033751	90	311	221	0.986607	0.638728
GCA_902077795.2-Fun_CABFNQ020000754.1_i000_016766	193	417	224	1	0.356688
GCA_016628565.1-Fun_JABBWD010000008.1_i000_013818	185	411	226	1.00893	0.416206
GCA_003327735.1-Fun_QLNQ01000018.1_i000_003006	190	415	225	1.00446	0.445545
GCA_014905635.1-Pla_CM026547.1_i000_000687	186	411	225	1.00446	0.460123
GCA_902177915.1-Ani_CABIJS010000111.1_i000_003837	187	412	225	1.00446	0.389273
GCA_013396795.1-Ani_VWZH01000008.1_i000_011722	184	418	234	1.04464	0.480493
GCA_001687445.1-Fun_KV722382.1_i000_005074	186	412	226	1.00893	0.426415
GCA_001700775.1-Fun_LGRB01000009.1_i000_003179	190	416	226	1.00893	0.437137
GCA_021604985.1-Pla_BQKI01000082.1_i000_047139	188	412	224	1	0.424242
GCA_001879085.1-Pla_CM007400.1_i000_010661	187	412	225	1.00446	0.406137
GCA_000235365.1-Fun_CP002500.1_i000_002479	190	415	225	1.00446	0.438596
GCA_000151175.1-Fun_DS995720.1_i000_007623	190	416	226	1.00893	0.433781
GCA_000151455.1-Fun_GG698515.1_i000_002123	190	416	226	1.00893	0.433781
GCA_020169575.1-Pla_CM035000.1_i000_003182	187	413	226	1.00893	0.40942
GCA_001680005.1-Pro_CP016246.1_i000_002246	181	401	220	0.982143	0.464135
GCA_001651985.1-Fun_LVYI01000005.1_i000_008893	182	395	213	0.950893	0.325688
GCA_002016555.1-Fun_LJBN01000122.1_i000_003986	182	406	224	1	0.278954
GCA_000006355.3-Pro_AM910990.2_i000_001634	181	401	220	0.982143	0.464135
GCA_002140095.1-Pro_NETL01000024.1_i000_000273	181	401	220	0.982143	0.464135
GCA_900005025.2-Pro_CWHR02000028.1_i000_000307	181	401	220	0.982143	0.464135
GCA_011392965.1-Ani_WNWW01000907.1_i000_009562	136	360	224	1	0.507937
GCA_015529785.1-Fun_JAAAUK010002242.1_i000_004353	2	144	142	0.633929	0.614719
GCA_002220415.3-Pla_CM022214.1_i000_014939	173	397	224	1	0.482759
GCA_000767015.2-Ani_ASGP02000001.1_i000_001104	204	428	224	1	0.429119
GCA_000235995.2-Ani_KZ248834.1_i000_012793	158	382	224	1	0.522145
GCA_015529505.1-Fun_JAAAUI010000387.1_i000_005702	186	381	195	0.870536	0.511811
GCA_015529515.1-Fun_JAAAUJ010000086.1_i000_009259	186	381	195	0.870536	0.511811
GCA_900080155.1-Fun_LT558138.1_i000_000273	188	412	224	1	0.434951
GCA_900519155.1-Fun_ULHB01000032.1_i000_002200	188	412	224	1	0.434951
GCA_001890125.1-Fun_KV878127.1_i000_004149	182	406	224	1	0.38488
GCA_000442575.2-Pro_ATMG01006513.1_i000_010387	96	314	218	0.973214	0.643068
GCA_015500155.1-Fun_JAAAUE010003121.1_i000_004878	2	144	142	0.633929	0.609442
GCA_015679645.1-Fun_JAAAVC010000074.1_i000_010389	2	144	142	0.633929	0.609442
GCA_021604985.1-Pla_BQKI01000015.1_i000_023540	188	412	224	1	0.408759
GCA_003709845.1-Fun_QQXO01000142.1_i000_001036	190	416	226	1.00893	0.296588
GCA_000150505.2-Fun_KE503206.1_i000_000943	186	411	225	1.00446	0.447316
GCA_008802855.1-Ani_VVIM01001705.1_i000_015475	186	411	225	1.00446	0.463918
GCA_008802855.1-Ani_VVIM01000008.1_i000_011861	186	411	225	1.00446	0.463918
GCA_010458925.1-Pla_CM021233.1_i000_017683	125	342	217	0.96875	0.223481
GCA_001447935.2-Fun_LMYN01000010.1_i000_000884	181	400	219	0.977679	0.427734
GCA_014133895.1-Fun_CP059247.1_i000_001472	189	415	226	1.00893	0.439689
GCA_019059645.1-Ani_JAFELL010002276.1_i000_015500	192	357	165	0.736607	0.273179
GCA_019059645.1-Ani_JAFELL010002276.1_i000_015500	370	442	72	0.321429	0.119205
GCA_001263375.1-Fun_LAVV01003265.1_i000_002460	212	420	208	0.928571	0.347826
GCA_910592245.1-Fun_CAJVQB010027124.1_i000_025001	139	358	219	0.977679	0.481319
GCA_000743665.3-Fun_JMRO03000017.1_i000_000767	206	416	210	0.9375	0.415842
GCA_000442575.2-Pro_ATMG01008579.1_i000_008322	96	314	218	0.973214	0.643068
GCA_000365165.2-Fun_KB822698.1_i000_002170	190	416	226	1.00893	0.436293
GCA_001511075.1-Fun_CDMC01000009.1_i000_010753	182	406	224	1	0.388889
GCA_905221615.1-Pro_CAJNDT010000206.1_i000_004265	254	476	222	0.991071	0.359806
GCA_002571385.1-Ani_LSMT01000240.1_i000_012647	185	410	225	1.00446	0.400356
GCA_001235845.1-Pro_LFNC01000426.1_i000_004431	201	432	231	1.03125	0.484277
GCA_001890705.1-Fun_KV878584.1_i000_004030	182	406	224	1	0.38488
GCA_000697645.1-Fun_KL142369.1_i000_003630	186	411	225	1.00446	0.420561
GCA_000835495.1-Fun_KN847041.1_i000_004587	190	416	226	1.00893	0.435453
GCA_905231905.1-Pro_CAJNIZ010047748.1_i000_022909	101	323	222	0.991071	0.526066
GCA_000775505.1-Fun_AJJB01000035.1_i000_002773	181	400	219	0.977679	0.424419
GCA_015501595.1-Fun_JADNRX010000005.1_i000_020240	187	412	225	1.00446	0.422932
GCA_015179045.1-Fun_WHUZ01000001.1_i000_000663	181	402	221	0.986607	0.365894
GCA_000691765.2-Fun_KK667235.1_i000_004376	181	400	219	0.977679	0.424419
GCA_000773805.1-Fun_AJIY01000028.1_i000_002740	181	400	219	0.977679	0.424419
GCA_000775465.1-Fun_AJIZ01000034.1_i000_003730	181	400	219	0.977679	0.424419
GCA_000784615.1-Fun_JPEW01000040.1_i000_003793	181	400	219	0.977679	0.424419
GCA_000784655.1-Fun_JTBX01000052.1_i000_004274	181	400	219	0.977679	0.424419
GCA_000773735.1-Fun_AJIW01000038.1_i000_003503	181	400	219	0.977679	0.424419
GCA_000774085.1-Fun_AJIT01000028.1_i000_002728	181	400	219	0.977679	0.424419
GCA_014607435.1-Fun_JAACFV010000096.1_i000_012365	187	412	225	1.00446	0.433526
GCA_018320845.1-Ani_CM031329.1_i000_017417	18	226	208	0.928571	0.815686
GCA_015039435.1-Fun_MU131030.1_i000_011661	186	411	225	1.00446	0.397527
GCA_000784495.1-Fun_AJJE01000025.1_i000_002724	181	400	219	0.977679	0.424419
GCA_000784505.1-Fun_AJJD01000020.1_i000_001497	181	400	219	0.977679	0.424419
GCA_000151125.2-Fun_ABSU01000018.1_i000_002724	208	434	226	1.00893	0.419295
GCA_000773755.1-Fun_AJIS01000046.1_i000_004328	181	400	219	0.977679	0.425243
GCA_000784635.1-Fun_AJJF01000028.1_i000_003229	181	400	219	0.977679	0.425243
GCA_001661415.1-Fun_KV453911.1_i000_002139	190	415	225	1.00446	0.448207
GCA_900180425.1-Fun_FXLY01000004.1_i000_004895	189	415	226	1.00893	0.44664
GCA_001972345.1-Fun_BDGX01000045.1_i000_008768	190	415	225	1.00446	0.43021
GCA_910592135.1-Fun_CAJVPZ010002597.1_i000_003125	96	313	217	0.96875	0.290107
GCA_013358455.1-Pla_JABWDY010000907.1_i000_000659	188	406	218	0.973214	0.490991
GCA_000002975.1-Pro_AJ010592.2_i000_000194	159	385	226	1.00893	0.573604
GCA_003698115.1-Fun_RAQS01000443.1_i000_007449	182	407	225	1.00446	0.382653
GCA_000209535.1-Ani_FN653018.1_i000_003232	181	402	221	0.986607	0.448276
GCA_020736525.1-Fun_JAHBOE010000003.1_i000_006582	194	419	225	1.00446	0.441176
GCA_000271585.1-Fun_JH711785.1_i000_003664	179	401	222	0.991071	0.393617
GCA_016861865.1-Fun_AP024445.1_i000_004945	182	406	224	1	0.38488
GCA_016584175.1-Fun_PUHR01000085.1_i000_005086	189	415	226	1.00893	0.44664
GCA_000271625.1-Fun_JH711578.1_i000_006097	186	410	224	1	0.415584
GCA_001481415.2-Fun_LNZH02000165.1_i000_000042	186	411	225	1.00446	0.390625
GCA_001447755.1-Ani_JYDO01000183.1_i000_003455	188	409	221	0.986607	0.197145
GCA_000250985.1-Fun_JH605027.1_i000_002008	172	389	217	0.96875	0.520384
GCA_905221625.1-Pro_CAJNDU010058002.1_i000_035201	485	707	222	0.991071	0.247492
GCA_000190615.1-Fun_GL870880.1_i000_001910	172	389	217	0.96875	0.520384
GCA_018360185.1-Fun_SRPU01000150.1_i000_000934	192	417	225	1.00446	0.522042
GCA_003676035.1-Fun_NSGQ01000074.1_i000_004791	181	401	220	0.982143	0.436508
GCA_000344635.1-Fun_KB468053.1_i000_006876	182	408	226	1.00893	0.420857
GCA_003014415.1-Fun_PYGM01000032.1_i000_002455	189	414	225	1.00446	0.446429
GCA_008275145.1-Fun_CP043442.1_i000_001305	189	414	225	1.00446	0.446429
GCA_000403535.1-Pla_CM001881.1_i000_009002	188	413	225	1.00446	0.412844
GCA_000348985.1-Fun_HE978315.1_i000_000900	189	415	226	1.00893	0.452906
GCA_001972345.1-Fun_BDGX01000035.1_i000_006822	94	312	218	0.973214	0.494331
GCA_000968595.1-Fun_LASV01000099.1_i000_002431	190	415	225	1.00446	0.259815
GCA_002240705.1-Fun_NPHW01004850.1_i000_004792	190	416	226	1.00893	0.271961
GCA_900617975.1-Ani_UZAE01001155.1_i000_002368	162	387	225	1.00446	0.524476
GCA_014839625.1-Fun_WIWV01000003.1_i000_004170	182	407	225	1.00446	0.394046
GCA_014839855.1-Fun_WIWU01000006.1_i000_006221	182	407	225	1.00446	0.394046
GCA_000209555.1-Ani_FN654536.1_i000_010790	181	402	221	0.986607	0.45102
GCA_003184635.1-Fun_KZ826398.1_i000_010509	182	407	225	1.00446	0.386598
GCA_916048055.1-Pla_CAJZHL010000028.1_i000_006239	187	412	225	1.00446	0.460123
GCA_001189475.1-Fun_LGST01000052.1_i000_005501	189	414	225	1.00446	0.446429
GCA_002759435.2-Fun_PEKT02000007.1_i000_000157	189	414	225	1.00446	0.446429
GCA_002775015.1-Fun_PGLS01000004.1_i000_000654	189	414	225	1.00446	0.446429
GCA_019332045.1-Fun_CP076749.1_i000_001141	189	414	225	1.00446	0.446429
GCA_003013715.2-Fun_CP043531.1_i000_000574	189	414	225	1.00446	0.446429
GCA_007168705.1-Fun_BGOX01000002.1_i000_002492	189	414	225	1.00446	0.446429
GCA_001651435.1-Fun_LHPN01000002.1_i000_003099	182	396	214	0.955357	0.353135
GCA_000151425.1-Fun_GG700648.1_i000_007249	182	396	214	0.955357	0.353719
GCA_000616765.1-Fun_KK204002.1_i000_007522	182	396	214	0.955357	0.353719
GCA_000616805.1-Fun_KK207382.1_i000_007486	182	396	214	0.955357	0.353719
GCA_000616825.1-Fun_KK207919.1_i000_007508	182	396	214	0.955357	0.353719
GCA_000616845.1-Fun_KK208457.1_i000_007457	182	396	214	0.955357	0.353719
GCA_000616905.1-Fun_KK209428.1_i000_007504	182	396	214	0.955357	0.353719
GCA_000616945.1-Fun_KK209950.1_i000_007562	182	396	214	0.955357	0.353719
GCA_000616965.1-Fun_KK210305.1_i000_007338	182	396	214	0.955357	0.353719
GCA_000616985.1-Fun_KK210807.1_i000_007642	182	396	214	0.955357	0.353719
GCA_000622995.1-Fun_AOLB01000308.1_i000_007495	182	396	214	0.955357	0.353719
GCA_000812105.1-Fun_JPGR01000005.1_i000_001058	182	396	214	0.955357	0.353719
GCA_001651445.1-Fun_LHPM01000018.1_i000_003076	182	396	214	0.955357	0.353719
STHE001.0722.00001.C001_01186	160	378	218	0.973214	0.530414
GCA_000237345.1-Fun_HE576752.1_i000_001394	189	415	226	1.00893	0.443137
GCA_000524495.1-Pro_KI965466.1_i000_002170	254	474	220	0.982143	0.402194
GCA_001636815.1-Fun_AZHD01000003.1_i000_005858	195	418	223	0.995536	0.434698
GCA_903064755.1-Fun_CAEFZW010000003.1_i000_001920	189	415	226	1.00893	0.447525
GCA_903987035.1-Fun_CAJDZR010000003.1_i000_002221	189	415	226	1.00893	0.447525
GCA_003676015.1-Fun_NSDU01000013.1_i000_001952	189	414	225	1.00446	0.444664
GCA_019359905.1-Fun_JAENJO010000006.1_i000_002443	181	400	219	0.977679	0.424419
GCA_905231925.1-Pro_CAJNJV010057260.1_i000_038067	550	772	222	0.991071	0.230769
GCA_019279435.1-Pla_JAAALK010000079.1_i000_040488	175	391	216	0.964286	0.232258
GCA_910592345.1-Fun_CAJVPI010000232.1_i000_002815	203	414	211	0.941964	0.307132
GCA_000151505.1-Fun_ACYE01000167.1_i000_004793	264	490	226	1.00893	0.379832
GCA_003611235.1-Fun_MCBS01015976.1_i000_000500	184	401	217	0.96875	0.455882
GCA_000986665.1-Fun_JYKN01002330.1_i000_004910	182	407	225	1.00446	0.385274
GCA_002846915.2-Fun_MSFN02000003.1_i000_004504	182	407	225	1.00446	0.385274
GCA_000986645.1-Fun_JZBS01002119.1_i000_005129	182	407	225	1.00446	0.385274
GCA_013397825.1-Ani_VZRK01000701.1_i000_011753	61	312	251	1.12054	0.551648
GCA_000938715.1-Fun_LN736362.1_i000_001605	96	321	225	1.00446	0.475687
GCA_000006445.2-Fun_CR382139.2_i000_005475	190	415	225	1.00446	0.445545
GCA_001895945.1-Fun_MNAD01000413.1_i000_010142	179	401	222	0.991071	0.395018
GCA_013368375.1-Fun_JAACJP010000022.1_i000_006996	186	411	225	1.00446	0.422932
GCA_001618945.2-Fun_CM038150.1_i000_007237	194	418	224	1	0.440945
GCA_001625195.1-Fun_CM004176.1_i000_005980	194	418	224	1	0.440945
GCA_902141235.2-Fun_CABFOC020000039.1_i000_009378	193	417	224	1	0.357257
GCA_000376725.2-Ani_KZ309230.1_i000_016016	186	373	187	0.834821	0.361004
GCA_000376725.2-Ani_KZ309230.1_i000_016016	361	440	79	0.352679	0.15251
GCA_003184625.1-Fun_KZ821466.1_i000_007258	182	407	225	1.00446	0.388601
GCA_020004485.1-Ani_JAATJU010024516.1_i000_016243	4	190	186	0.830357	0.861111
GCA_002922495.1-Fun_PJQD01000038.1_i000_003766	176	390	214	0.955357	0.39777
GCA_003184925.1-Fun_KZ821614.1_i000_000507	182	407	225	1.00446	0.388601
GCA_001890685.1-Fun_KV878238.1_i000_003305	182	407	225	1.00446	0.388601
GCA_001515345.1-Fun_BCMY01000002.1_i000_001845	182	407	225	1.00446	0.388601
GCA_001890745.1-Fun_KV878198.1_i000_006502	182	407	225	1.00446	0.388601
GCA_003184535.1-Fun_MSFU01000024.1_i000_005136	182	407	225	1.00446	0.388601
GCA_003184835.1-Fun_KZ824575.1_i000_010385	182	407	225	1.00446	0.388601
GCA_013340325.1-Fun_BLWE01000006.1_i000_004514	182	407	225	1.00446	0.388601
GCA_003184755.1-Fun_KZ825057.1_i000_003405	182	407	225	1.00446	0.388601
GCA_019154785.2-Pro_JAGRRH010000001.1_i000_013134	187	424	237	1.05804	0.455769
GCA_001243155.1-Fun_LM651693.1_i000_002589	188	412	224	1	0.478632
GCA_900323505.1-Fun_OOIN01000040.1_i000_012144	188	412	224	1	0.429119
GCA_900231445.1-Pla_LT934113.1_i000_009080	173	397	224	1	0.482759
GCA_903995115.1-Pro_LR877153.1_i000_005221	96	314	218	0.973214	0.643068
GCA_000347455.1-Pla_KD283606.1_i000_023314	150	374	224	1	0.507937
GCA_000585515.1-Fun_AMGW01000004.1_i000_005376	190	416	226	1.00893	0.437137
GCA_000151145.1-Fun_DS995703.1_i000_005347	190	416	226	1.00893	0.435453
ACSU001.0722.00001.C001_01932	153	376	223	0.995536	0.533493
GCA_900074765.1-Fun_LT598489.1_i000_000469	190	415	225	1.00446	0.446429
GCA_000240725.1-Pro_JH470846.1_i000_001235	19	243	224	1	0.722581
GCA_000315915.1-Fun_HE806320.1_i000_003449	190	415	225	1.00446	0.438596
GCA_004802695.1-Fun_SGPK01000298.1_i000_003977	134	358	224	1	0.455285
GCA_001417965.1-Ani_LJWW01000074.1_i000_023135	185	410	225	1.00446	0.402504
GCA_000092065.1-Pla_CP000588.1_i000_003726	187	413	226	1.00893	0.47983
GCA_019154785.2-Pro_JAGRRH010000019.1_i000_012172	187	424	237	1.05804	0.455769
GCA_000239835.2-Fun_DF126451.1_i000_002717	182	407	225	1.00446	0.388601
GCA_001602395.1-Fun_BCWF01000017.1_i000_001764	182	407	225	1.00446	0.388601
GCA_016861625.1-Fun_AP024425.1_i000_000792	182	407	225	1.00446	0.388601
GCA_016865315.1-Fun_AP024434.1_i000_000754	182	407	225	1.00446	0.388601
GCA_002148645.1-Ani_LVZM01004660.1_i000_002718	161	380	219	0.977679	0.447853
GCA_000330505.1-Pro_KB206537.1_i000_005247	179	403	224	1	0.489083
GCA_000182765.2-Fun_HE605202.1_i000_005779	181	400	219	0.977679	0.423598
GCA_014049445.1-Fun_JABWAB010000009.1_i000_004855	181	400	219	0.977679	0.423598
GCA_014049455.1-Fun_JABWAA010000009.1_i000_005053	181	400	219	0.977679	0.423598
GCA_014049495.1-Fun_JABWAC010000009.1_i000_005085	181	400	219	0.977679	0.423598
GCA_014049585.1-Fun_JABVZZ010000010.1_i000_005121	181	400	219	0.977679	0.423598
GCA_903989565.1-Fun_CAJEJE010000008.1_i000_005806	181	400	219	0.977679	0.423598
GCA_000585565.1-Fun_AMGY01000005.1_i000_006635	182	409	227	1.01339	0.358044
GCA_900074725.1-Fun_LT598455.1_i000_002751	190	415	225	1.00446	0.444664
GCA_000165395.2-Pro_CM031753.1_i000_001193	183	400	217	0.96875	0.494305
GCA_020726445.1-Fun_JAGJXA010000005.1_i000_006631	182	388	206	0.919643	0.340496
GCA_001594055.1-Ani_KQ982482.1_i000_005181	237	464	227	1.01339	0.42115
GCA_000226115.1-Fun_CP003014.1_i000_008988	182	388	206	0.919643	0.337152
GCA_900343105.1-Fun_OUUZ01000004.1_i000_005531	182	388	206	0.919643	0.337152
THPI001.0722.00001.C001_00454	147	366	219	0.977679	0.515294
GCA_003709845.1-Fun_QQXO01000012.1_i000_000701	182	411	229	1.02232	0.365231
GCA_000447185.1-Fun_KE647051.1_i000_000416	151	370	219	0.977679	0.540741
GCA_006542485.1-Fun_VIFY01000038.1_i000_005296	182	407	225	1.00446	0.387263
SUOH001.0722.00001.C001_01486	155	378	223	0.995536	0.545232
SUTO001.0722.00001.C001_01439	156	379	223	0.995536	0.543902
GCA_015179015.1-Fun_WHUW01000008.1_i000_017472	186	411	225	1.00446	0.50905
GCA_900106115.1-Fun_LT635756.1_i000_000778	190	415	225	1.00446	0.446429
GCA_900106125.1-Fun_LT635764.1_i000_000815	190	415	225	1.00446	0.446429
GCA_000313485.1-Fun_CAIF01000017.1_i000_005812	190	415	225	1.00446	0.435203
GCA_900002365.1-Fun_LK056670.1_i000_002926	188	412	224	1	0.429942
GCA_019973155.1-Fun_BPQB01000022.1_i000_007752	185	411	226	1.00893	0.424812
GCA_001447935.2-Fun_LMYN01000002.1_i000_000207	190	415	225	1.00446	0.442913
GCA_020536175.1-Fun_JAEUBF010001278.1_i000_004813	190	415	225	1.00446	0.448207
GCA_000569095.1-Pro_CM002467.1_i000_005852	19	243	224	1	0.678788
GCA_002204255.1-Fun_MZNU01000061.1_i000_008194	181	397	216	0.964286	0.31441
GCA_021653875.1-Fun_JAKFRD010000099.1_i000_000085	173	387	214	0.955357	0.515663
GCA_008636195.1-Fun_VXIT01000012.1_i000_002359	191	417	226	1.00893	0.443137
GCA_900169345.1-Fun_FWEW01001418.1_i000_003500	191	417	226	1.00893	0.443137
GCA_003795275.1-Fun_LJZO01000021.1_i000_005041	195	418	223	0.995536	0.427203
GCA_001907595.1-Fun_LFMY01000002.1_i000_001549	184	409	225	1.00446	0.384615
GCA_001792695.1-Fun_LYCR01000157.1_i000_011243	182	407	225	1.00446	0.389273
GCA_003144195.1-Fun_KZ819359.1_i000_001787	190	414	224	1	0.420263
GCA_000976875.3-Fun_CP006385.1_i000_003418	190	416	226	1.00893	0.448413
GCA_001661335.1-Fun_KV454427.1_i000_001337	180	401	221	0.986607	0.429961
GCA_001882365.1-Fun_LVVM01006541.1_i000_013894	185	410	225	1.00446	0.419776
GCA_900617915.1-Ani_UYRT01001655.1_i000_001383	19	240	221	0.986607	0.592493
GCA_000690575.1-Pla_AYPS01000861.1_i000_002079	186	417	231	1.03125	0.354839
GCA_903819495.1-Fun_CAIJDT010000010.1_i000_008261	147	372	225	1.00446	0.481799
GCA_005298045.1-Fun_SWBT01000113.1_i000_006779	187	412	225	1.00446	0.426945
GCA_000773845.1-Fun_AJIQ01000008.1_i000_006104	10	214	204	0.910714	0.521739
GCA_018994095.1-Fun_JAEMWZ010000033.1_i000_009507	193	414	221	0.986607	0.437624
GCA_910591825.1-Fun_CAJVPQ010002229.1_i000_007969	172	391	219	0.977679	0.331316
GCA_000585585.1-Fun_AMWN01000004.1_i000_004641	182	409	227	1.01339	0.360317
GCA_000827185.1-Fun_KN839846.1_i000_006170	185	411	226	1.00893	0.426415
GCA_910591915.1-Fun_CAJVQA010017081.1_i000_014436	154	371	217	0.96875	0.431412
GCA_019426215.1-Pla_CM033391.1_i000_003221	188	413	225	1.00446	0.431034
GCA_014065205.1-Fun_JACCEG010000262.1_i000_004808	181	404	223	0.995536	0.489035
GCA_001642415.1-Fun_LTDK01000181.1_i000_000280	172	388	216	0.964286	0.517986
GCA_011692745.1-Fun_JAACJD010000001.1_i000_000461	190	416	226	1.00893	0.435453
GCA_000835505.1-Fun_KN847321.1_i000_009026	182	410	228	1.01786	0.357928
GCA_001661475.1-Fun_KV453844.1_i000_004542	176	397	221	0.986607	0.418561
THGO001.0722.00001.C001_01449	147	366	219	0.977679	0.51049
GCA_018446385.1-Pla_CM031513.1_i000_020822	188	410	222	0.991071	0.38676
GCA_001889945.1-Fun_KV878680.1_i000_002152	182	407	225	1.00446	0.387263
GCA_002072245.1-Fun_MDYL01000005.1_i000_002256	182	407	225	1.00446	0.394737
GCA_900162805.1-Fun_FUGC01000002.1_i000_002456	99	317	218	0.973214	0.481236
GCA_004193795.1-Ani_QDEB01003290.1_i000_000393	1029	1253	224	1	0.16779
GCA_000150975.2-Fun_DS989822.1_i000_007460	190	416	226	1.00893	0.432122
GCA_000471905.1-Pla_KI393866.1_i000_013811	187	415	228	1.01786	0.410072
GCA_016413885.1-Pla_CM028177.1_i000_024721	187	412	225	1.00446	0.406872
GCA_009193595.1-Fun_ML736175.1_i000_002925	182	407	225	1.00446	0.387931
GCA_016881025.1-Ani_JAESOR010003700.1_i000_018216	184	411	227	1.01339	0.380235
GCA_000835475.1-Fun_KN846986.1_i000_005379	182	396	214	0.955357	0.330247
GCA_000836435.1-Fun_KN848068.1_i000_004593	182	396	214	0.955357	0.327217
GCA_001646985.1-Fun_LVCI01000056.1_i000_006946	182	396	214	0.955357	0.327217
GCA_016097325.1-Fun_JADPPX010000001.1_i000_001898	182	407	225	1.00446	0.388601
GCA_001646965.1-Fun_LVCJ01000023.1_i000_004530	182	395	213	0.950893	0.328704
GCA_000184455.3-Fun_BA000052.1_i000_006378	182	406	224	1	0.387543
GCA_000269785.2-Fun_AKHY01000127.1_i000_004212	182	406	224	1	0.387543
GCA_000691885.1-Fun_AMCJ01000158.1_i000_008960	182	406	224	1	0.387543
GCA_002007945.1-Fun_MKZY01000003.1_i000_003622	182	406	224	1	0.387543
GCA_009176375.1-Fun_ML734689.1_i000_011990	182	406	224	1	0.387543
GCA_004155035.1-Fun_QJOB01000058.1_i000_010212	191	417	226	1.00893	0.439689
GCA_000835455.1-Fun_KN846970.1_i000_003306	182	395	213	0.950893	0.328704
GCA_003184845.1-Fun_KZ824455.1_i000_008188	182	407	225	1.00446	0.385935
GCA_001049375.1-Pro_CDSF01000083.1_i000_003953	189	418	229	1.02232	0.40035
GCA_000223485.1-Fun_GL996505.1_i000_005219	181	401	220	0.982143	0.429688
GCA_003184525.1-Fun_MSFK01000022.1_i000_005224	182	407	225	1.00446	0.385935
GCA_021028975.1-Ani_CM037615.1_i000_003187	165	374	209	0.933036	0.512255
GCA_900088565.1-Pro_FLQU01000288.1_i000_002060	186	410	224	1	0.372093
GCA_900088555.1-Pro_FLQV01000356.1_i000_001871	186	410	224	1	0.371476
GCA_015499995.1-Fun_JADNRV010000053.1_i000_013578	125	351	226	1.00893	0.47479
GCA_900257145.2-Pro_LT990239.1_i000_002347	181	401	220	0.982143	0.469083
GCA_900090035.2-Pro_LT594590.1_i000_001927	186	410	224	1	0.370248
GCA_002105055.1-Fun_MCGR01000018.1_i000_002627	184	409	225	1.00446	0.422139
GCA_903819125.2-Fun_LR813494.2_i000_003650	190	416	226	1.00893	0.448413
GCA_001658105.1-Fun_KV448170.1_i000_003125	185	410	225	1.00446	0.415896
GCA_020726465.1-Fun_JAGIZQ010000006.1_i000_009807	194	419	225	1.00446	0.440313
GCA_022539455.1-Pla_CM039720.1_i000_003099	187	412	225	1.00446	0.409836
GCA_021432635.1-Fun_MU270017.1_i000_001674	194	418	224	1	0.435798
METE001.0722.00001.C001_00447	155	374	219	0.977679	0.534146
GCA_003184595.1-Fun_KZ821338.1_i000_000089	157	382	225	1.00446	0.405405
GCA_002211485.2-Fun_NKJJ02000003.1_i000_005465	182	407	225	1.00446	0.398936
GCA_902825445.1-Ani_CADEBC010000598.1_i000_016484	187	411	224	1	0.489083
GCA_902825455.1-Ani_CADEBD010000290.1_i000_005644	187	411	224	1	0.489083
GCA_003711515.1-Fun_ML119051.1_i000_000248	193	418	225	1.00446	0.436047
GCA_003144115.1-Fun_KZ819305.1_i000_006120	191	411	220	0.982143	0.371622
GCA_000002525.1-Fun_CR382130.1_i000_003251	191	416	225	1.00446	0.441176
GCA_001761485.1-Fun_CP017556.1_i000_004109	191	416	225	1.00446	0.441176
GCA_003367845.1-Fun_KZ857304.1_i000_001339	191	416	225	1.00446	0.441176
GCA_003367865.1-Fun_KZ857342.1_i000_004611	191	416	225	1.00446	0.441176
GCA_003367925.1-Fun_KZ857368.1_i000_005151	191	416	225	1.00446	0.441176
GCA_003367945.1-Fun_KZ858087.1_i000_004880	191	416	225	1.00446	0.441176
GCA_003367965.1-Fun_KZ858657.1_i000_003945	191	416	225	1.00446	0.441176
GCA_003698155.1-Fun_PKSB01000007.1_i000_006112	191	416	225	1.00446	0.441176
GCA_009194645.1-Fun_ML736631.1_i000_004640	191	416	225	1.00446	0.441176
GCA_009372015.1-Fun_ML756029.1_i000_004838	191	416	225	1.00446	0.441176
GCA_014490615.1-Fun_CP061015.1_i000_003239	191	416	225	1.00446	0.441176
GCA_900087985.1-Fun_LT576311.1_i000_000265	191	416	225	1.00446	0.441176
GCA_900537225.1-Fun_UTQH01000004.1_i000_002062	191	416	225	1.00446	0.441176
GCA_010093745.1-Fun_MU005957.1_i000_000083	182	388	206	0.919643	0.353952
GCA_000230395.2-Fun_ACJE01000010.1_i000_005549	182	407	225	1.00446	0.387931
GCA_003344505.1-Fun_KZ851850.1_i000_004343	182	407	225	1.00446	0.387931
GCA_003344705.1-Fun_KZ851967.1_i000_011675	182	407	225	1.00446	0.387931
GCA_003344945.1-Fun_KZ852045.1_i000_006000	182	407	225	1.00446	0.387931
GCA_003850985.1-Fun_BDHI01000001.1_i000_001152	182	407	225	1.00446	0.387931
GCA_900248155.1-Fun_OGUI01000007.1_i000_010113	182	407	225	1.00446	0.387931
GCA_000956085.1-Fun_JZEE01000308.1_i000_002228	182	407	225	1.00446	0.389273
GCA_009176385.1-Fun_ML734946.1_i000_003016	182	407	225	1.00446	0.389273
GCA_009176405.1-Fun_ML733434.1_i000_006863	182	407	225	1.00446	0.389273
GCA_009193505.1-Fun_ML738297.1_i000_001900	182	407	225	1.00446	0.389273
GCA_003324165.2-Pro_PYSW02000005.1_i000_002127	243	466	223	0.995536	0.346273
GCA_009193525.1-Fun_ML741770.1_i000_002781	182	407	225	1.00446	0.389273
GCA_009193545.1-Fun_ML737161.1_i000_008952	182	407	225	1.00446	0.389948
GCA_020726445.1-Fun_JAGJXA010000008.1_i000_009571	195	419	224	1	0.440079
GCA_002749805.1-Fun_NEXV01000672.1_i000_005843	182	407	225	1.00446	0.389273
GCA_001642475.1-Fun_LVKK01000040.1_i000_007332	182	395	213	0.950893	0.328704
GCA_020310725.1-Fun_LGJB01000029.1_i000_011060	182	395	213	0.950893	0.328704
THSI001.0722.00001.C001_00801	147	366	219	0.977679	0.528986
GCA_000211455.3-Ani_ADMH02002125.1_i000_000980	185	410	225	1.00446	0.447316
GCA_910890315.1-Fun_CAJVGD010000042.1_i000_007648	186	414	228	1.01786	0.436782
GCA_000182965.3-Fun_CP017628.1_i000_004282	181	400	219	0.977679	0.424419
GCA_000773725.1-Fun_AJIX01000033.1_i000_003750	181	400	219	0.977679	0.424419
GCA_000773745.1-Fun_AJIU01000026.1_i000_002745	181	400	219	0.977679	0.424419
GCA_000773825.1-Fun_AJJA01000027.1_i000_003307	181	400	219	0.977679	0.424419
GCA_000773845.1-Fun_AJIQ01000031.1_i000_002949	181	400	219	0.977679	0.424419
GCA_000775445.1-Fun_AJIV01000035.1_i000_003303	181	400	219	0.977679	0.424419
GCA_000775455.1-Fun_AJIR01000035.1_i000_003194	181	400	219	0.977679	0.424419
GCA_000775525.1-Fun_AJJC01000035.1_i000_003475	181	400	219	0.977679	0.424419
GCA_000784515.1-Fun_JSXQ01000031.1_i000_002411	181	400	219	0.977679	0.424419
GCA_000784525.1-Fun_JSXP01000026.1_i000_002750	181	400	219	0.977679	0.424419
GCA_000784575.1-Fun_JSXR01000035.1_i000_003665	181	400	219	0.977679	0.424419
GCA_000784695.1-Fun_AJJG01000050.1_i000_001764	181	400	219	0.977679	0.424419
GCA_014049485.1-Fun_JABWAD010000022.1_i000_002115	181	400	219	0.977679	0.424419
GCA_014872705.1-Fun_CM026498.1_i000_007871	185	411	226	1.00893	0.413163
GCA_000784595.1-Fun_JPEV01000034.1_i000_003566	181	400	219	0.977679	0.424419
GCA_000271605.1-Fun_JH717980.1_i000_009597	186	411	225	1.00446	0.40395
GCA_003046715.1-Fun_PTEQ01000304.1_i000_003747	190	416	226	1.00893	0.448413
GCA_000006275.3-Fun_AAIH03000093.1_i000_004120	182	406	224	1	0.387543
GCA_000952835.1-Fun_JZDT01000003.1_i000_006459	182	406	224	1	0.387543
GCA_002443195.2-Fun_NWUI02000282.1_i000_000079	182	406	224	1	0.387543
GCA_002443215.2-Fun_NWUG02001517.1_i000_001512	182	406	224	1	0.387543
GCA_002456175.2-Fun_NWUH02000292.1_i000_007482	182	406	224	1	0.387543
GCA_003709025.1-Fun_QQZZ01000032.1_i000_008204	182	406	224	1	0.387543
GCA_009017415.1-Fun_CP044618.1_i000_007306	182	406	224	1	0.387543
GCA_009176455.1-Fun_ML732764.1_i000_000333	182	406	224	1	0.387543
GCA_014117465.1-Fun_CP059869.1_i000_006439	182	406	224	1	0.387543
GCA_014117485.1-Fun_CP059861.1_i000_006480	182	406	224	1	0.387543
GCA_014784225.2-Fun_CP061807.2_i000_007379	182	406	224	1	0.387543
GCA_000300555.1-Fun_JH971390.1_i000_005337	185	411	226	1.00893	0.410909
GCA_000091205.1-Pro_AP006502.2_i000_004781	182	391	209	0.933036	0.405825
GCA_015039355.1-Fun_MU135458.1_i000_020150	188	413	225	1.00446	0.432692
GCA_002081605.1-Ani_MNPL01001525.1_i000_001359	186	412	226	1.00893	0.44227
GCA_000166175.1-Fun_GL541683.1_i000_003981	180	403	223	0.995536	0.409926
GCA_900120095.1-Fun_FQNC01000086.1_i000_012524	180	403	223	0.995536	0.409174
GCA_019343175.1-Ani_CM033279.1_i000_013228	190	415	225	1.00446	0.324207
GCA_000611835.1-Ani_KK107921.1_i000_015752	191	416	225	1.00446	0.442043
GCA_905332115.1-Ani_CAJOBH010038677.1_i000_028109	49	261	212	0.946429	0.701987
GCA_017309325.2-Fun_JAESVG020000002.1_i000_002138	192	417	225	1.00446	0.406137
GCA_000751015.1-Pla_LK032987.1_i000_044060	348	385	37	0.165179	0.0734127
GCA_000751015.1-Pla_LK032987.1_i000_044060	375	435	60	0.267857	0.119048
GCA_000751015.1-Pla_LK032987.1_i000_044060	426	503	77	0.34375	0.152778
GCA_000328475.2-Fun_CM003161.1_i000_006614	188	412	224	1	0.428298
GCA_000149365.1-Fun_DS981519.1_i000_005147	190	416	226	1.00893	0.448413
GCA_903994225.1-Pro_LR865371.1_i000_002127	185	409	224	1	0.456212
GCA_003426965.1-Fun_QUQM01000007.1_i000_010299	182	407	225	1.00446	0.380711
GCA_004798825.1-Fun_SOSA01000004.1_i000_007668	182	407	225	1.00446	0.380711
GCA_003795315.1-Fun_LKEA01000053.1_i000_008950	195	418	223	0.995536	0.429672
GCA_000149425.1-Fun_CH408157.1_i000_003236	189	414	225	1.00446	0.442043
GCA_001990825.1-Fun_KV907494.1_i000_001688	182	407	225	1.00446	0.436893
GCA_000312925.2-Fun_HE965034.1_i000_000199	187	413	226	1.00893	0.456566
GCA_903994205.1-Pro_LR865387.1_i000_002037	185	409	224	1	0.456212
GCA_001661335.1-Fun_KV454436.1_i000_004989	188	413	225	1.00446	0.442043
GCA_000143365.1-Fun_CH408035.1_i000_000617	194	419	225	1.00446	0.440313
GCA_000978195.2-Fun_CP006429.1_i000_003429	190	416	226	1.00893	0.448413
GCA_000292725.1-Fun_CM001574.1_i000_002204	190	416	226	1.00893	0.450199
GCA_002895965.2-Ani_PIJE02010130.1_i000_032502	1	162	161	0.71875	0.300935
GCA_002895965.2-Ani_PIJE02010130.1_i000_032502	157	244	87	0.388393	0.162617
GCA_903994265.1-Pro_LR865430.1_i000_002249	185	409	224	1	0.456212
GCA_000524515.1-Pro_KI965397.1_i000_001769	185	409	224	1	0.456212
GCA_903994235.1-Pro_LR865414.1_i000_002222	185	409	224	1	0.456212
GCA_903819175.2-Fun_LR813596.2_i000_003650	190	416	226	1.00893	0.449304
GCA_903819205.2-Fun_LR813562.2_i000_003598	190	416	226	1.00893	0.448413
GCA_000146045.2-Fun_BK006945.2_i000_003851	190	416	226	1.00893	0.448413
GCA_000181435.1-Fun_AAFW02000169.1_i000_003731	190	416	226	1.00893	0.448413
GCA_000182175.1-Fun_ABSV01001636.1_i000_003193	190	416	226	1.00893	0.448413
GCA_000182315.2-Fun_ACFL01000004.1_i000_005104	190	416	226	1.00893	0.448413
GCA_000190235.1-Fun_CM001137.1_i000_002479	190	416	226	1.00893	0.448413
GCA_000190255.1-Fun_CM001121.1_i000_002265	190	416	226	1.00893	0.448413
GCA_000269885.1-Fun_CM001533.1_i000_003492	190	416	226	1.00893	0.448413
GCA_000326105.1-Fun_AGVY01000041.1_i000_002810	190	416	226	1.00893	0.448413
GCA_000568005.1-Fun_CM002415.1_i000_003496	190	416	226	1.00893	0.448413
GCA_000568295.1-Fun_CM002343.1_i000_002645	190	416	226	1.00893	0.448413
GCA_000568365.1-Fun_CM002449.1_i000_003195	190	416	226	1.00893	0.448413
GCA_000662435.2-Fun_CP006467.1_i000_003466	190	416	226	1.00893	0.448413
GCA_000975615.2-Fun_CP006438.1_i000_003435	190	416	226	1.00893	0.448413
GCA_000975645.3-Fun_CP004110.1_i000_003439	190	416	226	1.00893	0.448413
GCA_000975705.2-Fun_CP006378.1_i000_003650	190	416	226	1.00893	0.448413
GCA_000975735.4-Fun_CP006435.1_i000_003639	190	416	226	1.00893	0.448413
GCA_000975765.2-Fun_CP006436.1_i000_003439	190	416	226	1.00893	0.448413
GCA_000975855.3-Fun_CP006441.1_i000_003443	190	416	226	1.00893	0.448413
GCA_000975915.2-Fun_CP006443.1_i000_003427	190	416	226	1.00893	0.448413
GCA_000975945.2-Fun_CP006444.1_i000_003438	190	416	226	1.00893	0.448413
GCA_000976035.2-Fun_CP006447.1_i000_003405	190	416	226	1.00893	0.448413
GCA_000976125.2-Fun_CP006450.1_i000_003412	190	416	226	1.00893	0.448413
GCA_000976155.4-Fun_CP006451.1_i000_003374	190	416	226	1.00893	0.448413
GCA_000976185.2-Fun_CP006452.1_i000_003474	190	416	226	1.00893	0.448413
GCA_000976245.2-Fun_CP006454.1_i000_003414	190	416	226	1.00893	0.448413
GCA_000976275.4-Fun_CP006455.1_i000_003451	190	416	226	1.00893	0.448413
GCA_000976305.2-Fun_CP006456.1_i000_003477	190	416	226	1.00893	0.448413
GCA_000976335.2-Fun_CP006457.1_i000_003449	190	416	226	1.00893	0.448413
GCA_000976395.2-Fun_CP006459.1_i000_003625	190	416	226	1.00893	0.448413
GCA_000976425.2-Fun_CP006460.1_i000_003655	190	416	226	1.00893	0.448413
GCA_000976455.3-Fun_CP006461.1_i000_003451	190	416	226	1.00893	0.448413
GCA_000976485.2-Fun_CP006462.1_i000_003618	190	416	226	1.00893	0.448413
GCA_000976515.2-Fun_CP006463.1_i000_003645	190	416	226	1.00893	0.448413
GCA_000976545.2-Fun_CP006464.1_i000_003457	190	416	226	1.00893	0.448413
GCA_000976575.4-Fun_CP006465.1_i000_003652	190	416	226	1.00893	0.448413
GCA_000976605.3-Fun_CP006466.1_i000_003377	190	416	226	1.00893	0.448413
GCA_000976665.2-Fun_CP006468.1_i000_003647	190	416	226	1.00893	0.448413
GCA_000976695.3-Fun_CP006379.1_i000_003349	190	416	226	1.00893	0.448413
GCA_000976725.3-Fun_CP006380.1_i000_003447	190	416	226	1.00893	0.448413
GCA_000976815.3-Fun_CP006383.1_i000_003415	190	416	226	1.00893	0.448413
GCA_000976845.3-Fun_CP006384.1_i000_003408	190	416	226	1.00893	0.448413
GCA_000976935.2-Fun_CP006387.1_i000_003458	190	416	226	1.00893	0.448413
GCA_000977055.3-Fun_CP006391.1_i000_003448	190	416	226	1.00893	0.448413
GCA_000977085.2-Fun_CP006392.1_i000_003472	190	416	226	1.00893	0.448413
GCA_000977145.2-Fun_CP006394.1_i000_003474	190	416	226	1.00893	0.448413
GCA_000977175.3-Fun_CP006395.1_i000_003427	190	416	226	1.00893	0.448413
GCA_000977205.2-Fun_CP006396.1_i000_003462	190	416	226	1.00893	0.448413
GCA_000977235.2-Fun_CP006397.1_i000_003459	190	416	226	1.00893	0.448413
GCA_000977325.2-Fun_CP006400.1_i000_003460	190	416	226	1.00893	0.448413
GCA_000977355.3-Fun_CP006401.1_i000_003486	190	416	226	1.00893	0.448413
GCA_000977415.2-Fun_CP006403.1_i000_003460	190	416	226	1.00893	0.448413
GCA_000977445.2-Fun_CP006404.1_i000_003443	190	416	226	1.00893	0.448413
GCA_000977685.2-Fun_CP006412.1_i000_003481	190	416	226	1.00893	0.448413
GCA_000977715.4-Fun_CP006413.1_i000_003456	190	416	226	1.00893	0.448413
GCA_000977805.2-Fun_CP006416.1_i000_003397	190	416	226	1.00893	0.448413
GCA_000977985.2-Fun_CP006422.1_i000_003405	190	416	226	1.00893	0.448413
GCA_000978075.3-Fun_CP006425.1_i000_003435	190	416	226	1.00893	0.448413
GCA_000978105.2-Fun_CP006426.1_i000_003431	190	416	226	1.00893	0.448413
GCA_000978165.2-Fun_CP006428.1_i000_003545	190	416	226	1.00893	0.448413
GCA_001298375.2-Fun_CM003548.1_i000_003446	190	416	226	1.00893	0.448413
GCA_001413975.1-Fun_CM003566.1_i000_003479	190	416	226	1.00893	0.448413
GCA_002571405.2-Fun_CP046092.1_i000_003767	190	416	226	1.00893	0.448413
GCA_002804325.1-Fun_PEJR01000107.1_i000_000149	190	416	226	1.00893	0.448413
GCA_010356925.1-Fun_CM021138.1_i000_003742	190	416	226	1.00893	0.448413
GCA_010356935.1-Fun_CM021122.1_i000_003706	190	416	226	1.00893	0.448413
GCA_016858165.1-Fun_CM029100.1_i000_003757	190	416	226	1.00893	0.448413
GCA_016858175.1-Fun_CM029084.1_i000_003712	190	416	226	1.00893	0.448413
GCA_905220315.1-Fun_LR999883.1_i000_003680	190	416	226	1.00893	0.448413
GCA_905220325.1-Fun_HG994151.1_i000_003675	190	416	226	1.00893	0.448413
GCA_000975975.3-Fun_CP006445.1_i000_003456	190	416	226	1.00893	0.448413
GCA_000977025.2-Fun_CP006390.1_i000_003408	190	416	226	1.00893	0.448413
GCA_000218975.1-Fun_FN393080.1_i000_003848	190	416	226	1.00893	0.448413
GCA_000260735.1-Fun_DG000048.1_i000_003715	190	416	226	1.00893	0.448413
GCA_000975585.2-Fun_CP006437.1_i000_003411	190	416	226	1.00893	0.448413
GCA_000975675.2-Fun_CP006377.1_i000_003431	190	416	226	1.00893	0.448413
GCA_000975885.2-Fun_CP006442.1_i000_003400	190	416	226	1.00893	0.448413
GCA_000976005.2-Fun_CP006446.1_i000_003415	190	416	226	1.00893	0.448413
GCA_000976095.2-Fun_CP006449.1_i000_003441	190	416	226	1.00893	0.448413
GCA_000976215.2-Fun_CP006453.1_i000_003435	190	416	226	1.00893	0.448413
GCA_000976755.2-Fun_CP006381.1_i000_003474	190	416	226	1.00893	0.448413
GCA_000976785.2-Fun_CP006382.1_i000_003432	190	416	226	1.00893	0.448413
GCA_000976905.2-Fun_CP006386.1_i000_003357	190	416	226	1.00893	0.448413
GCA_000976995.2-Fun_CP006389.1_i000_003482	190	416	226	1.00893	0.448413
GCA_000977115.3-Fun_CP006393.1_i000_003453	190	416	226	1.00893	0.448413
GCA_000977265.3-Fun_CP006398.1_i000_003427	190	416	226	1.00893	0.448413
GCA_000977475.3-Fun_CP006405.1_i000_003467	190	416	226	1.00893	0.448413
GCA_000977505.2-Fun_CP006406.1_i000_003443	190	416	226	1.00893	0.448413
GCA_000977535.2-Fun_CP006407.1_i000_003426	190	416	226	1.00893	0.448413
GCA_000977595.2-Fun_CP006409.1_i000_003444	190	416	226	1.00893	0.448413
GCA_000977625.2-Fun_CP006410.1_i000_003388	190	416	226	1.00893	0.448413
GCA_000977655.2-Fun_CP006411.1_i000_003467	190	416	226	1.00893	0.448413
GCA_000977745.2-Fun_CP006414.1_i000_003437	190	416	226	1.00893	0.448413
GCA_000977775.3-Fun_CP006415.1_i000_003455	190	416	226	1.00893	0.448413
GCA_000977835.2-Fun_CP006417.1_i000_003483	190	416	226	1.00893	0.448413
GCA_000977865.2-Fun_CP006418.1_i000_003421	190	416	226	1.00893	0.448413
GCA_000977925.2-Fun_CP006420.1_i000_003378	190	416	226	1.00893	0.448413
GCA_000977955.2-Fun_CP006421.1_i000_003309	190	416	226	1.00893	0.448413
GCA_000978015.2-Fun_CP006423.1_i000_003414	190	416	226	1.00893	0.448413
GCA_000978045.2-Fun_CP006424.1_i000_003401	190	416	226	1.00893	0.448413
GCA_000978135.2-Fun_CP006427.1_i000_003441	190	416	226	1.00893	0.448413
GCA_000978225.2-Fun_CP006430.1_i000_003648	190	416	226	1.00893	0.448413
GCA_000978255.2-Fun_CP006431.1_i000_003465	190	416	226	1.00893	0.448413
GCA_000978315.2-Fun_CP006433.1_i000_003435	190	416	226	1.00893	0.448413
GCA_000978345.2-Fun_CP006434.1_i000_003417	190	416	226	1.00893	0.448413
GCA_001983315.1-Fun_MQVN01000034.1_i000_002858	190	416	226	1.00893	0.448413
GCA_002335645.1-Fun_BEGW01000011.1_i000_003643	190	416	226	1.00893	0.448413
GCA_003046695.1-Fun_PTEP01000031.1_i000_003140	190	416	226	1.00893	0.448413
GCA_003046745.1-Fun_PTER01000019.1_i000_001625	190	416	226	1.00893	0.448413
GCA_009014655.1-Fun_BKZN01000043.1_i000_002991	190	416	226	1.00893	0.448413
GCA_011022315.1-Fun_CP048993.1_i000_003344	190	416	226	1.00893	0.448413
GCA_012275245.1-Fun_WMJW01000052.1_i000_006372	190	416	226	1.00893	0.448413
GCA_014132375.1-Fun_BLZP01000004.1_i000_001862	190	416	226	1.00893	0.448413
GCA_014132395.1-Fun_BLZQ01000004.1_i000_001753	190	416	226	1.00893	0.448413
GCA_014905575.1-Fun_BNHH01000089.1_i000_003893	190	416	226	1.00893	0.448413
GCA_903819135.2-Fun_LR813545.2_i000_003692	190	416	226	1.00893	0.448413
GCA_903819145.2-Fun_LR813528.2_i000_003641	190	416	226	1.00893	0.448413
GCA_903819155.2-Fun_LR813511.2_i000_003686	190	416	226	1.00893	0.448413
GCA_000981605.1-Fun_HF936128.1_i000_010823	181	406	225	1.00446	0.439453
GCA_010093995.1-Fun_ML992514.1_i000_008421	192	417	225	1.00446	0.405405
GCA_000325965.1-Fun_ADVV01000063.1_i000_002398	190	416	226	1.00893	0.448413
GCA_000326005.1-Fun_AEEZ01000066.1_i000_002206	190	416	226	1.00893	0.448413
GCA_903819195.2-Fun_LR813613.2_i000_003594	190	416	226	1.00893	0.448413
GCA_900095555.1-Pro_LT608175.1_i000_001784	185	409	224	1	0.456212
GCA_900095605.1-Pro_LT608161.1_i000_001872	185	409	224	1	0.456212
GCA_019202705.1-Fun_JAGSYN010000117.1_i000_001798	190	415	225	1.00446	0.446429
GCA_900002335.2-Pro_LK022886.2_i000_002141	185	409	224	1	0.456212
GCA_019202705.1-Fun_JAGSYN010000178.1_i000_002705	181	401	220	0.982143	0.42065
GCA_902459845.2-Pro_CABPSV020000014.1_i000_000185	185	410	225	1.00446	0.387263
GCA_900095565.1-Pro_LT608203.1_i000_001890	185	409	224	1	0.456212
GCA_900095625.1-Pro_LT608189.1_i000_001886	185	409	224	1	0.456212
GCA_000978285.2-Fun_CP006432.1_i000_003551	190	416	226	1.00893	0.443137
GCA_000975795.2-Fun_CP006439.1_i000_003411	190	416	226	1.00893	0.448413
GCA_000976365.2-Fun_CP006458.1_i000_003390	190	416	226	1.00893	0.448413
GCA_000976965.3-Fun_CP006388.1_i000_003411	190	416	226	1.00893	0.448413
GCA_002079055.1-Fun_CP020253.1_i000_003547	190	416	226	1.00893	0.448413
GCA_001602025.1-Pro_CM003865.1_i000_002193	181	401	220	0.982143	0.469083
GCA_900240055.1-Pro_LT969447.1_i000_002332	181	401	220	0.982143	0.469083
GCA_014925795.1-Fun_WIQF01000036.1_i000_010570	193	418	225	1.00446	0.389273
GCA_004104545.1-Ani_SAUD01000793.1_i000_001413	209	433	224	1	0.436647
GCA_001708105.1-Fun_CP014586.1_i000_003782	190	415	225	1.00446	0.453629
GCA_000827275.1-Fun_KN833715.1_i000_006880	18	243	225	1.00446	0.842697
GCA_000975825.2-Fun_CP006440.1_i000_003461	190	416	226	1.00893	0.448413
GCA_001235845.1-Pro_LFNC01000057.1_i000_000831	158	380	222	0.991071	0.526066
GCA_003184865.1-Fun_KZ824326.1_i000_010125	182	407	225	1.00446	0.382003
GCA_016413895.1-Pla_CM028163.1_i000_024996	187	412	225	1.00446	0.406872
GCA_001402995.1-Fun_CCBN010000005.1_i000_002288	181	402	221	0.986607	0.426641
GCA_014596635.1-Fun_QQZJ01000118.1_i000_000519	181	402	221	0.986607	0.426641
GCA_013365045.1-Fun_QQZM01000037.1_i000_002797	181	402	221	0.986607	0.421756
GCA_013365125.1-Fun_QQZK01000121.1_i000_000643	181	402	221	0.986607	0.421756
GCA_013305595.1-Fun_QQZN01000013.1_i000_000782	181	402	221	0.986607	0.424184
GCA_013365075.1-Fun_QQZL01000105.1_i000_000202	181	402	221	0.986607	0.424184
GCA_013365065.1-Fun_QQZO01000018.1_i000_001604	181	402	221	0.986607	0.421756
GCA_020360975.1-Fun_JAIZPD010000016.1_i000_010580	194	418	224	1	0.438356
THPE003.0722.00001.C001_00627	147	366	219	0.977679	0.514085
GCA_013398155.1-Ani_VZRU01017503.1_i000_010811	115	343	228	1.01786	0.463415
GCA_003184765.1-Fun_KZ824941.1_i000_002699	182	407	225	1.00446	0.382653
GCA_001890905.1-Fun_KV878970.1_i000_000706	182	407	225	1.00446	0.382653
GCA_003184695.1-Fun_KZ825319.1_i000_002288	182	407	225	1.00446	0.382653
GCA_003184825.1-Fun_KZ824645.1_i000_005816	182	407	225	1.00446	0.382653
GCA_009193445.1-Fun_ML743571.1_i000_005731	182	407	225	1.00446	0.390625
GCA_900097015.1-Pro_LT969419.1_i000_002308	181	401	220	0.982143	0.469083
GCA_009193485.1-Fun_ML738674.1_i000_009233	182	407	225	1.00446	0.389273
GCA_009193585.1-Fun_ML737594.1_i000_003263	182	407	225	1.00446	0.389273
GCA_009193665.1-Fun_ML735723.1_i000_005209	182	407	225	1.00446	0.389273
GCA_000223485.1-Fun_GL996500.1_i000_001301	189	414	225	1.00446	0.450902
GCA_001204775.2-Fun_JNOM01000146.1_i000_006044	182	407	225	1.00446	0.389273
GCA_009176395.1-Fun_ML734298.1_i000_007184	182	407	225	1.00446	0.389273
GCA_009193645.1-Fun_ML736765.1_i000_005400	182	407	225	1.00446	0.389273
GCA_000976065.2-Fun_CP006448.1_i000_003476	190	416	226	1.00893	0.448413
GCA_000977895.2-Fun_CP006419.1_i000_003387	190	416	226	1.00893	0.448413
GCA_000181695.1-Fun_AAYY01000006.1_i000_002445	1	126	125	0.558036	0.39185
GCA_003795295.1-Fun_LKEB01000100.1_i000_009748	195	418	223	0.995536	0.348983
GCA_000150975.2-Fun_DS989822.1_i000_008222	182	396	214	0.955357	0.353135
GCA_902651935.1-Pla_CACRSJ010000110.1_i000_023447	148	368	220	0.982143	0.532688
GCA_002554575.1-Fun_KZ301990.1_i000_003634	185	411	226	1.00893	0.402135
GCA_002335675.1-Pla_BEGY01000179.1_i000_012964	141	366	225	1.00446	0.51963
GCA_003711565.2-Ani_CM011072.1_i000_005141	185	352	167	0.745536	0.283051
GCA_003711565.2-Ani_CM011072.1_i000_005141	349	435	86	0.383929	0.145763
GCA_003184585.1-Fun_KZ821292.1_i000_009843	182	407	225	1.00446	0.382653
GCA_910592285.1-Fun_CAJVQC010041822.1_i000_016740	116	305	189	0.84375	0.388889
GCA_900100905.1-Fun_FMWP01000010.1_i000_002194	180	398	218	0.973214	0.4
INUZ001.0722.00001.C001_01667	161	380	219	0.977679	0.534146
GCA_001020605.1-Fun_KQ085967.1_i000_007824	185	410	225	1.00446	0.418994
GCA_001185155.1-Pla_LFYR01000182.1_i000_001757	225	445	220	0.982143	0.375427
GCA_003676015.1-Fun_NSDU01000013.1_i000_001968	181	401	220	0.982143	0.43222
GCA_005498985.1-Fun_CM016681.1_i000_006077	188	412	224	1	0.429119
GCA_011022315.1-Fun_CP049009.1_i000_008959	191	416	225	1.00446	0.448207
GCA_003184745.1-Fun_KZ821693.1_i000_004567	182	407	225	1.00446	0.382653
GCA_001298625.1-Fun_CM003577.1_i000_003544	191	416	225	1.00446	0.445545
GCA_003788595.2-Fun_ML120358.1_i000_001811	181	404	223	0.995536	0.206673
GCA_003672135.1-Ani_CM010856.1_i000_000660	189	415	226	1.00893	0.465021
GCA_000190215.1-Fun_CM001105.1_i000_002369	191	416	225	1.00446	0.414365
GCA_002895985.1-Fun_NKHZ01000011.1_i000_005041	192	417	225	1.00446	0.404676
GCA_001661395.1-Fun_KV454539.1_i000_001812	181	401	220	0.982143	0.422265
GCA_001691785.2-Fun_JNHV02000271.1_i000_005017	185	411	226	1.00893	0.407942
GCA_002117355.1-Fun_KZ110613.1_i000_011680	185	411	226	1.00893	0.465979
GCA_015832375.1-Fun_JADOXO010000058.1_i000_008682	185	411	226	1.00893	0.465979
GCA_004155035.1-Fun_QJOB01000135.1_i000_002321	182	399	217	0.96875	0.355738
GCA_020499695.1-Fun_JAIBRY010000106.1_i000_000616	182	407	225	1.00446	0.380711
GCA_020499715.1-Fun_JAIBSB010000115.1_i000_001048	182	407	225	1.00446	0.380711
GCA_020500065.1-Fun_JAIBRT010000107.1_i000_000399	182	407	225	1.00446	0.380711
GCA_020500485.1-Fun_JAIBSZ010000114.1_i000_000987	182	407	225	1.00446	0.380711
GCA_020501335.1-Fun_JAIBUN010000137.1_i000_001572	182	407	225	1.00446	0.380711
GCA_020501555.1-Fun_JAIBVA010000134.1_i000_001433	182	407	225	1.00446	0.380711
GCA_020501615.1-Fun_JAIBVD010000138.1_i000_001696	182	407	225	1.00446	0.380711
GCA_020501895.1-Fun_JAIBVQ010000114.1_i000_000827	182	407	225	1.00446	0.380711
GCA_020501935.1-Fun_JAIBVT010000057.1_i000_007124	182	407	225	1.00446	0.380711
GCA_020502035.1-Fun_JAIBVY010000135.1_i000_001636	182	407	225	1.00446	0.380711
GCA_020502245.1-Fun_JAIBWI010000137.1_i000_001510	182	407	225	1.00446	0.380711
GCA_020502375.1-Fun_JAIBWN010000125.1_i000_001153	182	407	225	1.00446	0.380711
GCA_020502575.1-Fun_JAIBWW010000132.1_i000_001417	182	407	225	1.00446	0.380711
GCA_020502625.1-Fun_JAIBXA010000128.1_i000_001233	182	407	225	1.00446	0.380711
GCA_020502985.1-Fun_JAIBXH010000131.1_i000_001310	182	407	225	1.00446	0.380711
GCA_020503345.1-Fun_JAIBXZ010000133.1_i000_001413	182	407	225	1.00446	0.380711
GCA_020503435.1-Fun_JAIBYE010000119.1_i000_000962	182	407	225	1.00446	0.380711
GCA_020498875.1-Fun_JAIBPW010000129.1_i000_001420	182	407	225	1.00446	0.381356
GCA_020499135.1-Fun_JAIBQJ010000140.1_i000_001706	182	407	225	1.00446	0.381356
GCA_020500165.1-Fun_JAIBRW010000137.1_i000_001526	182	407	225	1.00446	0.381356
GCA_020500935.1-Fun_JAIBTU010000109.1_i000_000647	182	407	225	1.00446	0.381356
GCA_020500965.1-Fun_JAIBTW010000144.1_i000_001971	182	407	225	1.00446	0.381356
GCA_020501325.1-Fun_JAIBUL010000131.1_i000_001412	182	407	225	1.00446	0.381356
GCA_020501445.1-Fun_JAIBUU010000138.1_i000_001650	182	407	225	1.00446	0.381356
GCA_020502185.1-Fun_JAIBWF010000138.1_i000_001533	182	407	225	1.00446	0.381356
GCA_020502495.1-Fun_JAIBWT010000125.1_i000_001164	182	407	225	1.00446	0.381356
GCA_020502545.1-Fun_JAIBWV010000136.1_i000_001545	182	407	225	1.00446	0.381356
GCA_020502595.1-Fun_JAIBWX010000128.1_i000_001243	182	407	225	1.00446	0.381356
GCA_020503365.1-Fun_JAIBYA010000136.1_i000_001523	182	407	225	1.00446	0.381356
GCA_000002655.1-Fun_CM000171.1_i000_004407	182	407	225	1.00446	0.380711
GCA_000150145.1-Fun_DS499596.1_i000_005359	182	407	225	1.00446	0.380711
GCA_000731615.1-Fun_JHOI01000605.1_i000_006421	182	407	225	1.00446	0.380711
GCA_002234955.1-Fun_NKHT01000219.1_i000_003562	182	407	225	1.00446	0.380711
GCA_002234985.1-Fun_NKHS01000215.1_i000_003267	182	407	225	1.00446	0.380711
GCA_012656115.1-Fun_JAAAQC010000212.1_i000_003078	182	407	225	1.00446	0.380711
GCA_012656125.1-Fun_JAAAQD010000204.1_i000_003057	182	407	225	1.00446	0.380711
GCA_012656165.1-Fun_JAAAQB010000215.1_i000_002573	182	407	225	1.00446	0.380711
GCA_012656185.1-Fun_JAAAQA010000762.1_i000_007986	182	407	225	1.00446	0.380711
GCA_012656215.1-Fun_JAAAPZ010000125.1_i000_000664	182	407	225	1.00446	0.380711
GCA_020498725.1-Fun_JAIBPO010000001.1_i000_000017	182	407	225	1.00446	0.380711
GCA_020498735.1-Fun_JAIBPN010000117.1_i000_000783	182	407	225	1.00446	0.380711
GCA_020498745.1-Fun_JAIBPM010000127.1_i000_001146	182	407	225	1.00446	0.380711
GCA_020498755.1-Fun_JAIBPP010000026.1_i000_003738	182	407	225	1.00446	0.380711
GCA_020498765.1-Fun_JAIBPQ010000120.1_i000_000897	182	407	225	1.00446	0.380711
GCA_020498805.1-Fun_JAIBPR010000135.1_i000_001627	182	407	225	1.00446	0.380711
GCA_020498815.1-Fun_JAIBPS010000141.1_i000_002014	182	407	225	1.00446	0.380711
GCA_020498865.1-Fun_JAIBPV010000135.1_i000_001593	182	407	225	1.00446	0.380711
GCA_020498885.1-Fun_JAIBPT010000014.1_i000_001496	182	407	225	1.00446	0.380711
GCA_020498895.1-Fun_JAIBPU010000117.1_i000_000744	182	407	225	1.00446	0.380711
GCA_020498905.1-Fun_JAIBPX010000128.1_i000_001459	182	407	225	1.00446	0.380711
GCA_020498945.1-Fun_JAIBPY010000004.1_i000_005922	182	407	225	1.00446	0.380711
GCA_020498965.1-Fun_JAIBPZ010000248.1_i000_004443	182	407	225	1.00446	0.380711
GCA_020498985.1-Fun_JAIBQA010000120.1_i000_001128	182	407	225	1.00446	0.380711
GCA_020499005.1-Fun_JAIBQC010000145.1_i000_001896	182	407	225	1.00446	0.380711
GCA_020499015.1-Fun_JAIBQB010000115.1_i000_000958	182	407	225	1.00446	0.380711
GCA_020499035.1-Fun_JAIBQD010000048.1_i000_006744	182	407	225	1.00446	0.380711
GCA_020499045.1-Fun_JAIBQE010000129.1_i000_001143	182	407	225	1.00446	0.380711
GCA_020499075.1-Fun_JAIBQF010000130.1_i000_001346	182	407	225	1.00446	0.380711
GCA_020499115.1-Fun_JAIBQG010000191.1_i000_003208	182	407	225	1.00446	0.380711
GCA_020499125.1-Fun_JAIBQH010000132.1_i000_001363	182	407	225	1.00446	0.380711
GCA_020499155.1-Fun_JAIBQK010000106.1_i000_000450	182	407	225	1.00446	0.380711
GCA_020499185.1-Fun_JAIBQL010000128.1_i000_001195	182	407	225	1.00446	0.380711
GCA_020499195.1-Fun_JAIBQM010000128.1_i000_001187	182	407	225	1.00446	0.380711
GCA_020499225.1-Fun_JAIBQN010000118.1_i000_000945	182	407	225	1.00446	0.380711
GCA_020499245.1-Fun_JAIBQI010000550.1_i000_007488	182	407	225	1.00446	0.380711
GCA_020499255.1-Fun_JAIBQP010000127.1_i000_001149	182	407	225	1.00446	0.380711
GCA_020499265.1-Fun_JAIBQO010000123.1_i000_001148	182	407	225	1.00446	0.380711
GCA_020499315.1-Fun_JAIBQQ010000147.1_i000_001896	182	407	225	1.00446	0.380711
GCA_020499325.1-Fun_JAIBQS010000132.1_i000_001408	182	407	225	1.00446	0.380711
GCA_020499335.1-Fun_JAIBQT010000136.1_i000_001508	182	407	225	1.00446	0.380711
GCA_020499355.1-Fun_JAIBQU010000137.1_i000_001184	182	407	225	1.00446	0.380711
GCA_020499395.1-Fun_JAIBQV010000116.1_i000_000764	182	407	225	1.00446	0.380711
GCA_020499405.1-Fun_JAIBQW010000075.1_i000_008443	182	407	225	1.00446	0.380711
GCA_020499415.1-Fun_JAIBQX010000134.1_i000_001515	182	407	225	1.00446	0.380711
GCA_020499455.1-Fun_JAIBQY010000015.1_i000_001841	182	407	225	1.00446	0.380711
GCA_020499475.1-Fun_JAIBQZ010000130.1_i000_001227	182	407	225	1.00446	0.380711
GCA_020499485.1-Fun_JAIBRA010000140.1_i000_001731	182	407	225	1.00446	0.380711
GCA_020499495.1-Fun_JAIBRB010000132.1_i000_001283	182	407	225	1.00446	0.380711
GCA_020499505.1-Fun_JAIBRC010000189.1_i000_002969	182	407	225	1.00446	0.380711
GCA_020499565.1-Fun_JAIBRD010000126.1_i000_001166	182	407	225	1.00446	0.380711
GCA_020499575.1-Fun_JAIBRE010000130.1_i000_001371	182	407	225	1.00446	0.380711
GCA_020499585.1-Fun_JAIBRG010000139.1_i000_001578	182	407	225	1.00446	0.380711
GCA_020499595.1-Fun_JAIBRF010000092.1_i000_009035	182	407	225	1.00446	0.380711
GCA_020499605.1-Fun_JAIBRI010000134.1_i000_001500	182	407	225	1.00446	0.380711
GCA_020499645.1-Fun_JAIBRJ010000140.1_i000_001699	182	407	225	1.00446	0.380711
GCA_020499675.1-Fun_JAIBRZ010000047.1_i000_006280	182	407	225	1.00446	0.380711
GCA_020499685.1-Fun_JAIBSA010000098.1_i000_009217	182	407	225	1.00446	0.380711
GCA_020499755.1-Fun_JAIBSC010000036.1_i000_005229	182	407	225	1.00446	0.380711
GCA_020499775.1-Fun_JAIBSD010000118.1_i000_000965	182	407	225	1.00446	0.380711
GCA_020499785.1-Fun_JAIBSE010000097.1_i000_009436	182	407	225	1.00446	0.380711
GCA_020499805.1-Fun_JAIBSF010000048.1_i000_006294	182	407	225	1.00446	0.380711
GCA_020499815.1-Fun_JAIBSG010000001.1_i000_000176	182	407	225	1.00446	0.380711
GCA_020499825.1-Fun_JAIBSH010000119.1_i000_001194	182	407	225	1.00446	0.380711
GCA_020499865.1-Fun_JAIBSI010000117.1_i000_000982	182	407	225	1.00446	0.380711
GCA_020499885.1-Fun_JAIBRH010000140.1_i000_001723	182	407	225	1.00446	0.380711
GCA_020499905.1-Fun_JAIBRK010000116.1_i000_001015	182	407	225	1.00446	0.380711
GCA_020499915.1-Fun_JAIBRL010000112.1_i000_000892	182	407	225	1.00446	0.380711
GCA_020499935.1-Fun_JAIBRM010000010.1_i000_000238	182	407	225	1.00446	0.380711
GCA_020499975.1-Fun_JAIBRN010000126.1_i000_001383	182	407	225	1.00446	0.380711
GCA_020499985.1-Fun_JAIBRO010000138.1_i000_001797	182	407	225	1.00446	0.380711
GCA_020499995.1-Fun_JAIBRP010000132.1_i000_001611	182	407	225	1.00446	0.380711
GCA_020500025.1-Fun_JAIBRQ010000110.1_i000_000642	182	407	225	1.00446	0.380711
GCA_020500075.1-Fun_JAIBRR010000056.1_i000_007361	182	407	225	1.00446	0.380711
GCA_020500085.1-Fun_JAIBRS010000155.1_i000_002282	182	407	225	1.00446	0.380711
GCA_020500105.1-Fun_JAIBRU010000128.1_i000_001249	182	407	225	1.00446	0.380711
GCA_020500115.1-Fun_JAIBRV010000133.1_i000_001699	182	407	225	1.00446	0.380711
GCA_020500185.1-Fun_JAIBSL010000008.1_i000_008346	182	407	225	1.00446	0.380711
GCA_020500195.1-Fun_JAIBRX010000126.1_i000_001246	182	407	225	1.00446	0.380711
GCA_020500205.1-Fun_JAIBSJ010000008.1_i000_008513	182	407	225	1.00446	0.380711
GCA_020500215.1-Fun_JAIBSK010000070.1_i000_007979	182	407	225	1.00446	0.380711
GCA_020500235.1-Fun_JAIBSM010000243.1_i000_004345	182	407	225	1.00446	0.380711
GCA_020500275.1-Fun_JAIBSO010000009.1_i000_009092	182	407	225	1.00446	0.380711
GCA_020500285.1-Fun_JAIBSP010000068.1_i000_007783	182	407	225	1.00446	0.380711
GCA_020500295.1-Fun_JAIBSN010000007.1_i000_007857	182	407	225	1.00446	0.380711
GCA_020500305.1-Fun_JAIBSQ010000097.1_i000_009193	182	407	225	1.00446	0.380711
GCA_020500355.1-Fun_JAIBSS010000038.1_i000_005349	182	407	225	1.00446	0.380711
GCA_020500365.1-Fun_JAIBSR010000147.1_i000_002076	182	407	225	1.00446	0.380711
GCA_020500385.1-Fun_JAIBST010000060.1_i000_007287	182	407	225	1.00446	0.380711
GCA_020500395.1-Fun_JAIBSU010000106.1_i000_000519	182	407	225	1.00446	0.380711
GCA_020500445.1-Fun_JAIBSV010000128.1_i000_001469	182	407	225	1.00446	0.380711
GCA_020500455.1-Fun_JAIBSW010000139.1_i000_001805	182	407	225	1.00446	0.380711
GCA_020500465.1-Fun_JAIBSY010000134.1_i000_001708	182	407	225	1.00446	0.380711
GCA_020500475.1-Fun_JAIBSX010000006.1_i000_007049	182	407	225	1.00446	0.380711
GCA_020500535.1-Fun_JAIBTB010000019.1_i000_003302	182	407	225	1.00446	0.380711
GCA_020500545.1-Fun_JAIBTC010000010.1_i000_000163	182	407	225	1.00446	0.380711
GCA_020500555.1-Fun_JAIBTD010000004.1_i000_005783	182	407	225	1.00446	0.380711
GCA_020500565.1-Fun_JAIBTE010000141.1_i000_001859	182	407	225	1.00446	0.380711
GCA_020500595.1-Fun_JAIBTF010000112.1_i000_000874	182	407	225	1.00446	0.380711
GCA_020500605.1-Fun_JAIBTG010000009.1_i000_009100	182	407	225	1.00446	0.380711
GCA_020500645.1-Fun_JAIBTH010000046.1_i000_006000	182	407	225	1.00446	0.380711
GCA_020500655.1-Fun_JAIBTI010000054.1_i000_006690	182	407	225	1.00446	0.380711
GCA_020500685.1-Fun_JAIBTJ010000065.1_i000_007672	182	407	225	1.00446	0.380711
GCA_020500695.1-Fun_JAIBTK010000004.1_i000_005476	182	407	225	1.00446	0.380711
GCA_020500705.1-Fun_JAIBTL010000056.1_i000_006926	182	407	225	1.00446	0.380711
GCA_020500765.1-Fun_JAIBTA010000113.1_i000_000922	182	407	225	1.00446	0.380711
GCA_020500775.1-Fun_JAIBTM010000108.1_i000_000667	182	407	225	1.00446	0.380711
GCA_020500785.1-Fun_JAIBTN010000061.1_i000_007321	182	407	225	1.00446	0.380711
GCA_020500805.1-Fun_JAIBTO010000002.1_i000_003238	182	407	225	1.00446	0.380711
GCA_020500815.1-Fun_JAIBTP010000002.1_i000_003155	182	407	225	1.00446	0.380711
GCA_020500845.1-Fun_JAIBTQ010000038.1_i000_005148	182	407	225	1.00446	0.380711
GCA_020500865.1-Fun_JAIBTS010000123.1_i000_001418	182	407	225	1.00446	0.380711
GCA_020500875.1-Fun_JAIBTR010000066.1_i000_007644	182	407	225	1.00446	0.380711
GCA_020500905.1-Fun_JAIBTT010000057.1_i000_006755	182	407	225	1.00446	0.380711
GCA_020500945.1-Fun_JAIBTV010000143.1_i000_001878	182	407	225	1.00446	0.380711
GCA_020500975.1-Fun_JAIBTX010000016.1_i000_002202	182	407	225	1.00446	0.380711
GCA_020500995.1-Fun_JAIBTY010000119.1_i000_000915	182	407	225	1.00446	0.380711
GCA_020501005.1-Fun_JAIBTZ010000165.1_i000_002584	182	407	225	1.00446	0.380711
GCA_020501045.1-Fun_JAIBUA010000035.1_i000_005934	182	407	225	1.00446	0.380711
GCA_020501075.1-Fun_JAIBUB010000138.1_i000_001662	182	407	225	1.00446	0.380711
GCA_020501095.1-Fun_JAIBUC010000139.1_i000_001648	182	407	225	1.00446	0.380711
GCA_020501105.1-Fun_JAIBUE010000044.1_i000_006048	182	407	225	1.00446	0.380711
GCA_020501115.1-Fun_JAIBUD010000122.1_i000_000947	182	407	225	1.00446	0.380711
GCA_020501135.1-Fun_JAIBUF010000139.1_i000_001605	182	407	225	1.00446	0.380711
GCA_020501145.1-Fun_JAIBUG010000031.1_i000_005264	182	407	225	1.00446	0.380711
GCA_020501175.1-Fun_JAIBUH010000080.1_i000_008863	182	407	225	1.00446	0.380711
GCA_020501185.1-Fun_JAIBUI010000013.1_i000_001515	182	407	225	1.00446	0.380711
GCA_020501235.1-Fun_JAIBUJ010000118.1_i000_000746	182	407	225	1.00446	0.380711
GCA_020501245.1-Fun_JAIBUK010000145.1_i000_001860	182	407	225	1.00446	0.380711
GCA_020501255.1-Fun_JAIBUO010000124.1_i000_001132	182	407	225	1.00446	0.380711
GCA_020501265.1-Fun_JAIBUM010000130.1_i000_001573	182	407	225	1.00446	0.380711
GCA_020501345.1-Fun_JAIBUP010000144.1_i000_001733	182	407	225	1.00446	0.380711
GCA_020501355.1-Fun_JAIBUQ010000039.1_i000_005903	182	407	225	1.00446	0.380711
GCA_020501375.1-Fun_JAIBUR010000013.1_i000_001242	182	407	225	1.00446	0.380711
GCA_020501405.1-Fun_JAIBUS010000010.1_i000_000246	182	407	225	1.00446	0.380711
GCA_020501425.1-Fun_JAIBUT010000121.1_i000_001262	182	407	225	1.00446	0.380711
GCA_020501465.1-Fun_JAIBUV010000138.1_i000_001483	182	407	225	1.00446	0.380711
GCA_020501475.1-Fun_JAIBUX010000126.1_i000_001172	182	407	225	1.00446	0.380711
GCA_020501495.1-Fun_JAIBUW010000158.1_i000_002444	182	407	225	1.00446	0.380711
GCA_020501535.1-Fun_JAIBUY010000044.1_i000_006224	182	407	225	1.00446	0.380711
GCA_020501545.1-Fun_JAIBUZ010000123.1_i000_001012	182	407	225	1.00446	0.380711
GCA_020501575.1-Fun_JAIBVB010000137.1_i000_001674	182	407	225	1.00446	0.380711
GCA_020501605.1-Fun_JAIBVC010000130.1_i000_001607	182	407	225	1.00446	0.380711
GCA_020501635.1-Fun_JAIBVE010000064.1_i000_007598	182	407	225	1.00446	0.380711
GCA_020501645.1-Fun_JAIBVF010000135.1_i000_001618	182	407	225	1.00446	0.380711
GCA_020501695.1-Fun_JAIBVG010000147.1_i000_001855	182	407	225	1.00446	0.380711
GCA_020501705.1-Fun_JAIBVI010000130.1_i000_001308	182	407	225	1.00446	0.380711
GCA_020501715.1-Fun_JAIBVH010000140.1_i000_001666	182	407	225	1.00446	0.380711
GCA_020501735.1-Fun_JAIBVJ010000134.1_i000_001427	182	407	225	1.00446	0.380711
GCA_020501765.1-Fun_JAIBVK010000006.1_i000_007555	182	407	225	1.00446	0.380711
GCA_020501785.1-Fun_JAIBVL010000134.1_i000_001461	182	407	225	1.00446	0.380711
GCA_020501805.1-Fun_JAIBVM010000136.1_i000_001570	182	407	225	1.00446	0.380711
GCA_020501815.1-Fun_JAIBVO010000137.1_i000_001651	182	407	225	1.00446	0.380711
GCA_020501835.1-Fun_JAIBVN010000124.1_i000_001133	182	407	225	1.00446	0.380711
GCA_020501875.1-Fun_JAIBVP010000136.1_i000_001581	182	407	225	1.00446	0.380711
GCA_020501885.1-Fun_JAIBVR010000138.1_i000_001613	182	407	225	1.00446	0.380711
GCA_020501905.1-Fun_JAIBVS010000032.1_i000_005821	182	407	225	1.00446	0.380711
GCA_020501985.1-Fun_JAIBVU010000132.1_i000_001559	182	407	225	1.00446	0.380711
GCA_020501995.1-Fun_JAIBVV010000135.1_i000_001664	182	407	225	1.00446	0.380711
GCA_020502005.1-Fun_JAIBVW010000047.1_i000_006388	182	407	225	1.00446	0.380711
GCA_020502025.1-Fun_JAIBVX010000139.1_i000_001710	182	407	225	1.00446	0.380711
GCA_020502045.1-Fun_JAIBVZ010000108.1_i000_000617	182	407	225	1.00446	0.380711
GCA_020502095.1-Fun_JAIBWA010000115.1_i000_000985	182	407	225	1.00446	0.380711
GCA_020502105.1-Fun_JAIBWB010000059.1_i000_007241	182	407	225	1.00446	0.380711
GCA_020502115.1-Fun_JAIBWC010000126.1_i000_001128	182	407	225	1.00446	0.380711
GCA_020502125.1-Fun_JAIBWD010000084.1_i000_008704	182	407	225	1.00446	0.380711
GCA_020502165.1-Fun_JAIBWE010000132.1_i000_001414	182	407	225	1.00446	0.380711
GCA_020502215.1-Fun_JAIBWG010000143.1_i000_001782	182	407	225	1.00446	0.380711
GCA_020502225.1-Fun_JAIBWH010000125.1_i000_001110	182	407	225	1.00446	0.380711
GCA_020502235.1-Fun_JAIBWJ010000195.1_i000_003324	182	407	225	1.00446	0.380711
GCA_020502325.1-Fun_JAIBWK010000136.1_i000_001511	182	407	225	1.00446	0.380711
GCA_020502335.1-Fun_JAIBWL010000136.1_i000_001489	182	407	225	1.00446	0.380711
GCA_020502365.1-Fun_JAIBWM010000125.1_i000_001094	182	407	225	1.00446	0.380711
GCA_020502385.1-Fun_JAIBWO010000678.1_i000_007913	182	407	225	1.00446	0.380711
GCA_020502425.1-Fun_JAIBWP010000053.1_i000_007105	182	407	225	1.00446	0.380711
GCA_020502435.1-Fun_JAIBWQ010000095.1_i000_009250	182	407	225	1.00446	0.380711
GCA_020502455.1-Fun_JAIBWR010000120.1_i000_000922	182	407	225	1.00446	0.380711
GCA_020502485.1-Fun_JAIBWS010000077.1_i000_008542	182	407	225	1.00446	0.380711
GCA_020502525.1-Fun_JAIBWU010000123.1_i000_000986	182	407	225	1.00446	0.380711
GCA_020502605.1-Fun_JAIBWY010000191.1_i000_003045	182	407	225	1.00446	0.380711
GCA_020502615.1-Fun_JAIBWZ010000013.1_i000_001369	182	407	225	1.00446	0.380711
GCA_020502675.1-Fun_JAIBXB010000027.1_i000_004571	182	407	225	1.00446	0.380711
GCA_020502695.1-Fun_JAIBXC010000138.1_i000_001726	182	407	225	1.00446	0.380711
GCA_020502705.1-Fun_JAIBXD010000130.1_i000_001285	182	407	225	1.00446	0.380711
GCA_020502715.1-Fun_JAIBXE010000128.1_i000_001219	182	407	225	1.00446	0.380711
GCA_020502725.1-Fun_JAIBXF010000122.1_i000_000984	182	407	225	1.00446	0.380711
GCA_020502875.1-Fun_JAIBXG010000131.1_i000_001270	182	407	225	1.00446	0.380711
GCA_020502995.1-Fun_JAIBXI010000128.1_i000_001142	182	407	225	1.00446	0.380711
GCA_020503015.1-Fun_JAIBXJ010000092.1_i000_009154	182	407	225	1.00446	0.380711
GCA_020503055.1-Fun_JAIBXK010000120.1_i000_000894	182	407	225	1.00446	0.380711
GCA_020503065.1-Fun_JAIBXL010000131.1_i000_001473	182	407	225	1.00446	0.380711
GCA_020503085.1-Fun_JAIBXM010000121.1_i000_000943	182	407	225	1.00446	0.380711
GCA_020503095.1-Fun_JAIBXN010000125.1_i000_001123	182	407	225	1.00446	0.380711
GCA_020503105.1-Fun_JAIBXO010000138.1_i000_001592	182	407	225	1.00446	0.380711
GCA_020503165.1-Fun_JAIBXQ010000104.1_i000_000422	182	407	225	1.00446	0.380711
GCA_020503175.1-Fun_JAIBXP010000125.1_i000_001241	182	407	225	1.00446	0.380711
GCA_020503185.1-Fun_JAIBXR010000133.1_i000_001448	182	407	225	1.00446	0.380711
GCA_020503195.1-Fun_JAIBXT010000143.1_i000_001641	182	407	225	1.00446	0.380711
GCA_020503205.1-Fun_JAIBXS010000134.1_i000_001380	182	407	225	1.00446	0.380711
GCA_020503245.1-Fun_JAIBXU010000026.1_i000_004453	182	407	225	1.00446	0.380711
GCA_020503265.1-Fun_JAIBXV010000126.1_i000_001108	182	407	225	1.00446	0.380711
GCA_020503275.1-Fun_JAIBXW010000133.1_i000_001327	182	407	225	1.00446	0.380711
GCA_020503295.1-Fun_JAIBXX010000593.1_i000_007321	182	407	225	1.00446	0.380711
GCA_020503305.1-Fun_JAIBXY010000096.1_i000_009160	182	407	225	1.00446	0.380711
GCA_020503375.1-Fun_JAIBYB010000137.1_i000_001585	182	407	225	1.00446	0.380711
GCA_020503395.1-Fun_JAIBYC010000025.1_i000_004193	182	407	225	1.00446	0.380711
GCA_020503445.1-Fun_JAIBYF010000142.1_i000_001847	182	407	225	1.00446	0.380711
GCA_020503455.1-Fun_JAIBYD010000141.1_i000_001694	182	407	225	1.00446	0.380711
GCA_020503465.1-Fun_JAIBYG010000023.1_i000_003799	182	407	225	1.00446	0.380711
GCA_020503515.1-Fun_JAIBYH010000021.1_i000_003495	182	407	225	1.00446	0.380711
GCA_020503535.1-Fun_JAIBYI010000082.1_i000_008910	182	407	225	1.00446	0.380711
GCA_020503545.1-Fun_JAIBYK010000129.1_i000_001209	182	407	225	1.00446	0.380711
GCA_020503555.1-Fun_JAIBYJ010000131.1_i000_001302	182	407	225	1.00446	0.380711
GCA_020503565.1-Fun_JAIBYL010000120.1_i000_000870	182	407	225	1.00446	0.380711
GCA_020503595.1-Fun_JAIBYM010000138.1_i000_001507	182	407	225	1.00446	0.380711
GCA_020503635.1-Fun_JAIBYN010000118.1_i000_000733	182	407	225	1.00446	0.380711
GCA_020503645.1-Fun_JAIBYO010000117.1_i000_000833	182	407	225	1.00446	0.380711
GCA_020503665.1-Fun_JAIBYP010000142.1_i000_001622	182	407	225	1.00446	0.380711
GCA_020503705.1-Fun_JAIBYQ010000144.1_i000_001820	182	407	225	1.00446	0.380711
GCA_020503715.1-Fun_JAIBYR010000125.1_i000_001066	182	407	225	1.00446	0.380711
GCA_020503725.1-Fun_JAIBYS010000138.1_i000_001555	182	407	225	1.00446	0.380711
GCA_020503735.1-Fun_JAIBYT010000035.1_i000_005101	182	407	225	1.00446	0.380711
GCA_020503745.1-Fun_JAIBYU010000135.1_i000_001516	182	407	225	1.00446	0.380711
GCA_020503795.1-Fun_JAIBYX010000053.1_i000_006979	182	407	225	1.00446	0.380711
GCA_020503805.1-Fun_JAIBYW010000130.1_i000_001294	182	407	225	1.00446	0.380711
GCA_020503815.1-Fun_JAIBYV010000141.1_i000_001721	182	407	225	1.00446	0.380711
GCA_020503825.1-Fun_JAIBYY010000136.1_i000_001668	182	407	225	1.00446	0.380711
GCA_020503885.1-Fun_JAIBYZ010000136.1_i000_001809	182	407	225	1.00446	0.380711
GCA_020503895.1-Fun_JAIBZA010000137.1_i000_001671	182	407	225	1.00446	0.380711
GCA_020503905.1-Fun_JAIBZB010000140.1_i000_001910	182	407	225	1.00446	0.380711
GCA_020503915.1-Fun_JAIBZC010000140.1_i000_001800	182	407	225	1.00446	0.380711
GCA_020503935.1-Fun_JAIBZD010000011.1_i000_000569	182	407	225	1.00446	0.380711
GCA_020510485.1-Fun_JAIBQR010000138.1_i000_001643	182	407	225	1.00446	0.380711
GCA_001029325.1-Fun_KQ087362.1_i000_003038	182	407	225	1.00446	0.380711
GCA_011074865.2-Fun_CP064812.1_i000_000355	190	415	225	1.00446	0.431862
GCA_001447455.1-Ani_JYDL01000144.1_i000_002208	182	402	220	0.982143	0.302613
GCA_016618255.1-Pla_VFSX01000041.1_i000_001156	187	410	223	0.995536	0.468487
GCA_001661255.1-Fun_KV454211.1_i000_003616	191	416	225	1.00446	0.446429
GCA_900088555.1-Pro_FLQV01001490.1_i000_005240	181	401	220	0.982143	0.456432
GCA_900088565.1-Pro_FLQU01000223.1_i000_001589	181	401	220	0.982143	0.456432
GCA_900090035.2-Pro_FLRI01000560.1_i000_006233	181	401	220	0.982143	0.456432
GCA_016906555.1-Fun_CP059642.1_i000_000770	180	400	220	0.982143	0.171073
GCA_002591405.1-Fun_NJEU01000001.1_i000_000006	182	388	206	0.919643	0.332258
GCA_012182645.1-Fun_JAATJQ010000145.1_i000_001218	182	396	214	0.955357	0.35082
GCA_012182655.1-Fun_JAAQVJ010000152.1_i000_001347	182	396	214	0.955357	0.35082
GCA_019359935.1-Fun_JAADCK010000150.1_i000_001396	182	396	214	0.955357	0.35082
GCA_000616785.1-Fun_KK204674.1_i000_004569	182	396	214	0.955357	0.35082
GCA_000622975.1-Fun_AOKY01000337.1_i000_005258	182	396	214	0.955357	0.35082
GCA_000151175.1-Fun_DS995748.1_i000_003137	182	396	214	0.955357	0.35082
GCA_000151455.1-Fun_GG698510.1_i000_002560	182	396	214	0.955357	0.35082
GCA_000006445.2-Fun_CR382139.2_i000_005499	181	400	219	0.977679	0.423598
GCA_013358455.1-Pla_JABWDY010008420.1_i000_006241	158	371	213	0.950893	0.385172
GCA_900005855.1-Pro_CVMV01000059.1_i000_004936	186	410	224	1	0.403604
GCA_900102585.1-Fun_FMWQ01000035.1_i000_006539	206	424	218	0.973214	0.381786
GCA_900097035.1-Pro_LT969559.1_i000_002219	181	401	220	0.982143	0.469083
GCA_014904895.1-Fun_MU125070.1_i000_013948	185	411	226	1.00893	0.424015
GCA_019973955.1-Ani_BMAV01028207.1_i000_051317	127	347	220	0.982143	0.574413
THKO001.0722.00001.C001_00188	147	366	219	0.977679	0.521429
GCA_000818155.1-Fun_CM003099.1_i000_002503	195	418	223	0.995536	0.428846
GCA_000499545.1-Pro_HG673815.1_i000_001252	201	426	225	1.00446	0.416667
GCA_018360225.1-Fun_SRPW01001007.1_i000_003551	535	760	225	1.00446	0.290698
GCA_008704415.1-Fun_VXIS01000292.1_i000_006146	182	406	224	1	0.410256
GCA_000968595.1-Fun_LASV01000095.1_i000_002371	182	408	226	1.00893	0.370492
GCA_017635955.1-Fun_JAAQQV010000005.1_i000_005358	191	416	225	1.00446	0.445545
GCA_002156985.1-Ani_KZ149936.1_i000_010238	186	411	225	1.00446	0.48913
GCA_000003195.3-Pla_CM000761.3_i000_009895	187	412	225	1.00446	0.39823
GCA_015952705.1-Pla_CM027681.1_i000_010086	187	412	225	1.00446	0.39823
GCA_000723685.1-Pro_HG810771.1_i000_002898	181	401	220	0.982143	0.469083
GCA_001601855.1-Pro_CM003851.1_i000_002126	181	401	220	0.982143	0.469083
GCA_900097025.1-Pro_LT969573.1_i000_002583	181	401	220	0.982143	0.469083
GCA_000585535.1-Fun_AMGX01000035.1_i000_012586	182	396	214	0.955357	0.330247
GCA_000002765.3-Pro_LN999944.1_i000_002547	181	401	220	0.982143	0.469083
GCA_000149665.2-Pro_CH671979.1_i000_002440	181	401	220	0.982143	0.469083
GCA_000150435.3-Pro_KE123618.1_i000_002820	181	401	220	0.982143	0.469083
GCA_000150455.3-Pro_KE123495.1_i000_002726	181	401	220	0.982143	0.469083
GCA_000401695.2-Pro_KE123814.1_i000_002758	181	401	220	0.982143	0.469083
GCA_000401715.2-Pro_KE124574.1_i000_002835	181	401	220	0.982143	0.469083
GCA_000521015.1-Pro_KI925079.1_i000_002741	181	401	220	0.982143	0.469083
GCA_000521035.1-Pro_KI925546.1_i000_002743	181	401	220	0.982143	0.469083
GCA_000521055.1-Pro_KI926414.1_i000_002789	181	401	220	0.982143	0.469083
GCA_000521075.1-Pro_KI926048.1_i000_002895	181	401	220	0.982143	0.469083
GCA_000521095.1-Pro_KI927303.1_i000_001275	181	401	220	0.982143	0.469083
GCA_000521115.1-Pro_KI927515.1_i000_002717	181	401	220	0.982143	0.469083
GCA_000521155.1-Pro_KI927891.1_i000_001800	181	401	220	0.982143	0.469083
GCA_002831795.1-Pro_NYMT01000016.1_i000_004583	181	401	220	0.982143	0.469083
GCA_012898025.1-Pro_QFXU01000017.1_i000_003020	181	401	220	0.982143	0.469083
GCA_900095595.1-Pro_LT963423.1_i000_002617	181	401	220	0.982143	0.469083
GCA_000151125.2-Fun_ABSU01000024.1_i000_001986	239	453	214	0.955357	0.323263
GCA_000149425.1-Fun_CH408157.1_i000_003220	181	401	220	0.982143	0.436508
GCA_015883425.1-Ani_JADDUC010000013.1_i000_001663	6	188	182	0.8125	0.52149
GCA_019623705.1-Fun_WSTJ01000001.1_i000_000042	1	208	207	0.924107	0.550532
GCA_000813385.1-Fun_KN714745.1_i000_007634	195	418	223	0.995536	0.429672
GCA_002901185.1-Fun_NRSZ01000655.1_i000_000899	194	418	224	1	0.435798
GCA_900000165.1-Fun_CCYA01000217.1_i000_001655	447	671	224	1	0.283544
GCA_000313485.1-Fun_CAIF01000076.1_i000_003833	181	400	219	0.977679	0.427734
GCA_903064755.1-Fun_CAEFZW010000002.1_i000_000815	181	401	220	0.982143	0.434783
GCA_003184705.1-Fun_KZ825118.1_i000_003616	182	407	225	1.00446	0.383305
GCA_003184685.1-Fun_KZ825591.1_i000_010400	182	407	225	1.00446	0.382653
GCA_002072405.1-Fun_MDDG01000008.1_i000_006541	182	407	225	1.00446	0.390625
GCA_903064755.1-Fun_CAEFZW010000002.1_i000_001097	181	401	220	0.982143	0.434783
GCA_903987035.1-Fun_CAJDZR010000002.1_i000_001711	181	401	220	0.982143	0.434783
GCA_003013795.1-Fun_NHZQ01000087.1_i000_007879	192	417	225	1.00446	0.401786
GCA_903987035.1-Fun_CAJDZR010000002.1_i000_001107	181	401	220	0.982143	0.434783
GCA_003184785.1-Fun_KZ824775.1_i000_002461	182	407	225	1.00446	0.382653
GCA_005382405.1-Fun_PTQR01000039.1_i000_004528	192	417	225	1.00446	0.401786
GCA_001594065.1-Ani_KQ977126.1_i000_003524	18	245	227	1.01339	0.707165
GCA_001645015.2-Fun_LWDF02000240.1_i000_003937	190	414	224	1	0.416357
GCA_009428345.1-Fun_RDSI01000130.1_i000_001179	190	414	224	1	0.416357
GCA_009428365.1-Fun_RDSJ01000347.1_i000_005578	190	414	224	1	0.416357
GCA_001645055.2-Fun_LWDG02000071.1_i000_006822	190	414	224	1	0.416357
GCA_009428295.1-Fun_RDSH01000110.1_i000_000483	190	414	224	1	0.416357
GCA_001984395.2-Fun_CP019499.1_i000_007179	99	317	218	0.973214	0.481236
GCA_000442575.2-Pro_ATMG01006551.1_i000_010349	190	420	230	1.02679	0.484211
GCA_903995115.1-Pro_LR877173.1_i000_010278	190	420	230	1.02679	0.484211
GCA_019364595.1-Fun_JAHRGV010000065.1_i000_006975	186	411	225	1.00446	0.402504
GCA_020310465.1-Fun_JAHSQE010000018.1_i000_004077	186	411	225	1.00446	0.395431
GCA_000530735.1-Fun_CBTC010000099.1_i000_007733	99	317	218	0.973214	0.481236
SUSP017.0722.00001.C001_01443	156	380	224	1	0.543689
SUSP018.0722.00001.C001_02547	156	380	224	1	0.543689
GCA_000616865.1-Fun_KK208920.1_i000_007512	182	396	214	0.955357	0.353719
GCA_010458925.1-Pla_CM021240.1_i000_038199	188	420	232	1.03571	0.412078
GCA_022496225.1-Fun_WTXE01000054.1_i000_009680	174	390	216	0.964286	0.412214
GCA_900088485.1-Pro_FLRD01000079.1_i000_002479	186	410	224	1	0.370248
GCA_900088545.1-Pro_FLRE01000104.1_i000_002471	186	410	224	1	0.370248
GCA_021018615.1-Fun_JAEVFL010000007.1_i000_007796	186	412	226	1.00893	0.388985
GCA_900090025.2-Pro_LT594513.1_i000_001788	186	410	224	1	0.368421
GCA_000977295.2-Fun_CP006399.1_i000_003448	190	416	226	1.00893	0.448413
GCA_000182985.1-Fun_ACOL01000064.1_i000_001271	151	370	219	0.977679	0.539409
GCA_000988165.1-Fun_JPQZ01000019.1_i000_000871	151	370	219	0.977679	0.539409
GCA_004919615.1-Fun_SMUP01000067.1_i000_002093	151	370	219	0.977679	0.539409
GCA_001636715.1-Fun_AZGZ01000014.1_i000_001334	182	409	227	1.01339	0.393414
GCA_003144125.1-Fun_KZ819191.1_i000_003003	188	412	224	1	0.419476
GCA_000165395.2-Pro_AAXT02000005.1_i000_003385	185	408	223	0.995536	0.391916
ACSP061.0722.00001.C001_02821	152	374	222	0.991071	0.541463
GCA_905332125.1-Ani_CAJOBJ010064450.1_i000_031595	186	398	212	0.946429	0.531328
GCA_000004155.2-Fun_KE546988.1_i000_001268	187	412	225	1.00446	0.448207
GCA_000344655.2-Fun_KE504124.1_i000_001157	186	411	225	1.00446	0.423729
GCA_019924265.1-Fun_JAHFXL010000053.1_i000_005405	182	409	227	1.01339	0.353033
GCA_000230625.1-Fun_JH226131.1_i000_001864	182	409	227	1.01339	0.353033
GCA_000002545.2-Fun_CR380955.2_i000_002898	180	401	221	0.986607	0.430799
GCA_010111755.1-Fun_CP048126.1_i000_002931	180	401	221	0.986607	0.430799
GCA_020797185.1-Fun_CM036839.1_i000_002940	180	401	221	0.986607	0.430799
GCA_020797325.1-Fun_CM036847.1_i000_002930	180	401	221	0.986607	0.430799
GCA_001466565.1-Fun_LMAB01000021.1_i000_000560	180	401	221	0.986607	0.430799
GCA_001466565.1-Fun_LMAB01000099.1_i000_001861	180	401	221	0.986607	0.430799
GCA_001466685.1-Fun_LMAY01000102.1_i000_001758	180	401	221	0.986607	0.430799
GCA_002219185.1-Fun_CM008089.1_i000_003039	180	401	221	0.986607	0.430799
GCA_002219195.1-Fun_CM008103.1_i000_003037	180	401	221	0.986607	0.430799
GCA_020450195.1-Fun_CP053494.1_i000_002742	180	401	221	0.986607	0.430799
GCA_020450215.1-Fun_CP053520.1_i000_002740	180	401	221	0.986607	0.430799
GCA_020450235.1-Fun_CP053533.1_i000_002740	180	401	221	0.986607	0.430799
GCA_020450265.1-Fun_CP060151.1_i000_002739	180	401	221	0.986607	0.430799
GCA_021605115.1-Pla_BMAR01000006.1_i000_004359	186	410	224	1	0.444444
GCA_020797215.1-Fun_JAGTTU010000019.1_i000_002938	180	401	221	0.986607	0.430799
GCA_020797225.1-Fun_JAGTTX010000015.1_i000_002942	180	401	221	0.986607	0.430799
GCA_020797355.1-Fun_JAGTUA010000015.1_i000_002920	180	401	221	0.986607	0.430799
GCA_014217725.1-Fun_CP048238.1_i000_002728	180	401	221	0.986607	0.430799
GCA_900096545.1-Fun_FMSJ01000051.1_i000_005024	180	401	221	0.986607	0.430799
GCA_900166875.1-Fun_FWDN01000051.1_i000_003257	180	401	221	0.986607	0.430799
GCA_020797195.1-Fun_CM036810.1_i000_002742	180	401	221	0.986607	0.429961
GCA_020797205.1-Fun_JAGTTV010000019.1_i000_002931	180	401	221	0.986607	0.429961
GCA_001890105.1-Fun_KV878348.1_i000_007470	182	407	225	1.00446	0.385274
INLU001.0722.00001.C001_01135	162	381	219	0.977679	0.535452
THGA001.0722.00001.C001_00481	147	366	219	0.977679	0.518957
GCA_000709005.1-Pro_KL446949.1_i000_002818	185	409	224	1	0.456212
GCA_900681995.1-Pro_LR215065.1_i000_001957	185	409	224	1	0.456212
GCA_001466525.1-Fun_LLWO01000048.1_i000_002852	180	401	221	0.986607	0.429961
GCA_001466535.1-Fun_LMAA01000076.1_i000_003085	180	401	221	0.986607	0.429961
GCA_001466575.1-Fun_LLZY01000077.1_i000_003741	180	401	221	0.986607	0.429961
GCA_001466635.1-Fun_LLZZ01000114.1_i000_002353	180	401	221	0.986607	0.429961
GCA_000006335.3-Fun_GG692404.1_i000_005862	190	415	225	1.00446	0.444664
GCA_017315405.1-Fun_JAFIQD010000004.1_i000_003713	190	415	225	1.00446	0.444664
GCA_001594075.1-Ani_KQ978782.1_i000_002095	250	477	227	1.01339	0.410488
GCA_001950575.1-Fun_BDGI01000123.1_i000_002921	188	413	225	1.00446	0.455466
GCA_020379485.1-Pla_JAGKQM010002591.1_i000_095093	197	421	224	1	0.494481
GCA_000709005.1-Pro_KL446946.1_i000_001400	181	402	221	0.986607	0.471215
GCA_900681995.1-Pro_LR215068.1_i000_003275	181	402	221	0.986607	0.471215
GCA_000827325.1-Fun_KN832873.1_i000_005271	181	400	219	0.977679	0.322533
GCA_000977385.2-Fun_CP006402.1_i000_003432	190	416	226	1.00893	0.448413
GCA_000977565.2-Fun_CP006408.1_i000_003263	190	416	226	1.00893	0.448413
GCA_001634645.1-Fun_CM004305.1_i000_004043	190	416	226	1.00893	0.448413
GCA_001563735.1-Fun_KQ962655.1_i000_008413	185	394	209	0.933036	0.51861
GCA_015039365.1-Fun_WION01000002.1_i000_005292	184	375	191	0.852679	0.381238
GCA_011074885.2-Fun_CP063136.1_i000_003505	102	327	225	1.00446	0.471698
GCA_000968615.1-Fun_LAEV01000214.1_i000_000726	192	418	226	1.00893	0.449304
GCA_019049425.1-Fun_JAHMUF010000022.1_i000_002534	181	401	220	0.982143	0.433071
GCA_021927905.1-Pro_BLLK01000029.1_i000_005132	197	434	237	1.05804	0.454894
GCA_018994095.1-Fun_JAEMWZ010000033.1_i000_009508	181	401	220	0.982143	0.248588
GCA_013305805.1-Fun_QVQA01000278.1_i000_002302	181	402	221	0.986607	0.426641
GCA_001691755.2-Fun_JNHY02000053.1_i000_005897	186	411	225	1.00446	0.464876
GCA_018446385.1-Pla_CM031510.1_i000_010524	188	410	222	0.991071	0.505695
GCA_001278495.1-Fun_LGSR01000022.1_i000_002788	197	422	225	1.00446	0.428571
GCA_003851025.1-Fun_BFAD01000005.1_i000_006116	185	411	226	1.00893	0.417745
GCA_002317995.1-Fun_MVNX01000153.1_i000_010730	181	397	216	0.964286	0.340157
FEFO001.0722.00001.C001_01216	159	380	221	0.986607	0.522459
GCA_014180765.2-Pla_MUAA02000157.1_i000_017233	186	411	225	1.00446	0.39267
GCA_001653205.1-Fun_LSBH01000010.1_i000_010611	194	418	224	1	0.436647
GCA_001653265.1-Fun_LSBI01000002.1_i000_002068	194	418	224	1	0.436647
GCA_000147195.1-Ani_GL452434.1_i000_012955	159	384	225	1.00446	0.487013
GCA_900412535.3-Pla_LS974624.2_i000_036984	908	1083	175	0.78125	0.147059
GCA_002926055.1-Fun_PKFO01000003.1_i000_002035	190	415	225	1.00446	0.443787
GCA_012184645.1-Fun_WYDC01000035.1_i000_003149	190	415	225	1.00446	0.443787
GCA_012184655.1-Fun_WYDD01000023.1_i000_002432	190	415	225	1.00446	0.443787
GCA_016767475.1-Fun_MU179396.1_i000_014041	185	411	226	1.00893	0.417745
GCA_000190715.1-Pro_GL871008.1_i000_003509	182	407	225	1.00446	0.416667
GCA_016584175.1-Fun_PUHR01000088.1_i000_005143	181	401	220	0.982143	0.5
GCA_016584175.1-Fun_PUHR01000223.1_i000_002271	181	401	220	0.982143	0.5
GCA_000585515.1-Fun_AMGW01000005.1_i000_007630	182	393	211	0.941964	0.316342
GCA_017607565.1-Ani_JAANIB010005791.1_i000_004160	237	464	227	1.01339	0.42115
GCA_001633055.2-Fun_LKCN02000016.1_i000_002565	194	417	223	0.995536	0.436399
GCA_002317995.1-Fun_MVNX01000092.1_i000_008153	181	397	216	0.964286	0.339623
GCA_013305925.1-Fun_QVTG01000160.1_i000_000574	181	402	221	0.986607	0.425
GCA_000271585.1-Fun_JH711787.1_i000_005695	185	409	224	1	0.414048
GCA_020536065.1-Fun_JAEUBE010000487.1_i000_002061	190	415	225	1.00446	0.455466
GCA_016809505.1-Fun_CP050673.1_i000_000575	189	414	225	1.00446	0.446429
GCA_001561935.1-Fun_LHQR01000069.1_i000_006632	182	406	224	1	0.390925
GCA_020736575.1-Fun_JAGPYM010000003.1_i000_008397	181	389	208	0.928571	0.354344
GCA_000365165.2-Fun_KB822703.1_i000_003353	182	393	211	0.941964	0.316342
GCA_001742945.1-Pla_DF973517.1_i000_022145	5	58	53	0.236607	0.360544
GCA_001742945.1-Pla_DF973517.1_i000_022145	56	83	27	0.120536	0.183673
GCA_001742945.1-Pla_DF973517.1_i000_022145	80	142	62	0.276786	0.421769
GCA_014176185.1-Fun_JABCYO010000002.1_i000_000141	102	327	225	1.00446	0.471698
GCA_003611195.1-Fun_MCBQ01001930.1_i000_000740	184	401	217	0.96875	0.340125
GCA_016584175.1-Fun_PUHR01000260.1_i000_002680	114	334	220	0.982143	0.5
GCA_003032435.1-Pla_KZ772741.1_i000_011699	186	411	225	1.00446	0.393357
GCA_009936355.2-Pla_AP019867.1_i000_005231	186	411	225	1.00446	0.393357
GCA_000150035.1-Fun_DS480396.1_i000_003582	181	401	220	0.982143	0.428016
GCA_000204515.1-Ani_GL888624.1_i000_012360	237	464	227	1.01339	0.42115
GCA_017607455.1-Ani_JAANHZ010000868.1_i000_004390	237	464	227	1.01339	0.42115
GCA_000320605.2-Fun_KB445793.1_i000_002895	186	412	226	1.00893	0.427221
GCA_001700775.1-Fun_LGRB01000014.1_i000_008193	182	393	211	0.941964	0.316342
GCA_001078395.2-Fun_BBXM02000002.1_i000_003055	182	407	225	1.00446	0.381356
GCA_003144605.1-Fun_LCWV01000006.1_i000_010866	225	449	224	1	0.411765
GCA_010723835.1-Fun_BLKC01000029.1_i000_004872	182	407	225	1.00446	0.380711
GCA_010724135.1-Fun_BLKE01000140.1_i000_006799	182	407	225	1.00446	0.380711
GCA_010724255.1-Fun_BLKF01000035.1_i000_004740	182	407	225	1.00446	0.380711
GCA_010724335.1-Fun_BLKG01000070.1_i000_006247	182	407	225	1.00446	0.380711
GCA_010724795.1-Fun_BLKK01000081.1_i000_004265	182	407	225	1.00446	0.380711
GCA_010093785.1-Fun_MU003849.1_i000_009157	194	418	224	1	0.407273
GCA_016858145.1-Pla_JAEHOE010000008.1_i000_003111	187	410	223	0.995536	0.44334
GCA_010093895.1-Fun_ML996083.1_i000_003675	192	417	225	1.00446	0.389273
GCA_015844325.1-Fun_VCAU01000009.1_i000_012417	182	406	224	1	0.386874
GCA_019096155.1-Fun_JAHCVI010000001.1_i000_004047	195	419	224	1	0.435798
GCA_000227115.2-Fun_HE580267.1_i000_000177	189	415	226	1.00893	0.449304
GCA_001447565.1-Ani_JYDW01000125.1_i000_001190	182	401	219	0.977679	0.20977
GCA_003611215.1-Fun_MCBR01018006.1_i000_004773	184	401	217	0.96875	0.340659
GCA_011692745.1-Fun_JAACJD010000001.1_i000_000950	182	396	214	0.955357	0.355482
GCA_001447435.1-Ani_JYDK01000141.1_i000_007781	182	401	219	0.977679	0.194321
GCA_001594045.1-Ani_KQ976490.1_i000_006122	212	439	227	1.01339	0.441634
GCA_003086715.1-Fun_MBFS01003796.1_i000_007023	19	226	207	0.924107	0.896104
GCA_006912115.1-Fun_VCMJ01000117.1_i000_000400	184	401	217	0.96875	0.340659
GCA_002007995.1-Fun_MSRZ01000009.1_i000_004984	190	415	225	1.00446	0.438596
GCA_002008065.1-Fun_MSSA01000044.1_i000_003820	190	415	225	1.00446	0.438596
GCA_002008085.1-Fun_MSSD01000016.1_i000_001324	190	415	225	1.00446	0.438596
GCA_002008095.1-Fun_MSSC01000050.1_i000_004232	190	415	225	1.00446	0.438596
GCA_000230245.1-Fun_FQ311444.1_i000_006482	188	412	224	1	0.425047
GCA_002102555.1-Fun_MCFL01000008.1_i000_011809	183	404	221	0.986607	0.435039
GCA_000311805.2-Ani_KB017491.1_i000_015004	136	333	197	0.879464	0.494975
GCA_019426215.1-Pla_CM033405.1_i000_024380	36	132	96	0.428571	0.32107
GCA_019426215.1-Pla_CM033405.1_i000_024380	124	223	99	0.441964	0.331104
GCA_900162835.1-Fun_LT795075.1_i000_000258	188	412	224	1	0.434951
GCA_001641455.1-Pla_LVLJ01002571.1_i000_006001	232	457	225	1.00446	0.364078
GCA_011745365.1-Fun_MU032349.1_i000_007780	195	418	223	0.995536	0.427203
GCA_019973975.1-Ani_BMAO01015866.1_i000_027907	247	461	214	0.955357	0.352554
GCA_001447585.1-Ani_JYDI01000172.1_i000_008161	182	401	219	0.977679	0.208571
GCA_001913855.2-Fun_MLYV02001198.1_i000_011861	185	410	225	1.00446	0.43021
GCA_004802665.1-Fun_SGPJ01000098.1_i000_008422	185	410	225	1.00446	0.43021
GCA_018404265.1-Fun_BOPL01000003.1_i000_003864	182	407	225	1.00446	0.381356
GCA_000836115.1-Fun_KN847498.1_i000_009765	182	410	228	1.01786	0.360759
GCA_000147195.1-Ani_GL446831.1_i000_002985	185	410	225	1.00446	0.453629
GCA_000208865.2-Pro_FR823393.1_i000_006587	203	437	234	1.04464	0.430147
GCA_001447505.1-Ani_JYDN01000114.1_i000_007441	222	441	219	0.977679	0.202403
GCA_001447745.1-Ani_JYDM01000148.1_i000_002698	220	439	219	0.977679	0.201472
GCA_014904985.1-Fun_MU128917.1_i000_001719	179	396	217	0.96875	0.413333
GCA_000530735.1-Fun_CBTC010000046.1_i000_004225	99	317	218	0.973214	0.481236
GCA_001984395.2-Fun_CP019490.1_i000_000783	99	317	218	0.973214	0.481236
GCA_001447425.1-Ani_JYDJ01000142.1_i000_006047	231	450	219	0.977679	0.199818
GCA_003676035.1-Fun_NSGQ01000049.1_i000_003630	598	823	225	1.00446	0.248344
GCA_000403515.1-Fun_DF238790.1_i000_002663	188	412	224	1	0.431599
GCA_002847465.1-Fun_MSZS01000013.1_i000_002787	182	407	225	1.00446	0.380711
GCA_016748045.1-Fun_WHVT01000025.1_i000_003909	182	407	225	1.00446	0.380711
GCA_000149645.3-Fun_DS027690.1_i000_005855	182	407	225	1.00446	0.380711
GCA_004679265.1-Fun_SEKV01000018.1_i000_002867	186	411	225	1.00446	0.424528
GCA_022264815.1-Fun_JADCUA010000003.1_i000_007325	186	411	225	1.00446	0.424528
GCA_000836295.1-Fun_KN847548.1_i000_006082	183	392	209	0.933036	0.364111
GCA_004155935.1-Fun_QJNV01000100.1_i000_000537	182	399	217	0.96875	0.35342
GCA_002007985.1-Fun_MSRX01000072.1_i000_004353	190	415	225	1.00446	0.438596
GCA_002008015.1-Fun_MSSE01000070.1_i000_004659	190	415	225	1.00446	0.438596
GCA_002008025.1-Fun_MSRY01000030.1_i000_002539	190	415	225	1.00446	0.438596
GCA_002008075.1-Fun_MSSB01000063.1_i000_004466	190	415	225	1.00446	0.438596
GCA_000151645.1-Fun_FN430064.1_i000_002046	181	404	223	0.995536	0.206481
GCA_900096595.1-Fun_FMSP01000005.1_i000_001918	180	401	221	0.986607	0.40255
GCA_001594115.1-Ani_KQ981424.1_i000_003691	183	410	227	1.01339	0.467078
GCA_002938385.1-Fun_NHYE01001430.1_i000_006741	186	403	217	0.96875	0.395264
GCA_019924255.1-Fun_JAHFXK010001947.1_i000_006707	2	165	163	0.727679	0.59707
GCA_020536995.1-Ani_CM035922.1_i000_117881	116	341	225	1.00446	0.481799
GCA_001983305.1-Fun_MPUK01000015.1_i000_005204	181	401	220	0.982143	0.428016
GCA_003205855.1-Fun_LK052914.1_i000_000573	181	401	220	0.982143	0.428016
GCA_900618355.1-Ani_UZAD01013129.1_i000_007815	268	524	256	1.14286	0.358042
GCA_900088565.1-Pro_FLQU01001693.1_i000_007481	181	402	221	0.986607	0.480435
GCA_002237265.2-Fun_NKHU02000178.1_i000_002584	182	407	225	1.00446	0.380711
GCA_000328365.1-Ani_KB309380.1_i000_024384	188	413	225	1.00446	0.446429
GCA_903994225.1-Pro_LR865374.1_i000_003500	181	402	221	0.986607	0.471215
GCA_900002335.2-Pro_LK022889.2_i000_003353	181	402	221	0.986607	0.471215
GCA_900095565.1-Pro_LT608206.1_i000_003008	181	402	221	0.986607	0.471215
GCA_900095605.1-Pro_LT608164.1_i000_003017	181	402	221	0.986607	0.471215
GCA_900095625.1-Pro_LT608192.1_i000_002997	181	402	221	0.986607	0.471215
GCA_002157705.1-Pro_BDQF01000009.1_i000_001635	181	402	221	0.986607	0.466245
GCA_018360865.1-Fun_SRRG01001065.1_i000_000321	182	393	211	0.941964	0.450855
GCA_903994205.1-Pro_LR865390.1_i000_003407	181	402	221	0.986607	0.471215
GCA_900625125.1-Ani_UYYG01000055.1_i000_005253	190	417	227	1.01339	0.478903
GCA_002234975.2-Fun_NIDN02000221.1_i000_003866	182	407	225	1.00446	0.380711
GCA_013368755.1-Fun_CP055899.1_i000_004416	182	407	225	1.00446	0.385935
GCA_002072375.1-Fun_MLKD01000014.1_i000_007345	181	405	224	1	0.392982
GCA_002234965.2-Fun_NKHV02000219.1_i000_003952	182	407	225	1.00446	0.380068
GCA_900095555.1-Pro_LT608178.1_i000_002866	181	402	221	0.986607	0.471215
GCA_000827465.1-Fun_KN823165.1_i000_014137	186	413	227	1.01339	0.476891
GCA_000524515.1-Pro_KI965398.1_i000_002477	181	402	221	0.986607	0.471215
GCA_903994235.1-Pro_LR865417.1_i000_003586	181	402	221	0.986607	0.471215
GCA_903994265.1-Pro_LR865433.1_i000_003630	181	402	221	0.986607	0.471215
GCA_012656225.1-Fun_JAAAPY010000099.1_i000_010571	182	407	225	1.00446	0.380711
GCA_012656285.1-Fun_JAAAPX010000095.1_i000_010187	182	407	225	1.00446	0.380711
GCA_012656295.1-Fun_JAAAPW010000092.1_i000_009951	182	407	225	1.00446	0.380711
GCA_012656325.1-Fun_JAAAPV010000098.1_i000_010441	182	407	225	1.00446	0.380711
GCA_000497045.1-Fun_KI545868.1_i000_003825	188	412	224	1	0.414048
GCA_017918215.1-Pro_CM030482.1_i000_001821	158	379	221	0.986607	0.490022
GCA_006247105.1-Pro_CM016928.1_i000_003952	174	396	222	0.991071	0.390158
GCA_003704595.1-Fun_QWIO01005188.1_i000_016799	122	346	224	1	0.641834
GCA_000002715.1-Fun_DS027056.1_i000_003641	182	407	225	1.00446	0.380068
GCA_015143295.1-Pla_CM026568.1_i000_024584	188	395	207	0.924107	0.344426
GCA_009014675.2-Fun_BKZM02000006.1_i000_005050	182	407	225	1.00446	0.389948
GCA_009932835.1-Fun_BLJY01000011.1_i000_008320	182	407	225	1.00446	0.389948
GCA_003144245.1-Fun_KZ819662.1_i000_000697	189	413	224	1	0.402154
GCA_001293395.1-Pro_LGTL01000022.1_i000_007842	190	420	230	1.02679	0.47817
GCA_003704595.1-Fun_QWIO01005189.1_i000_016800	122	346	224	1	0.632768
GCA_020726465.1-Fun_JAGIZQ010000008.1_i000_011465	182	388	206	0.919643	0.338816
GCA_000149615.1-Fun_CH476598.1_i000_006640	182	407	225	1.00446	0.389948
GCA_016808415.1-Fun_JAAWWR010000004.1_i000_002011	182	407	225	1.00446	0.389948
GCA_000224905.2-Pro_KN000265.1_i000_006652	4	171	167	0.745536	0.787736
GCA_013400895.1-Ani_VZTW01015422.1_i000_002776	1	209	208	0.928571	0.702703
GCA_017607525.1-Ani_JAANIA010001848.1_i000_002870	237	464	227	1.01339	0.42115
GCA_000785585.1-Fun_JSEJ01000059.1_i000_008415	182	407	225	1.00446	0.344564
GCA_000835495.1-Fun_KN847046.1_i000_011842	182	407	225	1.00446	0.344564
GCA_001645015.2-Fun_LWDF02000201.1_i000_003132	186	394	208	0.928571	0.344942
GCA_001645055.2-Fun_LWDG02000263.1_i000_003331	186	394	208	0.928571	0.344942
GCA_009428295.1-Fun_RDSH01000045.1_i000_005346	186	394	208	0.928571	0.344942
GCA_009428345.1-Fun_RDSI01000327.1_i000_004851	186	394	208	0.928571	0.344942
GCA_009428365.1-Fun_RDSJ01000206.1_i000_003181	186	394	208	0.928571	0.344942
GCA_002284615.2-Pla_MU069624.1_i000_005900	189	414	225	1.00446	0.429389
GCA_017607545.1-Ani_JAANIC010005341.1_i000_007022	237	464	227	1.01339	0.42115
GCA_000747765.1-Fun_DF830086.1_i000_000971	188	412	224	1	0.429119
GCA_900322835.1-Fun_OOIQ01000021.1_i000_006493	188	412	224	1	0.429119
THCA004.0722.00001.C001_01785	148	366	218	0.973214	0.515366
GCA_019633495.1-Fun_WSUD01000931.1_i000_005352	186	413	227	1.01339	0.422719
GCA_003614675.1-Fun_ML002380.1_i000_002166	185	408	223	0.995536	0.446894
GCA_011800145.1-Ani_JAAMPH010000037.1_i000_004911	132	329	197	0.879464	0.418259
GCA_008704595.1-Fun_SWFT01000116.1_i000_002025	190	415	225	1.00446	0.429389
GCA_019669825.1-Fun_MU253831.1_i000_003569	182	399	217	0.96875	0.319588
GCA_000835515.1-Fun_KN847343.1_i000_010184	182	410	228	1.01786	0.359621
GCA_021365285.1-Fun_JAJTJA010000008.1_i000_012504	182	407	225	1.00446	0.385274
GCA_017916335.1-Pro_CM030446.1_i000_001878	158	379	221	0.986607	0.490022
GCA_001661345.1-Fun_KV454475.1_i000_000475	199	424	225	1.00446	0.408348
GCA_902206195.3-Pla_CABITT030000003.1_i000_007084	86	131	45	0.200893	0.144695
GCA_902206195.3-Pla_CABITT030000003.1_i000_007084	128	262	134	0.598214	0.430868
GCA_003614695.1-Fun_ML004446.1_i000_001979	190	415	225	1.00446	0.442043
GCA_003614695.1-Fun_ML004902.1_i000_004746	190	415	225	1.00446	0.442043
GCA_003070745.1-Fun_NESQ01000017.1_i000_002791	181	404	223	0.995536	0.20629
GCA_014065215.1-Fun_JACCEH010000005.1_i000_008121	181	404	223	0.995536	0.391228
GCA_910592345.1-Fun_CAJVPI010000006.1_i000_000134	182	401	219	0.977679	0.428571
GCA_000409485.1-Fun_KE145353.1_i000_000860	180	397	217	0.96875	0.344992
GCA_000513255.1-Fun_HG792015.1_i000_002166	182	406	224	1	0.388889
GCA_002105055.1-Fun_MCGR01000043.1_i000_006259	180	402	222	0.991071	0.405109
GCA_015533775.1-Fun_JABCSE010000003.1_i000_001827	182	406	224	1	0.388889
GCA_900088485.1-Pro_FLRD01000064.1_i000_001918	181	401	220	0.982143	0.451745
GCA_900088545.1-Pro_FLRE01000081.1_i000_001942	181	401	220	0.982143	0.451745
GCA_021307315.1-Fun_JAJSPD010000016.1_i000_004109	182	399	217	0.96875	0.329787
GCA_009176365.1-Fun_ML733101.1_i000_009371	182	407	225	1.00446	0.384615
GCA_009193605.1-Fun_ML735261.1_i000_006901	182	407	225	1.00446	0.384615
GCA_013421405.2-Fun_SPNV01000009.1_i000_012311	182	407	225	1.00446	0.384615
GCA_019633425.1-Fun_WSUB01000017.1_i000_003413	188	415	227	1.01339	0.412727
GCA_019633485.1-Fun_WSUC01000014.1_i000_002233	188	415	227	1.01339	0.412727
THGU001.0722.00001.C001_01232	147	366	219	0.977679	0.518957
AECA001.0722.00001.C001_01410	164	382	218	0.973214	0.519048
GCA_019923975.1-Fun_JAHFWY010000001.1_i000_000394	175	366	191	0.852679	0.382766
GCA_000167075.2-Fun_JH797526.1_i000_002679	190	416	226	1.00893	0.447525
GCA_000326105.1-Fun_AGVY01000304.1_i000_007384	190	416	226	1.00893	0.44664
GCA_000224865.2-Pro_KN044642.1_i000_005990	1	165	164	0.732143	0.836735
GCA_000256725.2-Pro_KQ983279.1_i000_004317	1	165	164	0.732143	0.836735
GCA_015501585.1-Fun_JADNRY010000006.1_i000_018262	187	430	243	1.08482	0.431616
GCA_002287525.1-Ani_LIAE01010577.1_i000_025368	188	415	227	1.01339	0.438224
GCA_018856295.1-Fun_JAFLHD010017843.1_i000_009910	182	406	224	1	0.39646
GCA_001447655.1-Ani_JYDQ01000151.1_i000_007748	188	407	219	0.977679	0.19571
GCA_000209165.1-Fun_CP000499.1_i000_003743	181	401	220	0.982143	0.427184
GCA_016859295.1-Fun_CM029110.1_i000_005856	181	401	220	0.982143	0.427184
GCA_018924745.1-Fun_CM032184.1_i000_005893	181	406	225	1.00446	0.389273
GCA_000304475.1-Fun_HE650832.1_i000_005314	189	415	226	1.00893	0.452
GCA_900491785.1-Fun_UFAJ01000178.1_i000_002759	187	414	227	1.01339	0.439922
GCA_020623625.1-Fun_CM036080.1_i000_000219	187	414	227	1.01339	0.432381
GCA_001632365.1-Fun_KV427612.1_i000_003761	185	411	226	1.00893	0.437984
GCA_017639365.1-Fun_JAAQQX010000005.1_i000_004911	191	416	225	1.00446	0.444664
GCA_017639385.1-Fun_JAAQQW010000004.1_i000_003538	191	416	225	1.00446	0.444664
THEU001.0722.00001.C001_00117	147	366	219	0.977679	0.526442
GCA_000221225.1-Fun_GL988032.1_i000_000624	181	403	222	0.991071	0.381443
GCA_000313525.1-Fun_HE796948.1_i000_002259	185	414	229	1.02232	0.429644
GCA_020536995.1-Ani_CM035922.1_i000_118115	187	412	225	1.00446	0.418216
THTH003.0722.00001.C001_01947	147	366	219	0.977679	0.51773
GCA_002245815.2-Pla_LHPF02000003.1_i000_005094	187	410	223	0.995536	0.459794
GCA_019633465.1-Fun_WSTY01000611.1_i000_003490	143	370	227	1.01339	0.449505
MEIG001.0722.00001.C001_01233	145	366	221	0.986607	0.528708
GCA_001896365.1-Fun_MIKG01000001.1_i000_000867	190	414	224	1	0.391608
GCA_001895945.1-Fun_MNAD01000861.1_i000_013567	185	410	225	1.00446	0.415896
GCA_011074885.2-Fun_CP063136.1_i000_002684	180	405	225	1.00446	0.45
GCA_002926015.1-Pla_KZ648585.1_i000_024686	177	416	239	1.06696	0.407155
GCA_002891735.1-Pla_PGGS01000433.1_i000_008995	186	409	223	0.995536	0.438114
GCA_014176185.1-Fun_JABCYO010000020.1_i000_002130	190	415	225	1.00446	0.441176
GCA_014176175.1-Fun_JABCYN010000025.1_i000_002698	190	415	225	1.00446	0.441176
GCA_902155815.1-Fun_CABFWN010000005.1_i000_003902	190	415	225	1.00446	0.441176
GCA_000701005.1-Ani_KL363199.1_i000_003623	183	408	225	1.00446	0.431862
GCA_000701025.1-Ani_KL367583.1_i000_010411	183	408	225	1.00446	0.431862
GCA_003144195.1-Fun_KZ819419.1_i000_006067	190	408	218	0.973214	0.369492
GCA_003692655.1-Ani_QRBI01000105.1_i000_005957	1	86	85	0.379464	0.393519
GCA_004155915.1-Fun_QJOA01000203.1_i000_003444	182	399	217	0.96875	0.35342
AEPE001.0722.00001.C001_01485	163	381	218	0.973214	0.520286
GCA_010108815.1-Ani_QWKW01006058.1_i000_003706	1	103	102	0.455357	0.41129
GCA_003339415.1-Fun_PDHQ01000022.1_i000_002258	193	419	226	1.00893	0.444008
GCA_000513335.1-Fun_HG793140.1_i000_005274	182	406	224	1	0.389565
GCA_020536225.1-Fun_JAEUBG010001129.1_i000_002086	188	413	225	1.00446	0.452716
GCA_000835435.1-Fun_KN846960.1_i000_008119	182	393	211	0.941964	0.316342
GCA_003704575.1-Fun_QWIN01001507.1_i000_003377	37	261	224	1	0.565657
GCA_003704385.1-Fun_QWIM01003667.1_i000_015955	1	223	222	0.991071	0.620112
GCA_905221625.1-Pro_CAJNDU010000790.1_i000_001127	181	401	220	0.982143	0.43222
GCA_000760515.2-Fun_JMKJ01000014.1_i000_000175	180	385	205	0.915179	0.417515
GCA_003704575.1-Fun_QWIN01003653.1_i000_010449	37	261	224	1	0.565657
GCA_002926085.1-Fun_PKFP01000008.1_i000_000546	189	414	225	1.00446	0.442043
GCA_019332025.1-Fun_CP076661.1_i000_000498	189	414	225	1.00446	0.442043
GCA_012934285.1-Fun_JAAVMX010000005.1_i000_004498	194	418	224	1	0.440945
GCA_001513925.1-Fun_LLXE01000019.1_i000_003189	182	406	224	1	0.389565
GCA_002072265.1-Fun_MDYM01000018.1_i000_009479	182	406	224	1	0.389565
GCA_000180735.1-Ani_CAAE01014642.1_i000_014429	185	351	166	0.741071	0.2959
GCA_000180735.1-Ani_CAAE01014642.1_i000_014429	348	435	87	0.388393	0.15508
GCA_000265015.1-Fun_JH687735.1_i000_002107	251	427	176	0.785714	0.278481
GCA_004154915.1-Fun_QJNU01000112.1_i000_001057	182	399	217	0.96875	0.35342
GCA_014281905.1-Fun_JACBAD010001963.1_i000_002140	182	407	225	1.00446	0.380711
GCA_001466525.1-Fun_LLWO01000043.1_i000_002480	188	414	226	1.00893	0.444882
GCA_001466535.1-Fun_LMAA01000077.1_i000_003165	188	414	226	1.00893	0.444882
GCA_001466565.1-Fun_LMAB01000132.1_i000_003707	188	414	226	1.00893	0.444882
GCA_001466575.1-Fun_LLZY01000069.1_i000_003807	188	414	226	1.00893	0.444882
GCA_001466635.1-Fun_LLZZ01000157.1_i000_004713	188	414	226	1.00893	0.444882
GCA_001466685.1-Fun_LMAY01000103.1_i000_001825	188	414	226	1.00893	0.444882
GCA_002219185.1-Fun_CM008081.1_i000_000165	188	414	226	1.00893	0.444882
GCA_002219195.1-Fun_CM008095.1_i000_000165	188	414	226	1.00893	0.444882
GCA_014217725.1-Fun_CP048230.1_i000_000169	188	414	226	1.00893	0.444882
GCA_020797195.1-Fun_CM036803.1_i000_000168	188	414	226	1.00893	0.444882
GCA_020797205.1-Fun_CM036825.1_i000_000167	188	414	226	1.00893	0.444882
GCA_020797215.1-Fun_CM036796.1_i000_000169	188	414	226	1.00893	0.444882
GCA_020797225.1-Fun_CM036814.1_i000_000170	188	414	226	1.00893	0.444882
GCA_020797355.1-Fun_CM036851.1_i000_000170	188	414	226	1.00893	0.444882
GCA_900096545.1-Fun_FMSJ01000120.1_i000_000433	188	414	226	1.00893	0.444882
GCA_900166875.1-Fun_FWDN01000120.1_i000_000583	188	414	226	1.00893	0.444882
GCA_005059885.1-Fun_NAJL01000006.1_i000_006826	195	419	224	1	0.400716
GCA_900000165.1-Fun_CCYA01000250.1_i000_003316	190	408	218	0.973214	0.369492
GCA_014281935.1-Fun_JACBAF010001866.1_i000_006568	182	407	225	1.00446	0.380711
GCA_902498895.1-Fun_CABVLU010000001.1_i000_000682	181	401	220	0.982143	0.408922
GCA_004154975.1-Fun_QJNW01000170.1_i000_002288	182	399	217	0.96875	0.35342
GCA_004155895.1-Fun_QJNT01000048.1_i000_008615	182	399	217	0.96875	0.35342
GCA_004154925.1-Fun_QJNS01000082.1_i000_010258	182	399	217	0.96875	0.35342
GCA_002077065.1-Fun_NAJO01000043.1_i000_012964	194	418	224	1	0.398577
GCA_002284835.2-Ani_KV963907.1_i000_012642	204	370	166	0.741071	0.342268
GCA_002284835.2-Ani_KV963907.1_i000_012642	381	453	72	0.321429	0.148454
GCA_021029095.1-Fun_JAJOHG010000046.1_i000_010261	186	411	225	1.00446	0.408348
THSP001.0722.00001.C001_01818	148	366	218	0.973214	0.512941
THAC003.0722.00001.C001_02198	148	366	218	0.973214	0.512941
THAG001.0722.00001.C001_00164	160	379	219	0.977679	0.542079
GCA_003339455.1-Fun_PDHP01000007.1_i000_006188	194	418	224	1	0.436647
GCA_001691775.3-Fun_JNHW02000008.1_i000_006675	185	411	226	1.00893	0.415441
GCA_001584585.1-Pla_LSYV01000009.1_i000_004134	186	410	224	1	0.446215
GCA_000835395.1-Fun_KN846953.1_i000_006887	182	409	227	1.01339	0.355243
GCA_000224885.2-Pro_KL998096.1_i000_004665	4	171	167	0.745536	0.634981
GCA_002738545.1-Ani_NTJE010011556.1_i000_000660	33	230	197	0.879464	0.444695
GCA_018360755.1-Fun_SRQW01001066.1_i000_000314	184	392	208	0.928571	0.436975
GCA_018360855.1-Fun_SRRF01000745.1_i000_007353	184	392	208	0.928571	0.436975
GCA_016618355.2-Fun_JADGIP010000309.1_i000_004854	186	410	224	1	0.416357
GCA_001189435.1-Fun_LFRF01000048.1_i000_006943	194	418	224	1	0.440945
GCA_000213175.1-Fun_GL891305.1_i000_005443	182	388	206	0.919643	0.345059
GCA_000213195.1-Fun_GL891247.1_i000_007840	182	388	206	0.919643	0.345059
GCA_010015565.1-Fun_ML975945.1_i000_002488	193	418	225	1.00446	0.404676
GCA_000827275.1-Fun_KN833921.1_i000_016560	186	410	224	1	0.424242
GCA_003615045.1-Fun_ML014127.1_i000_001160	186	412	226	1.00893	0.448413
GCA_000182925.2-Fun_CM002237.1_i000_002562	182	388	206	0.919643	0.345059
GCA_000786625.1-Fun_KN389652.1_i000_003871	182	388	206	0.919643	0.345059
GCA_020744425.1-Fun_JAGMUV010000009.1_i000_020918	181	388	207	0.924107	0.352641
GCA_021015755.1-Fun_JABWDW010000015.1_i000_002471	187	430	243	1.08482	0.437838
GCA_009193565.1-Fun_ML739037.1_i000_000505	182	407	225	1.00446	0.383959
GCA_015476405.1-Fun_CM027201.1_i000_005658	187	430	243	1.08482	0.437838
GCA_003013735.1-Fun_PYFQ01000001.1_i000_000755	189	414	225	1.00446	0.442043
GCA_000027005.1-Fun_FN392319.1_i000_001190	190	415	225	1.00446	0.453629
GCA_001708085.1-Fun_CP014708.1_i000_001157	190	415	225	1.00446	0.453629
GCA_001746955.1-Fun_CP014715.1_i000_001157	190	415	225	1.00446	0.453629
GCA_900235035.1-Fun_LT962476.1_i000_001205	190	415	225	1.00446	0.453629
GCA_020450195.1-Fun_CP053486.1_i000_000165	221	446	225	1.00446	0.416667
GCA_020450215.1-Fun_CP053512.1_i000_000165	221	446	225	1.00446	0.416667
GCA_020450235.1-Fun_CP053525.1_i000_000165	221	446	225	1.00446	0.416667
GCA_020450265.1-Fun_CP060143.1_i000_000165	221	446	225	1.00446	0.416667
GCA_002918395.1-Fun_PEDP01000203.1_i000_001427	184	403	219	0.977679	0.432806
GCA_002563875.1-Pro_CM008346.1_i000_000572	198	420	222	0.991071	0.414953
GCA_002072425.1-Fun_MOOB01000052.1_i000_008412	182	406	224	1	0.390244
GCA_022376445.1-Fun_JACBKP010000003.1_i000_008847	185	411	226	1.00893	0.430476
GCA_003704355.1-Fun_QWIL01003406.1_i000_015421	193	417	224	1	0.502242
GCA_000710275.1-Fun_CM002801.1_i000_011086	182	406	224	1	0.390244
GCA_011058885.1-Fun_SWKS01000016.1_i000_002750	182	406	224	1	0.390244
GCA_002072365.1-Fun_MLQL01000029.1_i000_007547	182	406	224	1	0.390244
GCA_000576695.1-Fun_HG793125.1_i000_000304	190	415	225	1.00446	0.443787
GCA_900618395.1-Ani_UZAI01019276.1_i000_022159	206	414	208	0.928571	0.342105
GCA_002794465.1-Fun_MTSL01000041.1_i000_000576	196	421	225	1.00446	0.419776
GCA_000430065.1-Fun_ATCN01001017.1_i000_002017	170	388	218	0.973214	0.372014
GCA_001278595.1-Fun_LHQQ01000093.1_i000_012710	182	406	224	1	0.389565
GCA_014281895.1-Fun_JACBAE010001244.1_i000_002116	182	407	225	1.00446	0.380711
GCA_014281915.1-Fun_JACBAG010001762.1_i000_002410	182	407	225	1.00446	0.380711
GCA_001578235.1-Fun_LFZN01000173.1_i000_002918	182	397	215	0.959821	0.375874
GCA_000315645.2-Fun_JH993646.1_i000_002368	182	406	224	1	0.388889
GCA_000315665.1-Fun_JH993715.1_i000_002137	182	406	224	1	0.388889
GCA_012295545.2-Fun_JAAQRF020000027.1_i000_008010	182	406	224	1	0.388889
GCA_016767815.1-Fun_CP060778.1_i000_007872	182	406	224	1	0.388889
GCA_000769735.1-Fun_JQFY01000141.1_i000_009228	182	406	224	1	0.389565
GCA_000769745.1-Fun_JQFZ01000341.1_i000_010227	182	406	224	1	0.388889
GCA_000769755.1-Fun_JQFX01000787.1_i000_007310	182	406	224	1	0.388889
GCA_000769765.1-Fun_JQGA01000606.1_i000_006696	182	406	224	1	0.388889
GCA_013138035.1-Fun_JAASRZ010000044.1_i000_011795	182	406	224	1	0.402154
GCA_014621375.1-Fun_JAAOZQ010000007.1_i000_008653	182	406	224	1	0.389565
GCA_013402915.1-Fun_CP058608.1_i000_003366	189	415	226	1.00893	0.437137
GCA_004369235.1-Pro_SDXP01000463.1_i000_000401	645	869	224	1	0.246425
GCA_017655625.1-Fun_JAEOAQ010000002.1_i000_002709	188	413	225	1.00446	0.447316
GCA_010723975.1-Fun_BLKD01000019.1_i000_004057	182	407	225	1.00446	0.380711
GCA_012656335.1-Fun_JAAAPU010000108.1_i000_000283	182	407	225	1.00446	0.380711
GCA_012656445.1-Fun_JAAAPR010000161.1_i000_002374	182	407	225	1.00446	0.380711
GCA_012656455.1-Fun_JAAAPQ010000172.1_i000_002604	182	407	225	1.00446	0.380711
GCA_012656375.1-Fun_JAAAPT010000148.1_i000_001819	182	407	225	1.00446	0.380711
GCA_012656395.1-Fun_JAAAPS010000159.1_i000_002175	182	407	225	1.00446	0.380711
GCA_012656435.1-Fun_JAAAPP010000166.1_i000_002536	182	407	225	1.00446	0.380711
GCA_010724455.1-Fun_BLKH01000019.1_i000_004007	182	407	225	1.00446	0.380711
GCA_010724575.1-Fun_BLKI01000047.1_i000_007248	182	407	225	1.00446	0.380711
GCA_010724635.1-Fun_BLKJ01000037.1_i000_006625	182	407	225	1.00446	0.380711
GCA_010724915.1-Fun_BLKL01000036.1_i000_005609	182	407	225	1.00446	0.380711
GCA_019632305.1-Fun_WSTW01000557.1_i000_006982	186	412	226	1.00893	0.404293
GCA_001445615.2-Fun_BCLY01000004.1_i000_001467	182	407	225	1.00446	0.380711
GCA_007224835.1-Ani_SRMA01025407.1_i000_006559	192	358	166	0.741071	0.29174
GCA_007224835.1-Ani_SRMA01025407.1_i000_006559	360	442	82	0.366071	0.144112
GCA_014905375.1-Pla_BMAC01001247.1_i000_027891	1	101	100	0.446429	0.729927
GCA_900005765.1-Pro_LN835304.1_i000_001880	186	410	224	1	0.375209
GCA_900088575.1-Pro_FLQW01003590.1_i000_004273	181	426	245	1.09375	0.522388
GCA_900090045.1-Pro_LT594629.1_i000_001754	181	426	245	1.09375	0.522388
SASH001.0722.00002.C001_02403	156	380	224	1	0.542373
GCA_900000135.1-Fun_CCYT01000234.1_i000_015143	125	218	93	0.415179	0.424658
GCA_002072255.1-Fun_MDYP01000012.1_i000_004134	182	406	224	1	0.390244
GCA_018340605.1-Fun_BHVY01000004.1_i000_006441	182	407	225	1.00446	0.380711
GCA_000002545.2-Fun_CR380947.2_i000_000165	188	414	226	1.00893	0.444882
GCA_010111755.1-Fun_CP048118.1_i000_000167	188	414	226	1.00893	0.444882
GCA_020797185.1-Fun_CM036832.1_i000_000170	188	414	226	1.00893	0.444882
GCA_020797325.1-Fun_CM036842.1_i000_000170	188	414	226	1.00893	0.444882
GCA_002072235.1-Fun_MDYO01000015.1_i000_004989	182	406	224	1	0.389565
GCA_001460835.1-Pro_CYKH01001851.1_i000_013933	158	378	220	0.982143	0.520095
SACA001.0722.00001.C001_00856	156	379	223	0.995536	0.545232
GCA_000298775.1-Fun_JH921435.1_i000_004101	181	397	216	0.964286	0.330781
GCA_017911135.1-Fun_JABVCJ010000015.1_i000_000356	41	239	198	0.883929	0.825
GCA_004155055.1-Fun_QJNZ01000509.1_i000_007898	182	399	217	0.96875	0.35342
GCA_900290415.1-Fun_LR026969.1_i000_008140	182	397	215	0.959821	0.395221
GCA_000226545.1-Fun_CU638744.1_i000_008566	182	397	215	0.959821	0.393773
GCA_009769405.1-Fun_WNWR01000483.1_i000_009191	183	400	217	0.96875	0.376083
GCA_009769445.1-Fun_WNWQ01000219.1_i000_004009	183	400	217	0.96875	0.376083
GCA_019669845.1-Fun_MU251245.1_i000_001877	181	391	210	0.9375	0.348259
GCA_004115385.1-Pla_CM014054.1_i000_013414	188	392	204	0.910714	0.33887
GCA_003351075.1-Fun_QFBF01000054.1_i000_010926	183	400	217	0.96875	0.376083
GCA_000004825.1-Pro_GL291012.1_i000_011184	179	404	225	1.00446	0.413603
GCA_002007985.1-Fun_MSRX01000002.1_i000_002469	181	400	219	0.977679	0.418738
GCA_002008015.1-Fun_MSSE01000009.1_i000_005635	181	400	219	0.977679	0.418738
GCA_002008025.1-Fun_MSRY01000010.1_i000_000199	181	400	219	0.977679	0.418738
GCA_002008075.1-Fun_MSSB01000109.1_i000_000180	181	400	219	0.977679	0.418738
GCA_000238015.2-Fun_JH413869.1_i000_004195	180	397	217	0.96875	0.262394
GCA_000223135.1-Ani_JH000069.1_i000_002697	1	168	167	0.745536	0.540453
GCA_002818225.1-Fun_KZ454988.1_i000_001107	196	417	221	0.986607	0.415414
GCA_000250965.2-Pro_KQ973610.1_i000_001223	1	165	164	0.732143	0.638132
GCA_001642045.1-Fun_KV441560.1_i000_012987	180	400	220	0.982143	0.383275
GCA_010093485.1-Fun_MU001513.1_i000_013951	180	400	220	0.982143	0.382609
GCA_002382835.1-Fun_NPFJ01000003.1_i000_005331	190	414	224	1	0.390244
GCA_002382855.1-Fun_NPFK01000005.1_i000_008078	190	414	224	1	0.390244
GCA_011392495.1-Fun_QMIJ01000002.1_i000_004791	190	414	224	1	0.390244
GCA_001939145.1-Pro_LSRX01000555.1_i000_021616	603	770	167	0.745536	0.194412
GCA_000224805.2-Pro_KN040001.1_i000_006577	1	165	164	0.732143	0.638132
GCA_000829775.1-Fun_DF933830.1_i000_004871	190	414	224	1	0.390244
GCA_000691245.1-Pro_JMRU01001530.1_i000_009480	191	421	230	1.02679	0.47817
GCA_000223565.1-Fun_FR839628.1_i000_001227	190	415	225	1.00446	0.396127
GCA_000410735.1-Fun_KE148157.1_i000_005722	186	403	217	0.96875	0.369676
GCA_000003085.2-Pro_AABL01000242.1_i000_004050	142	366	224	1	0.443564
GCA_905250045.1-Ani_CAJNOG010000264.1_i000_022738	4	193	189	0.84375	0.768293
GCA_002906115.4-Pla_PKMF03021375.1_i000_075274	193	417	224	1	0.410256
GCA_013676235.1-Pla_CM025497.1_i000_004428	188	422	234	1.04464	0.414894
GCA_000003125.1-Fun_EQ962654.1_i000_002683	182	406	224	1	0.381601
GCA_004009835.2-Fun_RIBY02002067.1_i000_007097	193	417	224	1	0.412523
GCA_010093825.1-Fun_ML995944.1_i000_010549	193	417	224	1	0.403604
SUIS001.0722.00003.C001_01356	156	380	224	1	0.542373
SUIS001.0722.00004.C001_01421	156	380	224	1	0.542373
SUIS001.0722.00001.C001_01329	156	380	224	1	0.542373
SASH001.0722.00001.C001_02412	156	380	224	1	0.542373
GCA_010093815.1-Fun_ML996565.1_i000_000122	182	399	217	0.96875	0.367797
GCA_001632345.1-Fun_KV429099.1_i000_009391	185	411	226	1.00893	0.426415
GCA_001875675.1-Fun_MKPU01000064.1_i000_003071	184	405	221	0.986607	0.485714
GCA_019650175.1-Pla_BNCO01000004.1_i000_002251	186	410	224	1	0.443564
GCA_003672135.1-Ani_CM010856.1_i000_000658	189	414	225	1.00446	0.11658
GCA_009193465.1-Fun_ML742114.1_i000_005631	182	407	225	1.00446	0.393357
GCA_001305275.1-Fun_LHCL01000002.1_i000_003404	190	414	224	1	0.389565
GCA_001645005.2-Fun_LWDD02001812.1_i000_002590	186	394	208	0.928571	0.337115
GCA_009428275.1-Fun_RDSF01000922.1_i000_009475	186	394	208	0.928571	0.337115
GCA_009428285.1-Fun_RDSG01000857.1_i000_009069	186	394	208	0.928571	0.337115
GCA_905068135.1-Fun_CAJHJA010001693.1_i000_002694	186	394	208	0.928571	0.337115
GCA_905071705.1-Fun_CAJHJC010004711.1_i000_006238	186	394	208	0.928571	0.337115
GCA_905071715.1-Fun_CAJHJH010000783.1_i000_001416	186	394	208	0.928571	0.337115
GCA_905071725.1-Fun_CAJHJD010001690.1_i000_002892	186	394	208	0.928571	0.337115
GCA_905071735.1-Fun_CAJHJE010003729.1_i000_005143	186	394	208	0.928571	0.337115
GCA_905071745.1-Fun_CAJHJG010002066.1_i000_002968	186	394	208	0.928571	0.337115
GCA_905071755.1-Fun_CAJHJF010002240.1_i000_003608	186	394	208	0.928571	0.337115
GCA_905071765.1-Fun_CAJHJB010000113.1_i000_003708	186	394	208	0.928571	0.337115
GCA_905071775.1-Fun_CAJHJJ010000256.1_i000_000350	186	394	208	0.928571	0.337115
GCA_905071785.1-Fun_CAJHJI010004431.1_i000_006038	186	394	208	0.928571	0.337115
GCA_905072865.1-Fun_CAJHJV010005009.1_i000_007256	186	394	208	0.928571	0.337115
GCA_001605985.2-Pla_KZ503388.1_i000_023281	187	412	225	1.00446	0.411335
GCA_000448365.1-Fun_KE652523.1_i000_002997	194	418	224	1	0.440945
GCA_001645045.2-Fun_LWDE02001842.1_i000_002783	186	394	208	0.928571	0.338211
GCA_009428265.1-Fun_RDSE01001816.1_i000_002601	186	394	208	0.928571	0.338211
GCA_007735645.1-Fun_CP042191.1_i000_004586	183	390	207	0.924107	0.358752
GCA_001750085.1-Pro_KV784353.1_i000_000095	19	230	211	0.941964	0.627976
GCA_004565275.1-Pro_SDOX01000007.1_i000_007586	187	411	224	1	0.449799
GCA_001883825.1-Fun_LGRN01000460.1_i000_005887	181	395	214	0.955357	0.331783
GCA_002591415.1-Fun_NJET01000053.1_i000_006149	182	387	205	0.915179	0.330645
GCA_000338955.1-Fun_KB445551.1_i000_001641	195	419	224	1	0.39646
GCA_003704685.1-Fun_QWIT01000002.1_i000_000163	193	417	224	1	0.405797
GCA_000182805.2-Fun_CABT02000056.1_i000_001125	182	389	207	0.924107	0.348485
GCA_008692325.1-Fun_NMPR01000082.1_i000_009035	182	389	207	0.924107	0.348485
GCA_020800285.1-Fun_JAGTJO010000001.1_i000_001719	182	389	207	0.924107	0.348485
GCA_015476325.1-Pro_JADAQX010000836.1_i000_000720	182	408	226	1.00893	0.426415
GCA_014858505.1-Pla_CM026417.1_i000_022364	177	386	209	0.933036	0.366667
GCA_002849105.1-Fun_MSFO01000002.1_i000_005384	182	407	225	1.00446	0.391304
GCA_900090005.1-Pro_LT594496.1_i000_001364	181	426	245	1.09375	0.522388
THPA003.0722.00001.C001_01417	147	366	219	0.977679	0.530266
GCA_015679595.1-Fun_JAAAVB010001589.1_i000_002758	1	130	129	0.575893	0.578475
GCA_900660285.1-Fun_CAACVR010000056.1_i000_004380	190	415	225	1.00446	0.442913
GCA_003704375.1-Fun_QWIK01002973.1_i000_009027	182	406	224	1	0.414815
GCA_003704585.1-Fun_QWIP01000156.1_i000_003185	183	407	224	1	0.413284
GCA_003182015.1-Fun_PYWC01000052.1_i000_006283	181	404	223	0.995536	0.38918
GCA_000474925.1-Fun_KI440845.1_i000_004388	186	399	213	0.950893	0.358586
GCA_000961545.1-Fun_AXCR01000010.1_i000_007604	186	399	213	0.950893	0.358586
GCA_019650235.1-Pla_BNCP01000002.1_i000_001082	186	410	224	1	0.445328
GCA_019650255.1-Pla_BNCQ01000005.1_i000_002825	186	410	224	1	0.445328
GCA_014220965.1-Ani_LOND01006034.1_i000_007910	191	397	206	0.919643	0.365897
GCA_003704615.1-Fun_QWIQ01000021.1_i000_004153	193	417	224	1	0.405797
GCA_000224805.2-Pro_KN039986.1_i000_001207	201	433	232	1.03571	0.534562
GCA_000256725.2-Pro_KQ983273.1_i000_002598	201	433	232	1.03571	0.534562
GCA_003704345.1-Fun_QWIJ01002017.1_i000_005864	193	417	224	1	0.406534
GCA_003704615.1-Fun_QWIQ01000409.1_i000_008721	193	417	224	1	0.405797
GCA_004522655.2-Fun_SNSC02000010.1_i000_006013	183	400	217	0.96875	0.376083
GCA_004522665.1-Fun_SNSD01000010.1_i000_005879	183	400	217	0.96875	0.376083
GCA_001014755.1-Fun_LDEV01003351.1_i000_007922	181	394	213	0.950893	0.335962
GCA_900002375.2-Pro_LK023124.2_i000_002048	185	409	224	1	0.448898
GCA_900044335.1-Pro_LT160029.1_i000_002019	185	409	224	1	0.448898
GCA_900088445.1-Pro_LT614635.1_i000_001901	185	409	224	1	0.448898
GCA_900095545.1-Pro_LT608145.1_i000_001901	185	409	224	1	0.448898
GCA_900095585.1-Pro_LT608273.1_i000_001904	185	409	224	1	0.448898
GCA_900095635.1-Pro_LT608257.1_i000_001894	185	409	224	1	0.448898
GCA_003704645.1-Fun_QWIR01000052.1_i000_006299	193	417	224	1	0.405797
GCA_002127715.1-Fun_MUNK01000107.1_i000_015295	193	417	224	1	0.405797
GCA_003704675.1-Fun_QWIS01000006.1_i000_006362	193	417	224	1	0.405797
GCA_003704685.1-Fun_QWIT01000004.1_i000_007219	193	417	224	1	0.405797
GCA_000505035.1-Pro_KI635795.1_i000_004571	185	409	224	1	0.424242
GCA_002127715.1-Fun_MUNK01000021.1_i000_002435	193	417	224	1	0.405797
GCA_000820605.1-Fun_AWTV01000004.1_i000_001181	186	399	213	0.950893	0.358586
GCA_900180425.1-Fun_FXLY01000005.1_i000_002417	181	401	220	0.982143	0.434783
GCA_900180425.1-Fun_FXLY01000010.1_i000_005164	181	401	220	0.982143	0.434783
GCA_006381635.2-Pla_VEPZ02001051.1_i000_038914	188	398	210	0.9375	0.515971
GCA_905071725.1-Fun_CAJHJD010005633.1_i000_007809	190	414	224	1	0.417132
GCA_905071765.1-Fun_CAJHJB010000125.1_i000_003945	190	414	224	1	0.417132
GCA_905071775.1-Fun_CAJHJJ010004626.1_i000_005554	190	414	224	1	0.417132
GCA_905071785.1-Fun_CAJHJI010005857.1_i000_007424	190	414	224	1	0.417132
GCA_905071705.1-Fun_CAJHJC010008267.1_i000_009712	190	414	224	1	0.417132
GCA_012980515.1-Fun_JAACLJ010000002.1_i000_002146	194	418	224	1	0.443564
GCA_001645005.2-Fun_LWDD02000602.1_i000_008096	190	414	224	1	0.419476
GCA_001645045.2-Fun_LWDE02000858.1_i000_009205	190	414	224	1	0.419476
GCA_009428265.1-Fun_RDSE01000796.1_i000_008769	190	414	224	1	0.419476
GCA_009428275.1-Fun_RDSF01000858.1_i000_009197	190	414	224	1	0.419476
GCA_009428285.1-Fun_RDSG01000810.1_i000_008867	190	414	224	1	0.419476
GCA_905068135.1-Fun_CAJHJA010005055.1_i000_007312	190	414	224	1	0.419476
GCA_905071715.1-Fun_CAJHJH010003101.1_i000_004574	190	414	224	1	0.419476
GCA_905071735.1-Fun_CAJHJE010000099.1_i000_000153	190	414	224	1	0.419476
GCA_905071745.1-Fun_CAJHJG010001149.1_i000_001815	190	414	224	1	0.419476
GCA_905071755.1-Fun_CAJHJF010005857.1_i000_007459	190	414	224	1	0.419476
GCA_905072865.1-Fun_CAJHJV010005576.1_i000_008146	190	414	224	1	0.419476
GCA_001531365.1-Pla_CM009742.1_i000_015070	177	389	212	0.946429	0.414062
GCA_002007995.1-Fun_MSRZ01000103.1_i000_000052	181	400	219	0.977679	0.421965
GCA_001625215.1-Pla_CM004285.1_i000_027837	77	239	162	0.723214	0.580645
GCA_002008065.1-Fun_MSSA01000065.1_i000_004604	181	400	219	0.977679	0.41954
GCA_002008085.1-Fun_MSSD01000032.1_i000_003196	181	400	219	0.977679	0.41954
GCA_002008095.1-Fun_MSSC01000085.1_i000_005181	181	400	219	0.977679	0.421965
GCA_009769425.1-Fun_WNWS01000511.1_i000_010302	183	400	217	0.96875	0.311334
GCA_008692095.1-Ani_CM018458.1_i000_016358	170	365	195	0.870536	0.134762
GCA_900002385.2-Pro_LM993663.2_i000_002658	185	409	224	1	0.408759
GCA_900002395.1-Pro_LK934637.1_i000_002232	185	409	224	1	0.408759
GCA_009805785.1-Fun_WEHT01000144.1_i000_002034	183	403	220	0.982143	0.442656
GCA_002946425.1-Fun_NJPT01000031.1_i000_003739	182	398	216	0.964286	0.259928
GCA_002946385.1-Fun_NJPR01000070.1_i000_008529	182	398	216	0.964286	0.259928
GCA_021014935.1-Fun_MU267600.1_i000_001374	185	410	225	1.00446	0.418994
GCA_001747055.1-Fun_LPNN01000008.1_i000_003809	183	403	220	0.982143	0.442656
GCA_009805715.1-Fun_WEHR01000684.1_i000_002936	183	403	220	0.982143	0.442656
GCA_009805765.1-Fun_WEHS01000068.1_i000_002557	183	403	220	0.982143	0.442656
GCA_020080175.1-Fun_JAGHQL010000217.1_i000_003094	182	398	216	0.964286	0.345048
GCA_001865345.1-Pro_LRBP01000022.1_i000_001240	189	414	225	1.00446	0.450902
GCA_008692325.1-Fun_NMPR01000178.1_i000_003108	195	405	210	0.9375	0.513447
GCA_001984395.2-Fun_CP019502.1_i000_008753	180	402	222	0.991071	0.422053
GCA_002591385.1-Fun_NJEV01000217.1_i000_004195	228	452	224	1	0.409506
GCA_001306435.1-Fun_LKCW01000087.1_i000_012078	181	388	207	0.924107	0.347315
GCA_900332095.2-Pla_OOIL02000203.1_i000_003455	186	411	225	1.00446	0.412088
GCA_000338955.1-Fun_KB445550.1_i000_000388	182	398	216	0.964286	0.454737
GCA_020623625.1-Fun_CM036080.1_i000_000695	181	402	221	0.986607	0.433333
GCA_900491785.1-Fun_UFAJ01000463.1_i000_002400	181	402	221	0.986607	0.433333
GCA_000090985.2-Pla_CP001327.1_i000_004626	322	548	226	1.00893	0.366288
GCA_002287525.1-Ani_LIAE01009803.1_i000_018372	225	452	227	1.01339	0.408273
GCA_009176345.1-Fun_ML732154.1_i000_000834	182	406	224	1	0.389565
THSP032.0722.00001.C001_01431	147	366	219	0.977679	0.534146
GCA_004353045.1-Fun_SKBQ01000026.1_i000_004440	195	419	224	1	0.433269
GCA_000250965.2-Pro_KQ976326.1_i000_007585	201	435	234	1.04464	0.436567
GCA_000006565.2-Pro_CM002047.1_i000_007666	201	435	234	1.04464	0.436567
GCA_000150015.2-Pro_KI544497.1_i000_002283	201	435	234	1.04464	0.436567
GCA_000224865.2-Pro_KN044615.1_i000_001564	201	435	234	1.04464	0.436567
GCA_000325525.2-Pro_KN003119.1_i000_002643	201	435	234	1.04464	0.436567
GCA_013099955.1-Pro_CM023093.1_i000_007694	201	435	234	1.04464	0.436567
GCA_016584195.1-Fun_PUHU01000099.1_i000_005317	181	400	219	0.977679	0.410112
GCA_001447595.1-Ani_JYDH01000135.1_i000_008972	188	407	219	0.977679	0.20719
GCA_016584265.1-Fun_PUHW01000089.1_i000_005113	181	400	219	0.977679	0.410112
GCA_001275765.2-Fun_LCTW02000583.1_i000_010494	126	333	207	0.924107	0.376364
GCA_016584185.1-Fun_PUHS01000111.1_i000_000500	180	402	222	0.991071	0.426104
GCA_000499425.1-Pro_HG673481.1_i000_006192	203	438	235	1.04911	0.430403
GCA_008330635.1-Pro_VLTL01000002.1_i000_000208	189	413	224	1	0.433269
GCA_008330645.1-Pro_VLTN01000041.1_i000_005793	189	413	224	1	0.433269
GCA_008330665.1-Pro_VLTO01000005.1_i000_001379	189	413	224	1	0.433269
GCA_001661315.1-Fun_KV454413.1_i000_004642	182	402	220	0.982143	0.417457
GCA_011745365.1-Fun_MU032347.1_i000_005817	182	394	212	0.946429	0.358108
GCA_007825375.1-Fun_QGML01001565.1_i000_005810	180	397	217	0.96875	0.305204
GCA_007821475.1-Fun_QGMF01001152.1_i000_009038	180	397	217	0.96875	0.306497
GCA_019633595.1-Fun_WSUI01000211.1_i000_004443	186	413	227	1.01339	0.414234
GCA_001660665.1-Fun_LGUA01002297.1_i000_003328	175	388	213	0.950893	0.337025
GCA_007726485.1-Pla_CM017439.1_i000_000798	1	89	88	0.392857	0.366667
GCA_004022145.1-Fun_RCNU01000001.1_i000_000551	182	407	225	1.00446	0.376254
GCA_900162805.1-Fun_FUGC01000001.1_i000_004905	180	402	222	0.991071	0.421252
GCA_002865655.1-Fun_KZ613953.1_i000_014257	182	398	216	0.964286	0.303371
GCA_000315875.1-Fun_HE681722.1_i000_003240	217	442	225	1.00446	0.422932
GCA_004193775.2-Pla_CM014361.1_i000_011287	188	418	230	1.02679	0.413669
GCA_000530735.1-Fun_CBTC010000022.1_i000_001932	180	402	222	0.991071	0.421252
GCA_001984395.2-Fun_CP019494.1_i000_003715	180	402	222	0.991071	0.421252
GCA_000517465.1-Fun_AWNI01000041.1_i000_005710	188	412	224	1	0.431599
GCA_000497085.1-Fun_BAUL01000098.1_i000_005612	182	408	226	1.00893	0.379832
GCA_013423385.1-Fun_BLZA01000002.1_i000_000030	193	426	233	1.04018	0.398973
GCA_007825325.1-Fun_QGMG01001408.1_i000_008554	168	385	217	0.96875	0.31223
GCA_001661425.1-Fun_KV453848.1_i000_001057	181	400	219	0.977679	0.420345
GCA_019804575.1-Fun_JAHQZX010000285.1_i000_002586	181	406	225	1.00446	0.370675
GCA_905337325.1-Fun_CAJPDR010000072.1_i000_002796	182	399	217	0.96875	0.287798
GCA_021432635.1-Fun_MU270074.1_i000_017983	182	392	210	0.9375	0.324074
GCA_905332245.1-Ani_CAJOBP010028670.1_i000_032958	1	139	138	0.616071	0.673171
GCA_905332275.1-Ani_CAJOBR010021904.1_i000_032878	1	139	138	0.616071	0.673171
GCA_000507165.2-Ani_KZ498004.1_i000_011644	180	387	207	0.924107	0.351443
GCA_009733575.1-Fun_ML769608.1_i000_019673	182	400	218	0.973214	0.37913
GCA_019201745.1-Fun_JABELV010000047.1_i000_004998	194	425	231	1.03125	0.385
GCA_021052385.1-Fun_JAIFAB010000021.1_i000_004027	194	425	231	1.03125	0.385
GCA_015832175.1-Fun_WJXW01000016.1_i000_012559	234	447	213	0.950893	0.339172
GCA_003610855.1-Fun_MCFK01002518.1_i000_001473	184	401	217	0.96875	0.428854
GCA_014066305.1-Fun_JACCJC010000006.1_i000_002546	182	399	217	0.96875	0.287037
GCA_000209535.1-Ani_FN653020.1_i000_004302	172	400	228	1.01786	0.408602
GCA_011032825.1-Fun_JAADJZ010000007.1_i000_012938	179	386	207	0.924107	0.362522
GCA_001606155.1-Pro_LODT01000001.1_i000_009989	183	411	228	1.01786	0.363636
GCA_003260635.2-Pla_QGKW02000717.1_i000_045106	188	412	224	1	0.494481
GCA_000803265.1-Fun_JOKQ01000011.1_i000_001592	166	383	217	0.96875	0.453027
GCA_004324935.1-Fun_PITG01000014.1_i000_001579	166	383	217	0.96875	0.453027
GCA_000981445.1-Pro_LK391707.1_i000_000432	183	400	217	0.96875	0.494305
GCA_000209165.1-Fun_CM000437.1_i000_000752	190	415	225	1.00446	0.450902
GCA_016859295.1-Fun_JADGGA010000002.1_i000_000558	190	415	225	1.00446	0.450902
GCA_004325055.1-Fun_PITH01000022.1_i000_001562	166	383	217	0.96875	0.453027
GCA_014298035.1-Fun_JABCIY010000007.1_i000_000847	182	397	215	0.959821	0.451681
GCA_000985935.1-Fun_CVMT01000013.1_i000_009501	182	407	225	1.00446	0.385274
GCA_004324945.1-Fun_PITF01000017.1_i000_001573	166	383	217	0.96875	0.453027
GCA_018902385.1-Fun_JABSSW010000026.1_i000_005827	206	411	205	0.915179	0.264858
GCA_001875675.1-Fun_MKPU01000178.1_i000_001272	178	396	218	0.973214	0.502304
GCA_017607445.1-Fun_JAEVHH010000001.1_i000_000323	181	394	213	0.950893	0.33438
GCA_000769155.2-Pro_JROU02000047.1_i000_007131	201	426	225	1.00446	0.412844
GCA_000709125.1-Fun_AMGV01000002.1_i000_003002	182	393	211	0.941964	0.33124
GCA_010015655.1-Fun_ML976665.1_i000_003716	179	387	208	0.928571	0.360485
GCA_002003045.1-Fun_BDGU01000367.1_i000_008347	462	705	243	1.08482	0.27899
GCA_020360975.1-Fun_JAIZPD010000009.1_i000_007948	181	388	207	0.924107	0.349662
SUIS001.0722.00002.C001_01314	156	380	224	1	0.542373
GCA_016834595.1-Pla_JAEHOD010000003.1_i000_001729	187	410	223	0.995536	0.444223
GCA_001272575.2-Fun_LAZP02000672.1_i000_007126	181	388	207	0.924107	0.289106
GCA_000576695.1-Fun_HG793130.1_i000_005337	181	400	219	0.977679	0.421154
GCA_019208045.1-Fun_JAHLVS010000003.1_i000_003251	190	415	225	1.00446	0.456389
GCA_019207715.1-Fun_JAHLVL010000003.1_i000_003026	190	415	225	1.00446	0.455466
GCA_019207725.1-Fun_JAHLVK010000003.1_i000_003085	190	415	225	1.00446	0.455466
GCA_019207815.1-Fun_JAHLVO010000002.1_i000_002511	190	415	225	1.00446	0.455466
GCA_019207825.1-Fun_JAHLVP010000003.1_i000_002693	190	415	225	1.00446	0.455466
GCA_019207835.1-Fun_JAHLVN010000002.1_i000_002253	190	415	225	1.00446	0.455466
GCA_019207905.1-Fun_JAHLVQ010000001.1_i000_001936	190	415	225	1.00446	0.455466
GCA_019208005.1-Fun_JAHLVR010000003.1_i000_002892	190	415	225	1.00446	0.455466
GCA_020536115.1-Fun_JAEUBD010001266.1_i000_003430	190	415	225	1.00446	0.455466
THSI003.0722.00001.C001_00145	147	366	219	0.977679	0.516509
GCA_001691835.3-Fun_JNHZ02000025.1_i000_004617	186	412	226	1.00893	0.398589
GCA_002906115.4-Pla_PKMF03009427.1_i000_033608	193	417	224	1	0.410256
GCA_002572855.1-Fun_PDND01000163.1_i000_002297	181	394	213	0.950893	0.327189
GCA_014066315.1-Fun_JACCJB010000009.1_i000_010926	182	399	217	0.96875	0.287037
GCA_000193285.1-Fun_GL876966.1_i000_000043	183	395	212	0.946429	0.351575
GCA_000001985.1-Fun_DS995899.1_i000_008140	190	414	224	1	0.37774
GCA_000750115.1-Fun_JPOX01000010.1_i000_003373	190	414	224	1	0.37774
GCA_009556855.1-Fun_CP045653.1_i000_000424	190	414	224	1	0.37774
GCA_009650675.1-Fun_CM018873.1_i000_001897	190	414	224	1	0.37774
GCA_022432505.1-Fun_JAJKKH010000001.1_i000_000715	182	398	216	0.964286	0.346709
GCA_002572885.1-Fun_PDNC01000113.1_i000_000814	181	394	213	0.950893	0.337559
GCA_002240705.1-Fun_NPHW01006087.1_i000_006104	182	408	226	1.00893	0.36748
GCA_017639395.1-Pla_CM029880.1_i000_011180	188	413	225	1.00446	0.505618
THBA001.0722.00001.C001_01467	147	366	219	0.977679	0.516509
GCA_015852495.1-Fun_JAAAIK010002017.1_i000_003662	1	130	129	0.575893	0.605634
GCA_000150035.1-Fun_DS480378.1_i000_005275	130	367	237	1.05804	0.48073
GCA_001006365.1-Fun_LCUC01000114.1_i000_000533	182	397	215	0.959821	0.360738
GCA_019456465.1-Fun_JAHXPR010000015.1_i000_006314	187	404	217	0.96875	0.288948
GCA_017918225.1-Pro_CM030554.1_i000_001901	158	379	221	0.986607	0.493304
GCA_002754855.1-Ani_MRZV01000470.1_i000_020344	183	407	224	1	0.382906
GCA_000503235.1-Fun_KI628564.1_i000_002302	182	398	216	0.964286	0.378284
GCA_004786265.1-Fun_PQXO01000114.1_i000_003249	182	398	216	0.964286	0.377622
GCA_017916305.1-Pro_CM030590.1_i000_001925	158	379	221	0.986607	0.490022
GCA_001008285.1-Fun_LCZI01001214.1_i000_007001	181	393	212	0.946429	0.325653
GCA_014898465.1-Fun_RCTA01000003.1_i000_002709	182	398	216	0.964286	0.377622
GCA_000442495.1-Pro_ATMH01001635.1_i000_001632	17	238	221	0.986607	0.762069
GCA_000442495.1-Pro_ATMH01008172.1_i000_008149	17	238	221	0.986607	0.762069
GCA_902155815.1-Fun_CABFWN010000004.1_i000_003182	180	396	216	0.964286	0.545455
GCA_002812745.2-Fun_NCSJ02000139.1_i000_001611	182	400	218	0.973214	0.359736
GCA_003615035.1-Fun_ML009500.1_i000_001234	205	431	226	1.00893	0.42243
GCA_000743665.3-Fun_JMRO03000063.1_i000_003355	172	389	217	0.96875	0.367797
GCA_002573585.1-Fun_PDNB01000041.1_i000_007111	182	396	214	0.955357	0.344605
GCA_002245835.2-Pla_LHPG02000021.1_i000_004586	187	448	261	1.16518	0.497143
GCA_001566295.1-Fun_KQ964245.1_i000_000161	182	400	218	0.973214	0.365772
GCA_003144205.1-Fun_KZ819603.1_i000_003950	190	415	225	1.00446	0.426136
GCA_003019895.1-Fun_KZ678440.1_i000_005493	182	396	214	0.955357	0.360877
GCA_013995675.1-Pro_VWRR01000006.1_i000_004310	184	397	213	0.950893	0.461039
GCA_022376655.1-Fun_JAJJKE010000064.1_i000_009384	182	400	218	0.973214	0.360331
GCA_000286095.1-Pro_CP003681.1_i000_000285	162	382	220	0.982143	0.564103
SASO001.0722.00001.C001_01987	156	380	224	1	0.543689
SASO001.0722.00002.C001_01987	156	380	224	1	0.543689
SASO001.0722.00003.C001_01987	156	380	224	1	0.543689
SASO001.0722.00004.C001_01942	156	380	224	1	0.543689
SASO001.0722.00005.C001_01937	156	380	224	1	0.543689
SASO001.0722.00006.C001_01942	156	380	224	1	0.543689
SASO001.0722.00007.C001_01939	156	380	224	1	0.543689
SASO001.0722.00008.C001_01938	156	380	224	1	0.543689
SASO001.0722.00009.C001_01942	156	380	224	1	0.543689
SASO001.0722.00010.C001_01942	156	380	224	1	0.543689
SASO001.0722.00011.C001_03190	156	380	224	1	0.543689
SASO001.0722.00012.C001_00998	156	380	224	1	0.543689
GCA_009731335.1-Pro_BLBS01000011.1_i000_001083	190	420	230	1.02679	0.485232
GCA_003357145.1-Fun_NPIC01000001.1_i000_001228	181	398	217	0.96875	0.303497
GCA_003788565.2-Fun_ML119666.1_i000_005172	111	330	219	0.977679	0.453416
GCA_910591605.1-Ani_CAJVCH010478535.1_i000_030827	19	197	178	0.794643	0.903553
GCA_000956045.1-Fun_KQ030498.1_i000_000055	181	389	208	0.928571	0.343234
GCA_001661395.1-Fun_KV454541.1_i000_003334	188	413	225	1.00446	0.442043
GCA_004155925.1-Fun_QJNX01000006.1_i000_009987	182	399	217	0.96875	0.341732
GCA_001006365.1-Fun_LCUC01000255.1_i000_004468	195	418	223	0.995536	0.431335
GCA_004170445.1-Pla_CM014329.1_i000_033435	207	377	170	0.758929	0.278232
GCA_004170445.1-Pla_CM014329.1_i000_033435	396	483	87	0.388393	0.14239
GCA_001578225.1-Fun_LFZO01000223.1_i000_003461	182	397	215	0.959821	0.376532
GCA_000002875.2-Pro_FR796447.1_i000_001883	158	379	221	0.986607	0.496629
GCA_000227135.2-Pro_FR799602.2_i000_001852	158	379	221	0.986607	0.496629
GCA_003719575.1-Pro_CP029514.1_i000_002044	158	379	221	0.986607	0.496629
GCA_900635355.2-Pro_LR812635.1_i000_001953	158	379	221	0.986607	0.496629
THBA002.0722.00001.C001_01505	147	366	219	0.977679	0.530266
GCA_014621425.1-Fun_JAANBB010000096.1_i000_013593	181	389	208	0.928571	0.354949
GCA_900617995.1-Ani_UZAL01039559.1_i000_017343	201	409	208	0.928571	0.345515
GCA_000149335.2-Fun_GG704916.1_i000_000563	182	396	214	0.955357	0.352554
GCA_000149895.1-Fun_DS028097.1_i000_002781	182	396	214	0.955357	0.352554
GCA_000151335.1-Fun_ACFW01000030.1_i000_003712	182	396	214	0.955357	0.352554
GCA_004115165.2-Fun_RHJW02000001.1_i000_000698	182	396	214	0.955357	0.353135
GCA_002077065.1-Fun_NAJO01000005.1_i000_014258	194	418	224	1	0.385542
GCA_000150055.1-Fun_DS268114.1_i000_000549	182	396	214	0.955357	0.352554
GCA_000223465.1-Fun_GL996510.1_i000_000328	190	415	225	1.00446	0.444664
GCA_002897235.1-Pro_BDSA01000002.1_i000_002203	183	400	217	0.96875	0.494305
GCA_000264995.1-Fun_JH687539.1_i000_002113	186	397	211	0.941964	0.522277
GCA_000146945.2-Fun_CH476639.1_i000_002635	182	398	216	0.964286	0.378947
GCA_001857865.1-Fun_CP017818.1_i000_004185	182	398	216	0.964286	0.378947
GCA_000182805.2-Fun_CABT02000046.1_i000_001543	195	406	211	0.941964	0.408915
GCA_900332095.2-Pla_OOIL02005040.1_i000_035511	186	411	225	1.00446	0.413603
GCA_000182765.2-Fun_HE605206.1_i000_001722	188	413	225	1.00446	0.449102
GCA_014049445.1-Fun_JABWAB010000001.1_i000_000079	188	413	225	1.00446	0.449102
GCA_014049455.1-Fun_JABWAA010000001.1_i000_000079	188	413	225	1.00446	0.449102
GCA_014049495.1-Fun_JABWAC010000001.1_i000_000079	188	413	225	1.00446	0.449102
GCA_014049585.1-Fun_JABVZZ010000001.1_i000_001332	188	413	225	1.00446	0.449102
GCA_903989565.1-Fun_CAJEJE010000001.1_i000_000078	188	413	225	1.00446	0.449102
GCA_000530735.1-Fun_CBTC010000075.1_i000_006312	180	401	221	0.986607	0.421756
GCA_016584265.1-Fun_PUHW01000222.1_i000_001896	243	468	225	1.00446	0.451807
THSP013.0722.00001.C001_01672	147	366	219	0.977679	0.51773
GCA_003019875.1-Fun_KZ679007.1_i000_001826	180	397	217	0.96875	0.373494
GCA_905066765.1-Fun_CAJHIA010000007.1_i000_002019	182	398	216	0.964286	0.380952
GCA_905237085.1-Pro_CAJNNV010031529.1_i000_052088	181	403	222	0.991071	0.4625
GCA_905237095.1-Pro_CAJNNW010031279.1_i000_034317	181	403	222	0.991071	0.4625
GCA_001696595.2-Fun_MBFL02000434.1_i000_008500	182	406	224	1	0.390244
GCA_000187245.3-Fun_CM002304.1_i000_003345	190	415	225	1.00446	0.455466
GCA_019207595.1-Fun_JAHLVG010000004.1_i000_003382	190	415	225	1.00446	0.455466
GCA_019207695.1-Fun_JAHLVH010000005.1_i000_004567	190	415	225	1.00446	0.455466
GCA_019207935.1-Fun_JAHLVI010000001.1_i000_001940	190	415	225	1.00446	0.455466
GCA_010405405.1-Fun_MU004239.1_i000_009148	183	398	215	0.959821	0.380531
GCA_000188675.2-Pro_ADWP02026287.1_i000_010673	190	420	230	1.02679	0.47817
GCA_000496795.1-Pro_AYLP01000094.1_i000_005920	190	420	230	1.02679	0.47817
GCA_002219105.2-Pro_MBSY01000747.1_i000_012972	190	420	230	1.02679	0.47817
GCA_003719455.1-Pro_MKKV01000118.1_i000_006471	190	420	230	1.02679	0.47817
GCA_015033625.1-Pro_CM026612.1_i000_011005	190	420	230	1.02679	0.47817
GCA_003177105.1-Pro_PRFA01000021.1_i000_005473	190	420	230	1.02679	0.47817
GCA_008692225.1-Fun_VICG01000002.1_i000_001557	182	398	216	0.964286	0.379613
GCA_016906325.1-Fun_RKRL01000002.1_i000_000968	182	398	216	0.964286	0.379613
GCA_009299455.1-Fun_VIGI01000001.1_i000_000192	182	398	216	0.964286	0.379613
GCA_019096155.1-Fun_JAHCVI010000005.1_i000_009890	177	387	210	0.9375	0.356537
GCA_003260565.1-Fun_QKRW01000046.1_i000_008602	182	398	216	0.964286	0.380282
GCA_001664045.1-Fun_AECK01000003.1_i000_001904	190	415	225	1.00446	0.455466
GCA_019207735.1-Fun_JAHLVJ010000002.1_i000_002492	190	415	225	1.00446	0.455466
GCA_019207965.1-Fun_JAHLVM010000003.1_i000_002870	190	415	225	1.00446	0.455466
GCA_019207995.1-Fun_JAHLVT010000002.1_i000_002307	190	415	225	1.00446	0.455466
GCA_015852435.1-Fun_JAAAIJ010003532.1_i000_007121	1	181	180	0.803571	0.994475
GCA_000002595.3-Pla_CM008973.1_i000_012479	187	410	223	0.995536	0.44334
GCA_000751015.1-Pla_LK032588.1_i000_037115	188	413	225	1.00446	0.505618
GCA_021399475.1-Fun_JAJTUR010000069.1_i000_014547	182	398	216	0.964286	0.305085
GCA_004931855.1-Fun_SELW01000142.1_i000_000690	110	328	218	0.973214	0.575198
GCA_021014945.1-Fun_MU266455.1_i000_008069	185	410	225	1.00446	0.422932
GCA_021365275.1-Fun_JAJTIY010000002.1_i000_008385	182	398	216	0.964286	0.350081
GCA_019207475.1-Fun_JAHLUX010000004.1_i000_003329	190	415	225	1.00446	0.447316
GCA_019207505.1-Fun_JAHLUZ010000003.1_i000_002761	190	415	225	1.00446	0.447316
GCA_019207515.1-Fun_JAHLVA010000004.1_i000_003124	190	415	225	1.00446	0.447316
GCA_019207585.1-Fun_JAHLVF010000004.1_i000_003072	190	415	225	1.00446	0.447316
GCA_019207635.1-Fun_JAHLVE010000004.1_i000_003308	190	415	225	1.00446	0.447316
GCA_000170175.2-Fun_GL636488.1_i000_002449	182	396	214	0.955357	0.352554
GCA_018416015.1-Fun_CP075069.1_i000_002989	182	396	214	0.955357	0.352554
GCA_014595645.1-Fun_JACTAD010000007.1_i000_013519	182	397	215	0.959821	0.360134
GCA_019207455.1-Fun_JAHLUW010000004.1_i000_003437	190	415	225	1.00446	0.447316
GCA_019207555.1-Fun_JAHLUY010000005.1_i000_004192	190	415	225	1.00446	0.447316
GCA_019207615.1-Fun_JAHLVC010000003.1_i000_002984	190	415	225	1.00446	0.447316
GCA_002865625.1-Fun_KZ613468.1_i000_002430	182	398	216	0.964286	0.304654
GCA_014904845.1-Fun_MU119214.1_i000_003486	182	398	216	0.964286	0.333333
GCA_000769265.1-Fun_JPKY01000024.1_i000_003902	194	419	225	1.00446	0.431034
GCA_021399445.1-Fun_JAJTUQ010000001.1_i000_001016	182	399	217	0.96875	0.356908
THCE001.0722.00001.C001_00934	148	366	218	0.973214	0.512941
GCA_020379485.1-Pla_JAGKQM010000756.1_i000_090767	188	413	225	1.00446	0.497788
GCA_003260385.1-Pla_NQVE01000162.1_i000_009325	186	411	225	1.00446	0.412088
GCA_019206905.1-Fun_JAHLUB010000003.1_i000_003260	190	415	225	1.00446	0.449102
GCA_019206925.1-Fun_JAHLUE010000004.1_i000_003464	190	415	225	1.00446	0.449102
GCA_019206965.1-Fun_JAHLUF010000003.1_i000_003197	190	415	225	1.00446	0.449102
GCA_019206985.1-Fun_JAHLUC010000002.1_i000_002650	190	415	225	1.00446	0.449102
GCA_019207125.1-Fun_JAHLUD010000002.1_i000_002601	190	415	225	1.00446	0.449102
GCA_019207165.1-Fun_JAHLUV010000002.1_i000_002476	190	415	225	1.00446	0.449102
GCA_019207175.1-Fun_JAHLUI010000003.1_i000_003647	190	415	225	1.00446	0.449102
GCA_019207185.1-Fun_JAHLUG010000002.1_i000_002509	190	415	225	1.00446	0.449102
GCA_019207205.1-Fun_JAHLUJ010000003.1_i000_003108	190	415	225	1.00446	0.449102
GCA_019207235.1-Fun_JAHLUK010000005.1_i000_003751	190	415	225	1.00446	0.449102
GCA_019207265.1-Fun_JAHLUN010000002.1_i000_002595	190	415	225	1.00446	0.449102
GCA_019207285.1-Fun_JAHLUL010000001.1_i000_001965	190	415	225	1.00446	0.449102
GCA_019207315.1-Fun_JAHLUO010000003.1_i000_003112	190	415	225	1.00446	0.449102
GCA_019207325.1-Fun_JAHLUP010000005.1_i000_003705	190	415	225	1.00446	0.449102
GCA_019207365.1-Fun_JAHLUQ010000003.1_i000_003392	190	415	225	1.00446	0.449102
GCA_019207415.1-Fun_JAHLUU010000003.1_i000_003097	190	415	225	1.00446	0.449102
GCA_019207435.1-Fun_JAHLUT010000004.1_i000_003348	190	415	225	1.00446	0.449102
GCA_000827265.1-Fun_KN834807.1_i000_016393	191	433	242	1.08036	0.423077
GCA_019207005.1-Fun_JAHLUH010000004.1_i000_003548	190	415	225	1.00446	0.448207
GCA_019207375.1-Fun_JAHLUR010000002.1_i000_003219	190	415	225	1.00446	0.448207
GCA_019207405.1-Fun_JAHLUS010000004.1_i000_003622	190	415	225	1.00446	0.448207
GCA_014595645.1-Fun_JACTAD010000011.1_i000_003811	195	418	223	0.995536	0.430502
GCA_016695485.1-Fun_MU172348.1_i000_012891	185	394	209	0.933036	0.466518
GCA_016647635.1-Fun_JABBWG010000020.1_i000_005382	185	400	215	0.959821	0.530864
GCA_019207295.1-Fun_JAHLUM010000004.1_i000_003365	190	415	225	1.00446	0.442913
GCA_000166155.1-Fun_GL538363.1_i000_000887	181	394	213	0.950893	0.335962
GCA_011503125.2-Fun_WWBZ02000040.1_i000_009231	182	396	214	0.955357	0.379433
GCA_011503125.2-Fun_WWBZ02000082.1_i000_013469	182	396	214	0.955357	0.379433
PYFU002.0722.00001.C001_01814	161	382	221	0.986607	0.53253
GCA_000003525.2-Fun_EQ999977.1_i000_005079	181	394	213	0.950893	0.335962
GCA_000151595.1-Fun_GG749423.1_i000_006571	181	394	213	0.950893	0.335962
GCA_005059855.1-Fun_NAJP01000035.1_i000_009337	182	398	216	0.964286	0.357025
GCA_000003855.2-Fun_GG657470.1_i000_008402	181	394	213	0.950893	0.335962
GCA_013054445.1-Fun_JAAMPI010000326.1_i000_008746	181	397	216	0.964286	0.321429
GCA_013677255.1-Pla_CM025225.1_i000_011194	188	394	206	0.919643	0.522843
GCA_000166005.1-Fun_GL535264.1_i000_006368	177	385	208	0.928571	0.364273
GCA_009728635.1-Fun_WJSK01000003.1_i000_002813	177	385	208	0.928571	0.364273
GCA_009728645.1-Fun_WJSL01000004.1_i000_004314	177	385	208	0.928571	0.364273
GCA_009728655.1-Fun_WJSN01000003.1_i000_003554	177	385	208	0.928571	0.364273
GCA_009728665.1-Fun_WJSO01000003.1_i000_003605	177	385	208	0.928571	0.364273
GCA_009728675.1-Fun_WJSM01000003.1_i000_002661	177	385	208	0.928571	0.364273
GCA_900231935.2-Fun_OCTF02000005.1_i000_006027	177	385	208	0.928571	0.364273
GCA_900232045.3-Fun_HG992981.1_i000_006568	177	385	208	0.928571	0.364273
GCA_016800925.1-Fun_JABCPU010000153.1_i000_003810	185	396	211	0.941964	0.520988
GCA_017365405.1-Fun_JAFJYH010000304.1_i000_013247	182	398	216	0.964286	0.338028
THIN004.0722.00001.C001_02173	148	366	218	0.973214	0.514151
STAZ001.0722.00001.C001_00880	155	378	223	0.995536	0.545232
GCA_000277815.3-Fun_CP002722.1_i000_001496	166	387	221	0.986607	0.451943
GCA_015832175.1-Fun_WJXW01000012.1_i000_010486	192	415	223	0.995536	0.43301
GCA_004014815.1-Fun_RYZI01000426.1_i000_007304	191	436	245	1.09375	0.460526
GCA_017918235.1-Pro_CM030518.1_i000_001686	158	379	221	0.986607	0.493304
GCA_900119595.1-Fun_FQNF01000170.1_i000_000610	183	403	220	0.982143	0.44
COCA004.0722.00001.C001_01565	150	373	223	0.995536	0.550617
GCA_002087225.1-Pro_NBCO01000025.1_i000_004228	190	420	230	1.02679	0.472279
GCA_002844615.1-Fun_MVDW01000024.1_i000_004400	192	416	224	1	0.404332
GCA_002844615.1-Fun_MVDW01000034.1_i000_005372	182	397	215	0.959821	0.379859
GCA_000699945.1-Ani_JMFT01216671.1_i000_011303	170	349	179	0.799107	0.511429
GCA_001675575.1-Ani_LZPO01055082.1_i000_011060	142	347	205	0.915179	0.45354
GCA_000003515.2-Fun_CH476619.1_i000_007126	182	396	214	0.955357	0.351974
GCA_000499605.1-Pro_HG718948.1_i000_000547	205	435	230	1.02679	0.414414
GCA_001245095.1-Fun_CDQK01000002.1_i000_001798	181	401	220	0.982143	0.429688
GCA_001661405.1-Fun_KV453935.1_i000_004282	181	401	220	0.982143	0.429688
GCA_001749795.1-Fun_LPNL01000008.1_i000_003589	183	403	220	0.982143	0.442656
GCA_003719485.1-Pro_MKKU01000330.1_i000_005532	190	420	230	1.02679	0.472279
GCA_911649665.1-Fun_CAJVRL010000101.1_i000_011973	180	397	217	0.96875	0.24382
GCA_019207525.1-Fun_JAHLVB010000005.1_i000_003912	190	415	225	1.00446	0.447316
GCA_019207605.1-Fun_JAHLVD010000004.1_i000_003810	190	415	225	1.00446	0.447316
GCA_002865645.1-Fun_KZ613785.1_i000_005577	182	398	216	0.964286	0.271016
GCA_002914845.1-Pla_JXTC01000007.1_i000_002532	65	171	106	0.473214	0.609195
GCA_016584195.1-Fun_PUHU01000214.1_i000_001887	360	585	225	1.00446	0.365854
GCA_900073065.1-Fun_FJOG01000011.1_i000_012792	111	327	216	0.964286	0.505855
GCA_010093795.1-Fun_MU006569.1_i000_003833	111	326	215	0.959821	0.426587
GCA_000825705.1-Fun_CDHN01000001.1_i000_000126	182	390	208	0.928571	0.350759
GCA_010015705.1-Fun_ML977176.1_i000_009296	183	399	216	0.964286	0.363636
GCA_016834605.1-Pla_JAEHOC010000008.1_i000_004667	187	410	223	0.995536	0.444223
IGHO001.0722.00001.C001_00075	172	395	223	0.995536	0.515012
GCA_905231915.1-Pro_CAJNJA010091941.1_i000_033972	6	166	160	0.714286	0.627451
GCA_013677255.1-Pla_CM025219.1_i000_000386	117	323	206	0.919643	0.635802
THNA002.0722.00001.C001_01692	147	366	219	0.977679	0.52019
THHE001.0722.00001.C001_02043	147	366	219	0.977679	0.518957
THSP017.0722.00001.C001_02103	147	366	219	0.977679	0.518957
GCA_005059855.1-Fun_NAJP01000114.1_i000_001738	182	397	215	0.959821	0.345659
GCA_900618515.1-Ani_UZAO01051776.1_i000_003984	176	387	211	0.941964	0.378815
GCA_000321355.1-Pro_DF157100.1_i000_001653	181	389	208	0.928571	0.485981
GCA_001747045.1-Fun_LPNM01000007.1_i000_003274	181	402	221	0.986607	0.422562
GCA_021365365.1-Fun_JAJTIX010000016.1_i000_005077	181	388	207	0.924107	0.352641
GCA_003704355.1-Fun_QWIL01000730.1_i000_007046	193	417	224	1	0.405797
GCA_003704385.1-Fun_QWIM01002752.1_i000_014594	193	417	224	1	0.405797
GCA_001278495.1-Fun_LGSR01000006.1_i000_002183	181	393	212	0.946429	0.349259
GCA_016584275.1-Fun_PUHV01000073.1_i000_004270	181	401	220	0.982143	0.426357
GCA_009613015.1-Fun_VXCB01000087.1_i000_013602	179	396	217	0.96875	0.326316
GCA_016584165.1-Fun_PUHT01000005.1_i000_003787	181	401	220	0.982143	0.431373
GCA_900184115.1-Fun_LT854253.1_i000_000392	182	398	216	0.964286	0.377622
GCA_900002375.2-Pro_LK023127.2_i000_003150	181	402	221	0.986607	0.471215
GCA_900044335.1-Pro_LT160032.1_i000_003098	181	402	221	0.986607	0.471215
GCA_900088445.1-Pro_LT614638.1_i000_002939	181	402	221	0.986607	0.471215
GCA_900095545.1-Pro_LT608148.1_i000_002935	181	402	221	0.986607	0.471215
GCA_900095585.1-Pro_LT608276.1_i000_002950	181	402	221	0.986607	0.471215
GCA_900095635.1-Pro_LT608260.1_i000_002930	181	402	221	0.986607	0.471215
GCA_001417835.1-Fun_AP014600.1_i000_001113	181	401	220	0.982143	0.42885
GCA_001417885.1-Fun_AP012214.1_i000_001112	181	401	220	0.982143	0.42885
GCA_001854445.2-Fun_CP015055.1_i000_001152	181	401	220	0.982143	0.42885
GCA_000002825.1-Pro_DS113281.1_i000_049623	188	410	222	0.991071	0.390158
GCA_001883805.1-Fun_LGTZ01000830.1_i000_009460	181	394	213	0.950893	0.336493
GCA_013389885.1-Ani_VWPV01018471.1_i000_006457	180	359	179	0.799107	0.497222
GCA_001702395.2-Fun_MAVT02000972.1_i000_009044	182	397	215	0.959821	0.362563
GCA_000003085.2-Pro_AABL01001848.1_i000_002600	181	401	220	0.982143	0.469083
GCA_000505035.1-Pro_KI635790.1_i000_004173	181	401	220	0.982143	0.469083
GCA_900002385.2-Pro_LM993666.2_i000_004043	181	401	220	0.982143	0.469083
GCA_900002395.1-Pro_LK934640.1_i000_003399	181	401	220	0.982143	0.469083
GCA_000340215.1-Fun_KB446558.1_i000_006228	182	397	215	0.959821	0.377193
GCA_910393935.1-Fun_CAJSTJ010000022.1_i000_000484	181	389	208	0.928571	0.348993
GCA_000219625.1-Fun_CM001196.1_i000_000338	182	398	216	0.964286	0.377622
GCA_900091695.1-Fun_LT853692.1_i000_000392	182	398	216	0.964286	0.377622
GCA_900099495.1-Fun_LT882676.1_i000_000399	182	398	216	0.964286	0.377622
GCA_010093585.1-Fun_MU002012.1_i000_009648	182	391	209	0.933036	0.366667
GCA_003316985.1-Fun_QKXC01000297.1_i000_006429	181	389	208	0.928571	0.348409
GCA_021399465.1-Fun_JAJTUS010000037.1_i000_010447	182	398	216	0.964286	0.249135
GCA_002742065.1-Fun_CM008500.1_i000_002766	192	416	224	1	0.404332
GCA_019650295.1-Fun_BOLY01000001.1_i000_001631	192	416	224	1	0.404332
GCA_019321695.1-Fun_JAHWGW010000008.1_i000_007312	182	397	215	0.959821	0.362563
GCA_905219625.1-Fun_CAJMWX010001121.1_i000_005906	187	405	218	0.973214	0.392793
GCA_000259595.1-Fun_AHIQ01000042.1_i000_000606	156	376	220	0.982143	0.426357
GCA_020744515.1-Fun_JAGPXF010000001.1_i000_002075	180	388	208	0.928571	0.350759
GCA_000751175.1-Pro_CCKQ01012108.1_i000_012583	188	411	223	0.995536	0.437255
GCA_000280035.2-Fun_CP003528.1_i000_001430	166	386	220	0.982143	0.45082
GCA_013400395.1-Ani_WBNN01012465.1_i000_004090	115	269	154	0.6875	0.334056
GCA_013400395.1-Ani_WBNN01012465.1_i000_004090	280	330	50	0.223214	0.10846
GCA_022160335.1-Fun_MU274920.1_i000_008322	185	391	206	0.919643	0.520202
GCA_010108815.1-Ani_QWKW01006511.1_i000_003838	126	354	228	1.01786	0.549398
GCA_001653215.1-Fun_LUKN01003658.1_i000_000591	181	388	207	0.924107	0.349073
GCA_000418435.1-Fun_KE374994.1_i000_001479	184	400	216	0.964286	0.343949
GCA_900519115.1-Fun_LR026990.1_i000_004995	184	400	216	0.964286	0.343949
GCA_905067625.1-Fun_LR898474.1_i000_004698	184	400	216	0.964286	0.343949
GCA_001636795.1-Fun_AZHF01000010.1_i000_002294	181	389	208	0.928571	0.351946
GCA_011074885.2-Fun_CP063136.1_i000_003571	180	400	220	0.982143	0.413534
GCA_014176175.1-Fun_JABCYN010000034.1_i000_003929	180	400	220	0.982143	0.413534
GCA_014176185.1-Fun_JABCYO010000002.1_i000_000214	180	400	220	0.982143	0.413534
GCA_018342045.1-Fun_JAGEXW010000001.1_i000_000052	166	387	221	0.986607	0.451943
GCA_009768925.2-Pro_VHIT02000011.1_i000_003183	190	417	227	1.01339	0.455823
GCA_004155945.1-Fun_QJNY01000092.1_i000_011802	182	399	217	0.96875	0.35342
GCA_000523435.1-Fun_KI964564.1_i000_003203	177	393	216	0.964286	0.379613
GCA_905337355.1-Fun_CAJPDT010000026.1_i000_004074	211	428	217	0.96875	0.276081
GCA_000412225.2-Fun_CP006022.1_i000_001344	181	401	220	0.982143	0.423077
GCA_900074925.1-Fun_FJUY01000001.1_i000_008046	192	416	224	1	0.411765
GCA_000091025.4-Fun_AE016819.5_i000_003549	181	401	220	0.982143	0.42885
GCA_002220235.1-Pla_FO082275.1_i000_001974	187	413	226	1.00893	0.469854
MESP085.0722.00001.C001_01523	142	366	224	1	0.541063
GCA_000968835.1-Fun_CP002710.1_i000_003548	181	401	220	0.982143	0.426357
GCA_018127125.1-Pla_CM030794.1_i000_021464	107	327	220	0.982143	0.552764
GCA_022376275.1-Fun_JAJNOH010000004.1_i000_008952	182	398	216	0.964286	0.308131
GCA_001653205.1-Fun_LSBH01000004.1_i000_005854	181	390	209	0.933036	0.350084
GCA_001653265.1-Fun_LSBI01000006.1_i000_006774	181	390	209	0.933036	0.350084
GCA_003144605.1-Fun_LCWV01000019.1_i000_004190	181	390	209	0.933036	0.350084
GCA_003144135.1-Fun_KZ819321.1_i000_000570	189	413	224	1	0.397869
PYSP001.0722.00001.C001_00136	147	366	219	0.977679	0.544776
GCA_905219635.1-Fun_CAJMWY010002170.1_i000_004960	224	441	217	0.96875	0.35342
GCA_013266265.1-Fun_JABFAK010000153.1_i000_003201	181	388	207	0.924107	0.346734
GCA_001572075.1-Fun_JOOL01000710.1_i000_004759	192	417	225	1.00446	0.395431
GCA_001592465.1-Fun_JPDO01000113.1_i000_000713	192	417	225	1.00446	0.395431
SUAC003.0722.00001.C001_01361	155	377	222	0.991071	0.538835
SUAC003.0722.00002.C001_01365	155	377	222	0.991071	0.538835
SUAC003.0722.00003.C001_01389	155	377	222	0.991071	0.538835
SUAC003.0722.00004.C001_01331	155	377	222	0.991071	0.538835
SUAC003.0722.00005.C001_01331	155	377	222	0.991071	0.538835
GCA_000732775.1-Fun_KL659360.1_i000_000885	205	429	224	1	0.422642
GCA_020536115.1-Fun_JAEUBD010000983.1_i000_002979	181	400	219	0.977679	0.439759
STSP138.0722.00001.C001_02446	155	378	223	0.995536	0.547912
GCA_010093985.1-Fun_ML992709.1_i000_011178	192	416	224	1	0.404332
GCA_009731335.1-Pro_BLBS01000019.1_i000_001975	158	379	221	0.986607	0.497748
GCA_000442495.1-Pro_ATMH01002882.1_i000_002876	158	378	220	0.982143	0.510441
GCA_019208005.1-Fun_JAHLVR010000002.1_i000_002324	181	400	219	0.977679	0.439759
GCA_001664045.1-Fun_AECK01000002.1_i000_001221	181	400	219	0.977679	0.437126
GCA_019207715.1-Fun_JAHLVL010000001.1_i000_001907	181	400	219	0.977679	0.437126
GCA_019207725.1-Fun_JAHLVK010000002.1_i000_002514	181	400	219	0.977679	0.437126
GCA_019207735.1-Fun_JAHLVJ010000007.1_i000_004594	181	400	219	0.977679	0.437126
GCA_019207815.1-Fun_JAHLVO010000001.1_i000_001879	181	400	219	0.977679	0.437126
GCA_019207825.1-Fun_JAHLVP010000002.1_i000_002146	181	400	219	0.977679	0.437126
GCA_019207835.1-Fun_JAHLVN010000001.1_i000_001620	181	400	219	0.977679	0.437126
GCA_019207905.1-Fun_JAHLVQ010000003.1_i000_003092	181	400	219	0.977679	0.437126
GCA_019207965.1-Fun_JAHLVM010000002.1_i000_002320	181	400	219	0.977679	0.437126
GCA_019207995.1-Fun_JAHLVT010000004.1_i000_003557	181	400	219	0.977679	0.437126
GCA_019208045.1-Fun_JAHLVS010000002.1_i000_002469	181	400	219	0.977679	0.437126
GCA_003543875.1-Pro_CM010679.1_i000_003654	65	295	230	1.02679	0.642458
GCA_000150475.2-Fun_KN305540.1_i000_006293	140	354	214	0.955357	0.352554
GCA_004786245.1-Fun_PQXK01000146.1_i000_007730	182	398	216	0.964286	0.378284
GCA_004916875.1-Fun_PQXL01000186.1_i000_006422	182	398	216	0.964286	0.378284
GCA_013396595.1-Ani_VWZB01003567.1_i000_012634	115	312	197	0.879464	0.63141
GCA_013461495.1-Fun_JABFCT010000011.1_i000_007887	182	398	216	0.964286	0.378947
GCA_004786125.1-Fun_PQXH01000078.1_i000_006367	182	398	216	0.964286	0.378284
GCA_004786145.1-Fun_PQXI01000039.1_i000_003752	182	398	216	0.964286	0.378284
PYFU001.0722.00001.C001_01600	147	367	220	0.982143	0.547264
PYFU001.0722.00002.C001_00045	147	367	220	0.982143	0.547264
GCA_013402915.1-Fun_CP058605.1_i000_001483	118	350	232	1.03571	0.491525
GCA_000147415.1-Pla_GL433838.1_i000_002196	1096	1138	42	0.1875	0.0315315
GCA_000147415.1-Pla_GL433838.1_i000_002196	1132	1295	163	0.727679	0.122372
GCA_014898285.1-Fun_RCSV01000001.1_i000_000404	182	398	216	0.964286	0.378284
GCA_003704385.1-Fun_QWIM01000306.1_i000_003925	162	376	214	0.955357	0.361486
GCA_014898425.1-Fun_RCSZ01000003.1_i000_002726	182	398	216	0.964286	0.378284
GCA_000143535.4-Fun_CP009809.1_i000_004317	182	398	216	0.964286	0.380282
GCA_000227075.1-Fun_FQ790347.1_i000_012784	182	398	216	0.964286	0.380282
GCA_000349525.1-Fun_KB707880.1_i000_005478	182	398	216	0.964286	0.380282
GCA_001661245.1-Fun_KV454012.1_i000_001229	190	415	225	1.00446	0.450902
GCA_004379285.1-Fun_PHWZ01000353.1_i000_009024	188	404	216	0.964286	0.376307
GCA_010015825.1-Fun_ML977315.1_i000_003746	177	393	216	0.964286	0.375652
GCA_003171515.3-Fun_CM025796.1_i000_004457	177	385	208	0.928571	0.374101
GCA_003171545.1-Fun_NQWZ01000127.1_i000_005282	177	385	208	0.928571	0.374101
GCA_003231325.2-Fun_MVBF02000002.1_i000_004774	177	385	208	0.928571	0.374101
GCA_003231345.1-Fun_MVBI01000127.1_i000_005325	177	385	208	0.928571	0.374101
GCA_003231355.1-Fun_MVBG01000054.1_i000_003297	177	385	208	0.928571	0.374101
GCA_003231365.1-Fun_MVBH01000002.1_i000_000262	177	385	208	0.928571	0.374101
GCA_003231415.2-Fun_MUXC02000002.1_i000_004836	177	385	208	0.928571	0.374101
GCA_003231425.1-Fun_NRDI01000135.1_i000_005698	177	385	208	0.928571	0.374101
GCA_008692205.1-Fun_SAXQ01000002.1_i000_004686	177	385	208	0.928571	0.374101
GCA_020536225.1-Fun_JAEUBG010001205.1_i000_002248	181	401	220	0.982143	0.434783
GCA_002127715.1-Fun_MUNK01000033.1_i000_005847	182	396	214	0.955357	0.348534
GCA_003704675.1-Fun_QWIS01000309.1_i000_005091	182	396	214	0.955357	0.348534
GCA_003704685.1-Fun_QWIT01000959.1_i000_016896	182	396	214	0.955357	0.348534
GCA_020747065.1-Fun_JAGMVK010000010.1_i000_001529	182	398	216	0.964286	0.333849
GCA_001447515.1-Pro_LDAU01000073.1_i000_001700	179	398	219	0.977679	0.459119
GCA_900184105.1-Fun_LT854273.1_i000_000384	182	398	216	0.964286	0.377622
GCA_006381635.2-Pla_VEPZ02000981.1_i000_030936	177	221	44	0.196429	0.0852713
GCA_006381635.2-Pla_VEPZ02000981.1_i000_030936	216	358	142	0.633929	0.275194
THCA001.0722.00001.C001_00057	160	381	221	0.986607	0.548387
GCA_003704585.1-Fun_QWIP01000095.1_i000_015760	182	396	214	0.955357	0.348534
GCA_000143455.1-Pla_GL378357.1_i000_007798	186	410	224	1	0.445328
GCA_003704595.1-Fun_QWIO01000060.1_i000_001041	182	396	214	0.955357	0.347967
GCA_000769215.1-Fun_JPYM01000010.1_i000_001595	180	388	208	0.928571	0.351351
GCA_002127715.1-Fun_MUNK01000208.1_i000_004185	182	396	214	0.955357	0.350245
GCA_003704685.1-Fun_QWIT01000561.1_i000_012413	182	396	214	0.955357	0.350245
GCA_003704595.1-Fun_QWIO01000377.1_i000_004351	182	396	214	0.955357	0.349103
GCA_003704385.1-Fun_QWIM01001068.1_i000_009126	182	396	214	0.955357	0.349673
GCA_010093985.1-Fun_ML992665.1_i000_002460	182	397	215	0.959821	0.379189
GCA_003704375.1-Fun_QWIK01000942.1_i000_016273	182	396	214	0.955357	0.349673
GCA_003704345.1-Fun_QWIJ01001152.1_i000_001212	182	396	214	0.955357	0.349673
GCA_003704645.1-Fun_QWIR01000357.1_i000_005250	182	396	214	0.955357	0.350245
MESE002.0722.00001.C001_01782	155	375	220	0.982143	0.537897
MESE002.0722.00002.C001_01782	155	375	220	0.982143	0.537897
MESE002.0722.00003.C001_01782	155	375	220	0.982143	0.537897
MESE002.0722.00004.C001_01781	155	375	220	0.982143	0.537897
MESE002.0722.00005.C001_01781	155	375	220	0.982143	0.537897
MESP038.0722.00001.C001_01849	155	375	220	0.982143	0.537897
GCA_000150735.2-Fun_KN275965.1_i000_006622	182	396	214	0.955357	0.329738
GCA_001713695.1-Fun_LYUC01000081.1_i000_007673	182	396	214	0.955357	0.329738
GCA_003704355.1-Fun_QWIL01000164.1_i000_002428	182	396	214	0.955357	0.349673
GCA_003704585.1-Fun_QWIP01000441.1_i000_009727	182	396	214	0.955357	0.349673
GCA_003704615.1-Fun_QWIQ01000040.1_i000_008331	182	396	214	0.955357	0.349673
GCA_020744115.1-Fun_JAGMVH010000001.1_i000_002068	180	388	208	0.928571	0.350759
GCA_003704575.1-Fun_QWIN01000166.1_i000_004084	182	396	214	0.955357	0.349673
GCA_001713645.1-Fun_LZYO01000619.1_i000_006591	182	396	214	0.955357	0.329231
GCA_000966595.1-Fun_LAFY01000460.1_i000_004861	182	398	216	0.964286	0.377622
GCA_015033655.1-Pro_CM026650.1_i000_010148	190	420	230	1.02679	0.47817
GCA_003177095.1-Pro_PRFC01000122.1_i000_003160	190	420	230	1.02679	0.47817
GCA_000149985.1-Fun_DS231616.1_i000_009032	177	385	208	0.928571	0.364273
GCA_005059865.1-Fun_NAJQ01000287.1_i000_006645	179	403	224	1	0.402154
GCA_004786205.1-Fun_PQXM01000044.1_i000_001667	182	398	216	0.964286	0.378284
GCA_014898435.1-Fun_RCTB01000004.1_i000_002700	182	398	216	0.964286	0.378284
GCA_014898485.1-Fun_RCTC01000004.1_i000_003059	182	398	216	0.964286	0.378284
GCA_014898535.1-Fun_RCSX01000002.1_i000_001287	182	398	216	0.964286	0.378284
GCA_014898555.1-Fun_RCSY01000001.1_i000_000308	182	398	216	0.964286	0.378284
GCA_001661255.1-Fun_KV454211.1_i000_004419	181	401	220	0.982143	0.429688
GCA_003073865.1-Fun_KZ804147.1_i000_009790	182	398	216	0.964286	0.318115
GCA_020744155.1-Fun_JAGPNQ010000007.1_i000_018648	181	388	207	0.924107	0.352641
GCA_000300495.1-Pro_AHKC01019303.1_i000_009028	190	420	230	1.02679	0.475207
GCA_000442575.2-Pro_ATMG01008881.1_i000_008020	158	379	221	0.986607	0.536408
GCA_903995115.1-Pro_LR877167.1_i000_009333	158	379	221	0.986607	0.536408
GCA_900660285.1-Fun_CAACVR010000012.1_i000_002374	180	400	220	0.982143	0.415879
GCA_002742065.1-Fun_CM008508.1_i000_011653	182	397	215	0.959821	0.379859
GCA_019650295.1-Fun_BOLY01000003.1_i000_005682	182	397	215	0.959821	0.379859
GCA_002933655.1-Fun_PNEN01000556.1_i000_010285	182	397	215	0.959821	0.379859
GCA_000002845.2-Pro_FR798989.1_i000_001791	158	379	221	0.986607	0.497748
GCA_900537975.1-Pro_LS997614.1_i000_001969	158	379	221	0.986607	0.497748
GCA_000755165.1-Pro_CP009384.1_i000_001750	158	379	221	0.986607	0.497748
GCA_014607435.1-Fun_JAACFV010000098.1_i000_012463	182	409	227	1.01339	0.303882
GCA_009792415.2-Pro_VHLK02000057.1_i000_001784	190	417	227	1.01339	0.466119
GCA_019207235.1-Fun_JAHLUK010000002.1_i000_002671	181	400	219	0.977679	0.439759
GCA_019207285.1-Fun_JAHLUL010000002.1_i000_002732	181	400	219	0.977679	0.439759
GCA_019206905.1-Fun_JAHLUB010000001.1_i000_001953	181	400	219	0.977679	0.439759
GCA_019206915.1-Fun_JAHLUA010000005.1_i000_003898	181	400	219	0.977679	0.439759
GCA_019206925.1-Fun_JAHLUE010000008.1_i000_005023	181	400	219	0.977679	0.439759
GCA_019206965.1-Fun_JAHLUF010000007.1_i000_004776	181	400	219	0.977679	0.439759
GCA_019206985.1-Fun_JAHLUC010000008.1_i000_004959	181	400	219	0.977679	0.439759
GCA_019207005.1-Fun_JAHLUH010000007.1_i000_004700	181	400	219	0.977679	0.439759
GCA_019207125.1-Fun_JAHLUD010000003.1_i000_003164	181	400	219	0.977679	0.439759
GCA_019207185.1-Fun_JAHLUG010000003.1_i000_003086	181	400	219	0.977679	0.439759
GCA_019207205.1-Fun_JAHLUJ010000002.1_i000_002546	181	400	219	0.977679	0.439759
GCA_019207265.1-Fun_JAHLUN010000009.1_i000_005287	181	400	219	0.977679	0.439759
GCA_019207295.1-Fun_JAHLUM010000002.1_i000_002761	181	400	219	0.977679	0.439759
GCA_019207315.1-Fun_JAHLUO010000002.1_i000_002549	181	400	219	0.977679	0.439759
GCA_019207415.1-Fun_JAHLUU010000001.1_i000_001708	181	400	219	0.977679	0.439759
GCA_019207435.1-Fun_JAHLUT010000001.1_i000_001746	181	400	219	0.977679	0.439759
GCA_019207325.1-Fun_JAHLUP010000001.1_i000_001729	181	400	219	0.977679	0.439759
GCA_019207365.1-Fun_JAHLUQ010000007.1_i000_004710	181	400	219	0.977679	0.439759
GCA_019207165.1-Fun_JAHLUV010000009.1_i000_005230	181	400	219	0.977679	0.439759
GCA_019207175.1-Fun_JAHLUI010000006.1_i000_004525	181	400	219	0.977679	0.439759
GCA_014058105.1-Pla_JACGCM010001529.1_i000_042293	90	174	84	0.375	0.368421
GCA_014058105.1-Pla_JACGCM010001529.1_i000_042293	168	228	60	0.267857	0.263158
GCA_019207375.1-Fun_JAHLUR010000006.1_i000_004446	181	400	219	0.977679	0.437126
GCA_019207405.1-Fun_JAHLUS010000005.1_i000_003818	181	400	219	0.977679	0.437126
GCA_020744255.1-Fun_JAGTJQ010000001.1_i000_000449	182	400	218	0.973214	0.396364
GCA_000149585.1-Fun_CH476656.1_i000_006397	181	394	213	0.950893	0.335433
GCA_017310585.1-Fun_CP069115.1_i000_004225	181	394	213	0.950893	0.335433
GCA_000002725.2-Pro_FR796406.1_i000_001092	190	420	230	1.02679	0.486258
GCA_916722125.1-Pro_OU755544.1_i000_001115	190	420	230	1.02679	0.486258
GCA_014621405.1-Fun_JAANBC010000656.1_i000_008256	181	388	207	0.924107	0.273087
GCA_014898295.1-Fun_RCSW01000010.1_i000_005739	182	398	216	0.964286	0.378284
GCA_000151005.2-Fun_DS990638.1_i000_006543	181	394	213	0.950893	0.334906
GCA_017310615.1-Fun_CP069105.1_i000_006478	181	394	213	0.950893	0.334906
GCA_013358655.1-Pro_JABDHM010000016.1_i000_002656	224	454	230	1.02679	0.446602
GCA_000151035.1-Fun_GG692432.1_i000_001855	181	394	213	0.950893	0.334906
GCA_014898415.1-Fun_RCTD01000016.1_i000_006901	182	398	216	0.964286	0.380952
GCA_000150115.1-Fun_GG663364.1_i000_007342	181	394	213	0.950893	0.334906
GCA_017355575.1-Fun_CP069120.1_i000_006089	181	394	213	0.950893	0.334906
GCA_017607465.1-Fun_JAEVHI010000002.1_i000_003356	181	394	213	0.950893	0.334906
GCA_000150705.2-Fun_KN294005.1_i000_005382	182	395	213	0.950893	0.239595
GCA_000234665.4-Pro_FR799563.1_i000_001333	190	420	230	1.02679	0.485232
GCA_000521155.1-Pro_KI927918.1_i000_002140	186	410	224	1	0.518519
GCA_001572075.1-Fun_JOOL01000318.1_i000_002198	182	396	214	0.955357	0.364566
GCA_001592465.1-Fun_JPDO01000608.1_i000_008920	182	396	214	0.955357	0.364566
GCA_002591395.1-Fun_NJES01000008.1_i000_006892	194	418	224	1	0.443564
GCA_000234665.4-Pro_FR799568.1_i000_002135	158	379	221	0.986607	0.494407
GCA_000401715.2-Pro_KE124615.1_i000_003348	186	410	224	1	0.505643
GCA_003012295.1-Fun_PXXK01000377.1_i000_010635	181	389	208	0.928571	0.348409
GCA_020744385.1-Fun_JAHBOO010000005.1_i000_009605	181	389	208	0.928571	0.348409
GCA_018360145.1-Fun_SRPY01000038.1_i000_004298	181	398	217	0.96875	0.362876
GCA_019321695.1-Fun_JAHWGW010000009.1_i000_007970	195	418	223	0.995536	0.429672
GCA_000250695.1-Fun_JH604633.1_i000_000512	156	371	215	0.959821	0.528256
GCA_000738915.1-Fun_AKIJ01000002.1_i000_000586	156	371	215	0.959821	0.528256
GCA_001500285.1-Fun_KQ947418.1_i000_009299	180	396	216	0.964286	0.320951
GCA_020744375.1-Fun_JAGMUU010000002.1_i000_006524	181	388	207	0.924107	0.352641
GCA_003730175.1-Pro_RHLD01000037.1_i000_005958	158	379	221	0.986607	0.277638
GCA_001661345.1-Fun_KV454477.1_i000_002248	179	400	221	0.986607	0.394643
GCA_001747045.1-Fun_LPNM01000008.1_i000_004126	187	414	227	1.01339	0.443359
GCA_000732565.1-Fun_KL650463.1_i000_001366	205	429	224	1	0.390925
GCA_017357885.1-Fun_CP063413.1_i000_009019	182	398	216	0.964286	0.378284
GCA_020740775.1-Fun_JAHEWK010000010.1_i000_002898	181	388	207	0.924107	0.352641
GCA_002916505.1-Fun_PKSG01001006.1_i000_005151	186	394	208	0.928571	0.339315
GCA_003730215.1-Pro_RHLC01000033.1_i000_005670	158	379	221	0.986607	0.27284
GCA_019206915.1-Fun_JAHLUA010000002.1_i000_002466	190	415	225	1.00446	0.449102
GCA_010405425.1-Fun_MU005585.1_i000_009386	180	400	220	0.982143	0.383275
GCA_000151065.3-Fun_HF943546.1_i000_004288	184	400	216	0.964286	0.346709
GCA_019207555.1-Fun_JAHLUY010000001.1_i000_001825	181	400	219	0.977679	0.438878
GCA_000402015.1-Ani_KE124931.1_i000_006199	36	258	222	0.991071	0.628895
GCA_011058875.1-Fun_SWKT01000002.1_i000_004647	182	399	217	0.96875	0.356322
GCA_014621435.1-Fun_JAANBA010000284.1_i000_007468	182	399	217	0.96875	0.356322
GCA_000320565.2-Fun_KB456262.1_i000_003286	182	397	215	0.959821	0.378521
GCA_019207455.1-Fun_JAHLUW010000002.1_i000_002275	181	400	219	0.977679	0.438878
GCA_019207505.1-Fun_JAHLUZ010000001.1_i000_001799	181	400	219	0.977679	0.438878
GCA_019207515.1-Fun_JAHLVA010000003.1_i000_002735	181	400	219	0.977679	0.438878
GCA_019207525.1-Fun_JAHLVB010000001.1_i000_001687	181	400	219	0.977679	0.438878
GCA_019207585.1-Fun_JAHLVF010000002.1_i000_002132	181	400	219	0.977679	0.438878
GCA_019207605.1-Fun_JAHLVD010000001.1_i000_001690	181	400	219	0.977679	0.438878
GCA_019207475.1-Fun_JAHLUX010000002.1_i000_002161	181	400	219	0.977679	0.436255
GCA_003019895.1-Fun_KZ678505.1_i000_007723	195	418	223	0.995536	0.428846
GCA_000442575.2-Pro_ATMG01007233.1_i000_009668	158	379	221	0.986607	0.52
GCA_010093935.1-Fun_ML993586.1_i000_004128	182	396	214	0.955357	0.372822
GCA_013396025.1-Fun_JAAOAQ010000039.1_i000_001205	181	389	208	0.928571	0.350759
GCA_019207635.1-Fun_JAHLVE010000005.1_i000_003926	181	400	219	0.977679	0.436255
GCA_020509005.2-Fun_CP090173.1_i000_013238	192	416	224	1	0.403604
GCA_001642045.1-Fun_KV441561.1_i000_013570	192	415	223	0.995536	0.432171
GCA_018296305.1-Fun_JADFTW010000201.1_i000_005565	181	389	208	0.928571	0.354344
GCA_018296245.1-Fun_JADFTV010000236.1_i000_007233	181	388	207	0.924107	0.352641
GCA_018296265.1-Fun_JADFTU010000233.1_i000_007261	181	388	207	0.924107	0.352641
GCA_018296285.1-Fun_JADFTT010000285.1_i000_008095	181	388	207	0.924107	0.352641
GCA_018296325.1-Fun_JADFTY010000033.1_i000_001981	181	388	207	0.924107	0.352641
GCA_018296345.1-Fun_JADFTX010000195.1_i000_005390	181	388	207	0.924107	0.352641
MESP036.0722.00001.C001_00821	142	366	224	1	0.568528
GCA_902810595.1-Ani_LR778262.1_i000_011586	185	392	207	0.924107	0.389831
GCA_019633405.1-Fun_WSTX01000424.1_i000_001363	186	393	207	0.924107	0.365724
GCA_002933655.1-Fun_PNEN01000443.1_i000_006225	192	416	224	1	0.402878
GCA_021605075.1-Ani_BPLQ01002810.1_i000_009614	5	189	184	0.821429	0.744939
GCA_008636195.1-Fun_VXIT01000002.1_i000_004187	183	400	217	0.96875	0.290495
GCA_003016335.1-Fun_KZ678130.1_i000_003296	179	410	231	1.03125	0.401739
GCA_013399815.1-Ani_VZZX01005405.1_i000_006247	115	331	216	0.964286	0.451883
GCA_021365295.1-Fun_JAJTIW010000011.1_i000_001665	180	397	217	0.96875	0.332312
GCA_012931995.1-Fun_JAADYS010000257.1_i000_002010	181	388	207	0.924107	0.346734
GCA_000465215.2-Fun_KE747810.1_i000_001575	157	365	208	0.928571	0.376812
GCA_012550715.1-Fun_JAANYQ010000002.1_i000_001469	180	405	225	1.00446	0.454545
GCA_905337345.1-Fun_CAJPDS010000063.1_i000_007469	166	372	206	0.919643	0.264442
GCA_000190235.1-Fun_CM001140.1_i000_003526	181	401	220	0.982143	0.468085
THRA001.0722.00001.C001_01348	147	366	219	0.977679	0.51773
GCA_000568055.1-Fun_CM002436.1_i000_004194	181	401	220	0.982143	0.430528
GCA_000464535.1-Fun_KE721051.1_i000_004501	182	408	226	1.00893	0.301333
GCA_000340195.1-Fun_KB446537.1_i000_003742	182	396	214	0.955357	0.36833
GCA_021193595.1-Fun_JAJJMK010000548.1_i000_011847	42	258	216	0.964286	0.458599
GCA_000325965.1-Fun_ADVV01000081.1_i000_003156	181	401	220	0.982143	0.468085
GCA_000190255.1-Fun_CM001124.1_i000_003236	181	401	220	0.982143	0.465116
GCA_000187245.3-Fun_CM002305.1_i000_003886	181	400	219	0.977679	0.437126
GCA_019207595.1-Fun_JAHLVG010000002.1_i000_002518	181	400	219	0.977679	0.437126
GCA_019207695.1-Fun_JAHLVH010000001.1_i000_001619	181	400	219	0.977679	0.437126
GCA_000190195.1-Fun_CM001092.1_i000_003335	181	401	220	0.982143	0.465116
GCA_013266195.1-Fun_JABEYC010000533.1_i000_006773	181	387	206	0.919643	0.340496
GCA_000181435.1-Fun_AAFW02000032.1_i000_005012	181	401	220	0.982143	0.430528
GCA_000975675.2-Fun_CP005622.2_i000_004874	181	401	220	0.982143	0.430528
GCA_000976725.3-Fun_CP005625.2_i000_004907	181	401	220	0.982143	0.430528
GCA_000976755.2-Fun_CP005626.2_i000_004939	181	401	220	0.982143	0.430528
GCA_000976785.2-Fun_CP005627.2_i000_004871	181	401	220	0.982143	0.430528
GCA_000976695.3-Fun_CP005624.2_i000_004802	181	401	220	0.982143	0.428016
GCA_000977085.2-Fun_CP005637.2_i000_004907	181	401	220	0.982143	0.428016
GCA_018282135.1-Fun_JAGPUO010000012.1_i000_002008	267	475	208	0.928571	0.305882
GCA_000977625.2-Fun_CP005655.2_i000_004841	181	401	220	0.982143	0.423077
GCA_009732865.1-Fun_ML769344.1_i000_016133	182	398	216	0.964286	0.303371
GCA_000338975.1-Fun_KB445585.1_i000_011749	177	393	216	0.964286	0.381625
GCA_020509005.2-Fun_CP090172.1_i000_012013	182	396	214	0.955357	0.368966
GCA_000977025.2-Fun_CP005635.2_i000_004854	181	401	220	0.982143	0.425532
GCA_900169345.1-Fun_FWEW01000268.1_i000_007465	183	400	217	0.96875	0.290495
GCA_022376535.1-Fun_JAJJKD010000183.1_i000_003808	182	399	217	0.96875	0.343899
GCA_000304475.1-Fun_HE650822.1_i000_001204	181	401	220	0.982143	0.440882
GCA_003268335.1-Fun_QGDH01000078.1_i000_008010	108	320	212	0.946429	0.419802
GCA_000442495.1-Pro_ATMH01009196.1_i000_009168	189	419	230	1.02679	0.485232
GCA_001640025.2-Fun_CP014503.1_i000_003123	181	402	221	0.986607	0.432485
GCA_017552425.1-Pla_JAEQKX010000776.1_i000_035000	134	350	216	0.964286	0.352365
GCA_004009835.2-Fun_RIBY02001545.1_i000_004452	182	397	215	0.959821	0.355372
GCA_001191545.1-Fun_LGLR01000185.1_i000_004605	111	323	212	0.946429	0.417323
GCA_003268315.1-Fun_QGDG01000031.1_i000_004173	111	323	212	0.946429	0.417323
GCA_013390005.1-Ani_WEIV01029094.1_i000_012264	115	189	74	0.330357	0.146825
GCA_013390005.1-Ani_WEIV01029094.1_i000_012264	196	348	152	0.678571	0.301587
GCA_000304475.1-Fun_HE650824.1_i000_002357	181	401	220	0.982143	0.439122
GCA_900074765.1-Fun_LT598487.1_i000_000145	181	401	220	0.982143	0.415879
GCA_003144295.1-Fun_KZ819638.1_i000_006100	190	415	225	1.00446	0.415129
GCA_020379485.1-Pla_CM035457.1_i000_049325	188	413	225	1.00446	0.504484
GCA_000281105.1-Fun_JH767562.1_i000_002478	181	398	217	0.96875	0.366554
GCA_900618425.1-Ani_UZAN01001631.1_i000_000485	84	295	211	0.941964	0.682848
GCA_000977265.3-Fun_CP005643.1_i000_004885	181	401	220	0.982143	0.430528
GCA_903819125.2-Fun_LR813497.2_i000_005165	181	401	220	0.982143	0.435644
GCA_903819175.2-Fun_LR813599.2_i000_005167	181	401	220	0.982143	0.433071
GCA_000260735.1-Fun_DG000051.1_i000_005262	181	401	220	0.982143	0.430528
GCA_002335645.1-Fun_BEGW01000002.1_i000_004757	181	401	220	0.982143	0.430528
GCA_014058105.1-Pla_JACGCM010001219.1_i000_040293	1	149	148	0.660714	0.762887
GCA_021399435.1-Fun_JAJTUP010000127.1_i000_003630	182	397	215	0.959821	0.336991
GCA_002079055.1-Fun_CP020256.1_i000_005016	181	401	220	0.982143	0.430528
GCA_000977715.4-Fun_CP005658.2_i000_004917	181	401	220	0.982143	0.430528
GCA_001983315.1-Fun_MQVN01000017.1_i000_001761	181	401	220	0.982143	0.440882
GCA_001634645.1-Fun_CM004308.1_i000_005692	181	401	220	0.982143	0.428016
GCA_000976815.3-Fun_CP005628.2_i000_004890	181	401	220	0.982143	0.425532
GCA_000978345.2-Fun_CP005679.2_i000_004890	181	401	220	0.982143	0.425532
GCA_000977985.2-Fun_CP005667.2_i000_004855	181	401	220	0.982143	0.433071
GCA_000146045.2-Fun_BK006948.2_i000_005441	181	401	220	0.982143	0.430528
GCA_000149365.1-Fun_CH408045.1_i000_003862	181	401	220	0.982143	0.430528
GCA_000182315.2-Fun_ACFL01000078.1_i000_003442	181	401	220	0.982143	0.430528
GCA_000190215.1-Fun_CM001108.1_i000_003445	181	401	220	0.982143	0.430528
GCA_000269885.1-Fun_CM001536.1_i000_004938	181	401	220	0.982143	0.430528
GCA_000568005.1-Fun_CM002418.1_i000_004891	181	401	220	0.982143	0.430528
GCA_000568365.1-Fun_CM002452.1_i000_004541	181	401	220	0.982143	0.430528
GCA_000662435.2-Fun_CP005620.2_i000_004943	181	401	220	0.982143	0.430528
GCA_000975615.2-Fun_CP005591.2_i000_004808	181	401	220	0.982143	0.430528
GCA_000975645.3-Fun_CP004113.1_i000_004904	181	401	220	0.982143	0.430528
GCA_000975705.2-Fun_CP005623.1_i000_005120	181	401	220	0.982143	0.430528
GCA_000975795.2-Fun_CP005592.2_i000_004874	181	401	220	0.982143	0.430528
GCA_000975885.2-Fun_CP005595.2_i000_004864	181	401	220	0.982143	0.430528
GCA_000975915.2-Fun_CP005596.2_i000_004889	181	401	220	0.982143	0.430528
GCA_000975945.2-Fun_CP005597.2_i000_004898	181	401	220	0.982143	0.430528
GCA_000976035.2-Fun_CP005600.2_i000_004867	181	401	220	0.982143	0.430528
GCA_000976065.2-Fun_CP005601.2_i000_004945	181	401	220	0.982143	0.430528
GCA_000976185.2-Fun_CP005605.2_i000_004927	181	401	220	0.982143	0.430528
GCA_000976275.4-Fun_CP005608.2_i000_004920	181	401	220	0.982143	0.430528
GCA_000976395.2-Fun_CP005612.2_i000_005093	181	401	220	0.982143	0.430528
GCA_000976425.2-Fun_CP005613.1_i000_005126	181	401	220	0.982143	0.430528
GCA_000976455.3-Fun_CP005614.2_i000_004917	181	401	220	0.982143	0.430528
GCA_000976485.2-Fun_CP005615.2_i000_005097	181	401	220	0.982143	0.430528
GCA_000976515.2-Fun_CP005616.2_i000_005122	181	401	220	0.982143	0.430528
GCA_000976545.2-Fun_CP005617.2_i000_004918	181	401	220	0.982143	0.430528
GCA_000976575.4-Fun_CP005618.2_i000_005129	181	401	220	0.982143	0.430528
GCA_000976605.3-Fun_CP005619.2_i000_004856	181	401	220	0.982143	0.430528
GCA_000976665.2-Fun_CP005621.2_i000_005126	181	401	220	0.982143	0.430528
GCA_000976845.3-Fun_CP005629.2_i000_004879	181	401	220	0.982143	0.430528
GCA_000976935.2-Fun_CP005632.2_i000_004832	181	401	220	0.982143	0.430528
GCA_000976965.3-Fun_CP005633.1_i000_004874	181	401	220	0.982143	0.430528
GCA_000977145.2-Fun_CP005639.2_i000_004940	181	401	220	0.982143	0.430528
GCA_000977175.3-Fun_CP005640.2_i000_004897	181	401	220	0.982143	0.430528
GCA_000977205.2-Fun_CP005641.2_i000_004897	181	401	220	0.982143	0.430528
GCA_000977235.2-Fun_CP005642.2_i000_004933	181	401	220	0.982143	0.430528
GCA_000977295.2-Fun_CP005644.2_i000_004867	181	401	220	0.982143	0.430528
GCA_000977325.2-Fun_CP005645.2_i000_004936	181	401	220	0.982143	0.430528
GCA_000977385.2-Fun_CP005647.2_i000_004899	181	401	220	0.982143	0.430528
GCA_000977805.2-Fun_CP005661.2_i000_004861	181	401	220	0.982143	0.430528
GCA_000978075.3-Fun_CP005670.2_i000_004906	181	401	220	0.982143	0.430528
GCA_000978165.2-Fun_CP005673.1_i000_005010	181	401	220	0.982143	0.430528
GCA_000978195.2-Fun_CP005674.2_i000_004874	181	401	220	0.982143	0.430528
GCA_000978225.2-Fun_CP005675.2_i000_005109	181	401	220	0.982143	0.430528
GCA_000978285.2-Fun_CP005677.2_i000_005006	181	401	220	0.982143	0.430528
GCA_001298375.2-Fun_CM003551.1_i000_004533	181	401	220	0.982143	0.430528
GCA_001413975.1-Fun_CM003569.1_i000_004574	181	401	220	0.982143	0.430528
GCA_002571405.2-Fun_CP046095.1_i000_005312	181	401	220	0.982143	0.430528
GCA_009014655.1-Fun_BKZN01000033.1_i000_002468	181	401	220	0.982143	0.430528
GCA_010356925.1-Fun_CM021141.1_i000_005294	181	401	220	0.982143	0.430528
GCA_010356935.1-Fun_CM021125.1_i000_005259	181	401	220	0.982143	0.430528
GCA_016858165.1-Fun_CM029103.1_i000_005307	181	401	220	0.982143	0.430528
GCA_016858175.1-Fun_CM029087.1_i000_005250	181	401	220	0.982143	0.430528
GCA_905220315.1-Fun_LR999886.1_i000_005195	181	401	220	0.982143	0.430528
GCA_905220325.1-Fun_HG994154.1_i000_005184	181	401	220	0.982143	0.430528
GCA_000977565.2-Fun_CP005653.1_i000_004714	181	401	220	0.982143	0.423077
GCA_000976095.2-Fun_CP005602.2_i000_004889	181	401	220	0.982143	0.435644
GCA_010093485.1-Fun_MU001501.1_i000_008076	192	415	223	0.995536	0.43301
GCA_000975975.3-Fun_CP005598.2_i000_004915	181	401	220	0.982143	0.428016
GCA_000976005.2-Fun_CP005599.2_i000_004880	181	401	220	0.982143	0.428016
GCA_000976125.2-Fun_CP005603.1_i000_004871	181	401	220	0.982143	0.428016
GCA_000976155.4-Fun_CP005604.2_i000_004836	181	401	220	0.982143	0.428016
GCA_000976215.2-Fun_CP005606.2_i000_004881	181	401	220	0.982143	0.428016
GCA_000976245.2-Fun_CP005607.2_i000_004867	181	401	220	0.982143	0.428016
GCA_000976305.2-Fun_CP005609.2_i000_004939	181	401	220	0.982143	0.428016
GCA_000976905.2-Fun_CP005631.2_i000_004812	181	401	220	0.982143	0.428016
GCA_000976995.2-Fun_CP005634.2_i000_004949	181	401	220	0.982143	0.428016
GCA_000977115.3-Fun_CP005638.2_i000_004914	181	401	220	0.982143	0.428016
GCA_000977355.3-Fun_CP005646.2_i000_004952	181	401	220	0.982143	0.428016
GCA_000977655.2-Fun_CP005656.1_i000_004934	181	401	220	0.982143	0.428016
GCA_000977775.3-Fun_CP005660.2_i000_004890	181	401	220	0.982143	0.428016
GCA_000977835.2-Fun_CP005662.2_i000_004951	181	401	220	0.982143	0.428016
GCA_000977865.2-Fun_CP005663.1_i000_004862	181	401	220	0.982143	0.428016
GCA_000977925.2-Fun_CP005665.2_i000_004845	181	401	220	0.982143	0.428016
GCA_000978255.2-Fun_CP005676.2_i000_004934	181	401	220	0.982143	0.428016
GCA_002804325.1-Fun_PEJR01000174.1_i000_001496	181	401	220	0.982143	0.428016
GCA_903819135.2-Fun_LR813548.2_i000_005205	181	401	220	0.982143	0.428016
GCA_000151355.1-Fun_GG698905.1_i000_006044	197	404	207	0.924107	0.341021
GCA_000977415.2-Fun_CP005648.2_i000_004927	181	401	220	0.982143	0.428016
GCA_000182175.1-Fun_ABSV01002237.1_i000_004212	181	401	220	0.982143	0.428016
GCA_000975585.2-Fun_CP005590.2_i000_004861	181	401	220	0.982143	0.425532
GCA_000977055.3-Fun_CP005636.2_i000_004895	181	401	220	0.982143	0.425532
GCA_000977445.2-Fun_CP005649.2_i000_004883	181	401	220	0.982143	0.425532
GCA_000977595.2-Fun_CP005654.2_i000_004898	181	401	220	0.982143	0.425532
GCA_000978015.2-Fun_CP005668.2_i000_004864	181	401	220	0.982143	0.425532
GCA_000978135.2-Fun_CP005672.2_i000_004895	181	401	220	0.982143	0.425532
GCA_000976335.2-Fun_CP005610.2_i000_004901	181	401	220	0.982143	0.430528
GCA_000326005.1-Fun_AEEZ01000093.1_i000_003034	181	401	220	0.982143	0.428016
GCA_000975765.2-Fun_CP005589.2_i000_004903	181	401	220	0.982143	0.428016
GCA_000975855.3-Fun_CP005594.2_i000_004849	181	401	220	0.982143	0.428016
GCA_000978105.2-Fun_CP005671.2_i000_004895	181	401	220	0.982143	0.428016
GCA_014132375.1-Fun_BLZP01000002.1_i000_001098	181	401	220	0.982143	0.428016
GCA_014132395.1-Fun_BLZQ01000003.1_i000_001470	181	401	220	0.982143	0.428016
GCA_000975825.2-Fun_CP005593.1_i000_004910	181	401	220	0.982143	0.430528
GCA_003046695.1-Fun_PTEP01000006.1_i000_004427	181	401	220	0.982143	0.430528
GCA_003046715.1-Fun_PTEQ01000068.1_i000_004762	181	401	220	0.982143	0.430528
GCA_003046745.1-Fun_PTER01000002.1_i000_003285	181	401	220	0.982143	0.430528
GCA_014905575.1-Fun_BNHH01000052.1_i000_002931	181	401	220	0.982143	0.430528
GCA_000836255.1-Fun_DF938581.1_i000_008065	197	422	225	1.00446	0.374376
GCA_000977895.2-Fun_CP005664.2_i000_004767	181	401	220	0.982143	0.430528
GCA_903819145.2-Fun_LR813531.2_i000_005138	181	401	220	0.982143	0.430528
GCA_005059885.1-Fun_NAJL01000001.1_i000_000293	182	396	214	0.955357	0.35082
GCA_000976365.2-Fun_CP005611.2_i000_004870	181	401	220	0.982143	0.428016
GCA_000977745.2-Fun_CP005659.2_i000_004908	181	401	220	0.982143	0.428016
GCA_903819155.2-Fun_LR813514.2_i000_005183	181	401	220	0.982143	0.428016
GCA_002901185.1-Fun_NRSZ01000686.1_i000_001114	224	432	208	0.928571	0.31853
GCA_000977475.3-Fun_CP005650.2_i000_004933	181	401	220	0.982143	0.425532
GCA_000326105.1-Fun_AGVY01000048.1_i000_004002	181	401	220	0.982143	0.443548
GCA_000977955.2-Fun_CP005666.2_i000_004701	181	401	220	0.982143	0.428016
THPR002.0722.00001.C001_01998	148	366	218	0.973214	0.508159
GCA_022059095.1-Pro_JAJSEB010000045.1_i000_006660	190	420	230	1.02679	0.472279
GCA_000218975.1-Fun_FN394216.1_i000_005443	181	401	220	0.982143	0.433071
GCA_000975735.4-Fun_CP005588.2_i000_005087	181	401	220	0.982143	0.433071
GCA_000976875.3-Fun_CP005630.2_i000_004836	181	401	220	0.982143	0.433071
GCA_000977685.2-Fun_CP005657.2_i000_004947	181	401	220	0.982143	0.433071
GCA_903819205.2-Fun_LR813565.2_i000_005111	181	401	220	0.982143	0.430528
GCA_019207935.1-Fun_JAHLVI010000005.1_i000_003925	181	400	219	0.977679	0.437126
GCA_000516985.1-Fun_KI912114.1_i000_009166	182	399	217	0.96875	0.354575
GCA_903819195.2-Fun_LR813616.2_i000_005097	181	401	220	0.982143	0.428016
GCA_000755165.1-Pro_CP009379.1_i000_000985	190	420	230	1.02679	0.488323
GCA_003260635.2-Pla_QGKW02001660.1_i000_006827	1	138	137	0.611607	0.556911
GCA_000359705.1-Fun_KB908559.1_i000_004395	177	405	228	1.01786	0.400703
GCA_008636045.1-Pro_SNRW01009411.1_i000_026428	1	218	217	0.96875	0.442857
GCA_015832245.1-Fun_SBJO01000046.1_i000_000936	147	369	222	0.991071	0.548148
GCA_001006345.1-Fun_LCWF01000072.1_i000_005720	182	408	226	1.00893	0.362179
GCA_000214015.2-Pla_CAID01000008.2_i000_003890	187	413	226	1.00893	0.477801
GCA_002158475.1-Pla_KZ155780.1_i000_002597	187	413	226	1.00893	0.477801
GCA_013396295.1-Fun_JAAGWQ010000124.1_i000_006694	180	387	207	0.924107	0.348485
GCA_018360185.1-Fun_SRPU01000992.1_i000_003939	181	394	213	0.950893	0.354409
GCA_018360225.1-Fun_SRPW01000306.1_i000_001174	181	394	213	0.950893	0.354409
GCA_011022315.1-Fun_CP048996.1_i000_004816	181	401	220	0.982143	0.433925
GCA_905116865.2-Ani_CAJHNH020001733.1_i000_009794	1	219	218	0.973214	0.543641
GCA_011058895.1-Fun_SWKV01000059.1_i000_008739	180	396	216	0.964286	0.379613
GCA_012275245.1-Fun_WMJW01000017.1_i000_002633	181	401	220	0.982143	0.426357
GCA_000210295.1-Pro_FN554971.1_i000_004430	190	420	230	1.02679	0.47619
GCA_003947005.1-Fun_NKCL01000121.1_i000_001761	181	388	207	0.924107	0.350254
GCA_000002445.1-Pro_CP000071.1_i000_003839	190	420	230	1.02679	0.47619
GCA_001457755.2-Pro_CZPT02000691.1_i000_004863	190	420	230	1.02679	0.47619
GCA_010405375.1-Fun_MU004360.1_i000_008425	111	320	209	0.933036	0.415507
GCA_018360255.1-Fun_SRPZ01000031.1_i000_004274	181	391	210	0.9375	0.349418
GCA_000237345.1-Fun_HE576753.1_i000_001588	181	401	220	0.982143	0.427184
GCA_002116315.1-Fun_KZ107840.1_i000_003642	180	396	216	0.964286	0.387097
GCA_019721275.1-Fun_JAASLF010000047.1_i000_006894	180	396	216	0.964286	0.387097
GCA_000002845.2-Pro_FR798984.1_i000_001004	190	420	230	1.02679	0.488323
GCA_900537975.1-Pro_LS997609.1_i000_001097	190	420	230	1.02679	0.488323
GCA_013266165.1-Fun_JAAGWP010000270.1_i000_006826	180	387	207	0.924107	0.348485
GCA_000385595.1-Fun_KB916303.1_i000_005401	181	394	213	0.950893	0.376325
GCA_010078445.1-Ani_VULE01000234.1_i000_000279	115	341	226	1.00893	0.480851
GCA_001460835.1-Pro_CYKH01000638.1_i000_005221	169	399	230	1.02679	0.50885
GCA_002966975.2-Pla_PJQY01000397.1_i000_010551	42	253	211	0.941964	0.518428
GCA_021604985.1-Pla_BQKI01000018.1_i000_026443	157	356	199	0.888393	0.402834
GCA_003177095.1-Pro_PRFC01000059.1_i000_018972	190	420	230	1.02679	0.47817
GCA_000315915.1-Fun_HE806317.1_i000_001313	181	402	221	0.986607	0.427466
GCA_000230445.1-Ani_JH171628.1_i000_014940	1	157	156	0.696429	0.509804
GCA_000002725.2-Pro_FR796411.1_i000_001950	315	536	221	0.986607	0.36711
GCA_916722125.1-Pro_OU755549.1_i000_001984	315	536	221	0.986607	0.36711
GCA_010093825.1-Fun_ML995875.1_i000_008373	332	547	215	0.959821	0.284768
GCA_001548555.1-Fun_CP014244.1_i000_001730	181	401	220	0.982143	0.416667
GCA_011058905.1-Fun_SWKU01000020.1_i000_004667	180	396	216	0.964286	0.385714
GCA_000977505.2-Fun_CP005651.2_i000_004882	181	401	220	0.982143	0.425532
GCA_000977535.2-Fun_CP005652.2_i000_004869	181	401	220	0.982143	0.425532
GCA_000978315.2-Fun_CP005678.2_i000_004879	181	401	220	0.982143	0.425532
GCA_010093885.1-Fun_ML995496.1_i000_009115	181	396	215	0.959821	0.387387
GCA_001664025.1-Fun_LXPE01000086.1_i000_004566	183	403	220	0.982143	0.441767
GCA_000523455.1-Fun_KI964013.1_i000_007398	177	405	228	1.01786	0.40354
GCA_001619985.1-Fun_KV407455.1_i000_001600	182	398	216	0.964286	0.354098
GCA_001883845.1-Fun_MNUE01000020.1_i000_003337	181	397	216	0.964286	0.385027
GCA_005406105.1-Fun_BIMX01000022.1_i000_003794	180	402	222	0.991071	0.428571
GCA_017916325.1-Pro_CM030405.1_i000_001023	190	420	230	1.02679	0.485232
GCA_022117675.1-Ani_JACEFF010000511.1_i000_014381	1	156	155	0.691964	0.525424
GCA_900412535.3-Pla_LS974618.2_i000_009585	188	412	224	1	0.504505
GCA_010093505.1-Fun_MU001640.1_i000_008225	182	395	213	0.950893	0.349754
GCA_019632275.1-Fun_WSTT01000223.1_i000_004007	190	416	226	1.00893	0.412409
GCA_019632285.1-Fun_WSTV01000631.1_i000_008055	190	416	226	1.00893	0.412409
GCA_019632265.1-Fun_WSTU01000942.1_i000_009618	190	416	226	1.00893	0.412409
GCA_000338975.1-Fun_KB445594.1_i000_012934	177	393	216	0.964286	0.381625
GCA_000354255.1-Fun_KB733452.1_i000_005019	177	393	216	0.964286	0.381625
GCA_019454015.1-Fun_JAHUAA010000015.1_i000_004409	177	393	216	0.964286	0.381625
GCA_003709365.1-Pla_QOKY01000159.1_i000_002059	242	465	223	0.995536	0.409174
GCA_000338995.1-Fun_KB445637.1_i000_001234	177	393	216	0.964286	0.382301
GCA_000798715.1-Fun_JNVN01001454.1_i000_003065	184	401	217	0.96875	0.429703
GCA_012932025.1-Fun_JAADJG010000495.1_i000_010313	181	389	208	0.928571	0.350168
GCA_001299535.1-Pro_LJSK01000061.1_i000_002768	190	420	230	1.02679	0.485232
GCA_010093895.1-Fun_ML996091.1_i000_008861	182	389	207	0.924107	0.362522
GCA_013399695.1-Ani_VXAU01005792.1_i000_012543	115	192	77	0.34375	0.167756
GCA_013399695.1-Ani_VXAU01005792.1_i000_012543	194	319	125	0.558036	0.272331
MEBA001.0722.00001.C001_01251	142	366	224	1	0.541063
GCA_020726525.1-Fun_JAGPXC010000002.1_i000_005195	182	398	216	0.964286	0.361204
GCA_019207615.1-Fun_JAHLVC010000002.1_i000_002358	181	400	219	0.977679	0.438878
GCA_004011705.1-Fun_RZGK01000007.1_i000_003994	180	396	216	0.964286	0.378947
GCA_010093945.1-Fun_ML993879.1_i000_001801	182	390	208	0.928571	0.358003
GCA_020726555.1-Fun_JAHBNH010000008.1_i000_011407	180	395	215	0.959821	0.385305
GCA_001879085.1-Pla_MJEQ01002129.1_i000_025727	12	149	137	0.611607	0.901316
GCA_011058865.1-Fun_SWKW01000106.1_i000_000656	180	396	216	0.964286	0.379613
GCA_019828565.1-Pro_JAHDYR010000020.1_i000_004357	162	378	216	0.964286	0.442623
GCA_000730325.1-Fun_KL647752.1_i000_001535	205	429	224	1	0.390925
GCA_016097525.1-Fun_JADAKD010000001.1_i000_000668	1	157	156	0.696429	0.609375
GCA_010094145.1-Fun_ML978961.1_i000_003065	180	396	216	0.964286	0.378947
GCA_000145635.1-Fun_GL385400.1_i000_010754	183	395	212	0.946429	0.352745
GCA_003339415.1-Fun_PDHQ01000337.1_i000_003439	182	390	208	0.928571	0.300144
GCA_022343325.1-Fun_JACTNT010000013.1_i000_003447	180	395	215	0.959821	0.376532
GCA_016508695.1-Fun_VNKQ01000002.1_i000_000612	182	399	217	0.96875	0.247717
GCA_900617985.1-Ani_UYRR01030973.1_i000_009829	209	426	217	0.96875	0.397436
GCA_001642395.1-Fun_LTDL01000040.1_i000_001155	156	376	220	0.982143	0.53012
GCA_003698175.1-Fun_NKUJ01000005.1_i000_011976	181	388	207	0.924107	0.350254
GCA_003946995.1-Fun_NKCK01000302.1_i000_009633	181	388	207	0.924107	0.350254
GCA_003947015.1-Fun_NKCJ01000036.1_i000_008429	181	388	207	0.924107	0.350254
GCA_003947045.1-Fun_NIZV01000059.1_i000_013829	181	388	207	0.924107	0.350254
GCA_003957675.1-Fun_MIKF01000445.1_i000_011808	181	388	207	0.924107	0.350254
GCA_003946985.1-Fun_NKCI01000025.1_i000_007227	181	388	207	0.924107	0.350254
GCA_015852335.1-Fun_JAAAID010001196.1_i000_006975	186	396	210	0.9375	0.428571
GCA_000825725.1-Fun_CDGI01000023.1_i000_001569	181	372	191	0.852679	0.506631
THON001.0722.00001.C001_01342	147	366	219	0.977679	0.521429
THPA004.0722.00001.C001_00111	148	366	218	0.973214	0.509346
GCA_005059865.1-Fun_NAJQ01000390.1_i000_008276	182	398	216	0.964286	0.347267
GCA_003615045.1-Fun_ML014196.1_i000_003528	205	424	219	0.977679	0.375
GCA_001839685.1-Pro_MLAK01000545.1_i000_004488	184	401	217	0.96875	0.467672
GCA_016771965.1-Pla_CM028693.1_i000_030087	188	412	224	1	0.511416
GCA_009982855.1-Fun_JAADKA010000051.1_i000_010296	180	394	214	0.955357	0.374781
GCA_002894225.1-Fun_MTQA01000070.1_i000_013289	181	388	207	0.924107	0.349662
MEVA001.0722.00001.C001_01532	147	368	221	0.986607	0.45102
GCA_020536065.1-Fun_JAEUBE010000295.1_i000_003895	181	400	219	0.977679	0.435388
GCA_001636675.1-Fun_AZGY01000005.1_i000_006481	182	388	206	0.919643	0.338259
GCA_010093695.1-Fun_MU006334.1_i000_010558	180	394	214	0.955357	0.370884
PYYA001.0722.00001.C001_01516	147	366	219	0.977679	0.544776
GCA_000230375.1-Fun_FP929139.1_i000_011384	180	388	208	0.928571	0.359862
GCA_022343315.1-Fun_JACTNS010000008.1_i000_003023	180	388	208	0.928571	0.359862
GCA_010583015.1-Fun_MU007060.1_i000_009171	183	390	207	0.924107	0.343854
MEFE002.0722.00001.C001_00105	142	365	223	0.995536	0.537349
GCA_001531365.1-Pla_CM009741.1_i000_014359	67	268	201	0.897321	0.476303
MEHA003.0722.00001.C001_02023	155	375	220	0.982143	0.539216
GCA_000978045.2-Fun_CP005669.2_i000_004847	181	401	220	0.982143	0.430528
GCA_000521055.1-Pro_KI926441.1_i000_003279	186	410	224	1	0.426667
GCA_010093625.1-Fun_MU006749.1_i000_012033	180	394	214	0.955357	0.376098
GCA_014461125.1-Fun_JACAZG010000001.1_i000_000600	966	1153	187	0.834821	0.141989
GCA_001630375.1-Fun_JYNV01000176.1_i000_003861	180	394	214	0.955357	0.374781
GCA_004011695.1-Fun_RYYQ01000019.1_i000_009366	180	394	214	0.955357	0.374781
PYKU001.0722.00001.C001_01408	147	367	220	0.982143	0.547264
GCA_001680005.1-Pro_CP016247.1_i000_002484	187	413	226	1.00893	0.449304
THCH001.0722.00001.C001_00146	147	367	220	0.982143	0.545906
THCH001.0722.00002.C001_00141	147	367	220	0.982143	0.545906
GCA_000002875.2-Pro_FR796442.1_i000_001058	190	420	230	1.02679	0.486258
GCA_000227135.2-Pro_FR799597.2_i000_001046	190	420	230	1.02679	0.486258
GCA_003719575.1-Pro_CP029509.1_i000_001117	190	420	230	1.02679	0.486258
GCA_003730175.1-Pro_RHLD01000045.1_i000_006653	190	420	230	1.02679	0.486258
GCA_003730215.1-Pro_RHLC01000036.1_i000_006159	190	420	230	1.02679	0.486258
GCA_900500625.2-Pro_LR812943.1_i000_001093	190	420	230	1.02679	0.486258
GCA_900635355.2-Pro_LR812630.1_i000_001094	190	420	230	1.02679	0.486258
GCA_003012285.1-Fun_PXOG01000256.1_i000_009602	181	389	208	0.928571	0.348993
GCA_018360655.1-Fun_SRQS01000011.1_i000_000429	181	393	212	0.946429	0.352745
GCA_000521035.1-Pro_KI925567.1_i000_003228	186	410	224	1	0.415584
GCA_000521095.1-Pro_KI927387.1_i000_005075	186	410	224	1	0.415584
GCA_018360735.1-Fun_SRQX01000375.1_i000_004537	181	393	212	0.946429	0.352159
GCA_000401695.2-Pro_KE123835.1_i000_003127	186	410	224	1	0.414815
GCA_018360475.1-Fun_SRQQ01000083.1_i000_007710	181	393	212	0.946429	0.352159
GCA_018360535.1-Fun_SRQR01000295.1_i000_003646	181	393	212	0.946429	0.352159
GCA_018360675.1-Fun_SRQZ01000004.1_i000_004884	181	393	212	0.946429	0.352159
GCA_018360725.1-Fun_SRQU01000012.1_i000_000664	181	393	212	0.946429	0.352159
GCA_018360745.1-Fun_SRQT01000119.1_i000_000619	181	393	212	0.946429	0.352159
GCA_018360835.1-Fun_SRRB01000384.1_i000_004731	181	393	212	0.946429	0.352159
GCA_018360845.1-Fun_SRRE01000068.1_i000_006976	181	393	212	0.946429	0.352159
GCA_018360855.1-Fun_SRRF01000019.1_i000_002007	181	393	212	0.946429	0.352159
GCA_018360925.1-Fun_SRRJ01000497.1_i000_005927	181	393	212	0.946429	0.352159
GCA_000003085.2-Pro_AABL01000416.1_i000_005732	181	391	210	0.9375	0.534351
GCA_018360205.1-Fun_SRPT01000940.1_i000_007966	181	394	213	0.950893	0.355
GCA_001189435.1-Fun_LFRF01000002.1_i000_001238	181	389	208	0.928571	0.338762
PAPA004.0722.00001.C001_00956	149	367	218	0.973214	0.512941
GCA_000349385.1-Fun_KB705796.1_i000_002220	182	400	218	0.973214	0.310541
GCA_020379485.1-Pla_CM035447.1_i000_007332	208	431	223	0.995536	0.483731
GCA_007821535.1-Fun_QGMI01000460.1_i000_005811	180	397	217	0.96875	0.315866
GCA_020746875.1-Fun_JAGTJL010000008.1_i000_015683	182	398	216	0.964286	0.340157
GCA_000149795.1-Pro_DS016117.1_i000_002908	186	410	224	1	0.400716
GCA_000521015.1-Pro_KI925184.1_i000_005761	186	410	224	1	0.4
GCA_017916325.1-Pro_CM030410.1_i000_001826	158	380	222	0.991071	0.495536
GCA_002906115.4-Pla_PKMF03002623.1_i000_009146	182	397	215	0.959821	0.362563
GCA_000521075.1-Pro_KI926053.1_i000_003417	186	410	224	1	0.398577
NIMA002.0722.00001.C001_01520	149	370	221	0.986607	0.470213
GCA_000521115.1-Pro_KI927522.1_i000_003217	186	410	224	1	0.39646
GCA_900618025.1-Ani_UZAG01001951.1_i000_002327	104	180	76	0.339286	0.422222
GCA_003719475.1-Pro_MKGL01000071.1_i000_002926	190	420	230	1.02679	0.475207
GCA_010093935.1-Fun_ML993587.1_i000_004564	192	416	224	1	0.405063
GCA_017366145.1-Fun_JAFJYG010000075.1_i000_002910	182	398	216	0.964286	0.317181
GCA_020726505.1-Fun_JAHLEZ010000010.1_i000_002352	182	398	216	0.964286	0.315789
GCA_021432625.1-Fun_MU270344.1_i000_005146	182	398	216	0.964286	0.315789
GCA_014764975.1-Fun_JACYFE010005670.1_i000_007428	181	389	208	0.928571	0.350759
GCA_000982615.1-Pro_HF955210.1_i000_005503	190	420	230	1.02679	0.488323
GCA_002573605.1-Fun_PDNA01000140.1_i000_001800	182	395	213	0.950893	0.253571
GCA_000499725.1-Pro_HG710781.1_i000_001993	195	401	206	0.919643	0.392381
GCA_002980475.2-Fun_PVQB02000090.1_i000_002558	181	389	208	0.928571	0.351351
GCA_000383075.1-Fun_KB909498.1_i000_003593	147	368	221	0.986607	0.545679
GCA_001293395.1-Pro_LGTL01000026.1_i000_008488	160	380	220	0.982143	0.517647
GCA_020736505.1-Fun_JAHBNI010000005.1_i000_008808	177	386	209	0.933036	0.367958
GCA_000002765.3-Pro_LN999945.1_i000_003043	186	410	224	1	0.377104
GCA_000149665.2-Pro_CH671954.1_i000_003143	186	410	224	1	0.377104
GCA_012898025.1-Pro_QFXU01000005.1_i000_004898	186	410	224	1	0.377104
GCA_900095595.1-Pro_LT963424.1_i000_003093	186	410	224	1	0.375839
GCA_013266175.1-Fun_JABFAI010000273.1_i000_009873	181	388	207	0.924107	0.349073
GCA_003589665.1-Fun_MVGC01000068.1_i000_002859	182	407	225	1.00446	0.380711
GCA_003012105.1-Fun_PXOA01000193.1_i000_003384	181	389	208	0.928571	0.34609
GCA_018360135.1-Fun_SRPV01000105.1_i000_000200	181	402	221	0.986607	0.36711
GCA_015679495.1-Fun_JAAAUW010003870.1_i000_011150	1	126	125	0.558036	0.603865
GCA_000150435.3-Pro_KE123623.1_i000_003331	186	410	224	1	0.369028
GCA_000150455.3-Pro_KE123501.1_i000_003250	186	410	224	1	0.369028
GCA_000227115.2-Fun_HE580271.1_i000_002702	181	401	220	0.982143	0.42065
GCA_003024255.1-Pla_CM009669.1_i000_017501	142	306	164	0.732143	0.362031
GCA_003795295.1-Fun_LKEB01000028.1_i000_005512	183	395	212	0.946429	0.339744
GCA_019633535.1-Fun_WSUE01000116.1_i000_001131	189	415	226	1.00893	0.410909
GCA_019633555.1-Fun_WSUG01000051.1_i000_010848	189	415	226	1.00893	0.410909
GCA_020744495.1-Fun_JAGTJS010000013.1_i000_003595	197	404	207	0.924107	0.340461
GCA_002276475.2-Fun_NCSK02000020.1_i000_003033	181	398	217	0.96875	0.191696
GCA_000337935.2-Ani_AKCR02000303.1_i000_013596	167	382	215	0.959821	0.466377
GCA_911693285.1-Fun_CAJVRM010000003.1_i000_000262	180	397	217	0.96875	0.243547
GCA_000186055.2-Pro_GG665024.1_i000_003837	186	410	224	1	0.377104
GCA_020744475.1-Fun_JAGMUX010000015.1_i000_004770	181	389	208	0.928571	0.350759
GCA_000441895.2-Ani_KE524806.1_i000_002231	183	407	224	1	0.429942
GCA_005059855.1-Fun_NAJP01000007.1_i000_015146	194	418	224	1	0.403604
GCA_001298625.1-Fun_CM003589.1_i000_002446	181	401	220	0.982143	0.425532
GCA_013396195.1-Fun_JAAQRI010000035.1_i000_001930	181	388	207	0.924107	0.349662
GCA_000150825.1-Fun_DS985216.1_i000_007554	227	397	170	0.758929	0.348361
PYSP002.0722.00001.C001_00602	147	366	219	0.977679	0.550251
GCA_001466705.1-Fun_LATX01000627.1_i000_001658	185	405	220	0.982143	0.409683
GCA_000236905.1-Fun_HE612862.1_i000_002860	180	401	221	0.986607	0.429961
CANI016.0722.00001.C001_01439	149	370	221	0.986607	0.456612
GCA_004154745.1-Fun_PDXA01000001.1_i000_000021	177	386	209	0.933036	0.364111
GCA_003574525.1-Fun_QPFE01000105.1_i000_005311	177	386	209	0.933036	0.364111
GCA_004154755.1-Fun_PDXD01000033.1_i000_007973	177	386	209	0.933036	0.364111
GCA_004154765.1-Fun_PDXG01000031.1_i000_008378	177	386	209	0.933036	0.364111
GCA_004154815.1-Fun_PEJP01000095.1_i000_012708	177	386	209	0.933036	0.364111
GCA_004154835.1-Fun_PDUP01000063.1_i000_010839	177	386	209	0.933036	0.364111
GCA_004154845.1-Fun_PDXH01000065.1_i000_011462	177	386	209	0.933036	0.364111
GCA_004155955.1-Fun_PDWY01000042.1_i000_008511	177	386	209	0.933036	0.364111
GCA_004156015.1-Fun_PDXB01000034.1_i000_007432	177	386	209	0.933036	0.364111
GCA_004156035.1-Fun_PDXC01000009.1_i000_013337	177	386	209	0.933036	0.364111
GCA_004168565.1-Fun_PDXF01000030.1_i000_006970	177	386	209	0.933036	0.364111
GCA_020736535.1-Fun_JAHBNJ010000009.1_i000_012363	177	386	209	0.933036	0.364111
GCA_018360275.1-Fun_SRQB01000027.1_i000_003068	181	390	209	0.933036	0.347754
GCA_000149555.1-Fun_CM000584.1_i000_011330	181	388	207	0.924107	0.365079
GCA_010093715.1-Fun_MU005781.1_i000_010944	182	389	207	0.924107	0.362522
GCA_018360575.1-Fun_SRQL01000017.1_i000_001790	181	393	212	0.946429	0.352159
GCA_018360355.1-Fun_SRQC01000028.1_i000_003410	181	390	209	0.933036	0.347176
GCA_018360525.1-Fun_SRQD01000079.1_i000_007222	181	390	209	0.933036	0.347176
GCA_001572055.1-Fun_LPVP01000042.1_i000_011495	177	386	209	0.933036	0.364111
GCA_001642055.1-Fun_KV441470.1_i000_001757	177	386	209	0.933036	0.364111
GCA_004154735.1-Fun_PDXE01000062.1_i000_010828	177	386	209	0.933036	0.364111
GCA_018360385.1-Fun_SRQF01000053.1_i000_005576	181	390	209	0.933036	0.347176
GCA_018361025.1-Fun_SRRH01000268.1_i000_003271	181	393	212	0.946429	0.352159
GCA_004156025.2-Fun_PDWZ02000008.1_i000_011726	177	386	209	0.933036	0.364111
GCA_013036055.1-Fun_JAAABM010000007.1_i000_006990	177	386	209	0.933036	0.364111
GCA_018360345.1-Fun_SRQH01000006.1_i000_006082	181	390	209	0.933036	0.346026
GCA_018360375.1-Fun_SRQE01000003.1_i000_003527	181	390	209	0.933036	0.346026
GCA_010093705.1-Fun_MU006090.1_i000_001382	182	394	212	0.946429	0.377897
GCA_018360435.1-Fun_SRQI01000150.1_i000_001367	181	393	212	0.946429	0.352159
GCA_018360445.1-Fun_SRQK01000014.1_i000_001112	181	393	212	0.946429	0.352159
GCA_001702695.2-Fun_CM008293.1_i000_011487	181	388	207	0.924107	0.359375
GCA_018360595.1-Fun_SRQJ01000033.1_i000_004182	181	393	212	0.946429	0.352159
GCA_018360325.1-Fun_SRQG01000059.1_i000_006578	181	393	212	0.946429	0.352159
GCA_018360465.1-Fun_SRQM01000028.1_i000_003516	181	393	212	0.946429	0.352159
GCA_018360755.1-Fun_SRQW01000038.1_i000_004613	181	393	212	0.946429	0.352159
GCA_018360765.1-Fun_SRQV01000001.1_i000_000074	181	393	212	0.946429	0.352159
GCA_018360685.1-Fun_SRRD01000003.1_i000_003694	181	393	212	0.946429	0.352745
GCA_018360055.1-Fun_SRPP01000129.1_i000_000815	181	393	212	0.946429	0.352159
GCA_018360085.1-Fun_SRPR01000013.1_i000_000902	181	393	212	0.946429	0.350993
GCA_019633545.1-Fun_WSUF01000044.1_i000_009665	189	415	226	1.00893	0.410909
GCA_018360975.1-Fun_SRRC01000008.1_i000_007793	181	393	212	0.946429	0.352159
GCA_000347355.1-Fun_CAGA01000002.1_i000_008366	181	393	212	0.946429	0.352159
GCA_018360565.1-Fun_SRQP01000047.1_i000_005376	181	393	212	0.946429	0.352159
GCA_018360585.1-Fun_SRQN01000058.1_i000_006193	181	393	212	0.946429	0.352159
GCA_018360605.1-Fun_SRQO01000001.1_i000_000041	181	393	212	0.946429	0.352159
GCA_018360825.1-Fun_SRRA01000013.1_i000_000984	181	393	212	0.946429	0.352159
GCA_018360865.1-Fun_SRRG01000010.1_i000_000073	181	393	212	0.946429	0.352159
GCA_018360905.1-Fun_SRRI01000020.1_i000_002380	181	393	212	0.946429	0.352159
GCA_018360955.1-Fun_SRQY01000064.1_i000_006740	181	393	212	0.946429	0.352159
GCA_018360935.1-Fun_SRRK01000563.1_i000_006421	181	393	212	0.946429	0.352159
GCA_011022315.1-Fun_CP049005.1_i000_008041	181	401	220	0.982143	0.425532
GCA_018360215.1-Fun_SRPX01000544.1_i000_005978	181	393	212	0.946429	0.352159
GCA_018360075.1-Fun_SRPQ01000006.1_i000_005724	181	393	212	0.946429	0.351575
GCA_000340195.1-Fun_KB446544.1_i000_010146	192	416	224	1	0.405797
GCA_018360045.1-Fun_SRPN01000069.1_i000_006782	181	393	212	0.946429	0.352159
GCA_018360065.1-Fun_SRPO01000008.1_i000_007141	181	393	212	0.946429	0.352159
GCA_905337335.1-Fun_CAJPDQ010000002.1_i000_000788	181	388	207	0.924107	0.2875
GCA_020747015.1-Fun_JAGTJM010000018.1_i000_003639	180	389	209	0.933036	0.364111
GCA_000142805.1-Fun_CU928180.1_i000_005048	181	401	220	0.982143	0.430528
GCA_001023035.1-Fun_JRVG01000060.1_i000_010151	181	388	207	0.924107	0.349073
GCA_001023045.1-Fun_JRVF01000498.1_i000_008285	181	388	207	0.924107	0.349073
GCA_001023065.1-Fun_JRVH01002846.1_i000_010681	181	388	207	0.924107	0.349073
GCA_003290285.1-Fun_PKMI01000001.1_i000_001130	181	388	207	0.924107	0.349073
GCA_003615215.1-Fun_MRDB01000063.1_i000_012693	181	388	207	0.924107	0.349073
GCA_009663055.1-Fun_CP023083.1_i000_009500	181	388	207	0.924107	0.349073
GCA_009663095.1-Fun_CP023095.1_i000_009474	181	388	207	0.924107	0.349073
GCA_009663115.1-Fun_CP023107.1_i000_009509	181	388	207	0.924107	0.349073
GCA_013396165.1-Fun_JAAQPF010000392.1_i000_008727	181	388	207	0.924107	0.349073
GCA_017309865.1-Fun_PKMH01000079.1_i000_003958	181	388	207	0.924107	0.349073
GCA_017309875.1-Fun_PKMG01000089.1_i000_009332	181	388	207	0.924107	0.349073
GCA_017309895.1-Fun_PKMJ01000010.1_i000_011063	181	388	207	0.924107	0.349073
GCA_900029915.1-Fun_FCQG01000012.1_i000_011293	181	388	207	0.924107	0.349073
GCA_900079805.1-Fun_HF679029.1_i000_010257	181	388	207	0.924107	0.349073
GCA_900096505.1-Fun_FMSL01000015.1_i000_002267	181	388	207	0.924107	0.349073
GCA_900096605.1-Fun_FMJS01000015.1_i000_008130	181	388	207	0.924107	0.349073
GCA_900096615.1-Fun_FMJV01000016.1_i000_004219	181	388	207	0.924107	0.349073
GCA_900096625.1-Fun_FMJX01000016.1_i000_012574	181	388	207	0.924107	0.349073
GCA_900096635.1-Fun_FMJW01000007.1_i000_004989	181	388	207	0.924107	0.349073
GCA_900096645.1-Fun_FMJU01000013.1_i000_002861	181	388	207	0.924107	0.349073
GCA_900096685.1-Fun_FMSM01000015.1_i000_011130	181	388	207	0.924107	0.349073
GCA_900096705.1-Fun_FMJT01000015.1_i000_005470	181	388	207	0.924107	0.349073
GCA_901677955.1-Fun_CABFJX010000279.1_i000_007484	181	388	207	0.924107	0.349073
GCA_901677965.1-Fun_CABFJW010000090.1_i000_003401	181	388	207	0.924107	0.349073
GCA_902702945.1-Fun_CACRXN010000163.1_i000_001971	181	388	207	0.924107	0.349073
GCA_019702505.1-Fun_JAANER010000010.1_i000_001940	177	386	209	0.933036	0.364111
GCA_005059855.1-Fun_NAJP01000037.1_i000_009666	194	418	224	1	0.511416
GCA_021176775.1-Fun_JAJEVK010000003.1_i000_003817	181	389	208	0.928571	0.356164
GCA_900067095.1-Fun_FJOF01000005.1_i000_008222	181	388	207	0.924107	0.349073
GCA_013781345.1-Fun_JAAOAJ010000598.1_i000_011601	181	388	207	0.924107	0.349662
GCA_003316975.2-Fun_CM010973.1_i000_009354	181	388	207	0.924107	0.349662
GCA_013395995.1-Fun_JAAOAR010000367.1_i000_007402	181	388	207	0.924107	0.349662
GCA_013396035.1-Fun_JAAOAS010000006.1_i000_000104	181	388	207	0.924107	0.349662
GCA_013396175.1-Fun_JAAOAK010000289.1_i000_009342	181	388	207	0.924107	0.349662
GCA_012932015.1-Fun_JAADJF010000167.1_i000_006852	181	388	207	0.924107	0.349073
GCA_000222805.1-Fun_AFQF01001995.1_i000_006500	181	388	207	0.924107	0.349073
GCA_000260215.2-Fun_KK033188.1_i000_006241	181	388	207	0.924107	0.349073
GCA_014154955.1-Fun_CM024368.1_i000_011894	181	388	207	0.924107	0.349073
GCA_018894095.1-Fun_RSAI01000012.1_i000_003890	181	388	207	0.924107	0.349073
GCA_000149955.2-Fun_CM000597.1_i000_014820	181	388	207	0.924107	0.349073
GCA_000259975.2-Fun_JH650830.1_i000_004594	181	388	207	0.924107	0.349073
GCA_000260155.3-Fun_JH651399.1_i000_014269	181	388	207	0.924107	0.349073
GCA_000260175.2-Fun_JH657930.1_i000_006854	181	388	207	0.924107	0.349073
GCA_000260195.2-Fun_JH658282.1_i000_007500	181	388	207	0.924107	0.349073
GCA_000260495.2-Fun_JH659333.1_i000_008502	181	388	207	0.924107	0.349073
GCA_000271705.2-Fun_JH717907.1_i000_014571	181	388	207	0.924107	0.349073
GCA_000271745.2-Fun_JH717845.1_i000_010609	181	388	207	0.924107	0.349073
GCA_000350345.1-Fun_KB730092.1_i000_003173	181	388	207	0.924107	0.349073
GCA_000350365.1-Fun_KB726235.1_i000_001497	181	388	207	0.924107	0.349073
GCA_003615075.1-Fun_MRCW01000087.1_i000_017320	181	388	207	0.924107	0.349073
GCA_003615085.1-Fun_CM010805.1_i000_011113	181	388	207	0.924107	0.349073
GCA_003615095.1-Fun_MRCV01000028.1_i000_009087	181	388	207	0.924107	0.349073
GCA_003615115.1-Fun_MRCX01000011.1_i000_001201	181	388	207	0.924107	0.349073
GCA_003615155.1-Fun_MRCY01000036.1_i000_010080	181	388	207	0.924107	0.349073
GCA_003615165.1-Fun_MRCZ01000008.1_i000_016210	181	388	207	0.924107	0.349073
GCA_003615185.1-Fun_MRDA01000028.1_i000_008081	181	388	207	0.924107	0.349073
GCA_004141715.1-Fun_MQTW01000073.1_i000_017786	181	388	207	0.924107	0.349073
GCA_005930515.1-Fun_SRMI01000009.1_i000_015120	181	388	207	0.924107	0.349073
GCA_007994515.1-Fun_VMNF01000012.1_i000_002101	181	388	207	0.924107	0.349073
GCA_013085055.1-Fun_CP052045.1_i000_012719	181	388	207	0.924107	0.349073
GCA_013363075.1-Fun_JAAFOW010000207.1_i000_001309	181	388	207	0.924107	0.349073
GCA_019157295.1-Fun_JAELUQ010000007.1_i000_015230	181	388	207	0.924107	0.349073
GCA_020744335.1-Fun_JAHBOG010000012.1_i000_003946	181	388	207	0.924107	0.349073
GCA_020796175.1-Fun_JAJGYP010000007.1_i000_017313	181	388	207	0.924107	0.349073
GCA_020744455.1-Fun_JAHEWL010000007.1_i000_015209	181	388	207	0.924107	0.349073
GCA_001673695.2-Fun_LYUB02000005.1_i000_002099	190	415	225	1.00446	0.431034
GCA_000260075.2-Fun_JH650974.1_i000_010837	181	388	207	0.924107	0.349073
GCA_000260235.2-Fun_JH658369.1_i000_005279	181	388	207	0.924107	0.349073
GCA_019157275.1-Fun_JAELUR010000005.1_i000_014875	181	388	207	0.924107	0.349073
GCA_010015605.1-Fun_ML975459.1_i000_010615	178	384	206	0.919643	0.355786
GCA_013396005.1-Fun_JAAOAO010000525.1_i000_011178	181	388	207	0.924107	0.349662
GCA_004337985.1-Fun_CM014985.1_i000_000669	184	395	211	0.941964	0.349338
GCA_001702395.2-Fun_MAVT02000360.1_i000_005089	195	418	223	0.995536	0.359098
GCA_001050175.1-Fun_LFMI01000838.1_i000_009053	181	389	208	0.928571	0.343234
GCA_021399435.1-Fun_JAJTUP010000011.1_i000_002417	195	418	223	0.995536	0.427203
GCA_001481775.2-Fun_JPDN02000003.1_i000_005315	181	398	217	0.96875	0.367797
GCA_002894205.1-Fun_MTYH01000056.1_i000_007829	181	398	217	0.96875	0.367797
GCA_002894145.1-Fun_MTYI01000063.1_i000_009763	181	389	208	0.928571	0.350168
GCA_900044065.1-Fun_FCQH01000016.1_i000_015571	181	388	207	0.924107	0.349073
GCA_017918225.1-Pro_CM030549.1_i000_001083	190	420	230	1.02679	0.485232
GCA_017916335.1-Pro_CM030441.1_i000_001062	190	420	230	1.02679	0.485232
GCA_017918215.1-Pro_CM030477.1_i000_001024	190	420	230	1.02679	0.485232
GCA_019669835.1-Fun_MU251626.1_i000_008723	180	397	217	0.96875	0.27125
GCA_013396255.1-Fun_JAAOAY010000076.1_i000_003003	181	388	207	0.924107	0.349073
GCA_000320565.2-Fun_KB456270.1_i000_008902	192	416	224	1	0.410256
GCA_011074865.2-Fun_CP064812.1_i000_000870	180	400	220	0.982143	0.402194
GCA_002022785.1-Fun_LVVK01000011.1_i000_008730	181	390	209	0.933036	0.353638
GCA_000326105.1-Fun_AGVY01000369.1_i000_008224	202	419	217	0.96875	0.5179
GCA_020045945.2-Fun_CM034696.1_i000_005352	181	390	209	0.933036	0.353638
GCA_001601855.1-Pro_CM003852.1_i000_002546	186	410	224	1	0.379019
GCA_900097025.1-Pro_LT969574.1_i000_003017	186	410	224	1	0.379019
GCA_011066345.1-Fun_QLNT01000004.1_i000_008524	181	390	209	0.933036	0.353638
GCA_000723685.1-Pro_HG810772.1_i000_003360	186	410	224	1	0.377104
GCA_000988865.1-Fun_JOKZ01000466.1_i000_009832	181	390	209	0.933036	0.351852
GCA_017916305.1-Pro_CM030585.1_i000_001114	190	420	230	1.02679	0.485232
GCA_000236905.1-Fun_HE612864.1_i000_003478	212	433	221	0.986607	0.409259
GCA_006981975.1-Fun_SPUL01000010.1_i000_006693	181	389	208	0.928571	0.351946
GCA_006981985.1-Fun_SPUK01000008.1_i000_006219	181	389	208	0.928571	0.351946
GCA_000277445.1-Pro_AJWJ01000038.1_i000_001568	182	407	225	1.00446	0.418216
GCA_002838845.1-Fun_NQLC01000509.1_i000_009420	181	389	208	0.928571	0.350168
GCA_003025095.1-Fun_KZ679676.1_i000_001878	181	389	208	0.928571	0.350168
GCA_001636745.1-Fun_AZHC01000007.1_i000_007966	181	388	207	0.924107	0.343284
GCA_007866325.1-Fun_SBHS01000001.1_i000_000374	181	388	207	0.924107	0.343284
GCA_013396205.1-Fun_JAAOAN010000219.1_i000_006632	181	388	207	0.924107	0.349073
GCA_020002365.1-Fun_JAINEY010000007.1_i000_009248	181	389	208	0.928571	0.343802
GCA_020744355.1-Fun_JAHEVI010000007.1_i000_014532	208	415	207	0.924107	0.333871
GCA_000209065.1-Pro_CH473844.1_i000_000043	1	222	221	0.986607	0.780919
GCA_000167675.2-Fun_GL985064.1_i000_004442	181	389	208	0.928571	0.343802
GCA_000513815.1-Fun_KI911148.1_i000_005029	181	389	208	0.928571	0.343802
GCA_018360175.1-Fun_SRPS01000017.1_i000_002179	181	393	212	0.946429	0.350993
GCA_010015635.1-Fun_ML976052.1_i000_006951	180	388	208	0.928571	0.358003
GCA_022432515.1-Fun_JAJKLA010000006.1_i000_009459	182	401	219	0.977679	0.351525
GCA_010094025.1-Fun_ML991820.1_i000_008156	182	395	213	0.950893	0.329212
GCA_001636725.1-Fun_AZHB01000011.1_i000_001779	181	391	210	0.9375	0.351759
GCA_019915245.1-Fun_CM034120.1_i000_009814	181	388	207	0.924107	0.349662
GCA_003490085.1-Pla_LXQA010521491.1_i000_077719	1	78	77	0.34375	0.974684
GCA_020726485.1-Fun_JAHEWH010000013.1_i000_002850	180	397	217	0.96875	0.27193
GCA_021653875.1-Fun_JAKFRD010000104.1_i000_000999	154	370	216	0.964286	0.533333
GCA_018360365.1-Fun_SRQA01000010.1_i000_000065	181	394	213	0.950893	0.355
CANI001.0722.00001.C001_01587	148	370	222	0.991071	0.513889
GCA_022432395.1-Fun_JAJKLJ010000005.1_i000_010407	182	399	217	0.96875	0.358678
GCA_900257145.2-Pro_LT990240.1_i000_002777	186	410	224	1	0.382906
GCA_003635345.1-Fun_QVQW01000037.1_i000_005039	182	386	204	0.910714	0.352332
GCA_004217705.1-Fun_CP034459.1_i000_004208	190	415	225	1.00446	0.448207
GCA_000167075.2-Fun_JH797452.1_i000_002506	271	491	220	0.982143	0.355987
GCA_000320625.2-Pro_KQ234279.1_i000_002666	187	413	226	1.00893	0.395797
MEJA003.0722.00001.C001_00745	142	365	223	0.995536	0.538647
GCA_014905795.1-Fun_JACBPP010000002.1_i000_001846	190	415	225	1.00446	0.448207
GCA_020744275.1-Fun_JAGTJR010000008.1_i000_013577	182	397	215	0.959821	0.382562
GCA_000302655.1-Fun_AHHD01000462.1_i000_010651	182	397	215	0.959821	0.381883
GCA_010094045.1-Fun_ML986593.1_i000_003972	182	396	214	0.955357	0.370242
GCA_000171015.2-Fun_ABDG02000027.1_i000_002035	181	398	217	0.96875	0.367797
GCA_000003835.1-Fun_CH408083.1_i000_005759	271	496	225	1.00446	0.375
GCA_914969965.1-Pro_CAJZCX010000007.1_i000_002750	187	413	226	1.00893	0.395797
GCA_002269645.1-Ani_NIVC01000179.1_i000_006203	185	409	224	1	0.412523
GCA_002269645.1-Ani_NIVC01001589.1_i000_028791	185	409	224	1	0.412523
GCA_002269645.1-Ani_NIVC01002030.1_i000_033414	185	409	224	1	0.412523
GCA_014636115.1-Fun_JAASFG010000007.1_i000_004514	271	496	225	1.00446	0.375
GCA_003025105.1-Fun_KZ679256.1_i000_000402	181	398	217	0.96875	0.367797
GCA_013423425.1-Fun_BLZH01000001.1_i000_000270	181	398	217	0.96875	0.367797
GCA_020647865.1-Fun_CP084944.1_i000_004173	181	398	217	0.96875	0.367797
GCA_009746105.1-Pla_CM019268.1_i000_009305	107	327	220	0.982143	0.209524
GCA_000582765.1-Pro_HF955102.1_i000_005720	190	420	230	1.02679	0.483193
GCA_000320685.2-Pro_KQ235387.1_i000_002936	187	413	226	1.00893	0.393728
GCA_900093555.2-Pro_LT635620.2_i000_002431	187	412	225	1.00446	0.389948
GCA_900093535.1-Pro_LT615264.1_i000_002265	187	413	226	1.00893	0.393043
GCA_000687475.2-Fun_CP072753.1_i000_000755	181	389	208	0.928571	0.344371
GCA_000965225.2-Fun_BBTG02000005.1_i000_001300	181	389	208	0.928571	0.344371
GCA_021066465.1-Fun_JAJKFY010000144.1_i000_004274	159	376	217	0.96875	0.382042
GCA_007821545.1-Fun_QGMJ01000381.1_i000_005069	180	396	216	0.964286	0.306818
GCA_001664035.1-Fun_LXTC01000003.1_i000_003350	190	415	225	1.00446	0.453629
GCA_900093545.1-Pro_LT615247.1_i000_002335	187	412	225	1.00446	0.388601
GCA_003675555.2-Fun_QOBI02000008.1_i000_004932	271	496	225	1.00446	0.373134
GCA_009498055.1-Fun_CP038491.1_i000_005532	271	496	225	1.00446	0.373134
GCA_009498075.1-Fun_CP039557.1_i000_005518	271	496	225	1.00446	0.373134
GCA_009498095.1-Fun_CP039659.1_i000_005540	271	496	225	1.00446	0.373134
GCA_009498115.1-Fun_CP039667.1_i000_005532	271	496	225	1.00446	0.373134
GCA_009498135.1-Fun_CP039625.1_i000_005535	271	496	225	1.00446	0.373134
NICO001.0722.00001.C001_01534	149	370	221	0.986607	0.437624
GCA_905397895.1-Ani_CAJPWZ010001066.1_i000_021242	180	304	124	0.553571	0.246032
GCA_905397895.1-Ani_CAJPWZ010001066.1_i000_021242	293	383	90	0.401786	0.178571
GCA_002120315.1-Fun_KZ111547.1_i000_004845	182	401	219	0.977679	0.352657
MEMA007.0722.00001.C001_00670	146	366	220	0.982143	0.462185
MEMA007.0722.00002.C001_00670	146	366	220	0.982143	0.462185
GCA_010015785.1-Fun_ML978726.1_i000_006314	182	396	214	0.955357	0.373473
GCA_020536175.1-Fun_JAEUBF010000443.1_i000_001828	181	401	220	0.982143	0.422265
GCA_900618395.1-Ani_UZAI01018017.1_i000_019163	18	225	207	0.924107	0.8625
THCL001.0722.00001.C001_01461	147	367	220	0.982143	0.518868
GCA_007825345.1-Fun_QGMK01002118.1_i000_008948	181	397	216	0.964286	0.309013
GCA_905237095.1-Pro_CAJNNW010034418.1_i000_042636	227	449	222	0.991071	0.423664
GCA_014133895.1-Fun_CP059253.1_i000_004547	181	401	220	0.982143	0.43222
GCA_002077065.1-Fun_NAJO01000009.1_i000_018370	182	396	214	0.955357	0.355482
GCA_001654555.2-Fun_LUFC02000232.1_i000_003919	181	388	207	0.924107	0.349073
GCA_013396075.1-Fun_JAAOAV010000003.1_i000_000739	181	388	207	0.924107	0.349073
GCA_019565615.1-Fun_CP075866.1_i000_005450	181	390	209	0.933036	0.353638
GCA_000696155.1-Ani_KK852458.1_i000_000966	187	419	232	1.03571	0.53211
GCA_905368565.1-Ani_CAJPIZ010055577.1_i000_022886	1	158	157	0.700893	0.975155
GCA_013396095.1-Fun_JAAQRM010000093.1_i000_002956	181	388	207	0.924107	0.349073
GCA_001578235.1-Fun_LFZN01000033.1_i000_006494	192	415	223	0.995536	0.401079
GCA_900096695.1-Fun_FMJY01000007.1_i000_004500	181	388	207	0.924107	0.349073
GCA_010093785.1-Fun_MU003792.1_i000_005219	182	395	213	0.950893	0.370435
GCA_003711515.1-Fun_ML119051.1_i000_000641	181	389	208	0.928571	0.308605
GCA_000956335.1-Pro_KQ001671.1_i000_002628	187	413	226	1.00893	0.430476
GCA_013364935.1-Fun_JABEVY010000110.1_i000_005062	211	418	207	0.924107	0.332263
GCA_002105025.1-Fun_MCFA01000340.1_i000_009511	181	398	217	0.96875	0.372213
GCA_013758895.1-Fun_JAAOAI010000961.1_i000_012755	211	418	207	0.924107	0.332263
GCA_013396185.1-Fun_JAAQPE010000422.1_i000_010916	211	418	207	0.924107	0.332797
GCA_010094095.1-Fun_ML979134.1_i000_003974	179	399	220	0.982143	0.389381
GCA_900617995.1-Ani_UZAL01030401.1_i000_009935	18	225	207	0.924107	0.8625
GCA_002271885.2-Pla_CM008444.1_i000_003526	95	233	138	0.616071	0.579832
GCA_900097035.1-Pro_LT969560.1_i000_002641	186	410	224	1	0.382253
GCA_002095265.1-Pro_MBFZ01000215.1_i000_002913	185	407	222	0.991071	0.368159
GCA_013396015.1-Fun_JAAOAM010000226.1_i000_009536	207	414	207	0.924107	0.33441
GCA_011745845.1-Pla_VYZY01003846.1_i000_016987	95	242	147	0.65625	0.607438
GCA_902077795.2-Fun_CABFNQ020000436.1_i000_000283	181	390	209	0.933036	0.354839
GCA_019669845.1-Fun_MU251271.1_i000_008298	194	418	224	1	0.439216
GCA_004936735.2-Pro_SCFC02000045.1_i000_003668	189	413	224	1	0.450704
GCA_902006505.2-Fun_CABFNO020001301.1_i000_003428	181	390	209	0.933036	0.354839
GCA_000340215.1-Fun_KB446564.1_i000_012063	192	416	224	1	0.432432
GCA_001602025.1-Pro_CM003866.1_i000_002627	186	410	224	1	0.360129
GCA_905216605.1-Pla_LR999452.1_i000_005048	65	168	103	0.459821	0.602339
GCA_012550715.1-Fun_JAANYQ010000001.1_i000_000117	202	411	209	0.933036	0.337097
GCA_004917725.1-Fun_QZBM01000666.1_i000_008325	182	389	207	0.924107	0.382625
GCA_000143105.2-Fun_GL629735.1_i000_000964	185	395	210	0.9375	0.352941
GCA_900074725.1-Fun_LT598458.1_i000_002830	181	401	220	0.982143	0.426357
GCA_001653235.2-Fun_CM008055.1_i000_001292	181	389	208	0.928571	0.343234
GCA_010015805.1-Fun_ML978131.1_i000_009501	187	404	217	0.96875	0.3875
GCA_001078035.1-Fun_LFTZ01000013.1_i000_001418	166	388	222	0.991071	0.45122
CANI005.0722.00001.C001_01591	149	370	221	0.986607	0.52
GCA_019425475.1-Pro_NLFJ01000114.1_i000_001755	190	420	230	1.02679	0.479167
GCA_021307395.1-Pro_SOPI01000535.1_i000_012669	190	420	230	1.02679	0.479167
GCA_002120305.1-Fun_KZ112482.1_i000_005199	182	401	219	0.977679	0.351525
GCA_010093805.1-Fun_ML996179.1_i000_009278	179	385	206	0.919643	0.355786
GCA_021845515.1-Fun_VIDS01000002.1_i000_004849	184	395	211	0.941964	0.352843
GCA_021442365.1-Fun_PHFK01000004.1_i000_006121	184	395	211	0.941964	0.352254
GCA_004346965.1-Fun_CP034204.1_i000_001183	184	395	211	0.941964	0.352254
GCA_004337975.1-Fun_RRCJ01000005.1_i000_000767	184	395	211	0.941964	0.352254
GCA_003025155.1-Fun_KZ679133.1_i000_006332	181	388	207	0.924107	0.342715
GCA_000091225.2-Fun_AL590451.2_i000_001649	166	388	222	0.991071	0.45122
GCA_900074905.1-Fun_FJUX01000114.1_i000_010243	182	398	216	0.964286	0.320951
GCA_905237085.1-Pro_CAJNNV010027271.1_i000_037542	312	534	222	0.991071	0.364532
GCA_001299535.1-Pro_LJSK01000048.1_i000_002378	158	380	222	0.991071	0.522353
GCA_000002515.1-Fun_CR382126.1_i000_004252	181	401	220	0.982143	0.430528
GCA_003033665.1-Fun_PVEM01000004.1_i000_009532	181	388	207	0.924107	0.347315
GCA_016952355.1-Fun_CP064748.1_i000_004807	181	388	207	0.924107	0.347315
GCA_900074925.1-Fun_FJUY01000004.1_i000_004984	182	398	216	0.964286	0.385714
GCA_017918235.1-Pro_JAFJZO010000041.1_i000_007868	190	420	230	1.02679	0.485232
GCA_900074885.1-Fun_FJUW01000012.1_i000_007633	182	398	216	0.964286	0.320951
GCA_002591405.1-Fun_NJEU01000029.1_i000_003715	194	418	224	1	0.439216
GCA_900091695.1-Fun_LT853702.1_i000_010514	192	416	224	1	0.411009
GCA_000769265.1-Fun_JPKY01000096.1_i000_008791	182	391	209	0.933036	0.336554
GCA_002900925.1-Fun_LN890542.1_i000_001439	181	401	220	0.982143	0.430528
GCA_000002495.2-Fun_CM001231.1_i000_001067	184	395	211	0.941964	0.352254
GCA_900099495.1-Fun_LT882686.1_i000_010490	192	416	224	1	0.411009
GCA_000219625.1-Fun_CM001206.1_i000_009432	192	416	224	1	0.411009
GCA_900184115.1-Fun_LT854263.1_i000_010543	192	416	224	1	0.411009
GCA_900184105.1-Fun_LT854283.1_i000_010449	192	416	224	1	0.411009
GCA_010015815.1-Fun_ML977498.1_i000_000745	180	395	215	0.959821	0.378521
GCA_004917225.1-Fun_QZAH01000722.1_i000_008788	182	389	207	0.924107	0.382625
GCA_000691945.2-Pro_LN871598.1_i000_002278	183	405	222	0.991071	0.498876
GCA_003369665.1-Fun_PDLM01000012.1_i000_003486	182	398	216	0.964286	0.350649
GCA_007821495.1-Fun_QGMH01000093.1_i000_005718	180	396	216	0.964286	0.3099
GCA_000292585.1-Fun_JH793404.1_i000_005945	184	395	211	0.941964	0.3376
GCA_000292605.1-Fun_JH795555.1_i000_010518	184	395	211	0.941964	0.3376
GCA_001692915.1-Fun_KV750114.1_i000_009292	182	396	214	0.955357	0.494226
GCA_900074755.1-Fun_LT598453.1_i000_003973	181	401	220	0.982143	0.425532
GCA_010094025.1-Fun_ML991780.1_i000_002806	190	417	227	1.01339	0.408273
GCA_900074735.1-Fun_LT598476.1_i000_004728	181	401	220	0.982143	0.425532
GCA_016906535.1-Fun_CP059658.1_i000_000475	330	543	213	0.950893	0.26071
GCA_000149285.1-Pla_CM000140.1_i000_010321	178	353	175	0.78125	0.333333
GCA_000818155.1-Fun_CM003100.1_i000_002996	182	395	213	0.950893	0.361017
NIUR001.0722.00001.C001_02134	149	370	221	0.986607	0.448276
GCA_000827425.1-Fun_KN822146.1_i000_016082	185	413	228	1.01786	0.41989
GCA_001937105.1-Fun_MPGH01000111.1_i000_001033	181	388	207	0.924107	0.33441
GCA_900074895.1-Fun_FJVC01000229.1_i000_008088	182	398	216	0.964286	0.319527
GCA_902141235.2-Fun_CABFOC020000002.1_i000_001598	181	390	209	0.933036	0.354237
GCA_000151145.1-Fun_DS995701.1_i000_007978	175	385	210	0.9375	0.354132
GCA_000813385.1-Fun_KN714668.1_i000_000765	182	395	213	0.950893	0.361017
GCA_000966595.1-Fun_LAFY01000422.1_i000_004442	228	452	224	1	0.385542
GCA_907166805.1-Fun_CAJRGZ010000017.1_i000_003793	177	386	209	0.933036	0.364111
GCA_001633055.2-Fun_LKCN02000004.1_i000_005498	182	389	207	0.924107	0.3
GCA_000303195.2-Fun_CM003200.1_i000_009074	181	388	207	0.924107	0.346734
GCA_001703955.2-Fun_CM004558.1_i000_008417	181	388	207	0.924107	0.346734
GCA_016952305.1-Fun_CP064756.1_i000_010706	181	388	207	0.924107	0.346734
GCA_905332025.1-Fun_CAJOAV010000106.1_i000_004283	213	420	207	0.924107	0.329618
GCA_905332055.1-Fun_CAJOAW010000116.1_i000_011161	213	420	207	0.924107	0.329618
GCA_905359465.1-Fun_CAJPIH010000764.1_i000_006323	213	420	207	0.924107	0.329618
GCA_905359485.1-Fun_CAJPIJ010000134.1_i000_006113	213	420	207	0.924107	0.329618
GCA_001006355.1-Fun_LAQI01000133.1_i000_001666	181	397	216	0.964286	0.385027
GCA_001975905.1-Fun_MSZU01000113.1_i000_006434	181	397	216	0.964286	0.385027
GCA_004786275.1-Fun_PQXN01000002.1_i000_000192	182	398	216	0.964286	0.378284
GCA_001675295.1-Fun_LYXU01000003.1_i000_008853	182	388	206	0.919643	0.347386
GCA_000002415.2-Pro_CM000450.1_i000_002159	187	413	226	1.00893	0.403571
GCA_014298035.1-Fun_JABCIY010000157.1_i000_007117	192	415	223	0.995536	0.401802
GCA_020341155.1-Ani_JAHMML010000006.1_i000_008391	223	448	225	1.00446	0.426945
GCA_000320645.2-Pro_KQ234864.1_i000_005415	187	413	226	1.00893	0.398589
GCA_900097015.1-Pro_LT969420.1_i000_002760	186	410	224	1	0.365416
GCA_000240135.3-Fun_CM000576.1_i000_009911	181	388	207	0.924107	0.347315
GCA_000599445.1-Fun_CM002653.1_i000_009707	181	388	207	0.924107	0.347315
GCA_002352725.1-Fun_NQOC01000002.1_i000_002573	181	388	207	0.924107	0.347315
GCA_900044135.1-Fun_HG970334.1_i000_010383	181	388	207	0.924107	0.347315
GCA_900073075.1-Fun_LT222055.1_i000_010424	181	388	207	0.924107	0.347315
GCA_000750715.1-Fun_JPJT01001936.1_i000_003364	182	398	216	0.964286	0.352365
NIPI001.0722.00001.C001_02012	149	370	221	0.986607	0.443775
GCA_010093605.1-Fun_MU004181.1_i000_000798	181	396	215	0.959821	0.366269
GCA_001661325.1-Fun_KV454296.1_i000_004670	190	408	218	0.973214	0.403704
GCA_004917495.1-Fun_QZBE01000059.1_i000_007939	219	426	207	0.924107	0.400387
GCA_004917275.1-Fun_QZAO01000394.1_i000_006126	182	389	207	0.924107	0.383333
GCA_004917135.1-Fun_QZAJ01000195.1_i000_002628	182	389	207	0.924107	0.383333
GCA_004918105.1-Fun_QZBS01000753.1_i000_009544	182	389	207	0.924107	0.382625
GCA_004917795.1-Fun_QZBL01000474.1_i000_006713	182	389	207	0.924107	0.383333
GCA_003025115.1-Fun_KZ680213.1_i000_004731	181	388	207	0.924107	0.342149
GCA_000721785.1-Fun_KL584974.1_i000_000885	182	389	207	0.924107	0.382625
GCA_004917115.1-Fun_QZAI01000550.1_i000_002231	182	389	207	0.924107	0.382625
GCA_004917155.1-Fun_QZAG01001266.1_i000_001244	182	389	207	0.924107	0.382625
GCA_004917185.1-Fun_QZAL01000196.1_i000_003607	182	389	207	0.924107	0.382625
GCA_004917255.1-Fun_QZAM01000084.1_i000_010015	182	389	207	0.924107	0.382625
GCA_004917305.1-Fun_QZAP01000299.1_i000_005506	182	389	207	0.924107	0.382625
GCA_004917375.1-Fun_QZAT01000018.1_i000_003032	182	389	207	0.924107	0.382625
GCA_004917415.1-Fun_QZAX01000980.1_i000_010537	182	389	207	0.924107	0.382625
GCA_004917435.1-Fun_QZBA01000158.1_i000_002315	182	389	207	0.924107	0.382625
GCA_004917445.1-Fun_QZBB01000152.1_i000_002461	182	389	207	0.924107	0.382625
GCA_004917485.1-Fun_QZBD01000466.1_i000_006634	182	389	207	0.924107	0.382625
GCA_004917505.1-Fun_QZBF01000145.1_i000_001999	182	389	207	0.924107	0.382625
GCA_004917525.1-Fun_QZBG01000201.1_i000_002845	182	389	207	0.924107	0.382625
GCA_004917595.1-Fun_QZAQ01001755.1_i000_003058	182	389	207	0.924107	0.382625
GCA_004917605.1-Fun_QZAU01001331.1_i000_001653	182	389	207	0.924107	0.382625
GCA_004917685.1-Fun_QZBI01001091.1_i000_000463	182	389	207	0.924107	0.382625
GCA_004917705.1-Fun_QZBK01000454.1_i000_006720	182	389	207	0.924107	0.382625
GCA_004917755.1-Fun_QZBO01000152.1_i000_002099	182	389	207	0.924107	0.382625
GCA_004918115.1-Fun_QZBT01000229.1_i000_004499	182	389	207	0.924107	0.382625
GCA_004918145.1-Fun_QZBV01000071.1_i000_009410	182	389	207	0.924107	0.382625
GCA_004918165.1-Fun_QZBW01000679.1_i000_009274	182	389	207	0.924107	0.382625
GCA_004918195.1-Fun_QZCA01000021.1_i000_003413	182	389	207	0.924107	0.382625
GCA_004918245.1-Fun_QZBX01000013.1_i000_001526	182	389	207	0.924107	0.382625
GCA_004918505.1-Fun_QZCB01000314.1_i000_004787	182	389	207	0.924107	0.382625
GCA_004918575.1-Fun_QZBY01000538.1_i000_007297	182	389	207	0.924107	0.382625
GCA_004917615.1-Fun_QZAY01000063.1_i000_008672	182	389	207	0.924107	0.381919
GCA_004917555.1-Fun_QZBJ01000009.1_i000_009730	182	389	207	0.924107	0.382625
GCA_004917815.1-Fun_QZBQ01000019.1_i000_003162	182	389	207	0.924107	0.382625
GCA_004917355.1-Fun_QZAS01000019.1_i000_003067	182	389	207	0.924107	0.382625
GCA_000320665.2-Pro_KQ235046.1_i000_002761	187	413	226	1.00893	0.392361
GCA_001661425.1-Fun_KV453851.1_i000_002612	190	415	225	1.00446	0.444664
GCA_020744415.1-Fun_JAGMWT010000004.1_i000_009802	179	409	230	1.02679	0.402802
GCA_010015735.1-Fun_ML978067.1_i000_003717	178	394	216	0.964286	0.388489
GCA_000938715.1-Fun_LN736364.1_i000_002313	181	401	220	0.982143	0.426357
GCA_900492705.2-Fun_UIHA02000073.1_i000_008788	212	419	207	0.924107	0.330144
GCA_901446245.1-Fun_CABDWO010000179.1_i000_007061	212	419	207	0.924107	0.330144
GCA_905359455.1-Fun_CAJPII010000059.1_i000_005145	212	419	207	0.924107	0.330144
GCA_905359475.1-Fun_CAJPIG010000154.1_i000_006819	212	419	207	0.924107	0.330144
GCA_001625195.1-Fun_CM004176.1_i000_007237	150	359	209	0.933036	0.371226
GCA_010015745.1-Fun_ML978300.1_i000_012511	179	387	208	0.928571	0.364273
GCA_005059845.1-Fun_NAJN01000045.1_i000_009846	182	396	214	0.955357	0.237778
GCA_004918275.1-Fun_QZBR01000023.1_i000_004289	195	402	207	0.924107	0.373646
GCA_004353045.1-Fun_SKBQ01000060.1_i000_009190	185	393	208	0.928571	0.355556
GCA_020631695.1-Fun_CM036090.1_i000_005898	181	389	208	0.928571	0.345515
GCA_001661245.1-Fun_KV454011.1_i000_001032	181	400	219	0.977679	0.423598
GCA_013402915.1-Fun_CP058609.1_i000_003503	181	401	220	0.982143	0.430528
GCA_010093505.1-Fun_MU001637.1_i000_006499	195	419	224	1	0.402154
GCA_903819485.1-Fun_CAIJDU010000003.1_i000_002725	201	408	207	0.924107	0.369643
GCA_001662575.1-Fun_KV454995.1_i000_004102	182	398	216	0.964286	0.3456
GCA_002077065.1-Fun_NAJO01000016.1_i000_003867	182	396	214	0.955357	0.355482
GCA_013423425.1-Fun_BLZH01000004.1_i000_002856	194	418	224	1	0.439216
GCA_021066465.1-Fun_JAJKFY010000221.1_i000_005012	194	418	224	1	0.439216
GCA_019425555.1-Fun_MXQG01000002.1_i000_004367	181	388	207	0.924107	0.347899
GCA_020744135.1-Fun_JAGMVI010000004.1_i000_012164	181	388	207	0.924107	0.347899
GCA_900007375.1-Fun_LN649231.1_i000_013153	181	388	207	0.924107	0.347899
GCA_019609905.1-Fun_CM033787.1_i000_009449	182	388	206	0.919643	0.347386
GCA_002111425.1-Fun_KZ107830.1_i000_007691	181	397	216	0.964286	0.384342
GCA_008931885.1-Fun_VCHE01000010.1_i000_000400	181	397	216	0.964286	0.384342
GCA_012971845.1-Fun_QCYV01000263.1_i000_010935	181	397	216	0.964286	0.384342
GCA_002003505.1-Fun_BDMC01000001.1_i000_000108	46	266	220	0.982143	0.827068
GCA_000026365.1-Fun_CU928178.1_i000_003779	180	402	222	0.991071	0.427746
GCA_021535285.1-Fun_JAKETS010000005.1_i000_003823	180	402	222	0.991071	0.427746
GCA_004355905.1-Fun_CM015042.1_i000_000965	192	403	211	0.941964	0.344771
GCA_004917205.1-Fun_QZAN01000092.1_i000_010070	227	434	207	0.924107	0.353242
GCA_001972345.1-Fun_BDGX01000021.1_i000_003895	180	402	222	0.991071	0.435294
GCA_004917425.1-Fun_QZAZ01000139.1_i000_001394	219	426	207	0.924107	0.358131
GCA_004917165.1-Fun_QZAK01000230.1_i000_004362	219	426	207	0.924107	0.358131
GCA_004917335.1-Fun_QZAR01000023.1_i000_004342	219	426	207	0.924107	0.358131
GCA_004917625.1-Fun_QZBC01000007.1_i000_008653	219	426	207	0.924107	0.358131
GCA_004917665.1-Fun_QZBH01000033.1_i000_005190	219	426	207	0.924107	0.358131
GCA_013364965.1-Fun_JAAMOD010000249.1_i000_007950	212	419	207	0.924107	0.330144
GCA_001618945.2-Fun_CM038149.1_i000_004539	181	390	209	0.933036	0.351852
GCA_001578225.1-Fun_LFZO01000045.1_i000_006575	192	416	224	1	0.403604
GCA_010093535.1-Fun_MU003496.1_i000_003223	181	401	220	0.982143	0.383275
GCA_009982845.1-Fun_JAADKB010000006.1_i000_007396	182	390	208	0.928571	0.361739
GCA_004917385.1-Fun_QZAV01000048.1_i000_007647	227	434	207	0.924107	0.353242
GCA_004917745.1-Fun_QZBN01000198.1_i000_003753	227	434	207	0.924107	0.353242
GCA_004917105.1-Fun_QZAF01000084.1_i000_009640	227	434	207	0.924107	0.353242
GCA_004917825.1-Fun_QZBZ01000270.1_i000_004885	227	434	207	0.924107	0.353242
GCA_004918535.1-Fun_QZBU01002010.1_i000_005800	227	434	207	0.924107	0.353242
GCA_004917145.1-Fun_QZAE01000330.1_i000_005243	227	434	207	0.924107	0.353242
GCA_004918215.1-Fun_QZBP01001305.1_i000_001417	227	434	207	0.924107	0.353242
GCA_011745845.1-Pla_VYZY01002554.1_i000_012140	47	146	99	0.441964	0.678082
GCA_011745865.1-Pla_VYZZ01001890.1_i000_009649	47	146	99	0.441964	0.678082
GCA_021821965.1-Fun_JACCJH010000018.1_i000_001572	166	384	218	0.973214	0.457023
GCA_001270105.1-Ani_LHQP01026721.1_i000_034868	177	379	202	0.901786	0.446903
GCA_900240055.1-Pro_LT969448.1_i000_002779	186	410	224	1	0.361874
GCA_905221635.1-Pro_CAJNDV010035552.1_i000_028795	605	766	161	0.71875	0.187865
GCA_004786225.1-Fun_PQXJ01000182.1_i000_006300	182	398	216	0.964286	0.378284
GCA_001292635.1-Fun_JXCE01000012.1_i000_001306	181	388	207	0.924107	0.346734
GCA_003012315.1-Fun_PXOF01000142.1_i000_009004	181	388	207	0.924107	0.346734
GCA_002157705.1-Pro_BDQF01000010.1_i000_002077	187	413	226	1.00893	0.413163
GCA_009299455.1-Fun_VIGI01000012.1_i000_008249	193	351	158	0.705357	0.319192
GCA_009299455.1-Fun_VIGI01000012.1_i000_008249	347	400	53	0.236607	0.107071
GCA_000499425.1-Pro_HG671351.1_i000_004092	61	232	171	0.763393	0.497093
GCA_000836255.1-Fun_DF938591.1_i000_001932	182	395	213	0.950893	0.370435
PYDE001.0722.00001.C001_00597	158	380	222	0.991071	0.529833
GCA_010015585.1-Fun_ML975159.1_i000_005588	181	389	208	0.928571	0.367491
GCA_014235945.1-Fun_WIGO01000117.1_i000_008332	181	389	208	0.928571	0.336026
GCA_013266185.1-Fun_JABEXW010001040.1_i000_013522	181	388	207	0.924107	0.345576
GCA_010093635.1-Fun_MU006842.1_i000_012665	180	410	230	1.02679	0.40636
GCA_003573695.1-Pla_PUWZ01001678.1_i000_042927	6	219	213	0.950893	0.963801
GCA_000696135.1-Fun_JMSE01001300.1_i000_009608	181	388	207	0.924107	0.332797
GCA_000814955.1-Fun_AZNH01000010.1_i000_000991	181	399	218	0.973214	0.361526
GCA_002591385.1-Fun_NJEV01000360.1_i000_006757	181	388	207	0.924107	0.343854
GCA_010094085.1-Fun_ML986487.1_i000_002858	182	403	221	0.986607	0.373311
GCA_000334115.1-Fun_KB317696.1_i000_000092	180	423	243	1.08482	0.170766
GCA_003369635.1-Fun_PDLN01000013.1_i000_003126	182	397	215	0.959821	0.349026
GCA_000313795.2-Fun_CACQ02005590.1_i000_010977	137	343	206	0.919643	0.356401
GCA_016801405.1-Fun_CP069028.1_i000_006001	179	400	221	0.986607	0.390459
GCA_020557385.1-Fun_JAIRDT010000022.1_i000_010936	179	400	221	0.986607	0.390459
GCA_020567955.1-Fun_JAIRGA010000023.1_i000_011287	179	400	221	0.986607	0.390459
GCA_020568045.1-Fun_JAIRGB010000053.1_i000_015297	179	400	221	0.986607	0.390459
GCA_020568055.1-Fun_JAIRGC010000018.1_i000_007404	179	400	221	0.986607	0.390459
GCA_020568095.1-Fun_JAIRGD010000023.1_i000_011815	179	400	221	0.986607	0.390459
GCA_020568205.1-Fun_JAIRGE010000022.1_i000_011367	179	400	221	0.986607	0.390459
GCA_020568325.1-Fun_JAIRDU010000019.1_i000_010236	179	400	221	0.986607	0.390459
GCA_020568415.1-Fun_JAIRDV010000036.1_i000_013581	179	400	221	0.986607	0.390459
GCA_020568635.1-Fun_JAIRDX010000026.1_i000_013112	179	400	221	0.986607	0.390459
GCA_020568705.1-Fun_JAIRGF010000018.1_i000_008978	179	400	221	0.986607	0.390459
GCA_020568765.1-Fun_JAIRDY010000042.1_i000_016142	179	400	221	0.986607	0.390459
GCA_020568775.1-Fun_JAIRGG010000053.1_i000_014034	179	400	221	0.986607	0.390459
GCA_020568935.1-Fun_JAIRGH010000022.1_i000_011465	179	400	221	0.986607	0.390459
GCA_020568945.1-Fun_JAIRDZ010000021.1_i000_010158	179	400	221	0.986607	0.390459
GCA_020569145.1-Fun_JAIREA010000020.1_i000_010819	179	400	221	0.986607	0.390459
GCA_020569235.1-Fun_JAIREB010000021.1_i000_011709	179	400	221	0.986607	0.390459
GCA_020569285.1-Fun_JAIREC010000001.1_i000_000779	179	400	221	0.986607	0.390459
GCA_020569505.1-Fun_JAIREE010000021.1_i000_011362	179	400	221	0.986607	0.390459
GCA_020569515.1-Fun_JAIRGJ010000023.1_i000_011590	179	400	221	0.986607	0.390459
GCA_020569685.1-Fun_JAIRGK010000002.1_i000_015344	179	400	221	0.986607	0.390459
GCA_020569895.1-Fun_JAIRGL010000017.1_i000_009456	179	400	221	0.986607	0.390459
GCA_020569945.1-Fun_JAIREF010000019.1_i000_009612	179	400	221	0.986607	0.390459
GCA_020570015.1-Fun_JAIREG010000001.1_i000_000317	179	400	221	0.986607	0.390459
GCA_020570045.1-Fun_JAIREI010000001.1_i000_000819	179	400	221	0.986607	0.390459
GCA_020570345.1-Fun_JAIRGM010000001.1_i000_000318	179	400	221	0.986607	0.390459
GCA_020570355.1-Fun_JAIREH010000001.1_i000_000767	179	400	221	0.986607	0.390459
GCA_020570395.1-Fun_JAIRGN010000002.1_i000_002247	179	400	221	0.986607	0.390459
GCA_020570405.1-Fun_JAIREJ010000002.1_i000_002416	179	400	221	0.986607	0.390459
GCA_020570415.1-Fun_JAIRGO010000002.1_i000_002404	179	400	221	0.986607	0.390459
GCA_020570525.1-Fun_JAIREK010000001.1_i000_000105	179	400	221	0.986607	0.390459
GCA_020570635.1-Fun_JAIRGP010000001.1_i000_000783	179	400	221	0.986607	0.390459
GCA_020570685.1-Fun_JAIRGQ010000036.1_i000_015097	179	400	221	0.986607	0.390459
GCA_020570735.1-Fun_JAIRGR010000001.1_i000_000710	179	400	221	0.986607	0.390459
GCA_020570935.1-Fun_JAIREL010000003.1_i000_002947	179	400	221	0.986607	0.390459
GCA_020570965.1-Fun_JAIRGS010000002.1_i000_001902	179	400	221	0.986607	0.390459
GCA_020570975.1-Fun_JAIRGT010000046.1_i000_016350	179	400	221	0.986607	0.390459
GCA_020571265.1-Fun_JAIREM010000034.1_i000_014175	179	400	221	0.986607	0.390459
GCA_020571295.1-Fun_JAIRGU010000022.1_i000_012228	179	400	221	0.986607	0.390459
GCA_020571325.1-Fun_JAIREN010000019.1_i000_009579	179	400	221	0.986607	0.390459
GCA_020571545.1-Fun_JAIREO010000023.1_i000_010831	179	400	221	0.986607	0.390459
GCA_020571575.1-Fun_JAIRGV010000001.1_i000_000164	179	400	221	0.986607	0.390459
GCA_020571605.1-Fun_JAIRGW010000015.1_i000_006295	179	400	221	0.986607	0.390459
GCA_020571815.1-Fun_JAIRGX010000022.1_i000_009767	179	400	221	0.986607	0.390459
GCA_020571885.1-Fun_JAIRGY010000049.1_i000_015878	179	400	221	0.986607	0.390459
GCA_020571895.1-Fun_JAIREP010000001.1_i000_000818	179	400	221	0.986607	0.390459
GCA_020571965.1-Fun_JAIRGZ010000002.1_i000_001664	179	400	221	0.986607	0.390459
GCA_020572075.1-Fun_JAIRHA010000017.1_i000_008281	179	400	221	0.986607	0.390459
GCA_020572205.1-Fun_JAIREQ010000021.1_i000_011072	179	400	221	0.986607	0.390459
GCA_020572305.1-Fun_JAIRHC010000023.1_i000_009346	179	400	221	0.986607	0.390459
GCA_020572315.1-Fun_JAIRHB010000020.1_i000_012043	179	400	221	0.986607	0.390459
GCA_020572345.1-Fun_JAIRHD010000001.1_i000_000164	179	400	221	0.986607	0.390459
GCA_020572395.1-Fun_JAIRHG010000020.1_i000_009022	179	400	221	0.986607	0.390459
GCA_020572635.1-Fun_JAIRHE010000005.1_i000_016820	179	400	221	0.986607	0.390459
GCA_020572645.1-Fun_JAIRHF010000030.1_i000_011572	179	400	221	0.986607	0.390459
GCA_020572675.1-Fun_JAIRHH010000056.1_i000_013641	179	400	221	0.986607	0.390459
GCA_020572945.1-Fun_JAIRHJ010000001.1_i000_016759	179	400	221	0.986607	0.390459
GCA_020572955.1-Fun_JAIRHI010000046.1_i000_015413	179	400	221	0.986607	0.390459
GCA_020572985.1-Fun_JAIRER010000015.1_i000_007321	179	400	221	0.986607	0.390459
GCA_020572995.1-Fun_JAIRES010000019.1_i000_009374	179	400	221	0.986607	0.390459
GCA_020573275.1-Fun_JAIRHK010000022.1_i000_010372	179	400	221	0.986607	0.390459
GCA_020573285.1-Fun_JAIRHL010000020.1_i000_011298	179	400	221	0.986607	0.390459
GCA_020573315.1-Fun_JAIRHM010000023.1_i000_010956	179	400	221	0.986607	0.390459
GCA_020573325.1-Fun_JAIRET010000019.1_i000_012172	179	400	221	0.986607	0.390459
GCA_020573605.1-Fun_JAIRHP010000049.1_i000_017205	179	400	221	0.986607	0.390459
GCA_020573625.1-Fun_JAIRHQ010000019.1_i000_009672	179	400	221	0.986607	0.390459
GCA_020573725.1-Fun_JAIREU010000059.1_i000_016887	179	400	221	0.986607	0.390459
GCA_020573765.1-Fun_JAIREV010000046.1_i000_015442	179	400	221	0.986607	0.390459
GCA_020573915.1-Fun_JAIRHR010000049.1_i000_013873	179	400	221	0.986607	0.390459
GCA_020574085.1-Fun_JAIRHT010000024.1_i000_013475	179	400	221	0.986607	0.390459
GCA_020574155.1-Fun_JAIREX010000020.1_i000_011229	179	400	221	0.986607	0.390459
GCA_020574265.1-Fun_JAIREY010000040.1_i000_015516	179	400	221	0.986607	0.390459
GCA_020574295.1-Fun_JAIRHV010000002.1_i000_001728	179	400	221	0.986607	0.390459
GCA_020574345.1-Fun_JAIREZ010000016.1_i000_009880	179	400	221	0.986607	0.390459
GCA_020574365.1-Fun_JAIRHW010000016.1_i000_008840	179	400	221	0.986607	0.390459
GCA_020574375.1-Fun_JAIRFA010000023.1_i000_012513	179	400	221	0.986607	0.390459
GCA_020574385.1-Fun_JAIRFB010000048.1_i000_015278	179	400	221	0.986607	0.390459
GCA_020574405.1-Fun_JAIRHY010000020.1_i000_010245	179	400	221	0.986607	0.390459
GCA_020574595.1-Fun_JAIRHX010000019.1_i000_010729	179	400	221	0.986607	0.390459
GCA_020574615.1-Fun_JAIRHZ010000002.1_i000_014919	179	400	221	0.986607	0.390459
GCA_020574725.1-Fun_JAIRFD010000024.1_i000_012971	179	400	221	0.986607	0.390459
GCA_020574755.1-Fun_JAIRIA010000053.1_i000_016144	179	400	221	0.986607	0.390459
GCA_020574825.1-Fun_JAIRIB010000023.1_i000_012588	179	400	221	0.986607	0.390459
GCA_020574875.1-Fun_JAIRIC010000020.1_i000_010140	179	400	221	0.986607	0.390459
GCA_020575035.1-Fun_JAIRFE010000019.1_i000_010658	179	400	221	0.986607	0.390459
GCA_020575105.1-Fun_JAIRID010000021.1_i000_010781	179	400	221	0.986607	0.390459
GCA_020575195.1-Fun_JAIRIE010000025.1_i000_010251	179	400	221	0.986607	0.390459
GCA_020575375.1-Fun_JAIRIG010000009.1_i000_005622	179	400	221	0.986607	0.390459
GCA_020575405.1-Fun_JAIRII010000001.1_i000_000322	179	400	221	0.986607	0.390459
GCA_020575445.1-Fun_JAIRIJ010000016.1_i000_007506	179	400	221	0.986607	0.390459
GCA_020575485.1-Fun_JAIRIK010000019.1_i000_009252	179	400	221	0.986607	0.390459
GCA_020575615.1-Fun_JAIRIL010000021.1_i000_009463	179	400	221	0.986607	0.390459
GCA_020575645.1-Fun_JAIRIM010000013.1_i000_007175	179	400	221	0.986607	0.390459
GCA_020575775.1-Fun_JAIRIN010000021.1_i000_009988	179	400	221	0.986607	0.390459
GCA_020575955.1-Fun_JAIRIO010000024.1_i000_008442	179	400	221	0.986607	0.390459
GCA_020575975.1-Fun_JAIRFF010000019.1_i000_008078	179	400	221	0.986607	0.390459
GCA_020575995.1-Fun_JAIRIP010000007.1_i000_004363	179	400	221	0.986607	0.390459
GCA_020576185.1-Fun_JAIRIQ010000001.1_i000_000105	179	400	221	0.986607	0.390459
GCA_020578265.1-Fun_JAIRIR010000049.1_i000_015321	179	400	221	0.986607	0.390459
GCA_020578295.1-Fun_JAIRIT010000021.1_i000_011437	179	400	221	0.986607	0.390459
GCA_020578315.1-Fun_JAIRIS010000037.1_i000_013652	179	400	221	0.986607	0.390459
GCA_020578375.1-Fun_JAIRFT010000023.1_i000_012588	179	400	221	0.986607	0.390459
GCA_020578445.1-Fun_JAIRIU010000048.1_i000_015113	179	400	221	0.986607	0.390459
GCA_020578515.1-Fun_JAIRIV010000045.1_i000_013878	179	400	221	0.986607	0.390459
GCA_020578585.1-Fun_JAIRIW010000020.1_i000_010653	179	400	221	0.986607	0.390459
GCA_020578615.1-Fun_JAIRIX010000047.1_i000_015988	179	400	221	0.986607	0.390459
GCA_020579845.1-Fun_JAIRJB010000021.1_i000_010542	179	400	221	0.986607	0.390459
GCA_020579855.1-Fun_JAIRFU010000021.1_i000_009508	179	400	221	0.986607	0.390459
GCA_020580075.1-Fun_JAIRJC010000018.1_i000_009084	179	400	221	0.986607	0.390459
GCA_020580085.1-Fun_JAIRJD010000018.1_i000_009380	179	400	221	0.986607	0.390459
GCA_020580115.1-Fun_JAIRFV010000018.1_i000_009169	179	400	221	0.986607	0.390459
GCA_020580145.1-Fun_JAIRJE010000025.1_i000_010507	179	400	221	0.986607	0.390459
GCA_020580155.1-Fun_JAIRJF010000041.1_i000_016190	179	400	221	0.986607	0.390459
GCA_020580305.1-Fun_JAIRJG010000025.1_i000_011754	179	400	221	0.986607	0.390459
GCA_020580415.1-Fun_JAIRFW010000021.1_i000_009839	179	400	221	0.986607	0.390459
GCA_020580425.1-Fun_JAIRJH010000018.1_i000_008885	179	400	221	0.986607	0.390459
GCA_020580655.1-Fun_JAIRFX010000018.1_i000_010169	179	400	221	0.986607	0.390459
GCA_020580665.1-Fun_JAIRFY010000019.1_i000_010722	179	400	221	0.986607	0.390459
GCA_020580695.1-Fun_JAIRJK010000052.1_i000_015689	179	400	221	0.986607	0.390459
GCA_020580725.1-Fun_JAIRJJ010000019.1_i000_010549	179	400	221	0.986607	0.390459
GCA_020580775.1-Fun_JAIRJL010000057.1_i000_013699	179	400	221	0.986607	0.390459
GCA_020580905.1-Fun_JAIRFZ010000022.1_i000_010588	179	400	221	0.986607	0.390459
GCA_020581045.1-Fun_JAIRJM010000019.1_i000_009803	179	400	221	0.986607	0.390459
GCA_020581155.1-Fun_JAIRJN010000019.1_i000_008190	179	400	221	0.986607	0.390459
GCA_020581165.1-Fun_JAIRJO010000003.1_i000_001429	179	400	221	0.986607	0.390459
GCA_020581275.1-Fun_JAIRJP010000056.1_i000_015469	179	400	221	0.986607	0.390459
GCA_000006355.3-Pro_AM910991.2_i000_002117	186	411	225	1.00446	0.406872
GCA_002140095.1-Pro_NETL01000026.1_i000_001225	186	411	225	1.00446	0.406872
GCA_900004885.2-Pro_CWHQ02000002.1_i000_002144	186	411	225	1.00446	0.406872
GCA_900005025.2-Pro_CWHR02000001.1_i000_004961	186	411	225	1.00446	0.406872
GCA_013694445.1-Fun_CP059273.1_i000_004094	181	401	220	0.982143	0.433925
GCA_000442495.1-Pro_ATMH01001626.1_i000_001623	94	312	218	0.973214	0.64497
GCA_000442495.1-Pro_ATMH01002459.1_i000_002454	94	312	218	0.973214	0.64497
GCA_000442495.1-Pro_ATMH01004699.1_i000_004688	94	312	218	0.973214	0.64497
GCA_020573495.1-Fun_JAIRHN010000018.1_i000_008070	179	400	221	0.986607	0.390459
GCA_020575285.1-Fun_JAIRIF010000019.1_i000_007798	179	400	221	0.986607	0.390459
GCA_020578205.1-Fun_JAIRFS010000010.1_i000_006152	179	400	221	0.986607	0.390459
GCA_020573595.1-Fun_JAIRHO010000021.1_i000_009592	179	400	221	0.986607	0.390459
GCA_020574115.1-Fun_JAIRHU010000018.1_i000_008039	179	400	221	0.986607	0.390459
GCA_020574145.1-Fun_JAIREW010000002.1_i000_001907	179	400	221	0.986607	0.390459
GCA_020574715.1-Fun_JAIRFC010000001.1_i000_000650	179	400	221	0.986607	0.390459
GCA_020575355.1-Fun_JAIRIH010000026.1_i000_012536	179	400	221	0.986607	0.390459
GCA_020576195.1-Fun_JAIRFG010000001.1_i000_000036	179	400	221	0.986607	0.390459
GCA_020576365.1-Fun_JAIRFI010000047.1_i000_014307	179	400	221	0.986607	0.390459
GCA_020577795.1-Fun_JAIRFH010000046.1_i000_014856	179	400	221	0.986607	0.390459
GCA_020577805.1-Fun_JAIRFJ010000043.1_i000_014387	179	400	221	0.986607	0.390459
GCA_020577855.1-Fun_JAIRFK010000045.1_i000_013952	179	400	221	0.986607	0.390459
GCA_020577905.1-Fun_JAIRFL010000046.1_i000_014794	179	400	221	0.986607	0.390459
GCA_020577915.1-Fun_JAIRFM010000042.1_i000_013484	179	400	221	0.986607	0.390459
GCA_020578075.1-Fun_JAIRFO010000047.1_i000_014422	179	400	221	0.986607	0.390459
GCA_020578085.1-Fun_JAIRFN010000007.1_i000_003888	179	400	221	0.986607	0.390459
GCA_020578095.1-Fun_JAIRFP010000049.1_i000_014267	179	400	221	0.986607	0.390459
GCA_020578105.1-Fun_JAIRFQ010000047.1_i000_014401	179	400	221	0.986607	0.390459
GCA_020578115.1-Fun_JAIRFR010000047.1_i000_014218	179	400	221	0.986607	0.390459
GCA_020579815.1-Fun_JAIRIZ010000002.1_i000_001978	179	400	221	0.986607	0.390459
GCA_020579835.1-Fun_JAIRJA010000003.1_i000_000108	179	400	221	0.986607	0.390459
GCA_020568465.1-Fun_JAIRDW010000021.1_i000_011961	179	400	221	0.986607	0.390459
GCA_020569485.1-Fun_JAIRGI010000024.1_i000_012857	179	400	221	0.986607	0.390459
GCA_020569495.1-Fun_JAIRED010000045.1_i000_015373	179	400	221	0.986607	0.390459
GCA_020574055.1-Fun_JAIRHS010000025.1_i000_011086	179	400	221	0.986607	0.390459
GCA_020579825.1-Fun_JAIRIY010000022.1_i000_009283	179	400	221	0.986607	0.390459
GCA_020580485.1-Fun_JAIRJI010000036.1_i000_013018	179	400	221	0.986607	0.390459
GCA_009806415.1-Fun_WOWK01000038.1_i000_014796	181	389	208	0.928571	0.342105
GCA_020744215.1-Fun_JAGMVJ010000002.1_i000_007283	179	385	206	0.919643	0.36014
GCA_004920355.1-Fun_MWPZ01000005.1_i000_009570	153	359	206	0.919643	0.346801
PYAB001.0722.00001.C001_00067	147	367	220	0.982143	0.544554
GCA_900074715.1-Fun_LT598481.1_i000_002216	181	402	221	0.986607	0.424184
GCA_002120335.1-Fun_KZ111242.1_i000_004174	182	401	219	0.977679	0.351525
GCA_000146915.2-Fun_CH445332.1_i000_010258	194	414	220	0.982143	0.378657
GCA_003073855.1-Fun_KZ805317.1_i000_003770	180	400	220	0.982143	0.388007
GCA_020736565.1-Fun_JAHBOF010000007.1_i000_023599	185	403	218	0.973214	0.411321
GCA_004367215.1-Fun_RYZW01000017.1_i000_003021	181	389	208	0.928571	0.337115
GCA_000203815.1-Pro_GL883006.1_i000_000116	180	404	224	1	0.198406
GCA_000372725.1-Pro_KB869132.1_i000_034192	114	223	109	0.486607	0.335385
GCA_015832245.1-Fun_SBJO01000006.1_i000_000188	166	379	213	0.950893	0.529851
GCA_022179045.1-Fun_BPPX01000012.1_i000_006588	181	388	207	0.924107	0.332263
GCA_000170995.2-Fun_ABDF02000092.1_i000_000422	181	390	209	0.933036	0.352445
GCA_020647635.1-Fun_CP071109.1_i000_005153	181	390	209	0.933036	0.352445
GCA_020647705.1-Fun_CP071117.1_i000_004933	181	389	208	0.928571	0.350759
GCA_008692225.1-Fun_VICG01000012.1_i000_009715	193	351	158	0.705357	0.296992
GCA_008692225.1-Fun_VICG01000012.1_i000_009715	348	397	49	0.21875	0.0921053
GCA_020746835.1-Fun_JAGPNK010000006.1_i000_012390	183	393	210	0.9375	0.354132
THPE001.0722.00001.C001_00388	162	381	219	0.977679	0.531553
GCA_918797485.1-Pro_CAKKNE010000002.1_i000_003522	195	433	238	1.0625	0.476
GCA_000750735.1-Fun_JPJU01000693.1_i000_002323	182	398	216	0.964286	0.354098
GCA_001972345.1-Fun_BDGX01000045.1_i000_008801	180	402	222	0.991071	0.430233
GCA_000750925.1-Fun_JPKC01002459.1_i000_008259	182	398	216	0.964286	0.343949
GCA_000750755.1-Fun_JPJW01001171.1_i000_003550	182	398	216	0.964286	0.352365
GCA_000750995.1-Fun_JPKE01002186.1_i000_005753	182	398	216	0.964286	0.343402
GCA_001672515.1-Fun_LTAN01000007.1_i000_010922	181	387	206	0.919643	0.33119
GCA_007210705.1-Ani_CM017379.1_i000_007515	214	345	131	0.584821	0.282937
GCA_000524495.1-Pro_KI965479.1_i000_004165	187	413	226	1.00893	0.413163
GCA_900074745.1-Fun_LT598466.1_i000_001225	181	401	220	0.982143	0.43222
NIAD001.0722.00001.C001_00489	149	370	221	0.986607	0.397482
GCA_013368445.1-Fun_JAACJO010000019.1_i000_009691	203	425	222	0.991071	0.183623
GCA_000750805.1-Fun_JPJY01001425.1_i000_007483	182	398	216	0.964286	0.3456
GCA_000750875.1-Fun_JPKA01000517.1_i000_003125	182	398	216	0.964286	0.3456
GCA_020887355.1-Pla_AP024993.1_i000_004725	190	416	226	1.00893	0.405745
GCA_000750675.1-Fun_JPJR01000340.1_i000_002120	182	398	216	0.964286	0.348387
GCA_000235365.1-Fun_CP002497.1_i000_000453	181	401	220	0.982143	0.428016
GCA_000750665.1-Fun_JPJS01000421.1_i000_001496	182	398	216	0.964286	0.348387
GCA_000750795.1-Fun_JPJX01001830.1_i000_005406	182	398	216	0.964286	0.348387
GCA_000750815.1-Fun_JPJZ01001073.1_i000_005992	182	398	216	0.964286	0.348387
GCA_001662605.1-Fun_KV458781.1_i000_000590	182	398	216	0.964286	0.347267
GCA_000691245.1-Pro_JMRU01000306.1_i000_004674	158	381	223	0.995536	0.518605
GCA_014235925.1-Fun_VUJX01000028.1_i000_008918	181	389	208	0.928571	0.338211
GCA_000186025.2-Pro_GG664563.1_i000_000655	186	402	216	0.964286	0.537313
GCA_016584195.1-Fun_PUHU01000058.1_i000_004205	101	320	219	0.977679	0.501144
GCA_016584265.1-Fun_PUHW01000076.1_i000_004783	101	320	219	0.977679	0.501144
GCA_019924135.1-Fun_JAHFXB010013006.1_i000_025207	29	236	207	0.924107	0.69697
GCA_902085965.1-Fun_CABFNS010000694.1_i000_002992	181	390	209	0.933036	0.354237
GCA_020747045.1-Fun_JAGTJN010000002.1_i000_006478	179	399	220	0.982143	0.387324
GCA_022432525.1-Fun_JAJKLB010000002.1_i000_004453	182	401	219	0.977679	0.349282
GCA_007993695.1-Fun_CP042456.1_i000_001173	181	401	220	0.982143	0.430528
GCA_012980515.1-Fun_JAACLJ010000006.1_i000_005793	181	390	209	0.933036	0.31194
GCA_003025105.1-Fun_KZ679258.1_i000_002930	194	418	224	1	0.439216
GCA_020647865.1-Fun_CP084944.1_i000_002751	194	418	224	1	0.439216
GCA_000982615.1-Pro_HF955201.1_i000_001907	158	380	222	0.991071	0.522353
GCA_022432385.1-Fun_JAJJXC010000006.1_i000_010727	182	399	217	0.96875	0.318649
GCA_019924155.1-Fun_JAHFXD010011905.1_i000_022318	42	249	207	0.924107	0.667742
GCA_022160365.1-Fun_MU273481.1_i000_001584	188	397	209	0.933036	0.397338
GCA_008694065.1-Fun_VYXO01000001.1_i000_000859	182	401	219	0.977679	0.349282
GCA_010015615.1-Fun_ML976615.1_i000_004664	180	387	207	0.924107	0.352041
GCA_018991925.1-Ani_JAHLQT010021643.1_i000_010869	551	754	203	0.90625	0.222588
GCA_001749795.1-Fun_LPNL01000003.1_i000_001203	196	422	226	1.00893	0.44227
GCA_900119595.1-Fun_FQNF01000053.1_i000_000161	196	422	226	1.00893	0.443137
GCA_014235955.1-Fun_WIGN01000112.1_i000_007328	181	389	208	0.928571	0.336026
GCA_002906115.4-Pla_PKMF03007331.1_i000_026918	170	385	215	0.959821	0.306705
GCA_002895985.1-Fun_NKHZ01000081.1_i000_001767	182	389	207	0.924107	0.359375
GCA_010015675.1-Fun_ML977025.1_i000_013295	180	394	214	0.955357	0.374126
GCA_000149035.1-Fun_GG697353.1_i000_006295	181	388	207	0.924107	0.333333
CANI009.0722.00001.C001_02593	160	384	224	1	0.5
GCA_000613005.1-Ani_HG805869.1_i000_002111	183	394	211	0.941964	0.524876
GCA_019425475.1-Pro_NLFJ01000389.1_i000_003999	158	381	223	0.995536	0.518605
GCA_021307395.1-Pro_SOPI01000403.1_i000_009727	158	381	223	0.995536	0.518605
GCA_001747055.1-Fun_LPNN01000005.1_i000_002908	196	422	226	1.00893	0.44227
GCA_009805715.1-Fun_WEHR01000356.1_i000_000812	196	422	226	1.00893	0.44227
GCA_009805765.1-Fun_WEHS01000049.1_i000_000834	196	422	226	1.00893	0.44227
GCA_009805785.1-Fun_WEHT01000151.1_i000_002289	196	422	226	1.00893	0.44227
GCA_011764045.1-Fun_JAANQQ010012574.1_i000_018010	1	74	73	0.325893	0.986486
GCA_010093595.1-Fun_MU003710.1_i000_012659	181	396	215	0.959821	0.364407
GCA_000968475.1-Fun_APLS01000032.1_i000_001965	196	422	226	1.00893	0.452
GCA_000187425.2-Fun_ADNJ02000004.1_i000_007291	181	389	208	0.928571	0.343802
GCA_000591435.1-Fun_JELW01000018.1_i000_007249	181	389	208	0.928571	0.343802
GCA_020102295.1-Fun_JACEFI010000003.1_i000_002371	181	389	208	0.928571	0.343802
GCA_001644525.1-Fun_KV441710.1_i000_006033	179	400	221	0.986607	0.389771
GCA_000820885.1-Fun_CCBQ010000045.1_i000_004049	181	401	220	0.982143	0.429688
GCA_005406065.1-Fun_BIMT01000060.1_i000_004170	190	415	225	1.00446	0.447316
GCA_000814965.1-Fun_AZNG01000004.1_i000_008248	181	389	208	0.928571	0.343802
GCA_013305495.1-Fun_JABUBV010000004.1_i000_008942	181	389	208	0.928571	0.343802
GCA_013426205.1-Fun_CP058935.1_i000_007178	181	389	208	0.928571	0.343802
GCA_021365335.1-Fun_JAJTIZ010000060.1_i000_012981	180	409	229	1.02232	0.415608
GCA_000968615.1-Fun_LAEV01000037.1_i000_004273	189	412	223	0.995536	0.383821
GCA_000739145.1-Fun_JNNZ01000193.1_i000_008932	181	389	208	0.928571	0.345515
GCA_000814975.1-Fun_AZNF01000001.1_i000_001470	181	389	208	0.928571	0.345515
GCA_000426965.1-Fun_KE384724.1_i000_002394	181	389	208	0.928571	0.343802
GCA_000426985.1-Fun_KE385404.1_i000_004930	181	389	208	0.928571	0.343802
GCA_002911725.1-Pro_NCKW01003646.1_i000_006158	157	265	108	0.482143	0.404494
GCA_001625265.1-Fun_LFIV01000012.1_i000_001306	181	388	207	0.924107	0.331731
GCA_001625285.1-Fun_LFIW01001200.1_i000_001591	181	388	207	0.924107	0.332263
GCA_001855235.1-Fun_KV841764.1_i000_000904	181	388	207	0.924107	0.332263
GCA_019627685.1-Fun_WSTO01002798.1_i000_008916	187	434	247	1.10268	0.48622
DEMU001.0722.00001.C001_00881	160	379	219	0.977679	0.539409
GCA_002894205.1-Fun_MTYH01000060.1_i000_008709	194	418	224	1	0.439216
GCA_000814945.1-Fun_AZNE01000004.1_i000_007630	181	389	208	0.928571	0.343802
GCA_004786065.1-Fun_ML220130.1_i000_006105	182	404	222	0.991071	0.41966
GCA_000721755.1-Fun_KL584750.1_i000_001370	182	389	207	0.924107	0.383333
GCA_000750745.1-Fun_JPJV01002202.1_i000_005679	182	398	216	0.964286	0.343949
GCA_001662595.1-Fun_KV456032.1_i000_002100	182	399	217	0.96875	0.352273
GCA_010094035.1-Fun_ML987194.1_i000_007326	179	389	210	0.9375	0.363322
GCA_022432365.1-Fun_JAJJXE010000001.1_i000_001412	182	401	219	0.977679	0.357259
GCA_000732125.1-Fun_JOWA01000106.1_i000_005101	186	400	214	0.955357	0.351974
GCA_000804445.1-Fun_AZHE01000005.1_i000_006755	181	388	207	0.924107	0.339901
GCA_000258705.1-Pla_AGSI01000013.1_i000_006651	190	415	225	1.00446	0.403226
GCA_000243375.1-Fun_HE616743.1_i000_000899	181	401	220	0.982143	0.436508
GCA_010356995.1-Fun_ML996697.1_i000_006025	183	396	213	0.950893	0.379679
DEAM001.0722.00001.C001_00794	160	381	221	0.986607	0.544335
ACSA002.0722.00001.C001_01354	158	377	219	0.977679	0.528986
GCA_003339455.1-Fun_PDHP01000015.1_i000_001440	182	389	207	0.924107	0.298271
GCA_000750935.1-Fun_JPKD01002179.1_i000_007499	182	398	216	0.964286	0.347267
GCA_013995675.1-Pro_VWRR01000002.1_i000_002740	187	418	231	1.03125	0.414722
GCA_000750895.1-Fun_JPKB01000367.1_i000_002431	182	398	216	0.964286	0.347267
GCA_001662655.1-Fun_KV460238.1_i000_006829	182	398	216	0.964286	0.347267
GCA_003012105.1-Fun_PXOA01000224.1_i000_003962	194	418	224	1	0.379019
GCA_903819455.1-Fun_CAIJDQ010000018.1_i000_008574	201	409	208	0.928571	0.370766
GCA_019677385.1-Fun_WSLO01000037.1_i000_000665	140	332	192	0.857143	0.0659341
GCA_000184105.1-Fun_GL573198.1_i000_002247	182	398	216	0.964286	0.347267
GCA_001641265.1-Fun_KV441394.1_i000_004267	182	398	216	0.964286	0.347267
GCA_012977835.1-Fun_SDJM01000038.1_i000_007227	182	390	208	0.928571	0.361739
GCA_003546025.1-Pla_QPKB01000001.1_i000_002591	188	412	224	1	0.522145
GCA_014461115.1-Fun_JACAZE010000001.1_i000_000524	187	419	232	1.03571	0.441905
GCA_022453505.1-Fun_JAJLYR010000009.1_i000_011780	182	399	217	0.96875	0.350565
GCA_012184295.1-Fun_LDUD01000006.1_i000_004911	183	402	219	0.977679	0.396739
GCA_007210665.1-Pro_PYHZ01000002.1_i000_000456	189	413	224	1	0.449799
GCA_014235935.1-Fun_WIGM01000250.1_i000_007164	181	389	208	0.928571	0.334405
GCA_020921065.1-Pla_CM037155.1_i000_012864	105	324	219	0.977679	0.518957
GCA_001662585.1-Fun_KV454580.1_i000_002467	182	398	216	0.964286	0.347267
GCA_001662645.1-Fun_KV459563.1_i000_008654	182	398	216	0.964286	0.347267
GCA_001481775.2-Fun_JPDN02000006.1_i000_009366	194	418	224	1	0.386874
GCA_001483515.1-Pro_JTAI01000036.1_i000_002272	189	413	224	1	0.448898
GCA_001593465.1-Pro_JIBM01000083.1_i000_001120	189	413	224	1	0.448898
GCA_001593475.1-Pro_JIBN01000124.1_i000_001631	189	413	224	1	0.448898
GCA_002223825.1-Pro_LN877948.1_i000_000431	189	413	224	1	0.448898
GCA_004366825.1-Fun_QAPG01000009.1_i000_000786	181	389	208	0.928571	0.337115
GCA_004367935.1-Fun_QAPF01000070.1_i000_004417	181	389	208	0.928571	0.337115
GCA_000389695.3-Fun_APWK03000116.1_i000_000881	189	412	223	0.995536	0.386482
GCA_000350065.2-Fun_AMCV02000003.1_i000_002124	181	389	208	0.928571	0.337115
GCA_902728155.2-Pla_CACVBM020000222.1_i000_003495	36	171	135	0.602679	0.521236
GCA_001457755.2-Pro_CZPT02000860.1_i000_004723	158	381	223	0.995536	0.522248
GCA_016808335.1-Pla_CM029039.1_i000_009636	12	171	159	0.709821	0.506369
GCA_020310465.1-Fun_JAHSQE010000001.1_i000_000259	190	377	187	0.834821	0.334526
GCA_003543875.1-Pro_CM010680.1_i000_003951	158	381	223	0.995536	0.518605
GCA_019973975.1-Ani_BMAO01027851.1_i000_049524	151	371	220	0.982143	0.540541
GCA_000171015.2-Fun_ABDG02000025.1_i000_004828	194	418	224	1	0.439216
GCA_020647795.1-Fun_CP084938.1_i000_008532	194	418	224	1	0.439216
GCA_001636735.1-Fun_AZHA01000002.1_i000_003416	181	388	207	0.924107	0.348485
GCA_003795315.1-Fun_LKEA01000049.1_i000_008749	183	396	213	0.950893	0.36163
GCA_000582765.1-Pro_HF955104.1_i000_005789	158	380	222	0.991071	0.519906
GCA_001636815.1-Fun_AZHD01000008.1_i000_008710	185	393	208	0.928571	0.345515
GCA_006381635.2-Pla_VEPZ02001331.1_i000_057350	19	208	189	0.84375	0.529412
GCA_001692895.1-Fun_KV748222.1_i000_010754	182	392	210	0.9375	0.356537
GCA_000236345.1-Ani_DF143554.1_i000_000726	1	147	146	0.651786	0.924051
GCA_002591395.1-Fun_NJES01000336.1_i000_003745	181	391	210	0.9375	0.312966
NISP011.0722.00001.C001_00259	149	370	221	0.986607	0.513953
GCA_003795275.1-Fun_LJZO01000018.1_i000_004760	183	396	213	0.950893	0.337559
GCA_019434395.1-Fun_JAGRQL010000056.1_i000_009093	159	367	208	0.928571	0.356775
GCA_012184315.1-Fun_LDDX01000119.1_i000_003433	183	401	218	0.973214	0.396364
GCA_020379485.1-Pla_CM035447.1_i000_007481	177	377	200	0.892857	0.389864
GCA_002087225.1-Pro_NBCO01000018.1_i000_002377	158	381	223	0.995536	0.506818
GCA_013201745.1-Fun_QPMT01000079.1_i000_014045	181	388	207	0.924107	0.340461
GCA_013201755.1-Fun_QPMR01000010.1_i000_003932	181	388	207	0.924107	0.340461
GCA_013201785.1-Fun_QPMP01000023.1_i000_007458	181	388	207	0.924107	0.340461
GCA_013201795.1-Fun_QPMS01000007.1_i000_003036	181	388	207	0.924107	0.340461
GCA_013201865.1-Fun_QPMU01000037.1_i000_010902	181	388	207	0.924107	0.340461
GCA_013390185.1-Fun_QPNB01000002.1_i000_002124	181	388	207	0.924107	0.340461
GCA_013390195.1-Fun_QPNA01000002.1_i000_003858	181	388	207	0.924107	0.340461
GCA_000319635.2-Fun_ANPB02000005.1_i000_008766	181	388	207	0.924107	0.340461
GCA_009771025.1-Fun_SSNE01000018.1_i000_004453	181	388	207	0.924107	0.340461
GCA_012932255.1-Fun_QLYQ01000014.1_i000_010901	181	388	207	0.924107	0.340461
GCA_013201875.1-Fun_QPMV01000005.1_i000_001569	181	388	207	0.924107	0.340461
GCA_013201905.1-Fun_QPMW01000007.1_i000_002005	181	388	207	0.924107	0.340461
GCA_013201925.1-Fun_QPMY01000007.1_i000_001788	181	388	207	0.924107	0.340461
GCA_013390205.1-Fun_QPMX01000002.1_i000_003973	181	388	207	0.924107	0.340461
GCA_019924775.1-Fun_JAHFYC010004786.1_i000_010980	182	389	207	0.924107	0.405088
GCA_000446055.1-Fun_AMYD01000812.1_i000_003567	56	264	208	0.928571	0.427984
GCA_019924615.1-Fun_JAHFXW010004806.1_i000_014762	143	350	207	0.924107	0.41483
GCA_019924905.1-Fun_JAHFYL010008367.1_i000_019278	143	350	207	0.924107	0.41483
GCA_010099065.1-Fun_PPTI01000004.1_i000_005362	147	354	207	0.924107	0.367673
GCA_003719475.1-Pro_MKGL01000210.1_i000_005779	158	381	223	0.995536	0.509132
GCA_019925055.1-Fun_JAHFYR010000004.1_i000_004502	182	389	207	0.924107	0.384758
GCA_001445595.3-Fun_DF977513.1_i000_010624	182	399	217	0.96875	0.345541
GCA_903819635.1-Fun_CAIJEN010000002.1_i000_001953	182	389	207	0.924107	0.419878
GCA_019924115.1-Fun_JAHFXA010000449.1_i000_002986	182	389	207	0.924107	0.46
GCA_019924275.1-Fun_JAHFXJ010000501.1_i000_003603	182	389	207	0.924107	0.46
GCA_000187405.1-Fun_GL698491.1_i000_003597	181	389	208	0.928571	0.343802
GCA_019434415.1-Fun_JAGRQK010000004.1_i000_006546	181	389	208	0.928571	0.343802
GCA_003426265.1-Fun_NQIL01000006.1_i000_009764	182	399	217	0.96875	0.351702
GCA_005350895.1-Fun_PJEX01000031.1_i000_002249	181	387	206	0.919643	0.330658
GCA_019925085.1-Fun_JAHFYT010000100.1_i000_010236	182	389	207	0.924107	0.385475
GCA_019925215.1-Fun_JAHFYS010004900.1_i000_010697	182	389	207	0.924107	0.384758
GCA_019924295.1-Fun_JAHFXI010004634.1_i000_010909	182	389	207	0.924107	0.384758
GCA_019923975.1-Fun_JAHFWY010000048.1_i000_006916	182	389	207	0.924107	0.384758
GCA_019924025.1-Fun_JAHFWX010000983.1_i000_007604	182	389	207	0.924107	0.384758
GCA_019924175.1-Fun_JAHFXG010000034.1_i000_005241	182	389	207	0.924107	0.384758
GCA_019924715.1-Fun_JAHFYG010000012.1_i000_001190	182	389	207	0.924107	0.384758
GCA_019924835.1-Fun_JAHFYI010000002.1_i000_000946	182	389	207	0.924107	0.384758
GCA_019924875.1-Fun_JAHFYK010000618.1_i000_006349	182	389	207	0.924107	0.384758
GCA_000165345.1-Pro_CM000430.1_i000_000390	189	413	224	1	0.448898
GCA_015245375.1-Pro_CP044421.1_i000_000810	189	413	224	1	0.448898
GCA_019924015.1-Fun_JAHFWZ010000020.1_i000_003184	182	389	207	0.924107	0.384758
GCA_000383075.1-Fun_KB908973.1_i000_001989	166	379	213	0.950893	0.395176
GCA_019924995.1-Fun_JAHFYO010000003.1_i000_006790	182	389	207	0.924107	0.386916
GCA_000002445.1-Pro_CM000207.1_i000_004669	232	455	223	0.995536	0.44511
GCA_000210295.1-Pro_FN554972.1_i000_005229	232	455	223	0.995536	0.44246
GCA_000280675.1-Fun_JH725156.1_i000_003602	181	388	207	0.924107	0.346734
GCA_021365345.1-Fun_JAAZTN010000006.1_i000_009415	181	388	207	0.924107	0.346734
GCA_006783085.1-Fun_PUHP01000134.1_i000_002503	181	387	206	0.919643	0.33119
GCA_000803265.1-Fun_JOKQ01000004.1_i000_000702	156	378	222	0.991071	0.53753
GCA_004324935.1-Fun_PITG01000004.1_i000_000698	156	378	222	0.991071	0.53753
GCA_004324945.1-Fun_PITF01000005.1_i000_000695	156	378	222	0.991071	0.53753
GCA_004325055.1-Fun_PITH01000006.1_i000_000694	156	378	222	0.991071	0.53753
GCA_010458925.1-Pla_CM021226.1_i000_000348	161	348	187	0.834821	0.537356
GCA_019924425.1-Fun_JAHFXT010000026.1_i000_004075	182	389	207	0.924107	0.384758
GCA_019924355.1-Fun_JAHFXO010001326.1_i000_009510	182	389	207	0.924107	0.384758
GCA_019924485.1-Fun_JAHFXR010001560.1_i000_009839	182	389	207	0.924107	0.384758
GCA_019924675.1-Fun_JAHFXY010000834.1_i000_004971	182	389	207	0.924107	0.384758
GCA_019924755.1-Fun_JAHFYB010000722.1_i000_004443	182	389	207	0.924107	0.384758
GCA_019924315.1-Fun_JAHFXH010000719.1_i000_004633	182	389	207	0.924107	0.384758
GCA_019924395.1-Fun_JAHFXN010000354.1_i000_002841	182	389	207	0.924107	0.384758
GCA_019924555.1-Fun_JAHFXU010001150.1_i000_008364	182	389	207	0.924107	0.384758
GCA_900618515.1-Ani_UZAO01071653.1_i000_012244	100	314	214	0.955357	0.618497
GCA_000721775.1-Fun_KL584848.1_i000_008643	182	389	207	0.924107	0.384758
GCA_019925005.1-Fun_JAHFYP010000016.1_i000_002708	182	389	207	0.924107	0.384758
GCA_019924195.1-Fun_JAHFXF010000085.1_i000_018672	182	389	207	0.924107	0.384758
GCA_019924255.1-Fun_JAHFXK010000004.1_i000_010116	182	389	207	0.924107	0.384758
GCA_019924995.1-Fun_JAHFYO010000011.1_i000_000231	182	389	207	0.924107	0.384758
GCA_000721765.1-Fun_KL584718.1_i000_008030	182	389	207	0.924107	0.381919
GCA_019924955.1-Fun_JAHFYN010000018.1_i000_002388	182	389	207	0.924107	0.381919
GCA_000006405.1-Pro_GG674889.1_i000_000801	189	419	230	1.02679	0.442308
GCA_020744225.1-Fun_JAGMWG010000002.1_i000_006712	179	385	206	0.919643	0.362039
GCA_013201765.1-Fun_QPMQ01000007.1_i000_000893	181	389	208	0.928571	0.343802
GCA_019924575.1-Fun_JAHFXX010004846.1_i000_014693	143	350	207	0.924107	0.41483
GCA_011800055.1-Fun_WVTB01000042.1_i000_006966	181	388	207	0.924107	0.340461
GCA_019924555.1-Fun_JAHFXU010002067.1_i000_011724	241	448	207	0.924107	0.346734
GCA_001682635.1-Fun_JRHA01000004.1_i000_006029	181	388	207	0.924107	0.346734
GCA_000770705.1-Fun_ANFO01001118.1_i000_009892	181	388	207	0.924107	0.348485
GCA_001563125.1-Fun_JFFI01000399.1_i000_001687	181	388	207	0.924107	0.336039
GCA_017309325.2-Fun_JAESVG020000003.1_i000_002694	182	390	208	0.928571	0.359862
GCA_010093995.1-Fun_ML992501.1_i000_000198	182	390	208	0.928571	0.359862
GCA_000004255.1-Pla_GL348714.1_i000_007247	63	166	103	0.459821	0.609467
GCA_013115145.1-Pro_JAAPAO010000361.1_i000_006244	190	419	229	1.02232	0.450787
GCA_000331365.3-Pla_AMZH03002417.1_i000_010573	1	152	151	0.674107	0.398417
GCA_000146465.1-Fun_CP001950.1_i000_001506	166	388	222	0.991071	0.452138
THUZ001.0722.00001.C001_01898	158	378	220	0.982143	0.526316
GCA_019925775.1-Fun_JAHFYE010000890.1_i000_008492	182	389	207	0.924107	0.384758
GCA_019924215.1-Fun_JAHFXC010000457.1_i000_003284	182	389	207	0.924107	0.384758
GCA_019924375.1-Fun_JAHFXM010000325.1_i000_002627	182	389	207	0.924107	0.384758
GCA_019924435.1-Fun_JAHFXP010000798.1_i000_004779	182	389	207	0.924107	0.384758
GCA_019924695.1-Fun_JAHFYA010000346.1_i000_002740	182	389	207	0.924107	0.384758
GCA_019924025.1-Fun_JAHFWX010000230.1_i000_003126	182	389	207	0.924107	0.384758
GCA_019924415.1-Fun_JAHFXV010000011.1_i000_001294	182	389	207	0.924107	0.384758
GCA_019924655.1-Fun_JAHFXZ010000375.1_i000_002974	182	389	207	0.924107	0.384758
GCA_019924735.1-Fun_JAHFYD010000386.1_i000_003081	182	389	207	0.924107	0.384758
GCA_019924875.1-Fun_JAHFYK010000206.1_i000_003223	182	389	207	0.924107	0.384758
GCA_019924895.1-Fun_JAHFYM010000260.1_i000_008900	182	389	207	0.924107	0.384758
GCA_019925035.1-Fun_JAHFYQ010000005.1_i000_006033	182	389	207	0.924107	0.384758
GCA_005382405.1-Fun_PTQR01000081.1_i000_008223	182	386	204	0.910714	0.354167
GCA_000225605.1-Fun_JH126405.1_i000_008503	181	400	219	0.977679	0.36745
GCA_001593445.1-Pro_JIBK01000023.1_i000_001845	189	413	224	1	0.445328
GCA_003013795.1-Fun_NHZQ01000072.1_i000_004620	182	386	204	0.910714	0.354167
GCA_001592805.2-Fun_CP051140.1_i000_003168	182	393	211	0.941964	0.371479
GCA_019924725.1-Fun_JAHFYF010000001.1_i000_000392	280	487	207	0.924107	0.325472
GCA_019924825.1-Fun_JAHFYH010000001.1_i000_000376	280	487	207	0.924107	0.325472
GCA_000186865.1-Pro_GL833130.1_i000_005500	193	409	216	0.964286	0.438134
CAPR004.0722.00001.C001_00284	159	380	221	0.986607	0.492205
PYAE001.0722.00001.C001_02278	158	378	220	0.982143	0.522565
GCA_000143415.2-Pla_GL377570.1_i000_005113	196	421	225	1.00446	0.438596
GCA_000143415.2-Pla_GL377639.1_i000_026503	196	421	225	1.00446	0.438596
GCA_002897235.1-Pro_BDSA01000002.1_i000_001756	185	407	222	0.991071	0.351823
GCA_011947485.2-Fun_JAATWK020000168.1_i000_003721	181	393	212	0.946429	0.350993
GCA_010093685.1-Fun_MU006217.1_i000_001946	172	399	227	1.01339	0.406082
GCA_002591415.1-Fun_NJET01000063.1_i000_006693	194	418	224	1	0.435798
GCA_018342105.1-Ani_JAFIRS010000060.1_i000_002151	180	402	222	0.991071	0.403636
GCA_905397405.1-Ani_CAJPVJ010019059.1_i000_016403	1	65	64	0.285714	0.284444
GCA_013115135.1-Pro_JABANP010000222.1_i000_004689	107	337	230	1.02679	0.520362
GCA_002911725.1-Pro_NCKW01011280.1_i000_018106	157	265	108	0.482143	0.404494
GCA_019924815.1-Fun_JAHFYJ010000001.1_i000_000404	344	551	207	0.924107	0.295714
GCA_000981445.1-Pro_LK391707.1_i000_000889	185	407	222	0.991071	0.36039
GCA_000224885.2-Pro_KL998082.1_i000_000783	4	193	189	0.84375	0.642857
GCA_000224905.2-Pro_KN000238.1_i000_001827	4	193	189	0.84375	0.642857
GCA_000256705.2-Pro_ML130728.1_i000_005147	4	193	189	0.84375	0.642857
GCA_003704345.1-Fun_QWIJ01000009.1_i000_014793	193	417	224	1	0.405797
GCA_014839935.1-Fun_QTSX01006703.1_i000_004268	1	158	157	0.700893	0.560714
THSP005.0722.00001.C001_00456	148	369	221	0.986607	0.53253
GCA_000165425.1-Pro_CT868130.1_i000_017310	192	393	201	0.897321	0.386538
GCA_000224845.2-Pro_KN044600.1_i000_007842	29	222	193	0.861607	0.597523
GCA_006381635.2-Pla_VEPZ02001419.1_i000_062088	26	242	216	0.964286	0.892562
GCA_000978885.1-Fun_LBBL01000010.1_i000_000299	189	412	223	0.995536	0.386482
PYHO001.0722.00001.C001_00049	147	366	219	0.977679	0.546135
GCA_019202805.1-Pla_CM032906.1_i000_032313	349	463	114	0.508929	0.161017
GCA_004014815.1-Fun_RYZI01000487.1_i000_008079	44	265	221	0.986607	0.833962
GCA_003719485.1-Pro_MKKU01000960.1_i000_008896	158	380	222	0.991071	0.503401
GCA_018902385.1-Fun_JABSSW010000003.1_i000_000908	146	354	208	0.928571	0.457143
HYBU002.0722.00001.C001_00032	159	377	218	0.973214	0.527845
GCA_008632915.2-Pla_AP019301.1_i000_014784	188	346	158	0.705357	0.199747
GCA_008632915.2-Pla_AP019301.1_i000_014784	337	389	52	0.232143	0.0657396
GCA_008080495.1-Fun_CP023326.1_i000_002018	181	394	213	0.950893	0.357383
GCA_000182985.1-Fun_ACOL01000182.1_i000_000747	165	378	213	0.950893	0.531172
GCA_000988165.1-Fun_JPQZ01000118.1_i000_000325	165	378	213	0.950893	0.531172
GCA_004919615.1-Fun_SMUP01000076.1_i000_001359	165	378	213	0.950893	0.531172
MEKA001.0722.00001.C001_00605	155	380	225	1.00446	0.538278
GCA_019974015.1-Ani_BMAW01009945.1_i000_005530	191	413	222	0.991071	0.494432
GCA_016771965.1-Pla_CM028693.1_i000_033165	8	200	192	0.857143	0.662069
GCA_003025115.1-Fun_KZ680209.1_i000_002484	194	419	225	1.00446	0.440313
GCA_012184355.1-Fun_LDUC01000016.1_i000_008105	183	401	218	0.973214	0.389286
GCA_021525005.1-Fun_JAKEYE010000011.1_i000_001631	185	399	214	0.955357	0.39777
GCA_013115115.1-Pro_JABAHT010000144.1_i000_001617	188	417	229	1.02232	0.43619
GCA_001644535.1-Fun_KV441657.1_i000_012011	180	388	208	0.928571	0.365554
GCA_003097735.1-Ani_NHOQ01000204.1_i000_001644	216	383	167	0.745536	0.323017
GCA_910592015.1-Fun_CAJVPK010000018.1_i000_000547	185	341	156	0.696429	0.338395
GCA_910592015.1-Fun_CAJVPK010000018.1_i000_000547	334	368	34	0.151786	0.0737527
CANI011.0722.00001.C001_00041	149	362	213	0.950893	0.426
GCA_003426235.1-Fun_NQIM01000182.1_i000_002707	182	399	217	0.96875	0.329787
GCA_000695605.1-Pla_KK784936.1_i000_013190	38	268	230	1.02679	0.801394
GCA_903819495.1-Fun_CAIJDT010000003.1_i000_002238	200	407	207	0.924107	0.370304
GCA_012274485.2-Pla_MU105901.1_i000_022780	201	420	219	0.977679	0.486667
GCA_003177095.1-Pro_PRFC01000204.1_i000_008572	158	381	223	0.995536	0.513825
GCA_015033655.1-Pro_CM026663.1_i000_012602	158	381	223	0.995536	0.513825
GCA_903819465.1-Fun_CAIJDR010000013.1_i000_008845	201	408	207	0.924107	0.369643
GCA_003177095.1-Pro_PRFC01000159.1_i000_005614	158	381	223	0.995536	0.513825
GCA_000188675.2-Pro_ADWP02017096.1_i000_006888	158	381	223	0.995536	0.513825
GCA_000496795.1-Pro_AYLP01000023.1_i000_002526	158	381	223	0.995536	0.513825
GCA_002219105.2-Pro_MBSY01000090.1_i000_001490	158	381	223	0.995536	0.513825
GCA_003177105.1-Pro_PRFA01000026.1_i000_006819	158	381	223	0.995536	0.513825
GCA_003719455.1-Pro_MKKV01000057.1_i000_004419	158	381	223	0.995536	0.513825
GCA_015033625.1-Pro_CM026593.1_i000_005916	158	381	223	0.995536	0.513825
GCA_010015725.1-Fun_ML977556.1_i000_000511	182	391	209	0.933036	0.358491
GCA_905332275.1-Ani_CAJOBR010005265.1_i000_024542	3	156	153	0.683036	0.695455
GCA_022059095.1-Pro_JAJSEB010000007.1_i000_000590	158	381	223	0.995536	0.510297
GCA_008636045.1-Pro_SNRW01010248.1_i000_027640	147	367	220	0.982143	0.348101
GCA_000300495.1-Pro_AHKC01012153.1_i000_005674	158	381	223	0.995536	0.513825
GCA_000006405.1-Pro_GG671079.1_i000_010208	188	417	229	1.02232	0.446394
GCA_011068445.1-Fun_JAAGKP010000141.1_i000_002332	183	402	219	0.977679	0.403315
GCA_014362265.1-Pla_BJWL01000007.1_i000_010432	184	372	188	0.839286	0.343066
GCA_020746835.1-Fun_JAGPNK010000004.1_i000_010172	195	419	224	1	0.4375
GCA_000006405.1-Pro_GG682243.1_i000_011656	189	419	230	1.02679	0.284653
CANI002.0722.00001.C001_01969	161	384	223	0.995536	0.503386
GCA_011066575.1-Fun_WIQW01000005.1_i000_007989	183	402	219	0.977679	0.403315
GCA_011066585.1-Fun_WIQY01000073.1_i000_010295	183	402	219	0.977679	0.403315
GCA_011066595.1-Fun_WIQZ01000177.1_i000_003287	183	402	219	0.977679	0.403315
GCA_011066605.1-Fun_WIQX01000172.1_i000_003631	183	402	219	0.977679	0.403315
GCA_011066695.1-Fun_WIRB01000168.1_i000_003203	183	402	219	0.977679	0.403315
GCA_011066565.1-Fun_WIRA01000084.1_i000_010858	183	402	219	0.977679	0.403315
GCA_000448365.1-Fun_KE652187.1_i000_000363	181	387	206	0.919643	0.309309
GCA_012934285.1-Fun_JAAVMX010000006.1_i000_005827	181	387	206	0.919643	0.309309
GCA_011066875.1-Fun_JAABOE010000030.1_i000_006243	183	402	219	0.977679	0.403315
GCA_011066885.1-Fun_WIWS01000185.1_i000_003721	183	402	219	0.977679	0.403315
GCA_011066905.1-Fun_WIWT01000111.1_i000_001067	183	402	219	0.977679	0.403315
GCA_011066925.1-Fun_WIPF01000180.1_i000_003358	183	402	219	0.977679	0.403315
GCA_011066985.1-Fun_WIPG01000109.1_i000_000800	183	402	219	0.977679	0.403315
GCA_012184305.1-Fun_LDUB01000091.1_i000_004457	166	385	219	0.977679	0.428571
GCA_020379485.1-Pla_CM035457.1_i000_049480	113	313	200	0.892857	0.440529
GCA_002276285.1-Fun_NLAX01000004.1_i000_004128	186	390	204	0.910714	0.33719
GCA_022201065.1-Pla_CM039171.1_i000_004418	68	299	231	1.03125	0.697885
PYNE001.0722.00001.C001_01773	158	378	220	0.982143	0.52381
GCA_001662595.1-Fun_KV456757.1_i000_008058	193	398	205	0.915179	0.420945
GCA_021432615.1-Fun_MU270217.1_i000_009304	181	388	207	0.924107	0.342149
GCA_000392275.1-Fun_KB932824.1_i000_001035	182	395	213	0.950893	0.335962
GCA_000225545.1-Fun_JH119108.1_i000_008022	202	421	219	0.977679	0.38968
GCA_002871155.1-Fun_MRVG01000002.1_i000_004017	181	388	207	0.924107	0.348485
GCA_007182795.1-Fun_VFLP01000034.1_i000_005387	182	400	218	0.973214	0.352181
GCA_000018645.1-Pro_CP000882.1_i000_000309	165	385	220	0.982143	0.54321
GCA_002897195.1-Pla_BDQV01000530.1_i000_024505	68	298	230	1.02679	0.725552
GCA_004000055.1-Fun_SAEB01000001.1_i000_005139	183	402	219	0.977679	0.404806
GCA_903853725.1-Fun_CAINUL010000002.1_i000_001919	166	373	207	0.924107	0.393536
GCA_020746995.1-Fun_JAGPXD010000007.1_i000_012206	181	389	208	0.928571	0.321484
GCA_020184695.1-Pro_JAANOX010000034.1_i000_001491	191	412	221	0.986607	0.430799
GCA_020186115.1-Pro_WSYJ01000001.1_i000_000173	191	412	221	0.986607	0.430799
THTE004.0722.00001.C001_01596	157	376	219	0.977679	0.523923
GCA_019925795.1-Pla_CM034302.1_i000_005859	187	406	219	0.977679	0.396022
GCA_020726575.1-Fun_JAGSXJ010000016.1_i000_003012	181	389	208	0.928571	0.322981
GCA_017310585.1-Fun_CP069114.1_i000_000577	1	121	120	0.535714	0.552995
GCA_000209065.1-Pro_CH473489.1_i000_004568	220	443	223	0.995536	0.449597
GCA_013358655.1-Pro_JABDHM010000029.1_i000_006004	220	443	223	0.995536	0.449597
GCA_001879275.1-Fun_KV875099.1_i000_007642	182	387	205	0.915179	0.356522
GCA_902806795.1-Ani_CADCXV010001394.1_i000_015682	178	308	130	0.580357	0.263692
GCA_902806795.1-Ani_CADCXV010001394.1_i000_015682	292	370	78	0.348214	0.158215
GCA_000441935.1-Fun_KE525618.1_i000_005405	183	401	218	0.973214	0.399267
GCA_000002975.1-Pro_AF083031.2_i000_000447	181	403	222	0.991071	0.5311
GCA_002003505.1-Fun_BDMC01000013.1_i000_005133	182	399	217	0.96875	0.340125
GCA_018107945.1-Pla_JACEIK010000925.1_i000_018146	1	92	91	0.40625	0.348659
GCA_900659725.1-Ani_CAACVG010007067.1_i000_006589	152	317	165	0.736607	0.518868
CANI003.0722.00001.C001_01089	149	371	222	0.991071	0.540146
GCA_004768765.1-Fun_SOZJ01000007.1_i000_010200	183	401	218	0.973214	0.401473
GCA_011066715.1-Fun_WIWQ01000007.1_i000_010146	183	401	218	0.973214	0.401473
GCA_011066735.1-Fun_JAABOI010000012.1_i000_001402	183	401	218	0.973214	0.401473
GCA_011066745.1-Fun_JAABOH010000203.1_i000_004438	183	401	218	0.973214	0.401473
GCA_011066795.1-Fun_WIWR01000104.1_i000_000761	183	401	218	0.973214	0.401473
GCA_011067015.1-Fun_JAABLO010000059.1_i000_009151	183	401	218	0.973214	0.401473
GCA_000442575.2-Pro_ATMG01010842.1_i000_006064	2	202	200	0.892857	0.881057
GCA_019974015.1-Ani_BMAW01132838.1_i000_072019	182	407	225	1.00446	0.367047
GCA_000493195.1-Pla_KI536312.1_i000_004034	68	298	230	1.02679	0.662824
GCA_022201045.1-Pla_CM039162.1_i000_003800	68	298	230	1.02679	0.662824
GCA_021029035.1-Pro_JAFCAH010000043.1_i000_008266	169	408	239	1.06696	0.432971
GCA_004014815.1-Fun_RYZI01000001.1_i000_000118	177	394	217	0.96875	0.31223
GCA_010093925.1-Fun_ML994745.1_i000_020810	182	391	209	0.933036	0.356048
GCA_020647635.1-Fun_CP071108.1_i000_004205	139	363	224	1	0.450704
CANI013.0722.00001.C001_01162	159	382	223	0.995536	0.527187
CANI014.0722.00001.C001_00701	159	382	223	0.995536	0.527187
IGIS001.0722.00001.C001_00679	168	392	224	1	0.52093
GCA_002105095.1-Fun_MCFJ01000012.1_i000_002601	183	401	218	0.973214	0.362729
GCA_001661235.1-Fun_KV454005.1_i000_004665	101	322	221	0.986607	0.502273
GCA_000497125.2-Pro_CM035319.1_i000_003496	166	403	237	1.05804	0.561611
GCA_002920065.1-Fun_PKSL01000393.1_i000_014660	195	402	207	0.924107	0.422449
GCA_003704355.1-Fun_QWIL01002179.1_i000_013020	1	201	200	0.892857	0.480769
GCA_000170995.2-Fun_ABDF02000005.1_i000_008617	194	418	224	1	0.439216
GCA_020647705.1-Fun_CP071116.1_i000_004120	194	418	224	1	0.41791
GCA_021432605.1-Fun_MU271148.1_i000_006510	182	387	205	0.915179	0.354671
MESP048.0722.00001.C001_00396	145	367	222	0.991071	0.536232
PYFE001.0722.00001.C001_01472	158	377	219	0.977679	0.52019
CALA001.0722.00001.C001_00321	159	377	218	0.973214	0.529126
GCA_003434825.1-Pla_CM010629.1_i000_007321	196	401	205	0.915179	0.483491
GCA_009194965.1-Fun_VSMA01000002.1_i000_008025	182	387	205	0.915179	0.3457
MEVU001.0722.00001.C001_00353	142	364	222	0.991071	0.528571
GCA_016097855.1-Fun_JAAAIM010002678.1_i000_005606	1	89	88	0.392857	0.356275
GCA_009194965.1-Fun_VSMA01000001.1_i000_001429	138	343	205	0.915179	0.375458
GCA_000582985.1-Fun_JARH01000220.1_i000_002732	181	388	207	0.924107	0.336585
GCA_020499125.1-Fun_JAIBQH010000033.1_i000_005576	190	348	158	0.705357	0.315369
GCA_020499125.1-Fun_JAIBQH010000033.1_i000_005576	341	395	54	0.241071	0.107784
GCA_002049455.2-Pro_KV918858.1_i000_004775	163	293	130	0.580357	0.163522
GCA_002049455.2-Pro_KV918858.1_i000_004775	303	402	99	0.441964	0.124528
PYCA001.0722.00001.C001_01180	156	376	220	0.982143	0.528846
GCA_003061485.1-Pla_CM009750.1_i000_007865	1	138	137	0.611607	0.637209
GCA_000004255.1-Pla_GL348719.1_i000_027488	162	374	212	0.946429	0.549223
GCA_002276285.1-Fun_NLAX01001623.1_i000_004487	196	420	224	1	0.436647
GCA_010015565.1-Fun_ML975945.1_i000_003065	182	397	215	0.959821	0.373264
GCA_001563115.1-Fun_JEMN01000017.1_i000_000191	181	388	207	0.924107	0.336585
GCA_001563135.1-Fun_JFBX01000347.1_i000_005420	181	388	207	0.924107	0.336585
GCA_011075155.1-Fun_JAAJBS010000009.1_i000_010298	181	388	207	0.924107	0.336585
GCA_018906675.1-Fun_JAESDO010000003.1_i000_007503	181	388	207	0.924107	0.336585
GCA_018906765.1-Fun_JAESDN010000003.1_i000_007528	181	388	207	0.924107	0.336585
GCA_018907675.1-Fun_JAESDM010000003.1_i000_007696	181	388	207	0.924107	0.336585
GCA_001831195.1-Fun_MJBS01000031.1_i000_007690	181	388	207	0.924107	0.331731
GCA_000018645.1-Pro_CP000881.1_i000_000127	182	406	224	1	0.542373
GCA_013115125.1-Pro_JABANN010000148.1_i000_001557	189	417	228	1.01786	0.215501
GCA_903853725.1-Fun_CAINUL010000001.1_i000_001368	178	391	213	0.950893	0.440083
GCA_002894145.1-Fun_MTYI01000004.1_i000_008575	255	479	224	1	0.392294
GCA_020631695.1-Fun_CM036090.1_i000_004971	194	418	224	1	0.435798
GCA_001839685.1-Pro_MLAK01000726.1_i000_011271	191	411	220	0.982143	0.408922
GCA_011057905.1-Fun_WUBL01000036.1_i000_006590	182	399	217	0.96875	0.342271
GCA_001642415.1-Fun_LTDK01000147.1_i000_001851	152	384	232	1.03571	0.574257
GCA_000190615.1-Fun_GL870876.1_i000_000092	152	384	232	1.03571	0.574257
GCA_000250985.1-Fun_JH605024.1_i000_001139	152	384	232	1.03571	0.574257
GCA_000005005.6-Pla_CM007647.1_i000_005346	1	147	146	0.651786	0.993197
CANI015.0722.00001.C001_01583	149	369	220	0.982143	0.502283
ACSP005.0722.00001.C001_01568	161	382	221	0.986607	0.527446
GCA_021556665.1-Fun_JAKFGG010000094.1_i000_010287	192	424	232	1.03571	0.451362
GCA_902728155.2-Pla_CACVBM020001884.1_i000_048668	1	109	108	0.482143	0.654545
GCA_002148645.1-Ani_LVZM01002395.1_i000_001390	205	407	202	0.901786	0.289813
GCA_900617915.1-Ani_UYRT01081163.1_i000_014335	69	286	217	0.96875	0.439271
GCA_000988865.1-Fun_JOKZ01000301.1_i000_008131	194	418	224	1	0.439216
GCA_022453515.1-Fun_JAJNNY010000012.1_i000_001393	182	400	218	0.973214	0.349359
GCA_002838845.1-Fun_NQLC01000171.1_i000_003185	194	418	224	1	0.439216
GCA_003025095.1-Fun_KZ679679.1_i000_005746	194	418	224	1	0.439216
GCA_000183805.3-Ani_JH712318.1_i000_009992	233	412	179	0.799107	0.434466
GCA_019565615.1-Fun_CP075865.1_i000_003099	194	418	224	1	0.439216
GCA_002022785.1-Fun_LVVK01000023.1_i000_005565	194	418	224	1	0.436647
GCA_011066345.1-Fun_QLNT01000014.1_i000_003207	194	418	224	1	0.439216
GCA_020045945.2-Fun_CM034695.1_i000_002455	194	418	224	1	0.439216
GCA_000149585.1-Fun_CH476659.1_i000_004087	1	121	120	0.535714	0.248447
GCA_001548555.1-Fun_CP014244.1_i000_002220	94	315	221	0.986607	0.477322
GCA_011766145.1-Pla_BLLF01004124.1_i000_023452	20	115	95	0.424107	0.811966
GCA_011947395.2-Fun_JAATWM020000026.1_i000_005269	181	388	207	0.924107	0.336039
GCA_000167675.2-Fun_GL985081.1_i000_007918	194	418	224	1	0.4375
GCA_000513815.1-Fun_KI911163.1_i000_008212	194	418	224	1	0.4375
GCA_000149815.1-Fun_DS016981.1_i000_010412	182	387	205	0.915179	0.355286
GCA_014529505.1-Pro_JABXOJ010000013.1_i000_000541	188	412	224	1	0.456212
PYIS001.0722.00001.C001_00435	158	378	220	0.982143	0.52381
GCA_905332135.1-Ani_CAJOBI010030581.1_i000_024819	3	156	153	0.683036	0.671053
GCA_000797535.1-Ani_KN538377.1_i000_001633	183	408	225	1.00446	0.431862
GCA_000732125.1-Fun_JOWA01000165.1_i000_007814	196	420	224	1	0.434109
GCA_021904315.1-Pla_CM038908.1_i000_002771	147	356	209	0.933036	0.389199
GCA_001050175.1-Fun_LFMI01000831.1_i000_008963	194	418	224	1	0.376471
GCA_001692735.1-Fun_KV745360.1_i000_011363	183	398	215	0.959821	0.364407
GCA_905219585.1-Fun_CAJMWS010000316.1_i000_003944	187	368	181	0.808036	0.340226
GCA_007990485.1-Pla_CM017617.1_i000_042113	177	214	37	0.165179	0.074
GCA_007990485.1-Pla_CM017617.1_i000_042113	208	346	138	0.616071	0.276
GCA_003260675.2-Pla_QGKX02001290.1_i000_014382	1	156	155	0.691964	0.523649
GCA_013398395.1-Ani_VZSK01000670.1_i000_013216	115	304	189	0.84375	0.621711
GCA_014282245.1-Pla_CM024959.1_i000_017160	107	327	220	0.982143	0.528846
GCA_011066845.1-Fun_JAABOJ010000061.1_i000_009845	183	402	219	0.977679	0.403315
GCA_004768795.1-Fun_SKBN01000083.1_i000_010398	236	393	157	0.700893	0.320408
GCA_000818735.3-Pla_JTFG03002729.1_i000_023027	1	87	86	0.383929	0.518072
GCA_001884805.1-Pla_MKKS01004507.1_i000_021994	1	87	86	0.383929	0.51497
CANI006.0722.00001.C001_00516	151	366	215	0.959821	0.381883
GCA_905330805.1-Ani_CAJNWK010000880.1_i000_027990	179	305	126	0.5625	0.286364
GCA_905330805.1-Ani_CAJNWK010000880.1_i000_027990	292	373	81	0.361607	0.184091
GCA_020002365.1-Fun_JAINEY010000005.1_i000_006893	194	418	224	1	0.39646
GCA_009733575.1-Fun_ML769473.1_i000_012487	189	426	237	1.05804	0.435662
GCA_900618405.1-Ani_UYSL01027347.1_i000_022019	177	359	182	0.8125	0.506964
GCA_004325035.1-Fun_PIXR01001817.1_i000_002995	147	396	249	1.11161	0.301453
GCA_000611835.1-Ani_KK107921.1_i000_015755	174	328	154	0.6875	0.381188
GCA_012275245.1-Fun_WMJW01000015.1_i000_002329	1	169	168	0.75	0.528302
GCA_004325065.1-Fun_PITI01000321.1_i000_001404	147	396	249	1.11161	0.299279
GCA_000732775.1-Fun_KL660883.1_i000_009768	182	390	208	0.928571	0.33121
GCA_004325045.1-Fun_PITJ01000191.1_i000_000830	147	396	249	1.11161	0.299279
GCA_902728155.2-Pla_CACVBM020000199.1_i000_002964	33	153	120	0.535714	0.774194
GCA_902728155.2-Pla_CACVBM020000410.1_i000_005875	33	153	120	0.535714	0.774194
GCA_004325075.1-Fun_PITK01000606.1_i000_002788	147	385	238	1.0625	0.618182
CANI010.0722.00001.C001_02036	160	384	224	1	0.5
GCA_000150825.1-Fun_DS985219.1_i000_004755	181	389	208	0.928571	0.347826
GCA_022085475.1-Pla_JAIUZE010045862.1_i000_015660	368	467	99	0.441964	0.211991
GCA_000150675.2-Fun_DS572709.1_i000_006302	181	389	208	0.928571	0.317557
GCA_002892985.1-Fun_MPSH01000001.1_i000_000481	181	389	208	0.928571	0.317557
GCA_002892995.1-Fun_PHNU01000042.1_i000_006776	181	389	208	0.928571	0.317557
GCA_002893025.1-Fun_PHNV01000288.1_i000_004695	181	389	208	0.928571	0.317557
GCA_002893035.1-Fun_PHNW01000286.1_i000_004200	181	389	208	0.928571	0.317557
GCA_002893045.1-Fun_PHNX01000065.1_i000_008514	181	389	208	0.928571	0.317557
GCA_003320035.1-Fun_CM010351.1_i000_006822	181	389	208	0.928571	0.317557
GCA_004109745.1-Fun_CM014045.1_i000_004388	181	389	208	0.928571	0.317557
GCA_011066485.2-Fun_MU010195.1_i000_008262	181	389	208	0.928571	0.317557
GCA_020726535.1-Fun_JAHEWJ010000007.1_i000_010567	181	389	208	0.928571	0.317557
GCA_003724135.2-Fun_RBVV01000025.1_i000_004413	181	389	208	0.928571	0.317557
GCA_018994095.1-Fun_JAEMWZ010000005.1_i000_013720	181	389	208	0.928571	0.317557
GCA_021525775.1-Fun_JAKELK010000003.1_i000_009119	186	393	207	0.924107	0.41483
GCA_011066465.2-Fun_MU009564.1_i000_008211	181	389	208	0.928571	0.328076
GCA_018994105.1-Fun_JAFKAI010005321.1_i000_001793	181	389	208	0.928571	0.299281
GCA_003490085.1-Pla_LXQA010222628.1_i000_056109	1	47	46	0.205357	0.474227
GCA_003490085.1-Pla_LXQA010222628.1_i000_056109	43	97	54	0.241071	0.556701
GCA_000194455.1-Pro_CP002173.1_i000_000285	155	378	223	0.995536	0.56743
GCA_000147195.1-Ani_GL450376.1_i000_009063	2	164	162	0.723214	0.885246
GCA_910591605.1-Ani_CAJVCH010051083.1_i000_007545	1	52	51	0.227679	0.980769
GCA_000091205.1-Pro_AP006499.2_i000_003358	187	418	231	1.03125	0.416968
GCA_903819115.1-Fun_CAIJCR010000001.1_i000_000403	1	193	192	0.857143	0.556522
GCA_011745845.1-Pla_VYZY01002554.1_i000_012141	1	91	90	0.401786	0.463918
GCA_011745865.1-Pla_VYZZ01001890.1_i000_009650	1	91	90	0.401786	0.463918
GCA_000732565.1-Fun_KL651591.1_i000_008983	182	390	208	0.928571	0.328594
GCA_000730325.1-Fun_KL648754.1_i000_011278	182	390	208	0.928571	0.328594
GCA_000732765.1-Fun_KL657467.1_i000_003071	182	390	208	0.928571	0.328594
GCA_905330665.1-Ani_HG994585.1_i000_007328	175	325	150	0.669643	0.461538
GCA_003073045.1-Ani_CM009762.1_i000_010178	718	896	178	0.794643	0.167293
GCA_013399895.1-Ani_VXBA01004484.1_i000_010219	101	275	174	0.776786	0.393665
GCA_021029045.1-Pro_JAFCAI010000029.1_i000_006686	261	395	134	0.598214	0.259188
GCA_006381635.2-Pla_VEPZ02001342.1_i000_058321	177	327	150	0.669643	0.458716
VUDI001.0722.00001.C001_00309	160	377	217	0.96875	0.515439
GCA_016098025.1-Fun_JAAAIU010002580.1_i000_005758	182	329	147	0.65625	0.446809
GCA_000333975.2-Fun_CAKM01000132.1_i000_002686	104	269	165	0.736607	0.444744
GCA_001268145.1-Fun_CVQH01017779.1_i000_008843	181	389	208	0.928571	0.195305
GCA_021821965.1-Fun_JACCJH010000006.1_i000_000704	179	401	222	0.991071	0.509174
MEIN004.0722.00001.C001_00949	139	362	223	0.995536	0.573265
GCA_010093515.1-Fun_MU001677.1_i000_003852	182	398	216	0.964286	0.36
GCA_019364655.1-Ani_JAGXCG010013462.1_i000_037857	2	159	157	0.700893	0.635628
GCA_013397655.1-Ani_VYZF01004093.1_i000_012789	208	373	165	0.736607	0.319149
GCA_000447185.1-Fun_KE647071.1_i000_000551	61	273	212	0.946429	0.718644
GCA_000209065.1-Pro_CH473548.1_i000_002956	6	149	143	0.638393	0.680952
GCA_011752425.2-Ani_CACVKT020005209.1_i000_028476	1	121	120	0.535714	0.495868
GCA_000143365.1-Fun_CH408033.1_i000_004015	172	362	190	0.848214	0.32872
GCA_000143365.1-Fun_CH408033.1_i000_004015	465	550	85	0.379464	0.147059
GCA_905332015.1-Ani_CAJOAZ010002591.1_i000_026235	1	121	120	0.535714	0.641711
GCA_018856295.1-Fun_JAFLHD010008894.1_i000_004897	186	399	213	0.950893	0.411992
GCA_015679645.1-Fun_JAAAVC010003458.1_i000_006953	21	175	154	0.6875	0.855556
GCA_910591605.1-Ani_CAJVCH010553695.1_i000_039817	1	57	56	0.25	0.523364
GCA_015499975.1-Fun_JAAAUD010000397.1_i000_006864	186	314	128	0.571429	0.27234
GCA_015499975.1-Fun_JAAAUD010000397.1_i000_006864	309	381	72	0.321429	0.153191
GCA_004153795.2-Pla_SDRB02012896.1_i000_027566	211	365	154	0.6875	0.313008
GCA_004153795.2-Pla_SDRB02012896.1_i000_027566	358	406	48	0.214286	0.097561
GCA_002271885.2-Pla_CM008443.1_i000_000539	1	76	75	0.334821	0.311203
HASP034.0722.00001.C001_00890	72	273	201	0.897321	0.725632
HASP033.0722.00001.C001_00913	72	273	201	0.897321	0.725632
HASP046.0722.00001.C001_00962	72	273	201	0.897321	0.725632
GCA_000492115.1-Pro_AUPL01001560.1_i000_001534	4	159	155	0.691964	0.741627
GCA_004768795.1-Fun_SKBN01000181.1_i000_002939	182	400	218	0.973214	0.323923
GCA_011766145.1-Pla_BLLF01004124.1_i000_023449	5	81	76	0.339286	0.926829
GCA_000231115.1-Fun_JH370140.1_i000_001284	177	389	212	0.946429	0.510843
GCA_003203535.1-Pla_BDRX01000021.1_i000_003664	177	292	115	0.513393	0.240084
GCA_003203535.1-Pla_BDRX01000021.1_i000_003664	299	368	69	0.308036	0.14405
MEST002.0722.00001.C001_01434	148	366	218	0.973214	0.533007
GCA_000497125.2-Pro_AUWU02000036.1_i000_008656	164	378	214	0.955357	0.438525
GCA_000497125.2-Pro_CM035319.1_i000_003383	164	378	214	0.955357	0.438525
GCA_019202795.1-Pla_CM032919.1_i000_032227	63	173	110	0.491071	0.588235
GCA_002911725.1-Pro_NCKW01017255.1_i000_022693	189	382	193	0.861607	0.505236
GCA_000733195.1-Pla_KL978098.1_i000_020102	193	352	159	0.709821	0.329193
GCA_021442195.1-Pla_CM038197.1_i000_006630	158	337	179	0.799107	0.348928
GCA_004768795.1-Fun_SKBN01000038.1_i000_007048	46	254	208	0.928571	0.670968
GCA_000499385.1-Pro_HG722743.1_i000_001243	244	400	156	0.696429	0.303502
GCA_903819665.1-Fun_CAIJEO010000006.1_i000_005060	135	338	203	0.90625	0.416838
GCA_016097855.1-Fun_JAAAIM010002023.1_i000_004294	153	245	92	0.410714	0.37551
GCA_022432375.1-Fun_JAJKKK010000023.1_i000_004402	182	399	217	0.96875	0.346645
GCA_013115135.1-Pro_JABANP010000068.1_i000_012397	1	131	130	0.580357	0.0981873
GCA_016628065.1-Fun_JABBWA010000244.1_i000_008782	172	388	216	0.964286	0.428571
GCA_022376445.1-Fun_JACBKP010000092.1_i000_017022	188	377	189	0.84375	0.361377
GCA_013401335.1-Ani_VYZX01018503.1_i000_006875	115	294	179	0.799107	0.602694
GCA_018127125.1-Pla_CM030792.1_i000_014801	10	115	105	0.46875	0.905172
GCA_015501075.1-Fun_JADNYJ010000055.1_i000_012450	183	391	208	0.928571	0.375451
GCA_016097525.1-Fun_JADAKD010000014.1_i000_006793	4	178	174	0.776786	0.47541
GCA_013115895.1-Pro_JABANM010011900.1_i000_009859	521	682	161	0.71875	0.23607
GCA_000147415.1-Pla_GL433843.1_i000_004379	200	336	136	0.607143	0.331707
GCA_000180735.1-Ani_CAAE01018048.1_i000_026803	2	135	133	0.59375	0.985185
GCA_004000155.1-Fun_RCSS01000412.1_i000_001690	164	392	228	1.01786	0.558824
GCA_003490085.1-Pla_LXQA010213347.1_i000_055150	5	124	119	0.53125	0.959677
GCA_002954075.1-Fun_CP025763.1_i000_003453	188	369	181	0.808036	0.425882
GCA_014058105.1-Pla_JACGCM010000067.1_i000_025369	313	475	162	0.723214	0.338205
GCA_000005005.6-Pla_CM000782.4_i000_026329	142	289	147	0.65625	0.508651
GCA_000004255.1-Pla_GL348714.1_i000_007245	446	556	110	0.491071	0.192982
GCA_013396875.1-Ani_VZRF01006670.1_i000_005415	3	87	84	0.375	0.261682
GCA_013396875.1-Ani_VZRF01006670.1_i000_005415	101	183	82	0.366071	0.255452
GCA_000321355.1-Pro_DF157101.1_i000_002093	172	388	216	0.964286	0.386404
VUMO001.0722.00001.C001_01403	160	376	216	0.964286	0.513064
HASA002.0722.00001.C001_01327	73	273	200	0.892857	0.722022
GCA_000512255.2-Pla_CM008455.1_i000_000654	47	141	94	0.419643	0.236776
GCA_902201215.1-Pla_LR694009.1_i000_013569	2	156	154	0.6875	0.49359
GCA_003426265.1-Fun_NQIL01000003.1_i000_005399	191	270	79	0.352679	0.161224
GCA_003426265.1-Fun_NQIL01000003.1_i000_005399	243	392	149	0.665179	0.304082
GCA_006783055.1-Ani_VCRD01007018.1_i000_021244	166	342	176	0.785714	0.51462
HALI003.0722.00001.C001_00900	117	274	157	0.700893	0.566787
GCA_000385875.2-Fun_KK365130.1_i000_000104	165	392	227	1.01339	0.555012
SASP011.0722.00001.C001_01479	109	273	164	0.732143	0.594203
GCA_019968985.1-Pro_JAHYSF010000267.1_i000_001110	1	212	211	0.941964	0.830709
GCA_015179025.1-Fun_WHUX01000038.1_i000_007254	190	376	186	0.830357	0.476923
GCA_019924895.1-Fun_JAHFYM010000631.1_i000_015261	2	185	183	0.816964	0.547904
HADA001.0722.00001.C001_01114	124	280	156	0.696429	0.525253
GCA_019924195.1-Fun_JAHFXF010000062.1_i000_015771	4	177	173	0.772321	0.535604
GCA_000223845.4-Pro_KK211460.1_i000_001437	187	410	223	0.995536	0.44246
GCA_020450195.1-Fun_CP053492.1_i000_001737	128	353	225	1.00446	0.469729
GCA_020450215.1-Fun_CP053518.1_i000_001735	128	353	225	1.00446	0.469729
GCA_020450235.1-Fun_CP053531.1_i000_001735	128	353	225	1.00446	0.469729
GCA_020450265.1-Fun_CP060149.1_i000_001735	128	353	225	1.00446	0.469729
GCA_001466525.1-Fun_LLWO01000031.1_i000_000120	128	353	225	1.00446	0.469729
GCA_001466535.1-Fun_LMAA01000132.1_i000_004977	128	353	225	1.00446	0.469729
GCA_001466565.1-Fun_LMAB01000103.1_i000_002265	128	353	225	1.00446	0.469729
GCA_001466575.1-Fun_LLZY01000043.1_i000_001660	128	353	225	1.00446	0.469729
GCA_001466635.1-Fun_LLZZ01000107.1_i000_001652	128	353	225	1.00446	0.469729
GCA_001466685.1-Fun_LMAY01000101.1_i000_000080	128	353	225	1.00446	0.469729
GCA_020797215.1-Fun_CM036799.1_i000_001744	128	353	225	1.00446	0.469729
GCA_020797225.1-Fun_CM036820.1_i000_001745	128	353	225	1.00446	0.469729
GCA_020797355.1-Fun_CM036856.1_i000_001725	128	353	225	1.00446	0.469729
GCA_000002545.2-Fun_CR380953.1_i000_001709	128	353	225	1.00446	0.469729
GCA_010111755.1-Fun_CP048124.1_i000_001735	128	353	225	1.00446	0.469729
GCA_020797185.1-Fun_CM036837.1_i000_001738	128	353	225	1.00446	0.469729
GCA_020797325.1-Fun_CM036845.1_i000_001734	128	353	225	1.00446	0.469729
CANI020.0722.00001.C001_03385	155	377	222	0.991071	0.513889
GCA_020797195.1-Fun_CM036808.1_i000_001736	128	353	225	1.00446	0.469729
GCA_020797205.1-Fun_CM036829.1_i000_001731	128	353	225	1.00446	0.469729
GCA_019924465.1-Fun_JAHFXQ010007493.1_i000_020853	2	172	170	0.758929	0.529595
GCA_019924535.1-Fun_JAHFXS010000667.1_i000_006454	2	172	170	0.758929	0.529595
GCA_905330805.1-Ani_CAJNWK010004074.1_i000_035780	62	188	126	0.5625	0.35493
GCA_013368315.1-Fun_JAACJM010000230.1_i000_016134	186	372	186	0.830357	0.356322
GCA_019924535.1-Fun_JAHFXS010000682.1_i000_006535	2	172	170	0.758929	0.529595
GCA_019968955.1-Pro_JAHYSE010000227.1_i000_001297	2	212	210	0.9375	0.826772
GCA_000695815.1-Ani_KK846943.1_i000_011486	61	221	160	0.714286	0.39801
HASP066.0722.00001.C001_02044	80	274	194	0.866071	0.700361
GCA_019924465.1-Fun_JAHFXQ010000445.1_i000_004940	2	171	169	0.754464	0.528125
GCA_006348945.1-Ani_SRLO01000285.1_i000_026908	33	220	187	0.834821	0.518006
GCA_014217725.1-Fun_CP048236.1_i000_001726	128	353	225	1.00446	0.469729
GCA_900096545.1-Fun_FMSJ01000007.1_i000_001898	128	353	225	1.00446	0.469729
GCA_900166875.1-Fun_FWDN01000007.1_i000_004964	128	353	225	1.00446	0.469729
GCA_905332225.1-Ani_CAJOBN010009435.1_i000_027137	27	139	112	0.5	0.366013
GCA_019924255.1-Fun_JAHFXK010000070.1_i000_016752	1	167	166	0.741071	0.530351
GCA_002219185.1-Fun_CM008087.1_i000_002028	128	353	225	1.00446	0.469729
GCA_002219195.1-Fun_CM008101.1_i000_002026	128	353	225	1.00446	0.469729
CAMA003.0722.00001.C001_01327	162	382	220	0.982143	0.537897
GCA_015679605.1-Fun_JAAAVE010000027.1_i000_005057	280	398	118	0.526786	0.0580709
GCA_015679605.1-Fun_JAAAVE010000027.1_i000_005057	396	480	84	0.375	0.0413386
GCA_013400335.1-Ani_VZZY01006200.1_i000_003285	115	274	159	0.709821	0.336864
GCA_009887335.1-Ani_SGJC01006288.1_i000_006823	102	192	90	0.401786	0.46875
CANA006.0722.00001.C001_00254	60	247	187	0.834821	0.751004
GCA_008932095.1-Pla_CM018510.1_i000_012789	188	372	184	0.821429	0.434988
GCA_010093745.1-Fun_MU005991.1_i000_005050	192	416	224	1	0.408759
GCA_000709325.1-Ani_KL447386.1_i000_003592	2	226	224	1	0.618785
MEMA006.0722.00003.C001_03162	150	313	163	0.727679	0.485119
GCA_013398875.1-Ani_VYZK01001106.1_i000_012770	115	267	152	0.678571	0.567164
GCA_019924185.1-Fun_JAHFXE010006537.1_i000_020473	191	362	171	0.763393	0.472376
GCA_001417965.1-Ani_LJWW01000023.1_i000_009163	187	351	164	0.732143	0.369369
GCA_014925825.1-Fun_JACGCK010000061.1_i000_014260	181	364	183	0.816964	0.488
NAOC001.0722.00001.C001_03740	115	278	163	0.727679	0.567944
GCA_900622545.1-Ani_UYWY01006005.1_i000_004006	3	161	158	0.705357	0.748815
GCA_006381635.2-Pla_VEPZ02001449.1_i000_064197	188	401	213	0.950893	0.410405
GCA_002926015.1-Pla_KZ650123.1_i000_034002	177	327	150	0.669643	0.457317
GCA_000182665.1-Pro_ACVC01000031.1_i000_004645	192	423	231	1.03125	0.457426
HASP051.0722.00001.C001_03622	79	279	200	0.892857	0.692042
GCA_905182995.1-Pro_CAJJDP010000009.1_i000_004039	1	120	119	0.53125	0.613402
GCA_000412225.2-Fun_CP006023.1_i000_002001	80	276	196	0.875	0.522667
GCA_000331365.3-Pla_AMZH03009647.1_i000_029801	47	198	151	0.674107	0.473354
GCA_013400255.1-Ani_VXBS01005705.1_i000_007053	115	280	165	0.736607	0.353319
GCA_016758765.1-Fun_JABBWL010000001.1_i000_000128	148	333	185	0.825893	0.392781
GCA_019924485.1-Fun_JAHFXR010008447.1_i000_021371	2	157	155	0.691964	0.506536
GCA_000002425.2-Pla_CM009340.1_i000_029607	188	377	189	0.84375	0.335106
GCA_009771035.1-Pla_CM020004.1_i000_010657	188	408	220	0.982143	0.478261
HAHU002.0722.00001.C001_01473	68	274	206	0.919643	0.743682
MEMI001.0722.00001.C001_02085	127	347	220	0.982143	0.583554
GCA_902651935.1-Pla_CACRSJ010000104.1_i000_006074	64	173	109	0.486607	0.582888
METH003.0722.00001.C001_00865	112	268	156	0.696429	0.561151
NAAE001.0722.00001.C001_02543	78	277	199	0.888393	0.665552
MEMA006.0722.00001.C001_03253	140	313	173	0.772321	0.514881
NIVI001.0722.00001.C001_01739	157	380	223	0.995536	0.507973
GCA_003704575.1-Fun_QWIN01001199.1_i000_001495	1	153	152	0.678571	0.413043
SAJA001.0722.00001.C001_01768	115	273	158	0.705357	0.572464
GCA_002271885.2-Pla_CM008447.1_i000_012816	1	136	135	0.602679	0.572034
MESI002.0722.00001.C001_00351	151	313	162	0.723214	0.482143
GCA_013841245.2-Ani_CM034062.1_i000_001201	186	352	166	0.741071	0.364035
MESM001.0722.00001.C001_01482	135	352	217	0.96875	0.560724
MESM001.0722.00002.C001_01022	135	352	217	0.96875	0.560724
MESM001.0722.00003.C001_01242	135	352	217	0.96875	0.560724
GCA_014805705.1-Fun_SBJP01000141.1_i000_000910	157	374	217	0.96875	0.545226
GCA_905330535.1-Ani_CAJNVN010001507.1_i000_032389	915	1043	128	0.571429	0.105698
GCA_000238015.2-Fun_JH413860.1_i000_002510	193	374	181	0.808036	0.363454
GCA_905332185.1-Ani_CAJOBM010001915.1_i000_011497	1001	1129	128	0.571429	0.0986893
HASP047.0722.00001.C001_00361	74	274	200	0.892857	0.722022
GCA_000286095.1-Pro_CP003682.1_i000_000406	183	398	215	0.959821	0.540201
GCA_905338385.1-Ani_CAJPEV010004180.1_i000_011860	192	346	154	0.6875	0.445087
NAGR001.0722.00001.C001_00182	87	281	194	0.866071	0.666667
GCA_000182405.1-Pro_ACGJ01002928.1_i000_000155	181	412	231	1.03125	0.460159
GCA_000498735.1-Pro_AHHH01000005.1_i000_000422	181	412	231	1.03125	0.460159
MESP079.0722.00001.C001_01247	138	352	214	0.955357	0.552972
GCA_009746105.1-Pla_QEFC01004011.1_i000_022342	150	203	53	0.236607	0.111814
GCA_009746105.1-Pla_QEFC01004011.1_i000_022342	195	328	133	0.59375	0.280591
GCA_000005005.6-Pla_CM000784.4_i000_032688	72	184	112	0.5	0.36246
GCA_000005005.6-Pla_CM000784.4_i000_032688	196	270	74	0.330357	0.239482
GCA_013115895.1-Pro_JABANM010005005.1_i000_004136	3	144	141	0.629464	0.979167
CANI004.0722.00001.C001_00558	157	380	223	0.995536	0.505669
GCA_000004655.2-Pla_CM000127.1_i000_008482	119	217	98	0.4375	0.28655
GCA_001884805.1-Pla_MKKS01012425.1_i000_039835	47	198	151	0.674107	0.409214
GCA_002920065.1-Fun_PKSL01000171.1_i000_011398	1	157	156	0.696429	0.981132
GCA_015178925.1-Fun_WHVC01000008.1_i000_012278	89	298	209	0.933036	0.487179
GCA_000818735.3-Pla_JTFG03002889.1_i000_023782	47	197	150	0.669643	0.406504
GCA_001884845.1-Pla_MKKT01002983.1_i000_017001	47	198	151	0.674107	0.402667
GCA_001651475.1-Pla_CM004359.1_i000_005914	64	212	148	0.660714	0.688372
GCA_904420315.1-Pla_LR881466.1_i000_004900	64	212	148	0.660714	0.688372
GCA_013235015.1-Ani_BGPR01005086.1_i000_097143	184	337	153	0.683036	0.44868
GCA_015178925.1-Fun_WHVC01000082.1_i000_012589	109	332	223	0.995536	0.481641
GCA_001543975.1-Pro_JXTI01000005.1_i000_000311	181	412	231	1.03125	0.460159
HASA003.0722.00001.C001_03693	127	280	153	0.683036	0.518644
GCA_905250095.1-Ani_CAJNOR010013248.1_i000_058916	1	121	120	0.535714	0.677966
GCA_000346465.2-Pla_CM007654.1_i000_014261	2	161	159	0.709821	0.77561
MESI002.0722.00003.C001_00310	151	313	162	0.723214	0.482143
GCA_002920205.1-Fun_PKSM01000055.1_i000_004503	214	405	191	0.852679	0.327616
GCA_014065215.1-Fun_JACCEH010000346.1_i000_006872	227	383	156	0.696429	0.301158
GCA_902713445.1-Pla_CACTIH010009500.1_i000_054373	19	181	162	0.723214	0.895028
GCA_000699005.1-Ani_KL214726.1_i000_000149	156	311	155	0.691964	0.313131
GCA_000187875.1-Ani_GL732678.1_i000_022990	1	96	95	0.424107	0.778689
GCA_019776745.2-Pla_CM034148.1_i000_011735	1	120	119	0.53125	0.563981
HASP045.0722.00001.C001_00399	86	275	189	0.84375	0.670213
MESP007.0722.00001.C001_01915	136	353	217	0.96875	0.56658
GCA_000498715.1-Pro_AHGT01000013.1_i000_001416	181	412	231	1.03125	0.463855
GCA_017607565.1-Ani_JAANIB010001770.1_i000_001266	129	275	146	0.651786	0.523297
GCA_003676055.1-Ani_QUSF01003367.1_i000_017523	121	264	143	0.638393	0.256732
GCA_003676055.1-Ani_QUSF01003367.1_i000_017523	284	383	99	0.441964	0.177738
NAHA001.0722.00001.C001_00860	81	276	195	0.870536	0.661017
GCA_910591915.1-Fun_CAJVQA010004890.1_i000_007349	175	400	225	1.00446	0.447316
GCA_000151645.1-Fun_FN430061.1_i000_001922	227	383	156	0.696429	0.304094
GCA_001191645.1-Fun_AJIL01000017.1_i000_003205	1	157	156	0.696429	0.981132
GCA_013400195.1-Ani_VXBL01005102.1_i000_007068	61	227	166	0.741071	0.396181
GCA_014065205.1-Fun_JACCEG010000238.1_i000_004110	225	384	159	0.709821	0.30814
GCA_021901655.1-Fun_CM038893.1_i000_008193	1	157	156	0.696429	0.981132
GCA_021901695.1-Fun_CM038875.1_i000_008335	1	157	156	0.696429	0.981132
GCA_013399635.1-Ani_VXAQ01004441.1_i000_013643	109	271	162	0.723214	0.356044
GCA_013401275.1-Ani_VYZV01019405.1_i000_005295	115	267	152	0.678571	0.567164
GCA_000002435.2-Pro_CM018789.1_i000_000326	181	412	231	1.03125	0.463855
MEHO003.0722.00001.C001_04149	152	314	162	0.723214	0.482143
GCA_006937295.1-Pla_VIBQ01000014.1_i000_023131	182	358	176	0.785714	0.109794
GCA_013396695.1-Ani_VWZD01009476.1_i000_009867	1	154	153	0.683036	0.470769
GCA_002920205.1-Fun_PKSM01000337.1_i000_012939	1	148	147	0.65625	0.97351
GCA_013389825.1-Ani_VWPW01030274.1_i000_012447	115	267	152	0.678571	0.567164
HAXA001.0722.00001.C001_00226	90	280	190	0.848214	0.633333
MEHA001.0722.00001.C001_00559	128	308	180	0.803571	0.571429
HAAL003.0722.00001.C001_03419	128	281	153	0.683036	0.515152
GCA_010077935.1-Ani_VUKX01003200.1_i000_003276	97	249	152	0.678571	0.608
NASP004.0722.00001.C001_00382	77	275	198	0.883929	0.680412
HANO001.0722.00001.C001_01851	77	274	197	0.879464	0.711191
GCA_006381635.2-Pla_VEPZ02001109.1_i000_042008	117	307	190	0.848214	0.567164
GCA_019677385.1-Fun_WSLO01005261.1_i000_012217	1	121	120	0.535714	0.234834
GCA_902705455.1-Pla_CACSHJ010000087.1_i000_005964	64	173	109	0.486607	0.582888
GCA_015852375.1-Fun_JAAAIF010003037.1_i000_005540	1	119	118	0.526786	0.813793
GCA_010078485.1-Ani_VULA01002610.1_i000_004036	115	267	152	0.678571	0.567164
GCA_011823955.1-Ani_JAAKFY010000006.1_i000_009741	159	324	165	0.736607	0.294118
GCA_000149285.1-Pla_CM000139.1_i000_007854	54	150	96	0.428571	0.303797
NAAI001.0722.00001.C001_03152	130	279	149	0.665179	0.515571
MEAE001.0722.00001.C001_00773	148	364	216	0.964286	0.438134
GCA_000733215.1-Pla_KL662175.1_i000_006254	188	348	160	0.714286	0.341151
GCA_000733215.1-Pla_KL662175.1_i000_006254	337	389	52	0.232143	0.110874
GCA_011057905.1-Fun_WUBL01000061.1_i000_008700	235	415	180	0.803571	0.350877
MELA002.0722.00001.C001_00219	151	313	162	0.723214	0.482143
NASP006.0722.00001.C001_01814	112	279	167	0.745536	0.568027
MEHA002.0722.00001.C001_00086	129	287	158	0.705357	0.504792
NAPE001.0722.00001.C001_02099	82	280	198	0.883929	0.662207
HASP061.0722.00001.C001_00946	92	249	157	0.700893	0.613281
MEMA006.0722.00002.C001_03262	153	312	159	0.709821	0.474627
GCA_000005425.2-Pla_AP008208.2_i000_006587	123	219	96	0.428571	0.249351
HASP048.0722.00001.C001_01526	77	274	197	0.879464	0.711191
GCA_020379485.1-Pla_CM035461.1_i000_071444	74	221	147	0.65625	0.585657
MEMA004.0722.00001.C001_00140	125	308	183	0.816964	0.580952
GCA_013397565.1-Ani_VZRJ01011332.1_i000_010858	115	238	123	0.549107	0.269737
GCA_013397565.1-Ani_VZRJ01011332.1_i000_010858	253	325	72	0.321429	0.157895
GCA_014466195.1-Ani_CM025385.1_i000_017097	94	158	64	0.285714	0.177285
GCA_014466195.1-Ani_CM025385.1_i000_017097	211	271	60	0.267857	0.166205
NAPH001.0722.00001.C001_01039	109	277	168	0.75	0.6
MEBU001.0722.00001.C001_01657	147	311	164	0.732143	0.486647
GCA_015178925.1-Fun_WHVC01000002.1_i000_004302	4	163	159	0.709821	0.514563
HALA002.0722.00001.C001_03187	120	282	162	0.723214	0.543624
GCA_019202795.1-Pla_CM032913.1_i000_005815	64	191	127	0.566964	0.463504
GCA_019202805.1-Pla_CM032900.1_i000_005674	64	191	127	0.566964	0.463504
NASP005.0722.00001.C001_01286	86	281	195	0.870536	0.645695
CAME002.0722.00001.C001_01585	171	333	162	0.723214	0.45
GCA_000827895.1-Ani_JWZT01003622.1_i000_009168	82	179	97	0.433036	0.535912
GCA_003336725.1-Ani_JOJR01015871.1_i000_028931	1	157	156	0.696429	0.962963
GCA_000510995.2-Pla_KQ134137.1_i000_002418	2	165	163	0.727679	0.981928
MEFL001.0722.00001.C001_01011	151	312	161	0.71875	0.479167
GCA_002738545.1-Ani_NTJE010111337.1_i000_005455	171	324	153	0.683036	0.469325
GCA_018397855.1-Fun_JAGFBS010000010.1_i000_000809	186	236	50	0.223214	0.0943396
GCA_018397855.1-Fun_JAGFBS010000010.1_i000_000809	259	387	128	0.571429	0.241509
NASP001.0722.00001.C001_00083	81	276	195	0.870536	0.656566
HASP062.0722.00001.C001_01574	130	275	145	0.647321	0.516014
NAMA001.0722.00001.C001_00673	93	294	201	0.897321	0.626168
GCA_000757645.3-Ani_AZBU02000002.1_i000_010150	1	127	126	0.5625	0.763636
METH002.0722.00001.C001_01214	151	311	160	0.714286	0.47619
NAPA001.0722.00001.C001_00436	111	275	164	0.732143	0.563574
GCA_000180755.1-Ani_ADBV01000453.1_i000_001856	1	120	119	0.53125	0.397993
ARVE002.0722.00001.C001_01312	56	257	201	0.897321	0.776062
NABA001.0722.00001.C001_03080	86	279	193	0.861607	0.665517
GCA_000512255.2-Pla_CM008459.1_i000_014498	39	233	194	0.866071	0.593272
MEAR001.0722.00001.C001_02894	122	287	165	0.736607	0.555556
GCA_019649035.1-Ani_BMAT01000236.1_i000_001278	187	373	186	0.830357	0.339416
HATU001.0722.00001.C001_02105	126	280	154	0.6875	0.522034
GCA_015680625.1-Fun_JAAAXW010000267.1_i000_005748	1	107	106	0.473214	0.572973
GCA_003942215.1-Fun_RSCD01000016.1_i000_002937	200	366	166	0.741071	0.294326
NASP007.0722.00001.C001_03544	130	293	163	0.727679	0.539735
GCA_014058105.1-Pla_JACGCM010002299.1_i000_028299	1	121	120	0.535714	0.441176
MEME001.0722.00001.C001_02227	147	312	165	0.736607	0.482456
GCA_016256075.1-Fun_SDVU01000236.1_i000_000807	316	511	195	0.870536	0.215947
GEAH001.0722.00001.C001_01820	52	258	206	0.919643	0.79845
GCA_015178925.1-Fun_WHVC01000016.1_i000_002927	7	171	164	0.732143	0.506173
GCA_905397895.1-Ani_CAJPWZ010002369.1_i000_049281	187	375	188	0.839286	0.384458
GCA_019202805.1-Pla_CM032907.1_i000_034629	30	197	167	0.745536	0.839196
NASU001.0722.00001.C001_02346	95	275	180	0.803571	0.629371
NASU001.0722.00002.C001_01324	95	275	180	0.803571	0.629371
GCA_003614675.1-Fun_ML003383.1_i000_006423	181	267	86	0.383929	0.178794
GCA_003614675.1-Fun_ML003383.1_i000_006423	264	369	105	0.46875	0.218295
GCA_014058105.1-Pla_JACGCM010000252.1_i000_010013	10	188	178	0.794643	0.264487
GCA_900617965.1-Ani_UYRV01010245.1_i000_003878	1	116	115	0.513393	0.46
GCA_900617965.1-Ani_UYRV01010245.1_i000_003878	112	155	43	0.191964	0.172
GCA_000209065.1-Pro_CH473405.1_i000_008476	190	387	197	0.879464	0.509044
NASA002.0722.00001.C001_00875	86	279	193	0.861607	0.656463
MESP004.0722.00001.C001_00258	152	313	161	0.71875	0.479167
GCA_000797555.1-Ani_KN551414.1_i000_007671	1	121	120	0.535714	0.655738
GCA_000512085.1-Pro_ASPP01008386.1_i000_011433	2	182	180	0.803571	0.474934
GCA_002352805.1-Ani_KZ349016.1_i000_012424	198	357	159	0.709821	0.439227
GCA_013399305.1-Ani_VXAI01000727.1_i000_012461	115	278	163	0.727679	0.347548
HABO001.0722.00001.C001_01527	131	278	147	0.65625	0.517606
GCA_003025155.1-Fun_KZ679130.1_i000_004540	198	364	166	0.741071	0.362445
GCA_000733195.1-Pla_CM002869.1_i000_002152	65	170	105	0.46875	0.0565428
GCA_010108815.1-Ani_QWKW01008341.1_i000_004177	104	194	90	0.401786	0.463918
GCA_016835505.1-Ani_CM029061.1_i000_006834	244	434	190	0.848214	0.322581
HASP052.0722.00001.C001_02452	119	274	155	0.691964	0.51495
GCA_000757645.3-Ani_AZBU02000002.1_i000_010500	1	168	167	0.745536	0.707627
NAVE001.0722.00001.C001_01936	84	276	192	0.857143	0.66436
GCA_015852605.2-Pla_CM027586.2_i000_027573	180	342	162	0.723214	0.469565
GCA_000165425.1-Pro_CT868008.1_i000_005186	181	387	206	0.919643	0.452747
GCA_905250095.1-Ani_CAJNOR010004571.1_i000_040299	185	336	151	0.674107	0.448071
METE004.0722.00001.C001_00228	185	351	166	0.741071	0.466292
GCA_008009225.1-Pla_CM017761.1_i000_000769	93	203	110	0.491071	0.443548
GCA_015178925.1-Fun_WHVC01000016.1_i000_002818	1	146	145	0.647321	0.496575
MECO001.0722.00001.C001_01837	88	237	149	0.665179	0.605691
GCA_014058105.1-Pla_JACGCM010001067.1_i000_031474	1	79	78	0.348214	0.896552
GCA_002870075.2-Pla_CM022520.1_i000_009479	33	232	199	0.888393	0.846809
MEBA002.0722.00003.C001_00528	155	309	154	0.6875	0.458333
HASP057.0722.00001.C001_01155	122	285	163	0.727679	0.567944
MEBA002.0722.00001.C001_02230	155	309	154	0.6875	0.458333
ACBO002.0722.00001.C001_00113	110	261	151	0.674107	0.576336
GCA_002600585.1-Pro_MIGC01005091.1_i000_008793	207	395	188	0.839286	0.474747
GCA_013368555.1-Fun_JAACJN010000015.1_i000_003525	188	348	160	0.714286	0.291439
GCA_013368555.1-Fun_JAACJN010000015.1_i000_003525	345	415	70	0.3125	0.127505
HALO001.0722.00001.C001_03448	79	276	197	0.879464	0.676976
NASP008.0722.00001.C001_00819	119	280	161	0.71875	0.545763
GCA_015178925.1-Fun_WHVC01000011.1_i000_001304	4	163	159	0.709821	0.504762
HASP044.0722.00001.C001_01610	79	275	196	0.875	0.695035
GCA_018994095.1-Fun_JAEMWZ010000091.1_i000_018506	181	378	197	0.879464	0.305901
HASP009.0722.00001.C001_02094	115	277	162	0.723214	0.566434
GCA_000803305.1-Ani_JPKZ01002282.1_i000_011742	190	312	122	0.544643	0.271715
GCA_000803305.1-Ani_JPKZ01002282.1_i000_011742	307	376	69	0.308036	0.153675
GCA_016098025.1-Fun_JAAAIU010001435.1_i000_002329	314	458	144	0.642857	0.31441
GCA_002786265.1-Pla_KZ451951.1_i000_008718	117	275	158	0.705357	0.570397
HASP041.0722.00001.C001_02904	118	273	155	0.691964	0.553571
GCA_002754855.1-Ani_MRZV01001178.1_i000_002480	180	395	215	0.959821	0.444215
GCA_001268165.1-Fun_CVQI01033718.1_i000_015915	193	368	175	0.78125	0.443038
GCA_000512255.2-Pla_CM008456.1_i000_004172	95	206	111	0.495536	0.538835
GCA_013401255.1-Ani_WBNH01011961.1_i000_012878	115	240	125	0.558036	0.269397
GCA_013401255.1-Ani_WBNH01011961.1_i000_012878	231	304	73	0.325893	0.157328
GCA_019924875.1-Fun_JAHFYK010008765.1_i000_022703	146	298	152	0.678571	0.510067
MESP023.0722.00001.C001_01570	158	366	208	0.928571	0.51358
GCA_001417885.1-Fun_AP012217.1_i000_003352	64	268	204	0.910714	0.488038
HADE001.0722.00001.C001_02629	126	277	151	0.674107	0.526132
MELA004.0722.00001.C001_00314	157	369	212	0.946429	0.514563
GCA_013397635.1-Ani_VYZG01003806.1_i000_011113	143	194	51	0.227679	0.119159
GCA_013397635.1-Ani_VYZG01003806.1_i000_011113	188	299	111	0.495536	0.259346
GCA_000091025.4-Fun_AE016817.6_i000_001788	81	275	194	0.866071	0.522911
GCA_000968835.1-Fun_CP002708.1_i000_001788	81	275	194	0.866071	0.522911
GCA_017911155.1-Fun_JAEFCI010007051.1_i000_004499	1	120	119	0.53125	0.515152
GCA_019845555.1-Pla_CM034081.1_i000_013084	68	216	148	0.660714	0.682028
GCA_000376725.2-Ani_KZ309475.1_i000_017138	26	103	77	0.34375	0.313008
MEFO003.0722.00001.C001_02648	75	282	207	0.924107	0.723776
HASP002.0722.00001.C001_01099	82	274	192	0.857143	0.688172
MESP046.0722.00001.C001_01593	147	354	207	0.924107	0.553476
GCA_900618505.1-Ani_UZAH01029990.1_i000_017341	188	349	161	0.71875	0.344754
HAWA001.0722.00001.C001_01698	121	281	160	0.714286	0.561404
GCA_006247105.1-Pro_CM016926.1_i000_002321	177	409	232	1.03571	0.482328
HAMU001.0722.00001.C001_02249	80	272	192	0.857143	0.688172
HASP032.0722.00001.C001_02901	80	272	192	0.857143	0.688172
GCA_000478725.1-Pla_KI517953.1_i000_026195	59	267	208	0.928571	0.64
GCA_017607545.1-Ani_JAANIC010001043.1_i000_001025	171	310	139	0.620536	0.377717
MESP010.0722.00001.C001_01723	183	365	182	0.8125	0.443902
HASP014.0722.00001.C001_00299	116	271	155	0.691964	0.547703
HASP035.0722.00001.C001_00202	61	276	215	0.959821	0.719064
HASP040.0722.00001.C001_01183	128	284	156	0.696429	0.534247
GCA_010458925.1-Pla_CM021239.1_i000_033561	2	143	141	0.629464	0.432515
MESP002.0722.00001.C001_03294	154	309	155	0.691964	0.46131
SASP001.0722.00001.C001_02191	129	284	155	0.691964	0.521886
GCA_018107945.1-Pla_JACEIK010007073.1_i000_044573	110	196	86	0.383929	0.358333
GCA_019924435.1-Fun_JAHFXP010005924.1_i000_016254	1	138	137	0.611607	0.477352
HASP022.0722.00001.C001_03088	84	273	189	0.84375	0.675
HASP025.0722.00001.C001_01541	121	272	151	0.674107	0.541219
HASP037.0722.00001.C001_00571	110	298	188	0.839286	0.598726
HASP011.0722.00001.C001_00184	123	279	156	0.696429	0.518272
HAPE003.0722.00001.C001_04419	115	274	159	0.709821	0.535354
HALA001.0722.00001.C001_01062	116	271	155	0.691964	0.54007
GCA_001432165.1-Fun_LGUB01000851.1_i000_002589	284	461	177	0.790179	0.383117
GCA_001417835.1-Fun_AP014603.1_i000_003331	65	265	200	0.892857	0.483092
GCA_003260675.2-Pla_QGKX02002183.1_i000_041511	1	119	118	0.526786	0.455598
MECH001.0722.00001.C001_00677	72	270	198	0.883929	0.692308
GCA_000230595.3-Fun_AFBI03000004.1_i000_002437	12	208	196	0.875	0.867257
MEPA005.0722.00001.C001_01604	71	232	161	0.71875	0.649194
SASP032.0722.00001.C001_01414	75	274	199	0.888393	0.715827
HALI005.0722.00001.C001_02583	138	290	152	0.678571	0.517007
HASI001.0722.00001.C001_01190	113	273	160	0.714286	0.571429
HAMA003.0722.00001.C001_00784	113	273	160	0.714286	0.571429
HAMA003.0722.00002.C001_00369	113	273	160	0.714286	0.571429
GCA_014058105.1-Pla_JACGCM010002660.1_i000_006019	3	90	87	0.388393	0.966667
GCA_013401275.1-Ani_VYZV01032024.1_i000_008829	178	304	126	0.5625	0.414474
GCA_014058105.1-Pla_JACGCM010001183.1_i000_030147	1	121	120	0.535714	0.882353
GCA_001678115.1-Fun_LVWM01000089.1_i000_006136	182	339	157	0.700893	0.459064
GCA_000209485.1-Fun_ABGB01000015.1_i000_003513	147	327	180	0.803571	0.518732
MEHO001.0722.00001.C001_00051	149	312	163	0.727679	0.445355
GCA_000231115.1-Fun_JH370147.1_i000_001726	148	364	216	0.964286	0.538653
HAAE003.0722.00001.C001_01769	92	249	157	0.700893	0.613281
GCA_003573695.1-Pla_CM010718.1_i000_015946	187	343	156	0.696429	0.453488
GCA_020623625.1-Fun_CM036082.1_i000_002211	113	322	209	0.933036	0.435417
GCA_900491785.1-Fun_UFAJ01000227.1_i000_000962	113	322	209	0.933036	0.435417
GCA_021605095.1-Ani_BPLR01009570.1_i000_036594	188	287	99	0.441964	0.18
GCA_021605095.1-Ani_BPLR01009570.1_i000_036594	278	384	106	0.473214	0.192727
GCA_002920065.1-Fun_PKSL01000028.1_i000_003648	267	347	80	0.357143	0.137221
GCA_002920065.1-Fun_PKSL01000028.1_i000_003648	379	482	103	0.459821	0.176672
MECO002.0722.00001.C001_02058	156	372	216	0.964286	0.533333
HAEZ001.0722.00001.C001_01078	138	296	158	0.705357	0.50641
GCA_000599465.2-Ani_AWGT02000418.1_i000_013505	212	371	159	0.709821	0.305182
MEOR003.0722.00001.C001_01864	150	313	163	0.727679	0.476608
MESO001.0722.00001.C001_01341	118	277	159	0.709821	0.535354
GCA_904845875.1-Pla_CAJGYO010000012.1_i000_046085	120	201	81	0.361607	0.229462
GCA_019677385.1-Fun_WSLO01005262.1_i000_012218	1	108	107	0.477679	0.393382
GCA_006783055.1-Ani_VCRD01007018.1_i000_021245	7	154	147	0.65625	0.924528
GCA_019924185.1-Fun_JAHFXE010004762.1_i000_018278	1	123	122	0.544643	0.448529
GCA_019924185.1-Fun_JAHFXE010000951.1_i000_007891	1	123	122	0.544643	0.448529
HATI002.0722.00001.C001_00340	56	274	218	0.973214	0.781362
HAHA004.0722.00001.C001_01255	131	279	148	0.660714	0.494983
HAUR001.0722.00001.C001_00195	84	275	191	0.852679	0.679715
GCA_018855395.1-Fun_JABAJW010009276.1_i000_007791	222	384	162	0.723214	0.349138
HASP026.0722.00001.C001_02021	116	273	157	0.700893	0.564748
GCA_017607545.1-Ani_JAANIC010001043.1_i000_000995	1	118	117	0.522321	0.536697
HAPE002.0722.00001.C001_00097	127	281	154	0.6875	0.522034
HADO001.0722.00001.C001_01339	113	269	156	0.696429	0.561151
MEFO001.0722.00001.C001_00329	159	368	209	0.933036	0.5199
MEFO001.0722.00002.C001_02061	159	368	209	0.933036	0.5199
HAPA001.0722.00001.C001_03962	84	275	191	0.852679	0.677305
GCA_001268145.1-Fun_CVQH01008002.1_i000_005012	193	334	141	0.629464	0.306522
GCA_001268145.1-Fun_CVQH01008002.1_i000_005012	330	369	39	0.174107	0.0847826
HASP063.0722.00001.C001_01125	126	281	155	0.691964	0.521886
GCA_018858115.1-Fun_JABCKT010000015.1_i000_001052	186	349	163	0.727679	0.332653
GCA_902206195.3-Pla_CABITT030000004.1_i000_010736	3	181	178	0.794643	0.967391
HASU001.0722.00001.C001_01600	111	272	161	0.71875	0.579137
HASU001.0722.00002.C001_01598	111	272	161	0.71875	0.579137
HALA003.0722.00001.C001_01621	128	275	147	0.65625	0.486755
GCA_017607455.1-Ani_JAANHZ010000559.1_i000_004099	211	321	110	0.491071	0.244989
GCA_017607455.1-Ani_JAANHZ010000559.1_i000_004099	318	380	62	0.276786	0.138085
HARA001.0722.00001.C001_00921	118	275	157	0.700893	0.558719
GCA_902206195.3-Pla_CABITT030000004.1_i000_010737	1	175	174	0.776786	0.84878
GCA_022201045.1-Pla_CM039162.1_i000_004641	993	1061	68	0.303571	0.0593886
GCA_022201045.1-Pla_CM039162.1_i000_004641	1057	1134	77	0.34375	0.0672489
SARU002.0722.00001.C001_02126	118	280	162	0.723214	0.556701
GCA_000147415.1-Pla_GL433839.1_i000_002446	114	215	101	0.450893	0.31962
GCA_017607455.1-Ani_JAANHZ010000576.1_i000_002614	48	208	160	0.714286	0.519481
HASP010.0722.00001.C001_00833	83	279	196	0.875	0.655518
GCA_001646965.1-Fun_LVCJ01000060.1_i000_009088	190	354	164	0.732143	0.341667
GCA_019924875.1-Fun_JAHFYK010010085.1_i000_023663	1	113	112	0.5	0.713376
GCA_019924875.1-Fun_JAHFYK010010087.1_i000_023664	1	113	112	0.5	0.713376
GCA_011745865.1-Pla_VYZZ01000998.1_i000_005071	49	191	142	0.633929	0.706468
HASP042.0722.00001.C001_01083	115	273	158	0.705357	0.560284
GCA_900618415.1-Ani_UZAM01007789.1_i000_003507	187	344	157	0.700893	0.45245
HASA005.0722.00001.C001_02472	124	271	147	0.65625	0.517606
FEPL001.0722.00001.C001_02164	36	254	218	0.973214	0.851562
GCA_000331365.3-Pla_AMZH03015451.1_i000_040184	112	272	160	0.714286	0.352423
GCA_000818735.3-Pla_JTFG03002109.1_i000_019560	112	272	160	0.714286	0.352423
GCA_001884805.1-Pla_MKKS01000202.1_i000_002460	112	272	160	0.714286	0.352423
GCA_001884845.1-Pla_MKKT01000513.1_i000_004461	112	272	160	0.714286	0.352423
GCA_000760515.2-Fun_JMKJ01000592.1_i000_003046	52	158	106	0.473214	0.263682
GCA_000760515.2-Fun_JMKJ01000592.1_i000_003046	155	247	92	0.410714	0.228856
GCA_001268145.1-Fun_CVQH01017779.1_i000_008873	1	145	144	0.642857	0.350365
HASP049.0722.00001.C001_01973	134	277	143	0.638393	0.491409
ARFU001.0722.00001.C001_02167	77	256	179	0.799107	0.693798
GCA_001268165.1-Fun_CVQI01001336.1_i000_001450	1	145	144	0.642857	0.393443
HASP004.0722.00001.C001_03169	114	273	159	0.709821	0.569892
GCA_003947045.1-Fun_NIZV01000036.1_i000_010172	193	412	219	0.977679	0.433663
GCA_003845795.1-Ani_CM011678.1_i000_004386	1	141	140	0.625	0.909091
HALI001.0722.00001.C001_03437	117	275	158	0.705357	0.526667
HASA006.0722.00002.C001_01596	82	277	195	0.870536	0.689046
HAHA005.0722.00001.C001_00935	127	275	148	0.660714	0.515679
HATA001.0722.00001.C001_01488	114	273	159	0.709821	0.567857
HASO002.0722.00001.C001_02287	141	300	159	0.709821	0.476048
GCA_002286715.1-Fun_NSJX01000001.1_i000_000659	102	269	167	0.745536	0.611722
GCA_002870075.2-Pla_CM022519.1_i000_005568	1	27	26	0.116071	0.356164
GCA_002870075.2-Pla_CM022519.1_i000_005568	22	69	47	0.209821	0.643836
NASU002.0722.00001.C001_01525	80	275	195	0.870536	0.698925
GCA_020142125.1-Ani_CM034701.1_i000_001484	190	286	96	0.428571	0.176471
GCA_020142125.1-Ani_CM034701.1_i000_001484	299	399	100	0.446429	0.183824
GCA_004679275.1-Fun_SEOQ01000906.1_i000_011227	185	349	164	0.732143	0.29078
HARO001.0722.00001.C001_00815	126	272	146	0.651786	0.512281
GCA_905250095.1-Ani_CAJNOR010007206.1_i000_049145	186	321	135	0.602679	0.420561
HAPE001.0722.00001.C001_00483	79	277	198	0.883929	0.6875
GCA_016584275.1-Fun_PUHV01000041.1_i000_003189	18	214	196	0.875	0.538462
GCA_003568945.1-Pro_BDIP01000689.1_i000_003555	1	148	147	0.65625	0.525
GCA_003568945.1-Pro_BDIP01001293.1_i000_005498	1	148	147	0.65625	0.525
GCA_003568945.1-Pro_BDIP01002074.1_i000_007390	1	148	147	0.65625	0.525
HASP058.0722.00001.C001_03473	128	278	150	0.669643	0.510204
HASP059.0722.00001.C001_03403	131	281	150	0.669643	0.501672
MEPA004.0722.00001.C001_02804	114	282	168	0.75	0.585366
HAUT001.0722.00001.C001_00411	79	274	195	0.870536	0.698925
HARU004.0722.00001.C001_03707	117	274	157	0.700893	0.532203
HAMA001.0722.00001.C001_00856	133	277	144	0.642857	0.496552
GCA_009835225.1-Ani_VUJU01005612.1_i000_018900	31	95	64	0.285714	0.206452
GCA_009835225.1-Ani_VUJU01005612.1_i000_018900	74	195	121	0.540179	0.390323
HAHI002.0722.00001.C001_01511	115	273	158	0.705357	0.566308
GCA_016584165.1-Fun_PUHT01000290.1_i000_002470	71	267	196	0.875	0.470024
HARU002.0722.00001.C001_02349	118	266	148	0.660714	0.530466
GCA_905332325.1-Ani_CAJOBW010074004.1_i000_041368	1	106	105	0.46875	0.65625
GCA_905332305.1-Ani_CAJOBU010008682.1_i000_028144	1	106	105	0.46875	0.65625
NALO001.0722.00001.C001_01109	118	275	157	0.700893	0.548951
GCA_005223365.2-Pla_SPHZ02000007.1_i000_021943	52	138	86	0.383929	0.292517
HARU001.0722.00002.C001_02329	117	274	157	0.700893	0.558719
HARU001.0722.00001.C001_02088	117	274	157	0.700893	0.558719
GCA_905331535.1-Ani_CAJNZB010000875.1_i000_032404	149	265	116	0.517857	0.363636
NABR001.0722.00001.C001_01136	127	275	148	0.660714	0.517483
GCA_000785585.1-Fun_JSEJ01000042.1_i000_006822	190	400	210	0.9375	0.456522
GCA_003573695.1-Pla_PUWZ01028491.1_i000_049449	1	113	112	0.5	0.516129
GCA_003573695.1-Pla_PUWZ01028491.1_i000_049449	108	178	70	0.3125	0.322581
HASA001.0722.00001.C001_03179	122	277	155	0.691964	0.547703
MESP014.0722.00001.C001_00694	158	371	213	0.950893	0.529851
GCA_900618415.1-Ani_UZAM01008124.1_i000_004087	18	129	111	0.495536	0.630682
MESU001.0722.00002.C001_01574	158	371	213	0.950893	0.529851
GCA_013467485.1-Pla_CM025283.1_i000_024812	1	119	118	0.526786	0.409722
HALI002.0722.00001.C001_02235	87	278	191	0.852679	0.638796
GCA_013487665.1-Pla_CM025192.1_i000_024353	1	119	118	0.526786	0.452107
GCA_002135145.1-Ani_MUJZ01005909.1_i000_001273	1	105	104	0.464286	0.512315
GCA_900659725.1-Ani_CAACVG010009229.1_i000_012679	63	120	57	0.254464	0.203571
GCA_000003835.1-Fun_CH408077.1_i000_001751	133	301	168	0.75	0.531646
HASP053.0722.00001.C001_00272	86	276	190	0.848214	0.671378
CAME003.0722.00001.C001_01119	169	334	165	0.736607	0.458333
GCA_015342405.1-Fun_JACYCF010000009.1_i000_011311	187	320	133	0.59375	0.249531
GCA_015342405.1-Fun_JACYCF010000009.1_i000_011311	316	387	71	0.316964	0.133208
GCA_000825725.1-Fun_CDGI01000041.1_i000_002568	48	147	99	0.441964	0.430435
HATR001.0722.00001.C001_00371	141	302	161	0.71875	0.509494
GCA_013487665.1-Pla_CM025186.1_i000_012715	1	119	118	0.526786	0.405498
GCA_019925215.1-Fun_JAHFYS010014573.1_i000_017979	1	78	77	0.34375	0.356481
GCA_019925215.1-Fun_JAHFYS010014579.1_i000_017984	1	78	77	0.34375	0.356481
MEEV001.0722.00001.C001_02268	143	315	172	0.767857	0.525994
HASA006.0722.00001.C001_01871	130	277	147	0.65625	0.519435
GCA_017607525.1-Ani_JAANIA010000477.1_i000_000926	37	225	188	0.839286	0.578462
MESU001.0722.00001.C001_01177	157	371	214	0.955357	0.532338
HAAL001.0722.00001.C001_02327	119	271	152	0.678571	0.542857
MEZI001.0722.00001.C001_02510	158	319	161	0.71875	0.468023
ARPR002.0722.00001.C001_00709	42	261	219	0.977679	0.829545
MEBO004.0722.00001.C001_01672	134	269	135	0.602679	0.472028
MESP088.0722.00001.C001_01135	150	351	201	0.897321	0.543243
GCA_000259595.1-Fun_AHIQ01000018.1_i000_000235	54	215	161	0.71875	0.74537
HAVO001.0722.00001.C001_01650	120	271	151	0.674107	0.539286
METH001.0722.00001.C001_01189	150	350	200	0.892857	0.540541
GCA_015680905.1-Pla_CM027382.1_i000_025638	16	158	142	0.633929	0.898734
GCA_007844105.2-Pla_CM017575.2_i000_021667	177	261	84	0.375	0.156716
GCA_007844105.2-Pla_CM017575.2_i000_021667	258	364	106	0.473214	0.197761
GCA_011745865.1-Pla_VYZZ01011883.1_i000_033643	1	125	124	0.553571	0.551111
HASA004.0722.00001.C001_00338	118	276	158	0.705357	0.524917
GCA_008124465.1-Pla_CM017872.1_i000_000365	488	573	85	0.379464	0.138436
GCA_000194455.1-Pro_CP002173.1_i000_000214	181	405	224	1	0.543689
GCA_015342795.1-Ani_CM027187.1_i000_007108	1	118	117	0.522321	0.661017
GCA_013398735.1-Ani_VZSV01000449.1_i000_009212	1	106	105	0.46875	0.441176
GCA_905332295.1-Ani_CAJOBT010004589.1_i000_021719	1	102	101	0.450893	0.60119
HALU001.0722.00001.C001_02641	125	275	150	0.669643	0.524476
GCA_905221625.1-Pro_CAJNDU010043274.1_i000_030638	1	111	110	0.491071	0.478261
GCA_013398345.1-Ani_WBNA01000666.1_i000_012441	1	106	105	0.46875	0.441176
MEMA003.0722.00001.C001_01577	150	354	204	0.910714	0.552846
MESP045.0722.00001.C001_01111	150	354	204	0.910714	0.552846
HAME001.0722.00001.C001_01769	118	269	151	0.674107	0.541219
HAME001.0722.00002.C001_02390	118	269	151	0.674107	0.541219
ARSU002.0722.00001.C001_00235	51	263	212	0.946429	0.80303
HAFO001.0722.00001.C001_00579	124	269	145	0.647321	0.525362
HAFO001.0722.00002.C001_00571	124	269	145	0.647321	0.525362
GCA_000150455.3-Pro_KE123540.1_i000_005990	1	96	95	0.424107	0.420354
HASP020.0722.00001.C001_01304	137	294	157	0.700893	0.498413
HASP060.0722.00001.C001_00110	136	295	159	0.709821	0.496875
GCA_905332115.1-Ani_CAJOBH010009913.1_i000_021597	19	150	131	0.584821	0.71978
GCA_001854445.2-Fun_CP015058.1_i000_003432	63	256	193	0.861607	0.475369
GCA_003046395.2-Pla_CM009690.2_i000_003062	473	608	135	0.602679	0.205167
GCA_905332125.1-Ani_CAJOBJ010326978.1_i000_067925	1	96	95	0.424107	0.590062
GCA_905332115.1-Ani_CAJOBH010223388.1_i000_056623	1	96	95	0.424107	0.58642
GCA_905332135.1-Ani_CAJOBI010009116.1_i000_018726	1	96	95	0.424107	0.58642
HADE002.0722.00004.C001_00838	112	273	161	0.71875	0.579137
HADE002.0722.00001.C001_02180	117	273	156	0.696429	0.561151
HADE002.0722.00003.C001_01563	112	273	161	0.71875	0.579137
HAGI002.0722.00002.C001_01683	117	268	151	0.674107	0.539286
GCA_016771965.1-Pla_CM028702.1_i000_082380	8	108	100	0.446429	0.518135
HAGI002.0722.00001.C001_01659	120	268	148	0.660714	0.528571
GCA_905332135.1-Ani_CAJOBI010329702.1_i000_074225	1	106	105	0.46875	0.617647
MELA003.0722.00001.C001_01738	39	271	232	1.03571	0.837545
GCA_003024255.1-Pla_CM009676.1_i000_025465	200	316	116	0.517857	0.263039
GCA_015852495.1-Fun_JAAAIK010000813.1_i000_010190	1	88	87	0.388393	0.310714
GCA_015852495.1-Fun_JAAAIK010000813.1_i000_010190	82	168	86	0.383929	0.307143
GCA_009176605.1-Ani_SEYY01013742.1_i000_007714	165	295	130	0.580357	0.261044
GCA_009176605.1-Ani_SEYY01013742.1_i000_007714	288	359	71	0.316964	0.14257
GCA_001974805.1-Pla_AWWV01014414.1_i000_024513	1	54	53	0.236607	0.963636
GCA_000797555.1-Ani_KN609667.1_i000_021458	1	50	49	0.21875	0.228972
GCA_013399675.1-Ani_VXAT01010386.1_i000_006593	61	225	164	0.732143	0.394231
GCA_905331515.1-Ani_CAJNZC010000729.1_i000_027531	422	522	100	0.446429	0.169779
GCA_022432385.1-Fun_JAJJXC010000001.1_i000_000010	102	232	130	0.580357	0.451389
MEMA005.0722.00001.C001_00541	70	275	205	0.915179	0.716783
HADE002.0722.00002.C001_01157	90	271	181	0.808036	0.651079
GCA_015178925.1-Fun_WHVC01000031.1_i000_007068	146	330	184	0.821429	0.367265
HAJE001.0722.00001.C001_01549	106	270	164	0.732143	0.594203
MEPA006.0722.00001.C001_02151	160	369	209	0.933036	0.514778
GCA_020921065.1-Pla_CM037158.1_i000_020719	52	178	126	0.5625	0.427119
GCA_020921065.1-Pla_CM037158.1_i000_020719	174	226	52	0.232143	0.176271
GCA_002271895.2-Pla_CM008435.1_i000_014039	1	125	124	0.553571	0.464419
GCA_021029035.1-Pro_JAFCAH010000114.1_i000_001775	460	554	94	0.419643	0.15235
GCA_021029035.1-Pro_JAFCAH010000114.1_i000_001775	551	600	49	0.21875	0.0794165
MESP053.0722.00001.C001_01041	158	365	207	0.924107	0.5175
GCA_002249935.1-Ani_KZ269977.1_i000_000341	203	333	130	0.580357	0.284464
GCA_014058105.1-Pla_JACGCM010002299.1_i000_028298	84	152	68	0.303571	0.447368
GCA_002197005.1-Ani_CM008040.1_i000_018494	1	122	121	0.540179	0.991803
GCA_003692655.1-Ani_QRBI01000106.1_i000_009145	44	123	79	0.352679	0.245342
GCA_013358455.1-Pla_JABWDY010008988.1_i000_006716	2	61	59	0.263393	0.475806
GCA_000722935.2-Pla_KN643869.1_i000_005429	170	332	162	0.723214	0.326613
GCA_905332125.1-Ani_CAJOBJ010013102.1_i000_020271	19	142	123	0.549107	0.866197
MEFE001.0722.00001.C001_01213	110	351	241	1.07589	0.671309
GCA_001432165.1-Fun_LGUB01001126.1_i000_000083	16	199	183	0.816964	0.809735
MEBO001.0722.00001.C001_00532	141	269	128	0.571429	0.442907
GCA_015178925.1-Fun_WHVC01000003.1_i000_006421	8	202	194	0.866071	0.496164
GCA_003260675.2-Pla_QGKX02001347.1_i000_018468	7	90	83	0.370536	0.584507
GCA_003260655.2-Pla_QGKV02001556.1_i000_060514	7	90	83	0.370536	0.584507
HARU003.0722.00001.C001_01398	113	274	161	0.71875	0.559028
GCA_000004985.1-Pro_GG738893.1_i000_010526	163	348	185	0.825893	0.303279
GCA_000372725.1-Pro_KB865350.1_i000_017104	182	328	146	0.651786	0.396739
GCA_003426235.1-Fun_NQIM01000025.1_i000_004456	45	268	223	0.995536	0.707937
GCA_010194725.1-Pro_WXXK01003404.1_i000_015773	194	337	143	0.638393	0.331787
GCA_001235845.1-Pro_LFNC01000001.1_i000_000407	153	399	246	1.09821	0.465028
GCA_905250035.1-Ani_CAJNOE010000051.1_i000_007776	20	87	67	0.299107	0.261719
GCA_013396955.1-Ani_VWZN01002372.1_i000_001389	128	234	106	0.473214	0.287263
GCA_910591605.1-Ani_CAJVCH010005229.1_i000_000964	65	105	40	0.178571	0.380952
GCA_001643675.2-Pro_LSRY02000014.1_i000_002399	3	139	136	0.607143	0.650718
HACE001.0722.00001.C001_00825	76	270	194	0.866071	0.705455
GCA_017309695.1-Pro_RCMJ01003620.1_i000_029561	1	120	119	0.53125	0.361702
GCA_003573695.1-Pla_PUWZ01001678.1_i000_042903	6	109	103	0.459821	0.488152
GCA_003573695.1-Pla_PUWZ01001678.1_i000_042903	100	168	68	0.303571	0.322275
MEAR003.0722.00001.C001_01503	166	381	215	0.959821	0.505882
GCA_015832365.1-Ani_JACWZX010000789.1_i000_017154	186	314	128	0.571429	0.294931
GCA_015832365.1-Ani_JACWZX010000789.1_i000_017154	306	385	79	0.352679	0.182028
GCA_020647795.1-Fun_CP084936.1_i000_004737	181	318	137	0.611607	0.381616
GCA_905332185.1-Ani_CAJOBM010081367.1_i000_054497	1	47	46	0.205357	0.766667
GCA_001186125.1-Pro_KQ242217.1_i000_007654	139	202	63	0.28125	0.311881
GCA_014188975.1-Fun_JACGCI010000077.1_i000_022935	171	256	85	0.379464	0.177083
GCA_014188975.1-Fun_JACGCI010000077.1_i000_022935	252	355	103	0.459821	0.214583
MEOL001.0722.00001.C001_01467	156	370	214	0.955357	0.52451
GCA_905332225.1-Ani_CAJOBN010003952.1_i000_016253	1	96	95	0.424107	0.58642
MEPE002.0722.00001.C001_00403	124	284	160	0.714286	0.549828
GCA_003024255.1-Pla_CM009663.1_i000_010456	177	296	119	0.53125	0.400673
CAME001.0722.00001.C001_00225	177	335	158	0.705357	0.431694
CAME001.0722.00002.C001_00227	177	335	158	0.705357	0.431694
GCA_014466175.1-Ani_CM025350.1_i000_014250	1	43	42	0.1875	0.33871
GCA_014466175.1-Ani_CM025350.1_i000_014250	39	69	30	0.133929	0.241935
GCA_011763645.1-Fun_JAASGZ010007049.1_i000_019285	186	323	137	0.611607	0.421538
GCA_002271885.2-Pla_CM008454.1_i000_027908	321	411	90	0.401786	0.218447
GCA_910591605.1-Ani_CAJVCH010165399.1_i000_017358	1	32	31	0.138393	0.96875
GCA_014362265.1-Pla_BJWL01000019.1_i000_027687	490	634	144	0.642857	0.218845
GCA_019154785.2-Pro_JAGRRH010000069.1_i000_011179	157	255	98	0.4375	0.371212
GCA_014466195.1-Ani_CM025385.1_i000_017152	2	40	38	0.169643	0.271429
GCA_014466195.1-Ani_CM025385.1_i000_017152	32	73	41	0.183036	0.292857
GCA_014466195.1-Ani_CM025385.1_i000_017152	66	112	46	0.205357	0.328571
GCA_013115895.1-Pro_JABANM010015503.1_i000_012790	1	112	111	0.495536	0.991071
GCA_905237095.1-Pro_CAJNNW010031658.1_i000_034907	1	56	55	0.245536	0.284974
GCA_000512255.2-Pla_CM008459.1_i000_015536	177	242	65	0.290179	0.141612
GCA_000512255.2-Pla_CM008459.1_i000_015536	257	362	105	0.46875	0.228758
GCA_905332225.1-Ani_CAJOBN010021986.1_i000_040523	179	304	125	0.558036	0.411184
GCA_011745845.1-Pla_VYZY01000102.1_i000_000469	98	198	100	0.446429	0.276243
GCA_010458925.1-Pla_CM021239.1_i000_033555	1	113	112	0.5	0.647399
GCA_003490085.1-Pla_LXQA010717351.1_i000_088199	1	61	60	0.267857	0.983607
GCA_011745865.1-Pla_VYZZ01009625.1_i000_031194	177	242	65	0.290179	0.130261
GCA_011745865.1-Pla_VYZZ01009625.1_i000_031194	257	362	105	0.46875	0.210421
GCA_011745845.1-Pla_VYZY01011444.1_i000_032812	177	242	65	0.290179	0.130785
GCA_011745845.1-Pla_VYZY01011444.1_i000_032812	257	362	105	0.46875	0.211268
GCA_001268165.1-Fun_CVQI01005446.1_i000_003638	181	331	150	0.669643	0.12605
GCA_000569095.1-Pro_CM002459.1_i000_002246	1	90	89	0.397321	0.654412
GCA_002271885.2-Pla_CM008447.1_i000_013171	197	281	84	0.375	0.165029
GCA_002271885.2-Pla_CM008447.1_i000_013171	292	392	100	0.446429	0.196464
GCA_000690575.1-Pla_AYPS01000243.1_i000_000807	79	173	94	0.419643	0.54023
GCA_905250095.1-Ani_CAJNOR010018722.1_i000_063058	1	47	46	0.205357	0.315068
GCA_016984195.1-Ani_JAAWVQ010180023.1_i000_018554	20	122	102	0.455357	0.406375
GCA_006381635.2-Pla_VEPZ02001419.1_i000_062086	69	265	196	0.875	0.569767
GCA_017607525.1-Ani_JAANIA010000477.1_i000_000895	31	166	135	0.602679	0.248619
GCA_014058105.1-Pla_JACGCM010002293.1_i000_014458	8	116	108	0.482143	0.679245
GCA_000611645.1-Pla_KK105888.1_i000_015774	1	53	52	0.232143	0.223176
GCA_905330235.1-Ani_CAJNUA010004655.1_i000_037846	5	65	60	0.267857	0.25641
GCA_020796205.1-Pla_CM036898.1_i000_017873	1	107	106	0.473214	0.990654
GCA_000316135.1-Fun_JH994096.1_i000_003068	165	352	187	0.834821	0.310116
GCA_011763605.1-Fun_JAANIO010016667.1_i000_014358	1	95	94	0.419643	0.959184
GCA_000230445.1-Ani_JH170704.1_i000_012489	19	144	125	0.558036	0.598086
GCA_002966975.2-Pla_PJQY01000153.1_i000_004607	188	289	101	0.450893	0.197652
GCA_002966975.2-Pla_PJQY01000153.1_i000_004607	287	370	83	0.370536	0.162427
GCA_015178925.1-Fun_WHVC01000013.1_i000_002140	84	249	165	0.736607	0.377574
GCA_019924185.1-Fun_JAHFXE010009124.1_i000_022593	1	95	94	0.419643	0.463054
GCA_003704345.1-Fun_QWIJ01002045.1_i000_005961	182	312	130	0.580357	0.416667
GCA_905250035.1-Ani_CAJNOE010000225.1_i000_020991	3	55	52	0.232143	0.232143
GCA_000512085.1-Pro_ASPP01022055.1_i000_025285	1	113	112	0.5	0.414815
GCA_000331365.3-Pla_AMZH03002068.1_i000_009332	56	212	156	0.696429	0.405195
GCA_001884805.1-Pla_MKKS01006588.1_i000_027784	56	212	156	0.696429	0.405195
GCA_018804465.1-Pla_CM032005.1_i000_023431	2	74	72	0.321429	0.261818
GCA_018804465.1-Pla_CM032005.1_i000_023431	66	105	39	0.174107	0.141818
GCA_905332185.1-Ani_CAJOBM010032513.1_i000_045352	1	47	46	0.205357	0.212963
GCA_905331535.1-Ani_CAJNZB010000157.1_i000_020799	11	67	56	0.25	0.237288
GCA_905331525.1-Ani_CAJNZF010000179.1_i000_018819	3	53	50	0.223214	0.225225
GCA_905331505.1-Ani_CAJNYZ010000160.1_i000_018578	3	53	50	0.223214	0.225225
GCA_002127325.2-Pla_CM007893.2_i000_014734	2	85	83	0.370536	0.922222
GCA_000818735.3-Pla_JTFG03000049.1_i000_001169	98	249	151	0.674107	0.35363
GCA_001884845.1-Pla_MKKT01006424.1_i000_028569	98	249	151	0.674107	0.35363
GCA_900618415.1-Ani_UZAM01018352.1_i000_012593	64	189	125	0.558036	0.657895
GCA_003568945.1-Pro_BDIP01002991.1_i000_009105	56	230	174	0.776786	0.756522
GCA_000511025.2-Pla_CM002326.2_i000_013595	36	163	127	0.566964	0.686486
CAMI002.0722.00001.C001_00386	48	264	216	0.964286	0.722408
GCA_002087915.1-Fun_LWDP01000029.1_i000_000873	120	322	202	0.901786	0.590643
GCA_014466175.1-Ani_CM025360.1_i000_018432	60	122	62	0.276786	0.193146
GCA_014466175.1-Ani_CM025360.1_i000_018432	193	256	63	0.28125	0.196262
GCA_013358455.1-Pla_JABWDY010040026.1_i000_030008	1	47	46	0.205357	0.294872
GCA_013358455.1-Pla_JABWDY010040026.1_i000_030008	42	79	37	0.165179	0.237179
GCA_002127325.2-Pla_CM007890.2_i000_003565	2	98	96	0.428571	0.979592
GCA_019154785.2-Pro_JAGRRH010000069.1_i000_011180	2	88	86	0.383929	0.352459
GCA_022201065.1-Pla_CM039171.1_i000_005250	1018	1118	100	0.446429	0.088574
GCA_019924185.1-Fun_JAHFXE010009121.1_i000_022590	1	94	93	0.415179	0.460396
GCA_002271895.2-Pla_CM008442.1_i000_029961	56	146	90	0.401786	0.117035
GCA_003073045.1-Ani_CM009758.1_i000_000897	152	237	85	0.379464	0.200946
GCA_003073045.1-Ani_CM009758.1_i000_000897	233	302	69	0.308036	0.163121
GCA_905332305.1-Ani_CAJOBU010017555.1_i000_036234	1	47	46	0.205357	0.212963
GCA_905332015.1-Ani_CAJOAZ010000718.1_i000_012338	179	298	119	0.53125	0.399329
GCA_015502505.1-Fun_JAAAUQ010000100.1_i000_000047	1	89	88	0.392857	0.517647
GCA_015502475.1-Fun_JAAAUL010000076.1_i000_011061	1	89	88	0.392857	0.52381
GCA_013400995.1-Ani_VZUB01054366.1_i000_011914	3	152	149	0.665179	0.532143
GCA_015529785.1-Fun_JAAAUK010000452.1_i000_007478	186	313	127	0.566964	0.405751
GCA_006381635.2-Pla_VEPZ02000431.1_i000_011434	164	402	238	1.0625	0.233333
GCA_014282095.1-Pla_CM024921.1_i000_026065	82	218	136	0.607143	0.461017
GCA_002081675.1-Fun_MNPJ01000002.1_i000_001741	170	386	216	0.964286	0.533333
GCA_015849305.1-Fun_JAAAHY010001887.1_i000_003290	1	89	88	0.392857	0.53012
GCA_900617985.1-Ani_UYRR01039140.1_i000_020276	40	82	42	0.1875	0.512195
GCA_009746105.1-Pla_CM019275.1_i000_020157	1	59	58	0.258929	0.42029
GCA_003490085.1-Pla_LXQA010159278.1_i000_048183	1	44	43	0.191964	0.417476
GCA_002271895.2-Pla_MCIT02002194.1_i000_033596	148	241	93	0.415179	0.198294
GCA_002271895.2-Pla_MCIT02002194.1_i000_033596	237	328	91	0.40625	0.19403
GCA_900492705.2-Fun_UIHA02000073.1_i000_008833	272	389	117	0.522321	0.215867
GCA_900492705.2-Fun_UIHA02000073.1_i000_008833	378	453	75	0.334821	0.138376
GCA_011066465.2-Fun_MU009422.1_i000_005896	154	249	95	0.424107	0.228365
GCA_020169535.1-Pla_CM034998.1_i000_035517	1318	1405	87	0.388393	0.0618777
GCA_020169555.1-Pla_CM035022.1_i000_034297	1318	1405	87	0.388393	0.0618777
GCA_015849295.1-Fun_JAAAHW010004734.1_i000_005849	184	304	120	0.535714	0.394737
GCA_002271895.2-Pla_CM008435.1_i000_014373	177	270	93	0.415179	0.186747
GCA_002271895.2-Pla_CM008435.1_i000_014373	266	357	91	0.40625	0.182731
GCA_014282245.1-Pla_CM024964.1_i000_027488	700	760	60	0.267857	0.0789474
MESP076.0722.00001.C001_03116	138	290	152	0.678571	0.515254
GCA_905332015.1-Ani_CAJOAZ010013981.1_i000_044695	164	283	119	0.53125	0.420495
GCA_020169585.1-Pla_CM034986.1_i000_034697	1318	1397	79	0.352679	0.0565093
GCA_004193775.2-Pla_CM014365.1_i000_024476	627	775	148	0.660714	0.157614
GCA_020497155.1-Pla_CM035715.1_i000_025825	660	808	148	0.660714	0.152263
GCA_000583005.2-Pla_ASHM01090858.1_i000_052713	4	78	74	0.330357	0.685185
GCA_900617775.1-Ani_UYRU01043287.1_i000_003185	129	166	37	0.165179	0.12892
GCA_900617775.1-Ani_UYRU01043287.1_i000_003185	162	245	83	0.370536	0.289199
GCA_001747045.1-Fun_LPNM01000012.1_i000_001360	151	371	220	0.982143	0.444444
CAME007.0722.00001.C001_01373	91	297	206	0.919643	0.693603
GCA_015852395.1-Fun_JAAAII010004384.1_i000_012440	143	270	127	0.566964	0.47037
GCA_013397315.1-Ani_WBMY01017427.1_i000_012639	115	235	120	0.535714	0.510638
GCA_001879085.1-Pla_CM007391.1_i000_000594	33	170	137	0.611607	0.489286
GCA_001879085.1-Pla_CM007391.1_i000_000594	162	205	43	0.191964	0.153571
GCA_003490085.1-Pla_LXQA010425416.1_i000_071756	1	44	43	0.191964	0.86
THAC002.0722.00001.C001_01304	48	190	142	0.633929	0.747368
GCA_009746105.1-Pla_CM019266.1_i000_004168	33	117	84	0.375	0.409756
GCA_002271895.2-Pla_CM008435.1_i000_013421	6	117	111	0.495536	0.932773
GCA_013397195.1-Ani_VYXD01007639.1_i000_006101	115	248	133	0.59375	0.353723
CAMA001.0722.00001.C001_00703	50	264	214	0.955357	0.638806
GCA_000209555.1-Ani_FN656912.1_i000_008196	1	35	34	0.151786	0.162679
GCA_000769155.2-Pro_JROU02000337.1_i000_006701	184	298	114	0.508929	0.229376
GCA_000769155.2-Pro_JROU02000337.1_i000_006701	302	367	65	0.290179	0.130785
GCA_013398615.1-Ani_VZSR01002477.1_i000_005247	115	235	120	0.535714	0.510638
GCA_014058105.1-Pla_JACGCM010001659.1_i000_015130	198	335	137	0.611607	0.253235
GCA_015529785.1-Fun_JAAAUK010000293.1_i000_005583	1	82	81	0.361607	0.476471
GCA_013396815.1-Ani_WBMX01030538.1_i000_011406	115	238	123	0.549107	0.516807
GCA_019776745.2-Pla_CM034156.1_i000_036096	12	155	143	0.638393	0.541667
FEAC001.0722.00001.C001_00185	39	238	199	0.888393	0.829167
FEAC002.0722.00001.C001_01164	39	238	199	0.888393	0.829167
GCA_015849305.1-Fun_JAAAHY010000398.1_i000_006792	186	307	121	0.540179	0.394137
GCA_000611645.1-Pla_KK103642.1_i000_012759	177	300	123	0.549107	0.392971
GCA_902702955.1-Ani_CACRXO010000051.1_i000_005760	188	263	75	0.334821	0.15
GCA_902702955.1-Ani_CACRXO010000051.1_i000_005760	254	336	82	0.366071	0.164
GCA_900618405.1-Ani_UYSL01026986.1_i000_021813	51	145	94	0.419643	0.648276
GCA_905332015.1-Ani_CAJOAZ010020202.1_i000_048391	1	47	46	0.205357	0.242105
GCA_002127325.2-Pla_CM007893.2_i000_012426	4	101	97	0.433036	0.889908
GCA_015849325.1-Fun_JAAAIB010002060.1_i000_003002	1	121	120	0.535714	0.991736
GCA_011745865.1-Pla_VYZZ01006004.1_i000_023921	28	170	142	0.633929	0.835294
GCA_013396775.1-Ani_VZRE01001870.1_i000_001729	68	199	131	0.584821	0.308235
GCA_003112345.1-Pla_PKPP01010204.1_i000_049864	27	110	83	0.370536	0.248503
GCA_002218305.1-Ani_MCFN01024344.1_i000_016975	127	252	125	0.558036	0.478927
PITO001.0722.00001.C001_00717	86	235	149	0.665179	0.62605
THVO001.0722.00001.C001_00375	83	226	143	0.638393	0.621739
GCA_000192795.1-Fun_GL877430.1_i000_001654	171	352	181	0.808036	0.240372
GCA_014058105.1-Pla_JACGCM010000772.1_i000_032171	140	247	107	0.477679	0.431452
GCA_013339695.1-Ani_CM023520.1_i000_002705	225	355	130	0.580357	0.301624
GCA_903114435.1-Pla_CAEKKB010000005.1_i000_017507	108	262	154	0.6875	0.587786
GCA_903112645.1-Pla_CAEKDK010000005.1_i000_017617	89	240	151	0.674107	0.629167
GCA_016413895.1-Pla_CM028154.1_i000_012282	80	124	44	0.196429	0.110831
GCA_016413895.1-Pla_CM028154.1_i000_012282	124	199	75	0.334821	0.188917
GCA_002352805.1-Ani_KZ345014.1_i000_000830	16	72	56	0.25	0.238298
GCA_014058105.1-Pla_JACGCM010000252.1_i000_010019	35	168	133	0.59375	0.791667
GCA_902729315.2-Pla_LR746274.1_i000_015529	121	231	110	0.491071	0.244444
GCA_902729315.2-Pla_LR746274.1_i000_015529	227	298	71	0.316964	0.157778
GCA_019924185.1-Fun_JAHFXE010009849.1_i000_023003	29	151	122	0.544643	0.802632
GCA_900618025.1-Ani_UZAG01019252.1_i000_012287	1	45	44	0.196429	0.209524
GCA_000224885.2-Pro_KL998095.1_i000_004442	13	112	99	0.441964	0.347368
GCA_000224905.2-Pro_KN000241.1_i000_002665	13	112	99	0.441964	0.347368
GCA_016097925.1-Fun_JAAAIQ010002098.1_i000_004421	2	69	67	0.299107	0.51145
GCA_000256705.2-Pro_ML130747.1_i000_007630	14	112	98	0.4375	0.34386
GCA_014905375.1-Pla_BMAC01001247.1_i000_027890	35	75	40	0.178571	0.533333
GCA_905397895.1-Ani_CAJPWZ010001460.1_i000_029657	288	443	155	0.691964	0.257903
GCA_000004255.1-Pla_GL348715.1_i000_008968	17	120	103	0.459821	0.804688
GCA_000325525.2-Pro_KN003134.1_i000_007311	1	88	87	0.388393	0.450777
GCA_019924295.1-Fun_JAHFXI010013738.1_i000_017326	1	56	55	0.245536	0.283505
GCA_000180755.1-Ani_ADBV01002264.1_i000_005736	179	300	121	0.540179	0.39934
GCA_002081575.1-Pro_JNBS01002046.1_i000_008216	1	62	61	0.272321	0.291866
GCA_015178925.1-Fun_WHVC01000012.1_i000_001864	1	117	116	0.517857	0.345238
GCA_015178925.1-Fun_WHVC01000012.1_i000_001864	119	170	51	0.227679	0.151786
GCA_002271895.2-Pla_CM008432.1_i000_003397	31	165	134	0.598214	0.788235
GCA_002271885.2-Pla_CM008449.1_i000_017921	103	145	42	0.1875	0.285714
GCA_016098165.1-Fun_JAAAJA010000621.1_i000_007801	1	82	81	0.361607	0.536424
GCA_001742945.1-Pla_DF974331.1_i000_036566	158	306	148	0.660714	0.471338
GCA_001235845.1-Pro_LFNC01000477.1_i000_004745	170	345	175	0.78125	0.431034
GCA_000224845.2-Pro_KN042481.1_i000_004058	1	88	87	0.388393	0.333333
GCA_000256725.2-Pro_KQ986313.1_i000_008308	1	88	87	0.388393	0.333333
GCA_015852425.1-Fun_JAAAIG010001555.1_i000_002422	2	67	65	0.290179	0.464286
GCA_000469725.3-Ani_LN902843.1_i000_005347	223	325	102	0.455357	0.157165
GCA_000469725.3-Ani_LN902843.1_i000_005347	336	396	60	0.267857	0.0924499
GCA_000469725.3-Ani_LN902843.1_i000_005347	440	473	33	0.147321	0.0508475
GCA_902206195.3-Pla_CABITT030000007.1_i000_020400	32	114	82	0.366071	0.37963
GCA_902206195.3-Pla_CABITT030000007.1_i000_020400	124	191	67	0.299107	0.310185
GCA_000005425.2-Pla_AP008213.2_i000_019800	187	309	122	0.544643	0.389776
GCA_001433935.1-Pla_AP014963.1_i000_029838	187	309	122	0.544643	0.389776
GCA_004007595.1-Pla_CM012947.1_i000_022896	187	309	122	0.544643	0.389776
GCA_009797565.1-Pla_CM020527.1_i000_024240	187	309	122	0.544643	0.389776
GCA_014905375.1-Pla_BMAC01001247.1_i000_027892	110	150	40	0.178571	0.266667
GCA_904845875.1-Pla_CAJGYO010000004.1_i000_015245	188	285	97	0.433036	0.18097
GCA_904845875.1-Pla_CAJGYO010000004.1_i000_015245	292	376	84	0.375	0.156716
GCA_905332325.1-Ani_CAJOBW010072130.1_i000_040493	186	305	119	0.53125	0.390164
GCA_001268145.1-Fun_CVQH01025048.1_i000_018284	1	81	80	0.357143	0.860215
GCA_902860255.1-Pla_LR794324.1_i000_007232	1	44	43	0.191964	0.220513
GCA_000004655.2-Pla_CM000132.1_i000_025885	188	312	124	0.553571	0.257796
GCA_000149285.1-Pla_CM000144.1_i000_024370	188	312	124	0.553571	0.257796
GCA_003573695.1-Pla_CM010716.1_i000_006130	118	243	125	0.558036	0.200642
GCA_001266575.1-Ani_JTDY01005801.1_i000_012938	150	215	65	0.290179	0.202492
GCA_001266575.1-Ani_JTDY01005801.1_i000_012938	206	283	77	0.34375	0.239875
GCA_902728155.2-Pla_CACVBM020000221.1_i000_003308	1	58	57	0.254464	0.435115
GCA_902728155.2-Pla_CACVBM020000221.1_i000_003308	50	128	78	0.348214	0.59542
GCA_016771965.1-Pla_CM028698.1_i000_061170	162	252	90	0.401786	0.208817
GCA_000583005.2-Pla_ASHM01033310.1_i000_033313	139	279	140	0.625	0.472973
MEHU001.0722.00001.C001_02376	128	291	163	0.727679	0.552542
GCA_019297735.1-Ani_CM033247.1_i000_014216	186	259	73	0.325893	0.17381
GCA_019297735.1-Ani_CM033247.1_i000_014216	247	371	124	0.553571	0.295238
GCA_000583005.2-Pla_ASHM01017621.1_i000_022086	158	297	139	0.620536	0.44127
GCA_019632305.1-Fun_WSTW01001030.1_i000_000276	223	375	152	0.678571	0.258944
GCA_000524195.1-Ani_APAU02000019.1_i000_007689	231	325	94	0.419643	0.144838
GCA_000524195.1-Ani_APAU02000019.1_i000_007689	336	396	60	0.267857	0.0924499
GCA_000524195.1-Ani_APAU02000019.1_i000_007689	440	473	33	0.147321	0.0508475
GCA_021556725.1-Ani_CM038616.1_i000_007052	231	325	94	0.419643	0.144838
GCA_021556725.1-Ani_CM038616.1_i000_007052	336	396	60	0.267857	0.0924499
GCA_021556725.1-Ani_CM038616.1_i000_007052	440	473	33	0.147321	0.0508475
GCA_002087875.1-Fun_LTAI01000304.1_i000_001581	85	304	219	0.977679	0.720395
GCA_015178925.1-Fun_WHVC01000005.1_i000_009787	539	724	185	0.825893	0.213134
GCA_015679595.1-Fun_JAAAVB010003310.1_i000_006524	1	80	79	0.352679	0.496855
GCA_002135145.1-Ani_MUJZ01022229.1_i000_004631	205	327	122	0.544643	0.373089
GCA_000751015.1-Pla_LK033138.1_i000_045596	145	230	85	0.379464	0.263158
GCA_020379485.1-Pla_CM035460.1_i000_068381	145	230	85	0.379464	0.263158
GCA_006381635.2-Pla_VEPZ02000929.1_i000_026152	177	281	104	0.464286	0.367491
GCA_000151035.1-Fun_GG692420.1_i000_007996	159	214	55	0.245536	0.240175
GCA_021604985.1-Pla_BQKI01000018.1_i000_026419	307	373	66	0.294643	0.110738
GCA_021604985.1-Pla_BQKI01000018.1_i000_026419	378	448	70	0.3125	0.11745
GCA_003573695.1-Pla_PUWZ01006673.1_i000_046113	189	324	135	0.602679	0.298013
GCA_000583005.2-Pla_ASHM01096417.1_i000_053785	18	140	122	0.544643	0.847222
GCA_003568945.1-Pro_BDIP01007418.1_i000_014407	2	123	121	0.540179	0.960317
GCA_022201045.1-Pla_CM039162.1_i000_003801	28	146	118	0.526786	0.802721
GCA_905397895.1-Ani_CAJPWZ010000459.1_i000_008391	64	145	81	0.361607	0.385714
GCA_011752425.2-Ani_CACVKT020007209.1_i000_039790	290	447	157	0.700893	0.259934
GCA_015679495.1-Fun_JAAAUW010005269.1_i000_012066	1	80	79	0.352679	0.427027
GCA_900618435.1-Ani_UYSU01037356.1_i000_012518	221	333	112	0.5	0.161151
GCA_900618435.1-Ani_UYSU01037356.1_i000_012518	430	474	44	0.196429	0.0633094
GCA_905332135.1-Ani_CAJOBI010138964.1_i000_045457	174	293	119	0.53125	0.406143
GCA_000583005.2-Pla_ASHM01046650.1_i000_039873	3	73	70	0.3125	0.382514
GCA_000583005.2-Pla_ASHM01064432.1_i000_046241	3	73	70	0.3125	0.382514
GCA_000583005.2-Pla_ASHM01096358.1_i000_053770	18	140	122	0.544643	0.847222
GCA_905338395.1-Ani_CAJPEW010000022.1_i000_000335	438	519	81	0.361607	0.108725
GCA_905338395.1-Ani_CAJPEW010000022.1_i000_000335	511	564	53	0.236607	0.0711409
GCA_001268165.1-Fun_CVQI01000086.1_i000_000467	1	88	87	0.388393	0.935484
GCA_018360435.1-Fun_SRQI01000060.1_i000_006617	12	207	195	0.870536	0.911215
GCA_000695385.1-Fun_KK764657.1_i000_002844	360	447	87	0.388393	0.147208
GCA_015852385.1-Fun_JAAAIE010000578.1_i000_008633	1	80	79	0.352679	0.420213
GCA_016771965.1-Pla_CM028699.1_i000_066701	182	267	85	0.379464	0.236769
GCA_000149815.1-Fun_DS017026.1_i000_001926	69	106	37	0.165179	0.345794
GCA_018360575.1-Fun_SRQL01000002.1_i000_002317	1	80	79	0.352679	0.334746
GCA_018360575.1-Fun_SRQL01000002.1_i000_002317	73	128	55	0.245536	0.233051
GCA_018360575.1-Fun_SRQL01000002.1_i000_002317	153	229	76	0.339286	0.322034
GCA_015178925.1-Fun_WHVC01000021.1_i000_004641	137	237	100	0.446429	0.232558
GCA_015178925.1-Fun_WHVC01000021.1_i000_004641	234	281	47	0.209821	0.109302
GCA_018360595.1-Fun_SRQJ01000128.1_i000_000902	9	126	117	0.522321	0.495763
GCA_018360595.1-Fun_SRQJ01000128.1_i000_000902	153	229	76	0.339286	0.322034
GCA_018360445.1-Fun_SRQK01000093.1_i000_008145	9	126	117	0.522321	0.495763
GCA_018360445.1-Fun_SRQK01000093.1_i000_008145	153	229	76	0.339286	0.322034
GCA_020921065.1-Pla_CM037157.1_i000_020179	1	53	52	0.232143	0.504854
GCA_020921065.1-Pla_CM037157.1_i000_020179	40	76	36	0.160714	0.349515
GCA_003604175.2-Ani_CM030370.1_i000_007394	337	404	67	0.299107	0.10229
GCA_003604175.2-Ani_CM030370.1_i000_007394	416	484	68	0.303571	0.103817
GCA_002087885.1-Fun_LVKB01000074.1_i000_002557	95	304	209	0.933036	0.6875
GCA_001683735.1-Fun_LUGG01000019.1_i000_011263	310	379	69	0.308036	0.137725
GCA_000236345.1-Ani_DF143195.1_i000_004604	370	437	67	0.299107	0.0973837
GCA_000236345.1-Ani_DF143195.1_i000_004604	449	517	68	0.303571	0.0988372
GCA_003260675.2-Pla_QGKX02001521.1_i000_024228	188	323	135	0.602679	0.325301
GCA_009445465.1-Pla_NMUH01000089.1_i000_003416	155	265	110	0.491071	0.272953
GCA_900604375.1-Ani_UXSR01000192.1_i000_001491	200	331	131	0.584821	0.254369
GCA_900604375.1-Ani_UXSR01000192.1_i000_001491	412	456	44	0.196429	0.0854369
MESP047.0722.00001.C001_00603	150	290	140	0.625	0.472973
GCA_022496225.1-Fun_WTXE01000115.1_i000_001441	2	62	60	0.267857	0.337079
GCA_022496225.1-Fun_WTXE01000115.1_i000_001441	60	130	70	0.3125	0.393258
GCA_900618005.1-Ani_UYRS01018323.1_i000_003966	228	324	96	0.428571	0.148148
GCA_900618005.1-Ani_UYRS01018323.1_i000_003966	340	393	53	0.236607	0.0817901
GCA_900618005.1-Ani_UYRS01018323.1_i000_003966	431	473	42	0.1875	0.0648148
GCA_021029115.1-Pro_JAFCAG010000005.1_i000_012725	5	120	115	0.513393	0.563725
GCA_013995675.1-Pro_VWRR01000007.1_i000_004595	99	258	159	0.709821	0.462209
GCA_015679535.1-Fun_JAAAUX010000743.1_i000_010377	1	80	79	0.352679	0.420213
GCA_004794785.1-Ani_SJOL01003848.1_i000_002161	299	404	105	0.46875	0.160305
GCA_004794785.1-Ani_SJOL01003848.1_i000_002161	425	484	59	0.263393	0.0900763
GCA_022117675.1-Ani_JACEFF010000584.1_i000_002233	186	318	132	0.589286	0.341085
GCA_016098025.1-Fun_JAAAIU010000416.1_i000_008252	6	75	69	0.308036	0.383333
GCA_015500155.1-Fun_JAAAUE010002813.1_i000_003695	3	67	64	0.285714	0.359551
GCA_015679645.1-Fun_JAAAVC010002137.1_i000_004591	2	65	63	0.28125	0.357955
GCA_013396775.1-Ani_VZRE01000561.1_i000_000568	167	269	102	0.455357	0.379182
GCA_900618515.1-Ani_UZAO01056536.1_i000_006408	192	318	126	0.5625	0.198738
GCA_900618515.1-Ani_UZAO01056536.1_i000_006408	337	412	75	0.334821	0.118297
GCA_900618515.1-Ani_UZAO01056536.1_i000_006408	422	461	39	0.174107	0.0615142
GCA_000183025.1-Fun_ABRE01012274.1_i000_007138	136	209	73	0.325893	0.345972
GCA_013389845.1-Ani_VWPX01066227.1_i000_013840	6	76	70	0.3125	0.503597
GCA_000346465.2-Pla_CM007655.1_i000_015432	1	138	137	0.611607	0.861635
GCA_013389825.1-Ani_VWPW01075165.1_i000_013643	6	76	70	0.3125	0.503597
GCA_003112345.1-Pla_PKPP01000635.1_i000_008846	2	87	85	0.379464	0.477528
GCA_000599465.2-Ani_AWGT02014240.1_i000_016700	3	72	69	0.308036	0.339901
GCA_003490085.1-Pla_LXQA010049703.1_i000_023373	1	35	34	0.151786	0.971429
GCA_010078415.1-Ani_VUKZ01012408.1_i000_010340	5	75	70	0.3125	0.411765
GCA_013396435.1-Ani_WBMU01006862.1_i000_012948	5	80	75	0.334821	0.353774
GCA_004115385.1-Pla_CM014063.1_i000_035843	1	44	43	0.191964	0.218274
GCA_010078485.1-Ani_VULA01010458.1_i000_009823	9	80	71	0.316964	0.342995
GCA_014466195.1-Ani_CM025385.1_i000_017149	4	57	53	0.236607	0.427419
GCA_014466195.1-Ani_CM025385.1_i000_017149	50	111	61	0.272321	0.491935
GCA_902702965.1-Ani_CACRXP010000103.1_i000_007335	203	335	132	0.589286	0.189383
GCA_902702965.1-Ani_CACRXP010000103.1_i000_007335	349	472	123	0.549107	0.176471
GCA_010080355.1-Ani_VULC01011628.1_i000_006314	9	80	71	0.316964	0.339713
GCA_001663975.1-Ani_CM004467.1_i000_003789	181	318	137	0.611607	0.273453
GCA_013400655.1-Ani_VYZQ01064124.1_i000_007072	3	76	73	0.325893	0.350962
GCA_902702955.1-Ani_CACRXO010000088.1_i000_008156	203	333	130	0.580357	0.18598
GCA_902702955.1-Ani_CACRXO010000088.1_i000_008156	426	473	47	0.209821	0.0672389
GCA_010087175.1-Ani_VULM01005893.1_i000_004624	7	80	73	0.325893	0.352657
GCA_010085335.1-Ani_VULH01015478.1_i000_004272	179	279	100	0.446429	0.358423
GCA_905250045.1-Ani_CAJNOG010000283.1_i000_023583	2	41	39	0.174107	0.185714
GCA_010090195.1-Ani_VUKY01001919.1_i000_001535	8	80	72	0.321429	0.346154
GCA_013396435.1-Ani_WBMU01008607.1_i000_013458	4	79	75	0.334821	0.369458
GCA_013400815.1-Ani_WBNK01005379.1_i000_012798	10	80	70	0.3125	0.324074
GCA_008787405.2-Ani_CM018493.1_i000_020522	50	267	217	0.96875	0.485459
GCA_013368495.1-Ani_LUCH01007744.1_i000_009855	246	307	61	0.272321	0.112546
GCA_013368495.1-Ani_LUCH01007744.1_i000_009855	296	377	81	0.361607	0.149446
GCA_004000445.1-Ani_RSAL01001208.1_i000_014462	169	250	81	0.361607	0.271812
GCA_013115895.1-Pro_JABANM010003733.1_i000_003153	150	196	46	0.205357	0.231156
GCA_002087885.1-Fun_LVKB01000021.1_i000_002438	149	340	191	0.852679	0.555233
GCA_018360325.1-Fun_SRQG01000041.1_i000_005240	1	125	124	0.553571	0.58216
GCA_900618405.1-Ani_UYSL01025538.1_i000_020753	108	132	24	0.107143	0.181818
GCA_015679645.1-Fun_JAAAVC010000867.1_i000_011278	2	65	63	0.28125	0.366279
GCA_000091205.1-Pro_AP006501.2_i000_004299	127	283	156	0.696429	0.428571
GCA_002763495.2-Ani_JXXN02003060.1_i000_007134	5	59	54	0.241071	0.164634
GCA_002763495.2-Ani_JXXN02003060.1_i000_007134	70	134	64	0.285714	0.195122
GCA_905332045.1-Ani_CAJOBB010003589.1_i000_031391	1	37	36	0.160714	0.174757
GCA_000827895.1-Ani_JWZT01004020.1_i000_010156	45	91	46	0.205357	0.45098
GCA_905332045.1-Ani_CAJOBB010000280.1_i000_007021	1	37	36	0.160714	0.174757
GCA_019924735.1-Fun_JAHFYD010006345.1_i000_016986	1	80	79	0.352679	0.344978
GCA_010085335.1-Ani_VULH01045817.1_i000_014711	3	79	76	0.339286	0.496732
GCA_002738505.1-Pla_KZ305019.1_i000_001016	135	265	130	0.580357	0.269151
CUDI001.0722.00001.C001_01501	82	252	170	0.758929	0.646388
CUDI001.0722.00002.C001_01485	82	252	170	0.758929	0.646388
GCA_002087875.1-Fun_LTAI01000048.1_i000_002073	149	356	207	0.924107	0.521411
GCA_904845875.1-Pla_CAJGYO010000018.1_i000_060810	311	395	84	0.375	0.135266
GCA_900617775.1-Ani_UYRU01075428.1_i000_014671	133	165	32	0.142857	0.192771
GCA_013339695.1-Ani_CM023520.1_i000_000918	37	111	74	0.330357	0.316239
GCA_003112345.1-Pla_PKPP01012615.1_i000_054184	66	126	60	0.267857	0.402685
GCA_013397615.1-Ani_WBNI01006786.1_i000_013044	5	76	71	0.316964	0.297071
GCA_000256705.2-Pro_ML130747.1_i000_007629	145	182	37	0.165179	0.203297
GCA_002738505.1-Pla_KZ305033.1_i000_011620	432	560	128	0.571429	0.164313
GCA_001444175.2-Ani_KQ570532.1_i000_016238	10	89	79	0.352679	0.322449
GCA_019455555.1-Ani_JAGFMF010011380.1_i000_000455	27	107	80	0.357143	0.282686
GCA_001045655.1-Ani_LBMM01036290.1_i000_018204	1	80	79	0.352679	0.523179
GCA_016098005.1-Fun_JAAAIS010000175.1_i000_003078	2	46	44	0.196429	0.325926
GCA_004369065.1-Fun_ML208300.1_i000_006243	185	307	122	0.544643	0.300493
GCA_015178925.1-Fun_WHVC01000021.1_i000_004703	146	328	182	0.8125	0.359684
GCA_000715545.1-Ani_KL596635.1_i000_002005	388	455	67	0.299107	0.0958512
GCA_000715545.1-Ani_KL596635.1_i000_002005	485	533	48	0.214286	0.0686695
GCA_905250035.1-Ani_CAJNOE010001566.1_i000_041181	1	35	34	0.151786	0.166667
GCA_001990785.1-Ani_KV906429.1_i000_009322	407	474	67	0.299107	0.0933148
GCA_001990785.1-Ani_KV906429.1_i000_009322	504	552	48	0.214286	0.0668524
GCA_022201065.1-Pla_CM039171.1_i000_004419	30	90	60	0.267857	0.487805
GCA_014220965.1-Ani_LOND01020971.1_i000_011324	341	478	137	0.611607	0.215071
GCA_014282245.1-Pla_CM024958.1_i000_014860	114	175	61	0.272321	0.251029
GCA_014282245.1-Pla_CM024958.1_i000_014860	171	216	45	0.200893	0.185185
GCA_900618445.1-Ani_UYSG01000146.1_i000_000945	203	326	123	0.549107	0.181416
GCA_900618445.1-Ani_UYSG01000146.1_i000_000945	342	463	121	0.540179	0.178466
GCA_902177915.1-Ani_CABIJS010000355.1_i000_009137	203	326	123	0.549107	0.181416
GCA_902177915.1-Ani_CABIJS010000355.1_i000_009137	342	463	121	0.540179	0.178466
GCA_002738505.1-Pla_KZ305023.1_i000_004778	219	349	130	0.580357	0.229277
GCA_001293395.1-Pro_LGTL01000015.1_i000_006610	1	128	127	0.566964	0.531381
GCA_015178925.1-Fun_WHVC01000007.1_i000_011384	173	264	91	0.40625	0.344697
GCA_015849295.1-Fun_JAAAHW010011890.1_i000_012751	2	48	46	0.205357	0.359375
GCA_018855395.1-Fun_JABAJW010005624.1_i000_005208	1	62	61	0.272321	0.677778
GCA_000797555.1-Ani_KN612517.1_i000_024336	19	125	106	0.473214	0.848
GCA_900618395.1-Ani_UZAI01017030.1_i000_015574	143	246	103	0.459821	0.186594
GCA_900618395.1-Ani_UZAI01017030.1_i000_015574	255	317	62	0.276786	0.112319
GCA_900618395.1-Ani_UZAI01017030.1_i000_015574	332	388	56	0.25	0.101449
GCA_015252655.1-Ani_JTDF01004738.1_i000_005823	444	511	67	0.299107	0.0909091
GCA_015252655.1-Ani_JTDF01004738.1_i000_005823	518	573	55	0.245536	0.0746269
GCA_900005705.1-Ani_FR908563.1_i000_013296	17	40	23	0.102679	0.100877
GCA_003719485.1-Pro_MKKU01000489.1_i000_006786	5	130	125	0.558036	0.523013
GCA_009731335.1-Pro_BLBS01000020.1_i000_002177	1	128	127	0.566964	0.531381
GCA_014466185.1-Ani_CM025410.1_i000_015480	96	165	69	0.308036	0.283951
GCA_017916325.1-Pro_CM030411.1_i000_002009	1	128	127	0.566964	0.531381
GCA_014338405.1-Ani_JTDE01003539.1_i000_006796	376	503	127	0.566964	0.191843
GCA_003490085.1-Pla_LXQA010311312.1_i000_063708	1	42	41	0.183036	0.745455
GCA_021461655.1-Ani_CM038289.1_i000_008331	186	334	148	0.660714	0.23125
GCA_021461655.1-Ani_CM038289.1_i000_008331	342	403	61	0.272321	0.0953125
GCA_021461655.1-Ani_CM038289.1_i000_008331	432	475	43	0.191964	0.0671875
GCA_015852605.2-Pla_CM027586.2_i000_027572	1	42	41	0.183036	0.218085
GCA_006368765.1-Ani_SKCS01000574.1_i000_008454	187	335	148	0.660714	0.230889
GCA_006368765.1-Ani_SKCS01000574.1_i000_008454	343	404	61	0.272321	0.0951638
GCA_006368765.1-Ani_SKCS01000574.1_i000_008454	433	476	43	0.191964	0.0670827
GCA_900617975.1-Ani_UZAE01012306.1_i000_008406	202	323	121	0.540179	0.17716
GCA_900617975.1-Ani_UZAE01012306.1_i000_008406	341	460	119	0.53125	0.174231
GCA_000227135.2-Pro_FR799603.2_i000_002043	1	128	127	0.566964	0.531381
GCA_003719575.1-Pro_CP029515.1_i000_002239	1	128	127	0.566964	0.531381
GCA_003730215.1-Pro_RHLC01000028.1_i000_004995	1	128	127	0.566964	0.531381
GCA_008360955.1-Ani_LUCM01001435.1_i000_001488	34	159	125	0.558036	0.355114
GCA_020424065.1-Pla_CM035467.1_i000_011305	237	350	113	0.504464	0.304582
GCA_003958945.1-Ani_QMKO01002905.1_i000_008794	163	236	73	0.325893	0.135436
GCA_003958945.1-Ani_QMKO01002905.1_i000_008794	245	307	62	0.276786	0.115028
GCA_003958945.1-Ani_QMKO01002905.1_i000_008794	321	378	57	0.254464	0.105751
GCA_003521335.2-Ani_QWLN02014001.1_i000_013010	3	75	72	0.321429	0.277992
GCA_000448345.1-Ani_KE686269.1_i000_020872	1	17	16	0.0714286	0.0744186
GCA_000698435.2-Pro_CP006629.1_i000_000481	149	301	152	0.678571	0.5
GCA_000002725.2-Pro_FR796412.1_i000_002141	1	128	127	0.566964	0.531381
GCA_916722125.1-Pro_OU755550.1_i000_002178	1	128	127	0.566964	0.531381
GCA_000002875.2-Pro_FR796448.1_i000_002075	1	128	127	0.566964	0.531381
GCA_003730175.1-Pro_RHLD01000028.1_i000_004973	1	128	127	0.566964	0.531381
GCA_900635355.2-Pro_LR812636.1_i000_002146	1	128	127	0.566964	0.531381
GCA_000699445.3-Ani_CM039142.1_i000_000702	259	332	73	0.325893	0.114961
GCA_000699445.3-Ani_CM039142.1_i000_000702	417	473	56	0.25	0.088189
GCA_000492115.1-Pro_AUPL01006999.1_i000_006881	190	322	132	0.589286	0.409938
GCA_018446385.1-Pla_CM031525.1_i000_065073	3	80	77	0.34375	0.261017
GCA_016098165.1-Fun_JAAAJA010001383.1_i000_001435	1	43	42	0.1875	0.75
GCA_020497155.1-Pla_CM035720.1_i000_040527	80	121	41	0.183036	0.20098
GCA_020497155.1-Pla_CM035720.1_i000_040527	118	174	56	0.25	0.27451
GCA_008508345.1-Ani_QNGE01001631.1_i000_005363	282	415	133	0.59375	0.229706
GCA_900617995.1-Ani_UZAL01034196.1_i000_013604	261	333	72	0.321429	0.11303
GCA_900617995.1-Ani_UZAL01034196.1_i000_013604	344	408	64	0.285714	0.100471
GCA_900617995.1-Ani_UZAL01034196.1_i000_013604	433	475	42	0.1875	0.0659341
GCA_013401445.1-Pla_CM023873.1_i000_006617	98	132	34	0.151786	0.251852
GCA_017916335.1-Pro_CM030447.1_i000_002064	1	128	127	0.566964	0.531381
GCA_900622495.1-Ani_UYWX01020295.1_i000_006186	244	324	80	0.357143	0.0631912
GCA_900622495.1-Ani_UYWX01020295.1_i000_006186	440	472	32	0.142857	0.0252765
GCA_017918225.1-Pro_CM030555.1_i000_002101	1	128	127	0.566964	0.531381
GCA_017916305.1-Pro_CM030591.1_i000_002102	1	128	127	0.566964	0.531381
GCA_001299535.1-Pro_LJSK01000114.1_i000_004047	1	128	127	0.566964	0.531381
GCA_010085315.1-Ani_VULG01053826.1_i000_013396	3	79	76	0.339286	0.469136
GCA_002906115.4-Pla_PKMF03013286.1_i000_046448	41	115	74	0.330357	0.440476
GCA_005239225.1-Pla_RCHU01001190.1_i000_006566	51	121	70	0.3125	0.0868486
GCA_905182985.1-Pro_CAJJDN010000014.1_i000_007286	125	199	74	0.330357	0.37
GCA_015501535.1-Fun_JADNRW010000078.1_i000_021149	14	84	70	0.3125	0.411765
GCA_000002845.2-Pro_FR798990.1_i000_001980	1	128	127	0.566964	0.531381
GCA_900537975.1-Pro_LS997615.1_i000_002154	1	128	127	0.566964	0.531381
GCA_014282245.1-Pla_CM024957.1_i000_012556	95	202	107	0.477679	0.138422
GCA_017918215.1-Pro_CM030483.1_i000_001996	1	128	127	0.566964	0.531381
GCA_017918235.1-Pro_CM030519.1_i000_001874	1	128	127	0.566964	0.531381
GCA_017607565.1-Ani_JAANIB010010429.1_i000_008622	1	56	55	0.245536	0.314286
GCA_000234665.4-Pro_FR799569.1_i000_002328	1	128	127	0.566964	0.531381
GCA_001664025.1-Fun_LXPE01000007.1_i000_004175	215	361	146	0.651786	0.299795
GCA_905332135.1-Ani_CAJOBI010302270.1_i000_065013	1	43	42	0.1875	0.954545
GCA_019924395.1-Fun_JAHFXN010006312.1_i000_016807	1	76	75	0.334821	0.333333
GCA_000350365.1-Fun_KB726235.1_i000_001541	26	89	63	0.28125	0.348066
GCA_012275245.1-Fun_WMJW01000015.1_i000_002328	111	165	54	0.241071	0.325301
GCA_008638375.1-Pla_CM018050.1_i000_016270	194	329	135	0.602679	0.217391
GCA_000492115.1-Pro_AUPL01005743.1_i000_005655	6	130	124	0.553571	0.518828
GCA_014282245.1-Pla_CM024964.1_i000_027491	1	44	43	0.191964	0.0409134
GCA_000512085.1-Pro_ASPP01018222.1_i000_020595	190	233	43	0.191964	0.176955
GCA_002786265.1-Pla_KZ451979.1_i000_011848	1	55	54	0.241071	0.931034
GCA_014058105.1-Pla_JACGCM010001067.1_i000_031475	1	56	55	0.245536	0.272277
GCA_001268145.1-Fun_CVQH01008047.1_i000_005025	1	41	40	0.178571	0.176211
GCA_019279435.1-Pla_JAAALK010000579.1_i000_047465	4	61	57	0.254464	0.292308
GCA_000755165.1-Pro_CP009385.1_i000_001929	1	128	127	0.566964	0.531381
NOTH001.0722.00001.C001_02122	309	363	54	0.241071	0.148352
GCA_000150085.1-Fun_DS268118.1_i000_010000	182	282	100	0.446429	0.185185
GCA_000150085.1-Fun_DS268118.1_i000_010000	279	349	70	0.3125	0.12963
GCA_022059095.1-Pro_JAJSEB010000047.1_i000_007223	3	129	126	0.5625	0.527197
GCA_021461655.1-Ani_CM038289.1_i000_008333	246	308	62	0.276786	0.113761
GCA_021461655.1-Ani_CM038289.1_i000_008333	337	380	43	0.191964	0.0788991
GCA_013115135.1-Pro_JABANP010000068.1_i000_012398	163	206	43	0.191964	0.193694
GCA_016808215.1-Pla_CM029009.1_i000_028225	194	290	96	0.428571	0.154093
GCA_018687715.1-Pla_CM031822.1_i000_028599	194	290	96	0.428571	0.154093
GCA_018688675.1-Pla_CM031838.1_i000_028349	194	290	96	0.428571	0.154093
GCA_018689175.1-Pla_CM031854.1_i000_026999	194	290	96	0.428571	0.154093
GCA_000182765.2-Fun_HE605205.1_i000_003878	5	92	87	0.388393	0.769912
GCA_014049445.1-Fun_JABWAB010000004.1_i000_002589	5	92	87	0.388393	0.769912
GCA_014049455.1-Fun_JABWAA010000003.1_i000_002254	5	92	87	0.388393	0.769912
GCA_014049495.1-Fun_JABWAC010000003.1_i000_002535	5	92	87	0.388393	0.769912
GCA_014049585.1-Fun_JABVZZ010000002.1_i000_002230	5	92	87	0.388393	0.769912
GCA_903989565.1-Fun_CAJEJE010000003.1_i000_003287	5	92	87	0.388393	0.769912
GCA_000499385.1-Pro_HG725401.1_i000_006117	1	78	77	0.34375	0.292776
GCA_015143295.1-Pla_CM026563.1_i000_018585	191	304	113	0.504464	0.180511
GCA_000002775.3-Pla_CM009302.1_i000_031225	1	49	48	0.214286	0.428571
GCA_013467475.1-Pla_CM025173.1_i000_010850	1	43	42	0.1875	0.42
GCA_905231905.1-Pro_CAJNIZ010000676.1_i000_000779	160	258	98	0.4375	0.379845
GCA_015679495.1-Fun_JAAAUW010003316.1_i000_010571	186	290	104	0.464286	0.358621
GCA_000818735.3-Pla_JTFG03001496.1_i000_015557	5	72	67	0.299107	0.223333
GCA_001884805.1-Pla_MKKS01001020.1_i000_007935	5	72	67	0.299107	0.223333
GCA_001884845.1-Pla_MKKT01001753.1_i000_011594	5	72	67	0.299107	0.223333
GCA_001275005.1-Pro_JWZX01003125.1_i000_013432	22	109	87	0.388393	0.360996
GCA_001275005.1-Pro_JWZX01003125.1_i000_013432	164	240	76	0.339286	0.315353
GCA_002218305.1-Ani_MCFN01001405.1_i000_015512	5	66	61	0.272321	0.276018
GCA_000219495.2-Pla_CM001222.2_i000_034914	108	187	79	0.352679	0.411458
GCA_000203815.1-Pro_GL883014.1_i000_005771	47	149	102	0.455357	0.68
GCA_007726485.1-Pla_CM017440.1_i000_009258	960	1074	114	0.508929	0.0957179
GCA_015852605.2-Pla_CM027588.2_i000_030116	44	117	73	0.325893	0.0937099
GCA_014282245.1-Pla_CM024964.1_i000_027489	1	44	43	0.191964	0.0793358
GCA_013115895.1-Pro_JABANM010019060.1_i000_015632	1	44	43	0.191964	0.313869
GCA_002211085.2-Pla_CM008047.2_i000_008078	1	42	41	0.183036	0.344538
GCA_013467475.1-Pla_CM025179.1_i000_024386	1	58	57	0.254464	0.286432
GCA_003260635.2-Pla_QGKW02002005.1_i000_026401	85	190	105	0.46875	0.347682
GCA_003260635.2-Pla_QGKW02002005.1_i000_026401	185	288	103	0.459821	0.34106
GCA_008787405.2-Ani_CM018485.1_i000_013326	219	300	81	0.361607	0.166667
GCA_016808335.1-Pla_CM029042.1_i000_053267	1	42	41	0.183036	0.506173
GCA_006461475.1-Ani_SUNJ01010334.1_i000_008230	212	272	60	0.267857	0.134529
GCA_002966975.2-Pla_PJQY01003174.1_i000_034223	574	663	89	0.397321	0.108273
ACIN002.0722.00003.C001_04019	6	134	128	0.571429	0.649746
GCA_016584175.1-Fun_PUHR01000280.1_i000_002842	191	300	109	0.486607	0.254079
NOSP051.0722.00001.C001_04014	38	172	134	0.598214	0.647343
GCA_015852435.1-Fun_JAAAIJ010002067.1_i000_004312	1	48	47	0.209821	0.29375
GCA_002906115.4-Pla_PKMF03015355.1_i000_054125	193	308	115	0.513393	0.186386
GCA_001513925.1-Fun_LLXE01000061.1_i000_009653	57	114	57	0.254464	0.375
GCA_021613535.1-Ani_CP075497.1_i000_027173	74	167	93	0.415179	0.157895
GCA_918697745.1-Ani_CAKKLH010000235.1_i000_008717	95	202	107	0.477679	0.264198
GCA_918697745.1-Ani_CAKKLH010000235.1_i000_008717	273	392	119	0.53125	0.293827
GCA_903112645.1-Pla_CAEKDK010000004.1_i000_016267	11	64	53	0.236607	0.80303
GCA_903114435.1-Pla_CAEKKB010000004.1_i000_016082	11	64	53	0.236607	0.80303
GCA_000230795.1-Ani_CM001267.1_i000_013048	2	72	70	0.3125	0.921053
GCA_000230815.1-Ani_CM001290.1_i000_011883	2	72	70	0.3125	0.921053
GCA_018688675.1-Pla_CM031825.1_i000_000852	23	80	57	0.254464	0.640449
GCA_011752425.2-Ani_CACVKT020005888.1_i000_032563	112	178	66	0.294643	0.207547
GCA_905338405.1-Ani_CAJPEX010002591.1_i000_008683	195	272	77	0.34375	0.0955335
GCA_905338405.1-Ani_CAJPEX010002591.1_i000_008683	294	370	76	0.339286	0.0942928
GCA_005393395.2-Pla_CM016617.1_i000_008584	87	211	124	0.553571	0.56621
GCA_013467475.1-Pla_CM025173.1_i000_012641	1	58	57	0.254464	0.247826
GCA_009835205.1-Pro_VJMI01016570.1_i000_010726	1080	1190	110	0.491071	0.092437
GCA_000582765.1-Pro_HF955089.1_i000_005104	1	128	127	0.566964	0.524793
GCA_001432165.1-Fun_LGUB01000255.1_i000_003057	1	88	87	0.388393	0.639706
GCA_000315875.1-Fun_HE681721.1_i000_002525	4	91	87	0.388393	0.756522
GCA_001432165.1-Fun_LGUB01001450.1_i000_001250	1	88	87	0.388393	0.621429
GCA_014282345.1-Pla_CM024981.1_i000_039993	102	143	41	0.183036	0.157692
GCA_014282345.1-Pla_CM024981.1_i000_039993	136	183	47	0.209821	0.180769
GCA_013368755.1-Fun_CP055899.1_i000_002511	663	797	134	0.598214	0.163017
GCA_905332245.1-Ani_CAJOBP010037010.1_i000_037349	31	123	92	0.410714	0.747967
GCA_905332275.1-Ani_CAJOBR010029324.1_i000_036594	31	123	92	0.410714	0.747967
GCA_010194725.1-Pro_WXXK01000658.1_i000_004422	192	271	79	0.352679	0.2
GCA_013115895.1-Pro_JABANM010018810.1_i000_015423	30	147	117	0.522321	0.795918
GCA_900618425.1-Ani_UZAN01045143.1_i000_007830	51	105	54	0.241071	0.166667
GCA_900618425.1-Ani_UZAN01045143.1_i000_007830	116	174	58	0.258929	0.179012
GCA_003325435.1-Fun_PJQL01000681.1_i000_006174	1	42	41	0.183036	0.398058
GCA_004011995.1-Pla_QGNW01000004.1_i000_002133	57	139	82	0.366071	0.405941
GCA_004011995.1-Pla_QGNW01000004.1_i000_002133	135	202	67	0.299107	0.331683
GCA_003573695.1-Pla_PUWZ01003678.1_i000_044893	3	69	66	0.294643	0.309859
GCA_905397895.1-Ani_CAJPWZ010000711.1_i000_013834	127	243	116	0.517857	0.248394
