#target	target_begin	target_end	hit_len	query_cov	target_cov
ALSP018.0722.00001.C001_02502	2	136	134	1	0.964029
SYLI002.0722.00001.C001_00359	1	134	133	0.992537	0.923611
CAKO002.0722.00001.C001_00570	9	142	133	0.992537	0.869281
KYTU001.0722.00001.C001_01116	2	135	133	0.992537	0.847134
SYAC003.0722.00001.C001_00628	1	134	133	0.992537	0.886667
LEIS001.0722.00003.C001_01320	4	137	133	0.992537	0.93662
CAUA001.0722.00001.C001_02604	4	135	131	0.977612	0.956204
CAME004.0722.00001.C001_00399	16	149	133	0.992537	0.886667
ALAC002.0722.00001.C001_02051	1	134	133	0.992537	0.904762
CHAU001.0722.00001.C001_04023	4	137	133	0.992537	0.869281
THTA001.0722.00001.C001_00631	1	131	130	0.970149	0.948905
ACST001.0722.00001.C001_01491	2	137	135	1.00746	0.971223
TIAE001.0722.00001.C001_00086	2	133	131	0.977612	0.97037
GCA_016618355.2-Fun_JADGIP010000056.1_i000_001953	153	286	133	0.992537	0.461806
SUVA001.0722.00001.C001_03482	4	137	133	0.992537	0.943262
SUFO001.0722.00001.C001_00114	4	133	129	0.962687	0.921429
PSRU001.0722.00001.C001_01894	12	145	133	0.992537	0.892617
ALSP012.0722.00001.C001_00984	1	134	133	0.992537	0.956835
VUIN001.0722.00001.C001_00543	1	133	132	0.985075	0.93617
CAIZ001.0722.00001.C001_01634	1	136	135	1.00746	0.978261
LEWA001.0722.00001.C001_01623	2	136	134	1	0.971014
LADE001.0722.00002.C001_00470	1	138	137	1.02239	0.964789
CAPU001.0722.00001.C001_00223	1	134	133	0.992537	0.923611
FIAL001.0722.00001.C001_01418	3	138	135	1.00746	0.971223
CAAB001.0722.00001.C001_02599	2	135	133	0.992537	0.970803
DITH001.0722.00001.C001_00848	1	134	133	0.992537	0.956835
THST001.0722.00001.C001_02111	1	136	135	1.00746	0.964286
CHTH003.0722.00001.C001_01436	20	153	133	0.992537	0.791667
MUVA001.0722.00002.C001_01093	2	134	132	0.985075	0.956522
CAPA003.0722.00001.C001_01152	17	150	133	0.992537	0.826087
SINE001.0722.00001.C001_00899	2	136	134	1	0.978102
SOMA002.0722.00001.C001_01417	1	134	133	0.992537	0.95
CAPE001.0722.00001.C001_01153	20	153	133	0.992537	0.852564
ORTS001.0722.00001.C001_01086	17	149	132	0.985075	0.840764
CARU002.0722.00001.C001_00053	4	138	134	1	0.943662
HAOC001.0722.00001.C001_05432	2	137	135	1.00746	0.971223
GCA_000507165.2-Ani_KZ497566.1_i000_001012	2	135	133	0.992537	0.222408
ALMU001.0722.00001.C001_00218	2	136	134	1	0.924138
COEN002.0722.00001.C001_00576	1	131	130	0.970149	0.948905
USPA001.0722.00001.C001_03732	3	135	132	0.985075	0.916667
CAPR002.0722.00001.C001_01121	9	142	133	0.992537	0.826087
HIMA001.0722.00001.C001_00027	1	134	133	0.992537	0.977941
GRTU001.0722.00001.C001_02759	4	138	134	1	0.937063
GCA_013368085.1-Ani_JABVZW010002580.1_i000_014006	174	307	133	0.992537	0.431818
WACH001.0722.00001.C001_01086	3	143	140	1.04478	0.945946
FLPL001.0722.00001.C001_01664	1	133	132	0.985075	0.93617
KTRU001.0722.00001.C001_06031	2	153	151	1.12687	0.92638
THTE003.0722.00001.C001_00086	1	134	133	0.992537	0.910959
EZMA001.0722.00001.C001_00404	3	136	133	0.992537	0.963768
PAFE001.0722.00001.C001_06885	15	152	137	1.02239	0.872611
MUCA001.0722.00001.C001_02562	2	135	133	0.992537	0.970803
THSP016.0722.00001.C001_01238	1	134	133	0.992537	0.401813
MESP069.0722.00001.C001_00972	1	134	133	0.992537	0.910959
CARH004.0722.00001.C001_00705	4	138	134	1	0.930556
LISU001.0722.00001.C001_02279	1	132	131	0.977612	0.97037
DEAF001.0722.00001.C001_03410	1	134	133	0.992537	0.985185
SUAZ001.0722.00001.C001_00776	2	133	131	0.977612	0.949275
BRLU001.0722.00001.C001_00529	6	140	134	1	0.848101
PLSP003.0722.00001.C001_02680	22	155	133	0.992537	0.782353
CARH002.0722.00001.C001_00662	2	134	132	0.985075	0.94964
CAHU001.0722.00001.C001_03842	4	137	133	0.992537	0.880795
GCA_013329495_00843	2	138	136	1.01493	0.964539
CAPL005.0722.00001.C001_00729	4	136	132	0.985075	0.942857
ACHY001.0722.00001.C001_02277	29	164	135	1.00746	0.741758
FRTU002.0722.00001.C001_01215	7	140	133	0.992537	0.801205
HAMA004.0722.00001.C001_03827	1	131	130	0.970149	0.977444
TEAL001.0722.00001.C001_00183	7	140	133	0.992537	0.869281
SAAM002.0722.00001.C001_04447	12	145	133	0.992537	0.810976
CHYU001.0722.00001.C001_01340	4	136	132	0.985075	0.846154
LIPI001.0722.00001.C001_02523	7	139	132	0.985075	0.795181
ROSP009.0722.00001.C001_05678	2	136	134	1	0.887417
CAPE002.0722.00001.C001_01079	15	148	133	0.992537	0.880795
ECSP001.0722.00001.C001_01228	17	153	136	1.01493	0.860759
EGHA001.0722.00001.C001_02212	18	153	135	1.00746	0.84375
MAIN001.0722.00001.C001_00044	2	137	135	1.00746	0.964286
NOSP001.0722.00001.C001_00320	27	159	132	0.985075	0.8
SOCE001.0722.00002.C001_04240	4	137	133	0.992537	0.956835
MESP078.0722.00001.C001_00329	11	145	134	1	0.887417
LULU001.0722.00001.C001_02276	7	140	133	0.992537	0.943262
BLEN002.0722.00001.C001_00253	2	135	133	0.992537	0.83125
IGSP001.0722.00001.C001_00875	18	148	130	0.970149	0.855263
ENPR001.0722.00001.C001_00751	2	134	132	0.985075	0.963504
BRVO001.0722.00001.C001_01075	12	145	133	0.992537	0.836478
DERE001.0722.00001.C001_01133	1	134	133	0.992537	0.93662
GRAN001.0722.00001.C001_01195	9	146	137	1.02239	0.925676
DEFO001.0722.00001.C001_00065	3	137	134	1	0.924138
DISP002.0722.00001.C001_01708	14	152	138	1.02985	0.878981
RIEN003.0722.00001.C001_00829	17	150	133	0.992537	0.858065
ACSP002.0722.00001.C001_02861	4	137	133	0.992537	0.880795
CAEX001.0722.00001.C001_00445	5	137	132	0.985075	0.897959
ISPA001.0722.00001.C001_00377	2	139	137	1.02239	0.748634
THAC004.0722.00001.C001_01066	6	138	132	0.985075	0.929577
DEIN001.0722.00001.C001_00478	2	137	135	1.00746	0.888158
TESP001.0722.00001.C001_05190	4	137	133	0.992537	0.886667
PRSP014.0722.00001.C001_02236	7	140	133	0.992537	0.93662
PISA001.0722.00002.C001_03049	5	131	126	0.940299	0.9
COAK001.0722.00001.C001_02456	1	133	132	0.985075	0.862745
MYSY001.0722.00004.C001_00079	1	135	134	1	0.978102
PABO001.0722.00001.C001_00756	8	141	133	0.992537	0.815951
MYSP013.0722.00001.C001_00198	2	137	135	1.00746	0.985401
CAAE001.0722.00001.C001_01148	22	149	127	0.947761	0.610577
ACHI001.0722.00001.C001_00613	1	135	134	1	0.964029
IMCE001.0722.00001.C001_01834	3	135	132	0.985075	0.963504
MYPU001.0722.00001.C001_00575	5	141	136	1.01493	0.931507
AMCO001.0722.00001.C001_01064	16	148	132	0.985075	0.868421
PYPI001.0722.00001.C001_00888	2	134	132	0.985075	0.942857
AHAF001.0722.00001.C001_04207	5	141	136	1.01493	0.957746
ACFE006.0722.00001.C001_02840	6	139	133	0.992537	0.93007
WOEN029.0722.00001.C001_00279	17	150	133	0.992537	0.858065
GCA_905338395.1-Ani_CAJPEW010032600.1_i000_015560	156	286	130	0.970149	0.454545
THAL001.0722.00001.C001_00151	1	132	131	0.977612	0.984962
CAHY004.0722.00001.C001_01558	1	134	133	0.992537	0.963768
HAHA001.0722.00001.C001_02333	10	141	131	0.977612	0.909722
BELE001.0722.00002.C001_03476	7	142	135	1.00746	0.918367
FOOE001.0722.00001.C001_01652	17	151	134	1	0.842767
ACWU001.0722.00001.C001_00278	18	151	133	0.992537	0.847134
ALSP015.0722.00001.C001_02509	2	135	133	0.992537	0.977941
MEDI001.0722.00001.C001_00229	5	140	135	1.00746	0.918367
GCA_905231925.1-Pro_CAJNJV010003113.1_i000_004109	754	886	132	0.985075	0.14683
SPPL002.0722.00001.C001_00314	1	136	135	1.00746	0.9
DEBA001.0722.00001.C001_02942	7	139	132	0.985075	0.910345
COSP022.0722.00001.C001_01525	15	153	138	1.02985	0.857143
GCA_001884805.1-Pla_MKKS01000016.1_i000_000534	173	299	126	0.940299	0.411765
MIAE002.0722.00001.C001_01001	17	156	139	1.03731	0.858025
BUAP001.0722.00001.C001_00149	1	132	131	0.977612	0.903448
MERO001.0722.00001.C001_01959	1	131	130	0.970149	0.970149
SPSA002.0722.00001.C001_00164	2	139	137	1.02239	0.919463
MYMO001.0722.00001.C001_00471	1	134	133	0.992537	0.923611
HYNE001.0722.00001.C001_02286	13	146	133	0.992537	0.880795
ANPH001.0722.00001.C001_00164	17	150	133	0.992537	0.801205
SPAT001.0722.00001.C001_00580	3	139	136	1.01493	0.964539
TEBO001.0722.00001.C001_02225	10	140	130	0.970149	0.896552
FRAD001.0722.00001.C001_01066	3	136	133	0.992537	0.970803
BRFE001.0722.00001.C001_01030	1	134	133	0.992537	0.892617
MOCU001.0722.00002.C001_01526	4	138	134	1	0.881579
MYAN003.0722.00002.C001_00079	1	141	140	1.04478	0.992908
IGAL001.0722.00001.C001_01362	7	140	133	0.992537	0.93007
MIPR001.0722.00001.C001_03125	7	138	131	0.977612	0.200613
ACSP041.0722.00001.C001_00520	7	142	135	1.00746	0.865385
DEMC001.0722.00009.C001_00050	1	127	126	0.940299	0.933333
MOOS001.0722.00009.C001_01870	17	154	137	1.02239	0.850932
NAAN002.0722.00001.C001_00873	3	136	133	0.992537	0.83125
GCA_000507165.2-Ani_KZ499229.1_i000_015698	198	320	122	0.910448	0.376543
HUBO001.0722.00001.C001_03833	1	139	138	1.02985	0.92
DEVU001.0722.00001.C001_02893	1	134	133	0.992537	0.93662
OPTE001.0722.00001.C001_03587	1	134	133	0.992537	0.917241
CANA002.0722.00001.C001_00595	8	139	131	0.977612	0.873333
MYSP017.0722.00001.C001_00095	1	136	135	1.00746	0.957447
MAAE002.0722.00001.C001_00300	37	167	130	0.970149	0.747126
MAAL001.0722.00001.C001_00468	12	145	133	0.992537	0.858065
GCA_905338395.1-Ani_CAJPEW010082003.1_i000_017515	7	143	136	1.01493	0.883117
HASP012.0722.00001.C001_02408	6	142	136	1.01493	0.883117
AECH001.0722.00001.C001_02077	4	136	132	0.985075	0.891892
FADU001.0722.00001.C001_00743	1	135	134	1	0.937063
SPSP027.0722.00001.C001_00548	2	138	136	1.01493	0.964539
ENOF007.0722.00001.C001_00271	28	161	133	0.992537	0.782353
WESP001.0722.00001.C001_00412	7	144	137	1.02239	0.938356
FISU001.0722.00002.C001_00394	1	135	134	1	0.978102
LUSP006.0722.00001.C001_01926	1	139	138	1.02985	0.945205
GCA_016097865.1-Fun_JAAAIN010000003.1_i000_000077	5	131	126	0.940299	0.425676
GEPH001.0722.00001.C001_00836	5	139	134	1	0.832298
PHCO001.0722.00002.C001_00757	1	134	133	0.992537	0.970803
FLTA001.0722.00001.C001_00968	2	135	133	0.992537	0.93662
MEAR002.0722.00001.C001_00154	1	140	139	1.03731	0.945578
THAM003.0722.00001.C001_01696	1	133	132	0.985075	0.977778
BISU001.0722.00001.C001_01246	1	153	152	1.13433	0.95
ORMA001.0722.00001.C001_03326	5	129	124	0.925373	0.939394
RHLA002.0722.00001.C001_00731	4	138	134	1	0.864516
CHTH002.0722.00001.C001_01354	30	163	133	0.992537	0.796407
EUPA001.0722.00001.C001_01740	6	136	130	0.970149	0.942029
ACYI001.0722.00001.C001_00284	1	134	133	0.992537	0.904762
OWHO001.0722.00001.C001_01184	2	135	133	0.992537	0.963768
SCSP002.0722.00001.C001_01140	17	151	134	1	0.757062
EPCI001.0722.00001.C001_00299	4	136	132	0.985075	0.963504
HYSP033.0722.00001.C001_00213	1	122	121	0.902985	0.98374
CAPO001.0722.00003.C001_00288	4	134	130	0.970149	0.970149
CHVO001.0722.00001.C001_00361	6	140	134	1	0.917808
URPA001.0722.00001.C001_00401	1	143	142	1.0597	0.965986
TERO001.0722.00001.C001_00023	5	138	133	0.992537	0.898649
ACFE004.0722.00001.C001_00957	7	136	129	0.962687	0.934783
ELBR001.0722.00001.C001_02734	2	135	133	0.992537	0.977941
SARU001.0722.00001.C001_01200	8	141	133	0.992537	0.93007
AQOL002.0722.00001.C001_00245	8	142	134	1	0.930556
PONE001.0722.00006.C001_01873	13	138	125	0.932836	0.874126
FIGI001.0722.00001.C001_01041	1	134	133	0.992537	0.963768
MIOC001.0722.00001.C001_01768	1	129	128	0.955224	0.977099
MAIO001.0722.00001.C001_00482	4	135	131	0.977612	0.956204
OCMA001.0722.00001.C001_03871	7	155	148	1.10448	0.930818
GCA_905221635.1-Pro_CAJNDV010029874.1_i000_018539	173	288	115	0.858209	0.399306
EGRH001.0722.00001.C001_03869	8	49	41	0.30597	0.253086
EGRH001.0722.00001.C001_03869	57	159	102	0.761194	0.62963
WOOC001.0722.00001.C001_00637	11	146	135	1.00746	0.90604
RIEN001.0722.00001.C001_00072	16	145	129	0.962687	0.86
TRRA001.0722.00001.C001_01947	3	137	134	1	0.87013
THPA002.0722.00001.C001_00330	1	133	132	0.985075	0.977778
MIMA002.0722.00001.C001_00408	1	132	131	0.977612	0.963235
THSP036.0722.00001.C001_02439	1	128	127	0.947761	0.976923
HYNI002.0722.00001.C001_03446	2	135	133	0.992537	0.93662
PHME001.0722.00001.C001_02865	3	134	131	0.977612	0.89726
SUWA001.0722.00001.C001_02268	13	135	122	0.910448	0.865248
CHPE001.0722.00001.C001_00532	8	144	136	1.01493	0.931507
CANA008.0722.00001.C001_00483	4	132	128	0.955224	0.934307
CAEN007.0722.00001.C001_00141	6	139	133	0.992537	0.910959
GCA_003427395.1-Pla_BFEA01000082.1_i000_008216	10	148	138	1.02985	0.192737
ARSP004.0722.00001.C001_02238	30	170	140	1.04478	0.614035
SAGR001.0722.00001.C001_00851	2	134	132	0.985075	0.970588
HYTH002.0722.00001.C001_01783	11	146	135	1.00746	0.798817
ACCA001.0722.00001.C001_00164	11	144	133	0.992537	0.898649
NEAE001.0722.00001.C001_00463	21	110	89	0.664179	0.42381
NEAE001.0722.00001.C001_00463	126	178	52	0.38806	0.247619
PECA001.0722.00001.C001_05891	1	125	124	0.925373	0.953846
FLCE001.0722.00001.C001_00169	1	134	133	0.992537	0.836478
JODE001.0722.00001.C001_01367	7	154	147	1.09701	0.88024
GCA_006369765.1-Pro_RRYP01036376.1_i000_017699	7	137	130	0.970149	0.872483
ENFR001.0722.00001.C001_00190	2	139	137	1.02239	0.925676
RUXY001.0722.00001.C001_00674	6	136	130	0.970149	0.928571
KOOL001.0722.00001.C001_01474	5	130	125	0.932836	0.527426
CAPR008.0722.00001.C001_00266	13	138	125	0.932836	0.892857
GCA_020379485.1-Pla_CM035461.1_i000_071092	441	578	137	1.02239	0.232598
TESP010.0722.00001.C001_01354	4	136	132	0.985075	0.862745
SUSP028.0722.00001.C001_00777	5	130	125	0.932836	0.94697
BRHY001.0722.00004.C001_00467	1	131	130	0.970149	0.935252
PRMA001.0722.00001.C001_00845	9	138	129	0.962687	0.843137
COWO001.0722.00001.C001_03056	1	125	124	0.925373	0.946565
GCA_000708835.1-Pla_DF237216.1_i000_007592	74	210	136	1.01493	0.586207
SYSP001.0722.00001.C001_01796	6	135	129	0.962687	0.772455
BOTA001.0722.00001.C001_00868	4	137	133	0.992537	0.836478
CAKI001.0722.00001.C001_00600	1	130	129	0.962687	0.955556
GCA_009835225.1-Ani_VUJU01014524.1_i000_030021	214	338	124	0.925373	0.280543
KOPA001.0722.00001.C001_00793	1	125	124	0.925373	0.53913
MEBO002.0722.00001.C001_00208	5	145	140	1.04478	0.945946
TRWH001.0722.00001.C001_00423	8	134	126	0.940299	0.868966
GCA_000341285.1-Pro_KB454498.1_i000_002062	62	196	134	1	0.538153
DINO001.0722.00001.C001_01095	3	128	125	0.932836	0.968992
CAMI003.0722.00001.C001_00249	23	154	131	0.977612	0.813665
CAHY003.0722.00001.C001_00460	16	148	132	0.985075	0.830189
CAPH002.0722.00001.C001_00055	17	146	129	0.962687	0.826923
CACH002.0722.00001.C001_00524	1	128	127	0.947761	0.940741
TUPA001.0722.00001.C001_03163	5	136	131	0.977612	0.956204
COPR003.0722.00001.C001_00723	1	129	128	0.955224	0.934307
GCA_008009225.1-Pla_CM017762.1_i000_003257	277	426	149	1.11194	0.20383
GCA_002966975.2-Pla_PJQY01003786.1_i000_039224	570	707	137	1.02239	0.190014
CAHE003.0722.00001.C001_00303	1	136	135	1.00746	0.985401
CAAV001.0722.00001.C001_00610	1	127	126	0.940299	0.992126
MYGE001.0722.00002.C001_00375	2	136	134	1	0.971014
BLCU001.0722.00012.C001_00140	2	134	132	0.985075	0.942857
CASU004.0722.00002.C001_00076	2	133	131	0.977612	0.963235
SERO002.0722.00001.C001_01722	1	133	132	0.985075	0.910345
GCA_000310025.1-Pro_FN649727.1_i000_000433	98	238	140	1.04478	0.542636
LESP003.0722.00001.C001_01516	16	162	146	1.08955	0.853801
GCA_000091205.1-Pro_AP006495.2_i000_002276	66	190	124	0.925373	0.558559
GCA_009746105.1-Pla_CM019272.1_i000_016016	465	602	137	1.02239	0.223491
GCA_000315625.1-Pro_JH993003.1_i000_010809	7	140	133	0.992537	0.917241
GCA_918797485.1-Pro_CAKKNE010000006.1_i000_015403	77	203	126	0.940299	0.531646
GCA_000372725.1-Pro_KB866393.1_i000_023439	25	157	132	0.985075	0.6
GCA_009363875.1-Pla_CM018689.1_i000_039161	306	439	133	0.992537	0.284797
HEWI001.0722.00001.C001_00358	4	142	138	1.02985	0.945205
GCA_000341285.1-Pro_KB454517.1_i000_003877	21	168	147	1.09701	0.864706
GCA_904420315.1-Pla_LR881466.1_i000_000985	715	848	133	0.992537	0.149775
STDE005.0722.00001.C001_00288	1	123	122	0.910448	0.890511
MAPI001.0722.00001.C001_00970	1	129	128	0.955224	0.603774
GCA_014282345.1-Pla_CM024968.1_i000_002528	269	407	138	1.02985	0.330144
THAC001.0722.00001.C001_00598	1	129	128	0.955224	0.920863
GCA_015852605.2-Pla_CM027573.2_i000_007773	69	202	133	0.992537	0.568376
GCA_002897195.1-Pla_BDQV01000015.1_i000_006297	737	870	133	0.992537	0.135853
GCA_003194525.1-Pro_NBIV01000198.1_i000_008431	33	166	133	0.992537	0.607306
GCA_003032435.1-Pla_KZ772682.1_i000_003085	148	282	134	1	0.404834
GCA_004379255.2-Pla_CM031493.1_i000_053493	312	449	137	1.02239	0.292735
GCA_008124465.1-Pla_CM017877.1_i000_010416	689	826	137	1.02239	0.149075
BAST002.0722.00001.C001_00617	16	152	136	1.01493	0.894737
NEFI001.0722.00001.C001_00006	1	126	125	0.932836	0.886525
GCA_000003745.2-Pla_FN597039.1_i000_018419	510	643	133	0.992537	0.195876
GCA_015731905.1-Pla_JADGMS010000022.1_i000_029607	502	635	133	0.992537	0.201515
GCA_904845875.1-Pla_CAJGYO010000002.1_i000_007821	487	622	135	1.00746	0.207055
GCA_020310875.1-Pla_CM035418.1_i000_012500	17	155	138	1.02985	0.846626
GCA_008690995.1-Pro_VRMN01000005.1_i000_003787	24	159	135	1.00746	0.758427
CASP011.0722.00001.C001_00757	1	123	122	0.910448	0.99187
GCA_905397405.1-Ani_CAJPVJ010000046.1_i000_000576	1	107	106	0.791045	0.392593
GCA_019448385.1-Pro_JAGTXO010000009.1_i000_006323	48	188	140	1.04478	0.595745
GCA_916048055.1-Pla_CAJZHL010000031.1_i000_007373	141	277	136	1.01493	0.478873
GCA_000143415.2-Pla_GL377574.1_i000_007751	24	155	131	0.977612	0.704301
GCA_000147415.1-Pla_GL433858.1_i000_008026	28	172	144	1.07463	0.634361
GCA_011745865.1-Pla_VYZZ01005692.1_i000_023089	152	287	135	1.00746	0.290948
GCA_000751175.1-Pro_CCKQ01013997.1_i000_014591	15	157	142	1.0597	0.599156
CACH003.0722.00001.C001_00297	2	129	127	0.947761	0.962121
GCA_002245815.2-Pla_LHPF02000021.1_i000_004059	570	714	144	1.07463	0.1875
GCA_013368085.1-Ani_JABVZW010002627.1_i000_014806	2	117	115	0.858209	0.156038
GCA_000583005.2-Pla_ASHM01014069.1_i000_018794	128	242	114	0.850746	0.402827
GCA_000150955.2-Pro_CM000606.1_i000_001617	18	154	136	1.01493	0.715789
MEPR001.0722.00001.C001_00300	1	125	124	0.925373	0.525424
GCA_003260695.2-Pla_QGKY02000190.1_i000_035694	65	194	129	0.962687	0.300699
MYSP006.0722.00001.C001_00089	6	145	139	1.03731	0.952055
GCA_000310025.1-Pro_FN649751.1_i000_010832	78	214	136	1.01493	0.459459
GCA_004565275.1-Pro_SDOX01000010.1_i000_000506	114	228	114	0.850746	0.485106
GCA_001049375.1-Pro_CDSF01000130.1_i000_008240	55	182	127	0.947761	0.574661
CAAZ002.0722.00001.C001_00068	1	131	130	0.970149	0.948905
LEFE002.0722.00001.C001_01493	28	174	146	1.08955	0.744898
GCA_000743755.1-Pro_JPUL02000350.1_i000_004794	21	151	130	0.970149	0.802469
GCA_918797485.1-Pro_CAKKNE010000003.1_i000_008037	18	151	133	0.992537	0.801205
HEBI001.0722.00001.C001_02350	1	148	147	1.09701	0.607438
GCA_000708835.1-Pla_DF237096.1_i000_010201	19	162	143	1.06716	0.8125
HASP018.0722.00001.C001_00642	16	152	136	1.01493	0.894737
GCA_010458925.1-Pla_JAAGAX010000511.1_i000_042809	601	693	92	0.686567	0.107351
GCA_021556665.1-Fun_JAKFGG010000039.1_i000_006803	21	166	145	1.08209	0.857988
GCA_002158475.1-Pla_KZ155793.1_i000_004706	63	212	149	1.11194	0.665179
DETU001.0722.00001.C001_00383	1	129	128	0.955224	0.558952
GCA_000569095.1-Pro_CM002469.1_i000_006443	75	222	147	1.09701	0.452308
GCA_002220235.1-Pla_FO082271.1_i000_004017	17	177	160	1.19403	0.8
DEPR002.0722.00001.C001_00318	28	148	120	0.895522	0.769231
BLCU001.0722.00019.C001_00160	2	144	142	1.0597	0.44795
GCA_003427395.1-Pla_BFEA01000194.1_i000_014909	607	729	122	0.910448	0.162019
GCA_016618385.1-Ani_JABFOP010000001.1_i000_000378	418	497	79	0.589552	0.140569
GCA_001939145.1-Pro_LSRX01000159.1_i000_009250	146	300	154	1.14925	0.342222
GCA_002794465.1-Fun_MTSL01000112.1_i000_002399	31	172	141	1.05224	0.79661
TESP004.0722.00001.C001_00085	1	127	126	0.940299	0.577982
HESP004.0722.00001.C001_00924	1	128	127	0.947761	0.976923
GCA_002335675.1-Pla_BEGY01000034.1_i000_006048	133	285	152	1.13433	0.362768
ATSA001.0722.00001.C001_00714	1	120	119	0.88806	0.464844
GCA_003112345.1-Pla_PKPP01000272.1_i000_004545	22	158	136	1.01493	0.824242
GCA_900660405.1-Pro_CAACVS010000018.1_i000_000774	211	339	128	0.955224	0.278867
GCA_002245835.2-Pla_LHPG02000015.1_i000_002830	532	649	117	0.873134	0.152542
GCA_000149405.2-Pro_CM000653.1_i000_011039	204	342	138	1.02985	0.326241
GCA_013368085.1-Ani_JABVZW010002889.1_i000_018038	1	144	143	1.06716	0.178974
GCA_001970955.1-Pro_MPUH01000550.1_i000_022375	17	145	128	0.955224	0.815287
PSHY002.0722.00001.C001_01229	3	114	111	0.828358	0.518692
PSTH001.0722.00001.C001_01711	1	111	110	0.820896	0.518868
GCA_905146915.1-Pla_CAJHUC010000605.1_i000_002473	34	160	126	0.940299	0.577982
GCA_013368085.1-Ani_JABVZW010002580.1_i000_014005	206	267	61	0.455224	0.227612
GCA_000189635.1-Pro_GG662704.1_i000_009956	23	162	139	1.03731	0.842424
GCA_017506865.1-Pro_JAFCMP010000002.1_i000_000431	16	144	128	0.955224	0.888889
GCA_000816705.1-Ani_KN716705.1_i000_011660	2	90	88	0.656716	0.888889
GCA_003112345.1-Pla_PKPP01003421.1_i000_028203	121	257	136	1.01493	0.503704
GCA_000372725.1-Pro_KB864346.1_i000_007844	16	152	136	1.01493	0.809524
GCA_000090985.2-Pla_CP001329.1_i000_006485	96	221	125	0.932836	0.308642
THSP006.0722.00001.C001_01407	1	110	109	0.813433	0.52657
GCA_001659605.2-Pla_CM004403.2_i000_029556	71	180	109	0.813433	0.305322
GCA_021904315.1-Pla_CM038921.1_i000_020405	16	109	93	0.69403	0.704545
MYHA002.0722.00001.C001_01103	1	134	133	0.992537	0.93007
GCA_003370565.1-Pla_QJKJ01001595.1_i000_007981	215	332	117	0.873134	0.180835
GCA_000333075.3-Pro_AOFI03000087.1_i000_011099	82	151	69	0.514925	0.2875
GCA_011952115.1-Fun_JAANRI010006888.1_i000_015351	138	212	74	0.552239	0.336364
GCA_019650235.1-Pla_BNCP01000009.1_i000_004186	82	229	147	1.09701	0.57874
GCA_008009225.1-Pla_CM017768.1_i000_018764	22	171	149	1.11194	0.801075
GCA_001179505.1-Pro_CDMY01001057.1_i000_022887	23	121	98	0.731343	0.324503
THAF001.0722.00001.C001_00567	1	108	107	0.798507	0.529703
GCA_013368085.1-Ani_JABVZW010002580.1_i000_014004	72	152	80	0.597015	0.0985222
GCA_002049455.2-Pro_KV918763.1_i000_000223	36	153	117	0.873134	0.50431
GCA_000611645.1-Pla_KK104203.1_i000_013680	48	197	149	1.11194	0.519164
GCA_008009225.1-Pla_CM017764.1_i000_011526	32	175	143	1.06716	0.756614
GCA_002049455.2-Pro_KV918880.1_i000_005384	57	165	108	0.80597	0.497696
GCA_011745845.1-Pla_VYZY01005148.1_i000_021286	22	75	53	0.395522	0.281915
GCA_002284615.2-Pla_MU069473.1_i000_001814	84	237	153	1.14179	0.612
GCA_008009225.1-Pla_CM017772.1_i000_025002	27	162	135	1.00746	0.771429
CAFO002.0722.00001.C001_00230	118	192	74	0.552239	0.37
GCA_000504015.1-Pla_KI632162.1_i000_022347	2	104	102	0.761194	0.980769
GCA_017506865.1-Pro_JAFCMP010000088.1_i000_005622	23	151	128	0.955224	0.547009
GCA_003112345.1-Pla_PKPP01011121.1_i000_051678	35	177	142	1.0597	0.755319
GCA_905182995.1-Pro_CAJJDP010000029.1_i000_011445	17	145	128	0.955224	0.876712
MIAE001.0722.00001.C001_03461	1	129	128	0.955224	0.984615
GCA_003112345.1-Pla_PKPP01000227.1_i000_003941	220	360	140	1.04478	0.369393
FEPE001.0722.00001.C001_00656	1	111	110	0.820896	0.497738
GCA_006381635.2-Pla_VEPZ02000305.1_i000_008851	85	197	112	0.835821	0.506787
GCA_000331365.3-Pla_AMZH03005598.1_i000_020213	79	130	51	0.380597	0.238318
GCA_008009225.1-Pla_CM017772.1_i000_025337	26	170	144	1.07463	0.8
GCA_021029115.1-Pro_JAFCAG010000127.1_i000_003877	162	283	121	0.902985	0.357988
HAHY003.0722.00001.C001_00440	3	133	130	0.970149	0.935252
GCA_020796215.1-Pla_CM036782.1_i000_006044	25	179	154	1.14925	0.77
GCA_002786265.1-Pla_KZ454132.1_i000_020761	71	180	109	0.813433	0.144562
GCA_008009225.1-Pla_CM017762.1_i000_003252	27	176	149	1.11194	0.706161
GCA_002897195.1-Pla_BDQV01000161.1_i000_017970	265	383	118	0.880597	0.201022
GCA_008009225.1-Pla_CM017764.1_i000_011518	101	205	104	0.776119	0.466368
GCA_002786265.1-Pla_KZ451933.1_i000_006306	200	252	52	0.38806	0.169935
GCA_014282245.1-Pla_CM024953.1_i000_001479	22	104	82	0.61194	0.773585
GCA_003112345.1-Pla_PKPP01007139.1_i000_042598	24	100	76	0.567164	0.71028
THNA001.0722.00001.C001_00601	1	127	126	0.940299	0.940299
GCA_000091205.1-Pro_AP006492.2_i000_001523	31	173	142	1.0597	0.767568
IOFO001.0722.00001.C001_00477	1	128	127	0.947761	0.969466
GCA_008009225.1-Pla_CM017764.1_i000_011522	28	132	104	0.776119	0.781955
GCA_008009225.1-Pla_CM017765.1_i000_013484	65	206	141	1.05224	0.643836
GCA_001983315.1-Fun_MQVN01000144.1_i000_005311	261	412	151	1.00667	0.155992
GCA_018320845.1-Ani_CM031327.1_i000_013969	567	723	156	1.04	0.190476
GCA_002895965.2-Ani_PIJE02001226.1_i000_021025	99	255	156	1.04	0.579926
GCA_001594075.1-Ani_KQ979584.1_i000_006874	151	307	156	1.04	0.373206
GCA_002895965.2-Ani_PIJE02003479.1_i000_028262	1	117	116	0.773333	0.991453
GCA_015852435.1-Fun_JAAAIJ010001805.1_i000_003562	43	186	143	0.953333	0.169834
GCA_019924905.1-Fun_JAHFYL010010170.1_i000_021064	1	159	158	1.05333	0.37799
GCA_011763645.1-Fun_JAASGZ010004413.1_i000_015833	279	426	147	0.98	0.151703
GCA_017911155.1-Fun_JAEFCI010005514.1_i000_003571	4	150	146	0.973333	0.327354
GCA_000187875.1-Ani_GL732629.1_i000_020555	471	617	146	0.973333	0.150982
GCA_000182175.1-Fun_ABSV01000957.1_i000_001707	599	680	81	0.54	0.119118
GCA_018924745.1-Fun_CM032185.1_i000_007291	113	264	151	1.00667	0.161497
GCA_019633465.1-Fun_WSTY01009694.1_i000_014714	50	137	87	0.58	0.204225
GCA_019633465.1-Fun_WSTY01009694.1_i000_014714	235	301	66	0.44	0.15493
GCA_001630345.1-Fun_KV417331.1_i000_010785	394	485	91	0.606667	0.105814
GCA_001630345.1-Fun_KV417331.1_i000_010785	515	572	57	0.38	0.0662791
GCA_002003045.1-Fun_BDGU01000053.1_i000_002524	735	886	151	1.00667	0.162891
GCA_905330665.1-Ani_HG994590.1_i000_011865	749	886	137	0.913333	0.139511
GCA_005298045.1-Fun_SWBT01000237.1_i000_006103	24	177	153	1.02	0.836066
GCA_900618345.1-Ani_UZAJ01009091.1_i000_008175	13	140	127	0.846667	0.518367
GCA_905219565.1-Fun_CAJMWR010001680.1_i000_003537	529	623	94	0.626667	0.118388
GCA_905219565.1-Fun_CAJMWR010001680.1_i000_003537	701	766	65	0.433333	0.081864
GCA_008275145.1-Fun_CP043442.1_i000_001874	98	251	153	1.02	0.336264
GCA_905250885.1-Ani_CAJNOQ010019671.1_i000_034861	729	885	156	1.04	0.161826
GCA_003614755.1-Fun_KZ990564.1_i000_004383	281	426	145	0.966667	0.221713
GCA_900618395.1-Ani_UZAI01006775.1_i000_011435	138	297	159	1.06	0.331942
GCA_903994135.1-Ani_CAJEWN010000045.1_i000_009519	91	248	157	1.04667	0.550877
GCA_021605095.1-Ani_BPLR01016320.1_i000_062258	47	204	157	1.04667	0.583643
GCA_020875895.1-Ani_JNEY01006606.1_i000_035428	673	830	157	1.04667	0.16973
GCA_905250095.1-Ani_CAJNOR010017005.1_i000_062064	168	315	147	0.98	0.466667
GCA_001186125.1-Pro_KQ243609.1_i000_011982	54	201	147	0.98	0.617647
GCA_900537205.1-Ani_UYRW01002535.1_i000_007064	756	879	123	0.82	0.139932
GCA_000187875.1-Ani_GL732642.1_i000_021330	3	103	100	0.666667	0.757576
GCA_900617995.1-Ani_UZAL01031213.1_i000_010838	3	117	114	0.76	0.590674
GCA_910591765.1-Fun_CAJVPS010022400.1_i000_011893	410	556	146	0.973333	0.230648
GCA_002249905.1-Ani_NNAY01004456.1_i000_014413	529	662	133	0.886667	0.184466
GCA_001969505.1-Fun_LSSK01000856.1_i000_002047	2	111	109	0.726667	0.141558
GCA_000611955.2-Ani_KK112642.1_i000_001706	1	47	46	0.306667	0.103837
GCA_002762385.1-Pla_NKXS01004566.1_i000_021287	268	427	159	1.06	0.192029
GCA_900617985.1-Ani_UYRR01013030.1_i000_006164	1	109	108	0.72	0.955752
GCA_000512085.1-Pro_ASPP01010511.1_i000_014331	84	235	151	1.00667	0.457576
GCA_902860255.1-Pla_LR794332.1_i000_040000	546	693	147	0.98	0.211816
GCA_000350255.1-Fun_CAOJ01002700.1_i000_001945	1	49	48	0.32	0.220183
GCA_910591835.1-Fun_CAJVPV010051341.1_i000_017176	1	83	82	0.546667	0.350427
GCA_000697645.1-Fun_KL142379.1_i000_009862	355	503	148	0.986667	0.190231
GCA_003990765.1-Fun_RBNJ01016562.1_i000_010975	701	792	91	0.606667	0.0992366
GCA_000187875.1-Ani_GL732621.1_i000_020054	1	84	83	0.553333	0.281356
GCA_019633495.1-Fun_WSUD01001404.1_i000_006612	614	705	91	0.606667	0.108852
GCA_902602495.3-Pro_CACKRE030005229.1_i000_025006	111	194	83	0.553333	0.153137
GCA_000183025.1-Fun_ABRE01011375.1_i000_007761	47	106	59	0.393333	0.137529
GCA_000797555.1-Ani_KN549221.1_i000_000573	153	287	134	0.893333	0.209375
GCA_900617915.1-Ani_UYRT01099577.1_i000_023938	157	247	90	0.6	0.364372
GCA_020736565.1-Fun_JAHBOF010000011.1_i000_002785	709	840	131	0.873333	0.146532
GCA_000569095.1-Pro_CM002456.1_i000_000637	592	753	161	1.07333	0.185912
GCA_019973975.1-Ani_BMAO01021025.1_i000_037200	476	618	142	0.946667	0.157428
COUT001.0722.00001.C001_01375	312	444	132	0.88	0.175066
GCA_000188675.2-Pro_ADWP02000720.1_i000_000274	425	575	150	1	0.227964
GCA_002994745.2-Pla_CM009583.1_i000_006724	273	432	159	1.06	0.348684
Asgard_ASG031_01048	369	505	136	0.906667	0.180132
GCA_003704385.1-Fun_QWIM01003987.1_i000_016227	639	738	99	0.66	0.130952
GCA_002284615.2-Pla_MU069522.1_i000_003340	25	143	118	0.786667	0.422939
GCA_015849295.1-Fun_JAAAHW010000846.1_i000_001914	654	748	94	0.626667	0.0943775
PSEX001.0722.00001.C001_00787	330	464	134	0.893333	0.168766
BAFR001.0722.00012.C001_00937	8	131	123	0.82	0.657754
GCA_002966975.2-Pla_PJQY01003173.1_i000_034193	1	98	97	0.646667	0.866071
GCA_018292915.1-Ani_JACVVK010000127.1_i000_012857	355	496	141	0.94	0.16726
GCA_000760515.2-Fun_JMKJ01000612.1_i000_003293	621	712	91	0.606667	0.127809
GCA_014282345.1-Pla_CM024971.1_i000_009757	37	187	150	1	0.724638
GCA_903813345.1-Ani_CAIIXF010000015.1_i000_023868	351	474	123	0.82	0.156091
GCA_000209535.1-Ani_FN654024.1_i000_000360	315	452	137	0.913333	0.194602
GCA_001447575.1-Ani_JYDT01000049.1_i000_005834	354	497	143	0.953333	0.182864
GCA_001940645_00636	329	467	138	0.92	0.174684
Asgard_ASG078_03102	336	476	140	0.933333	0.177891
GCA_007210705.1-Ani_CM017379.1_i000_007790	355	476	121	0.806667	0.163293
BAST002.0722.00001.C001_01927	336	466	130	0.866667	0.167742
GCA_000209185.1-Ani_DS231901.1_i000_013896	582	709	127	1.00794	0.146482
GCA_000209185.1-Ani_DS231901.1_i000_013896	743	865	122	0.968254	0.140715
VALU001.0722.00002.C001_00107	325	452	127	1.00794	0.173735
HECO001.0722.00001.C001_00688	322	447	125	0.992063	0.171468
MACA001.0722.00001.C001_02180	309	434	125	0.992063	0.175809
HAHA006.0722.00001.C001_00127	315	440	125	0.992063	0.174338
STSI001.0722.00003.C001_00902	315	440	125	0.992063	0.174581
Asgard_ASG078_03102	337	466	129	1.02381	0.163914
NACA001.0722.00001.C001_01802	320	450	130	1.03175	0.178817
HAPR001.0722.00001.C001_01779	322	446	124	0.984127	0.171508
COUT001.0722.00001.C001_01375	308	434	126	1	0.167109
MAAL002.0722.00001.C001_00443	327	452	125	0.992063	0.172652
ENTC001.0722.00001.C001_01591	315	439	124	0.984127	0.178932
DEAC001.0722.00001.C001_01838	310	435	125	0.992063	0.177054
MASP003.0722.00001.C001_01657	311	436	125	0.992063	0.174338
THAR001.0722.00001.C001_01808	324	450	126	1	0.157303
MEMA001.0722.00001.C001_00893	316	441	125	0.992063	0.17337
MEPR001.0722.00001.C001_01794	313	438	125	0.992063	0.174338
CASU001.0722.00001.C001_00127	318	443	125	0.992063	0.178317
PEMU001.0722.00001.C001_00005	315	438	123	0.97619	0.173239
SYDY001.0722.00001.C001_04094	319	444	125	0.992063	0.172891
PEIV001.0722.00001.C001_01072	305	430	125	0.992063	0.180375
FUMO001.0722.00001.C001_00206	317	445	128	1.01587	0.177531
GCA_002104905.1-Fun_MCFE01000598.1_i000_012346	406	540	134	1.06349	0.164015
URUR001.0722.00003.C001_00029	316	441	125	0.992063	0.177054
Asgard_ASG031_01048	361	495	134	1.06349	0.177483
BAFR001.0722.00012.C001_00937	1	121	120	0.952381	0.641711
CAUA001.0722.00001.C001_01949	317	442	125	0.992063	0.174338
BAST002.0722.00001.C001_01927	330	456	126	1	0.162581
ENPR001.0722.00001.C001_00246	321	448	127	1.00794	0.176634
SYAC001.0722.00001.C001_02754	322	448	126	1	0.164921
Asgard_ASG072_02209	315	436	121	0.960317	0.160477
MYSY001.0722.00004.C001_00644	314	440	126	1	0.178723
GCA_001594045.1-Ani_KQ976504.1_i000_006527	461	589	128	1.01587	0.184971
GCA_018292915.1-Ani_JACVVK010000127.1_i000_012857	358	486	128	1.01587	0.151839
GCA_903813345.1-Ani_CAIIXF010000015.1_i000_023868	337	465	128	1.01587	0.162437
GCA_001940645_00636	331	457	126	1	0.159494
BRSE002.0722.00001.C001_01884	325	454	129	1.02381	0.175989
GCA_905319865.3-Ani_CAJNRD030001123.1_i000_011588	448	577	129	1.02381	0.150525
GCA_001940725_02323	307	431	124	0.984127	0.175389
MYBO003.0722.00026.C001_00706	315	445	130	1.03175	0.180305
Asgard_ASG092_01304	432	560	128	1.01587	0.145289
GCA_000328365.1-Ani_KB311733.1_i000_030235	357	486	129	1.02381	0.16775
GCA_001417965.1-Ani_LJWW01000002.1_i000_007414	329	457	128	1.01587	0.160401
GCA_905397895.1-Ani_CAJPWZ010002323.1_i000_048085	402	527	125	0.992063	0.149701
GCA_003315655_00752	76	199	123	0.97619	0.38558
GCA_019973975.1-Ani_BMAO01021025.1_i000_037200	478	608	130	1.03175	0.144124
PSEX001.0722.00001.C001_00787	328	454	126	1	0.15869
MOOS001.0722.00010.C001_01250	350	488	138	1.09524	0.162544
GCA_000092065.1-Pla_CP000585.1_i000_002712	364	495	131	1.03968	0.164987
GCA_002571385.1-Ani_LSMT01000236.1_i000_012535	326	454	128	1.01587	0.159601
GCA_000259055.1-Ani_CM000364.1_i000_011313	527	655	128	1.01587	0.128773
MENE001.0722.00001.C001_00087	317	442	125	0.992063	0.176305
GCA_016984155.1-Ani_JAAWVP010002412.1_i000_003638	103	229	126	1	0.222615
TRPA002.0722.00002.C001_00920	332	453	121	0.960317	0.155527
GCA_016618385.1-Ani_JABFOP010000001.1_i000_000447	288	407	119	0.944444	0.158879
GCA_001632505.1-Ani_LRGB01002451.1_i000_014559	371	501	130	1.03175	0.160692
GCA_016920775.1-Ani_JAFDOW010000598.1_i000_000843	465	593	128	1.01587	0.146789
GCA_004798865.1-Ani_SJPD01000002.1_i000_006550	157	283	126	1	0.347107
GCA_905330665.1-Ani_HG994594.1_i000_014464	176	296	120	0.952381	0.208333
GCA_900005825.1-Ani_CVRI01000063.1_i000_017782	361	483	122	0.968254	0.159686
GCA_000326865.1-Ani_KB097778.1_i000_023166	330	459	129	1.02381	0.176955
GCA_002754855.1-Ani_MRZV01000167.1_i000_007611	291	415	124	0.984127	0.19195
GCA_002220235.1-Pla_FO082276.1_i000_001879	427	564	137	1.0873	0.156751
TESP001.0722.00001.C001_02107	326	448	122	0.968254	0.12249
TESP001.0722.00001.C001_02107	499	563	64	0.507937	0.064257
GCA_010799875.2-Ani_VXIV02002382.1_i000_025107	354	481	127	1.00794	0.162404
GCA_000764305.3-Ani_JQDR03012682.1_i000_006392	478	605	127	1.00794	0.161578
GCA_016618385.1-Ani_JABFOP010000510.1_i000_010977	421	550	129	1.02381	0.151408
GCA_921294245.1-Ani_OV121135.1_i000_005279	376	501	125	0.992063	0.158629
ALMU001.0722.00001.C001_01971	299	430	131	1.03968	0.175839
ALSP025.0722.00001.C001_01063	8	139	131	1.03968	0.505792
GCA_013339685.1-Ani_CM023486.1_i000_017109	510	636	126	1	0.1339
GCA_000697945.4-Ani_ML762972.1_i000_000035	526	658	132	1.04762	0.140127
GCA_902829235.1-Ani_CADEPI010000147.1_i000_009397	563	692	129	1.02381	0.130832
GCA_002498315_00892	339	460	121	0.960317	0.16485
GCA_000090985.2-Pla_CP001576.1_i000_007098	314	447	133	1.05556	0.173177
GCA_000151265.1-Pla_GG663740.1_i000_005653	5	133	128	1.01587	0.253465
GCA_916048055.1-Pla_CAJZHL010000001.1_i000_000431	364	495	131	1.03968	0.162935
GCA_905237095.1-Pro_CAJNNW010032268.1_i000_036838	551	609	58	0.460317	0.0585267
GCA_905237095.1-Pro_CAJNNW010032268.1_i000_036838	627	699	72	0.571429	0.0726539
GCA_003675905.2-Ani_NCKV01004812.1_i000_007555	239	366	127	1.00794	0.194785
GCA_002269645.1-Ani_NIVC01002124.1_i000_034204	384	510	126	1	0.149112
GCA_007210705.1-Ani_CM017379.1_i000_007790	339	466	127	1.00794	0.17139
GCA_900617795.1-Ani_CAAALY010095142.1_i000_021857	72	120	48	0.380952	0.178439
GCA_900617795.1-Ani_CAAALY010095142.1_i000_021857	154	243	89	0.706349	0.330855
GCA_000524195.1-Ani_APAU02000019.1_i000_007732	354	495	141	1.11905	0.15194
GCA_903995115.1-Pro_LR877172.1_i000_010167	288	410	122	0.968254	0.140715
GCA_001447575.1-Ani_JYDT01000049.1_i000_005834	357	487	130	1.03175	0.16624
GCA_000209535.1-Ani_FN654024.1_i000_000360	317	442	125	0.992063	0.177557
GCA_013215525_00661	288	405	117	0.928571	0.177273
GCA_900576705.1-Ani_UXUI01008029.1_i000_004993	326	460	134	1.06349	0.184066
GCA_900618415.1-Ani_UZAM01008137.1_i000_004110	33	182	149	1.18254	0.323913
GCA_904063045.1-Ani_CAJFCJ010000015.1_i000_009598	454	596	142	1.12698	0.217791
GCA_905338405.1-Ani_CAJPEX010000077.1_i000_000839	475	538	63	0.5	0.0671642
GCA_905338405.1-Ani_CAJPEX010000077.1_i000_000839	550	627	77	0.611111	0.0820896
GCA_009805615.1-Ani_VIIS01001685.1_i000_018442	294	425	131	1.03968	0.184248
GCA_905338395.1-Ani_CAJPEW010005556.1_i000_010828	451	587	136	1.07937	0.203288
GCA_900618355.1-Ani_UZAD01013256.1_i000_011849	342	471	129	1.02381	0.172691
GCA_000613005.1-Ani_HG807209.1_i000_008840	98	228	130	1.03175	0.357143
GCA_008360955.1-Ani_LUCM01009707.1_i000_009688	318	417	99	0.785714	0.122373
GCA_009776495_00028	321	444	123	0.97619	0.172028
GCA_022117675.1-Ani_JACEFF010000432.1_i000_002366	379	494	115	0.912698	0.166667
GCA_013115865.1-Pro_JABANO010022400.1_i000_017920	201	323	122	0.968254	0.285714
GCA_918797485.1-Pro_CAKKNE010000006.1_i000_015571	321	446	125	0.992063	0.174095
GCA_902829315.1-Ani_CADEPM010000007.1_i000_010081	332	461	129	1.02381	0.175989
GCA_003344405.1-Ani_NOWV01000021.1_i000_004443	342	397	55	0.436508	0.0727513
GCA_003344405.1-Ani_NOWV01000021.1_i000_004443	381	437	56	0.444444	0.0740741
GCA_000209225.1-Ani_DS469580.1_i000_015959	295	384	89	0.706349	0.124128
GCA_003789085.1-Ani_QCYY01001130.1_i000_000937	355	488	133	1.05556	0.172727
GCA_000507165.2-Ani_KZ497728.1_i000_006564	369	488	119	0.944444	0.151399
GCA_009739505.2-Ani_CM019177.2_i000_004423	478	608	130	1.03175	0.144605
GCA_905338385.1-Ani_CAJPEV010000357.1_i000_002960	1	109	108	0.857143	0.257757
GCA_905178165.1-Pro_CAJINU010000050.1_i000_017219	140	237	97	0.769841	0.305994
GCA_905178165.1-Pro_CAJINU010000050.1_i000_017219	244	307	63	0.5	0.198738
GCA_019364655.1-Ani_JAGXCG010012259.1_i000_028071	1	83	82	0.650794	0.214099
GCA_900624975.1-Ani_UYYA01004072.1_i000_007734	48	176	128	1.01587	0.406349
GCA_000372725.1-Pro_KB867271.1_i000_028150	359	446	87	0.690476	0.12
GCA_019448385.1-Pro_JAGTXO010000046.1_i000_004389	340	472	132	1.04762	0.152425
GCA_900660405.1-Pro_CAACVS010000141.1_i000_004424	305	439	134	1.06349	0.163415
GCA_021927905.1-Pro_BLLK01000058.1_i000_014170	327	456	129	1.02381	0.174089
GCA_003731715.1-Ani_RJVU01057857.1_i000_017015	530	621	91	0.722222	0.137048
GCA_000150955.2-Pro_CM000623.1_i000_008281	366	498	132	1.04762	0.136646
GCA_000143925.2-Ani_GL379877.1_i000_015545	345	477	132	1.04762	0.171651
GCA_020142125.1-Ani_CM034701.1_i000_002588	362	453	91	0.722222	0.182731
GCA_903632075.3-Ani_CAHIKZ030000377.1_i000_007292	247	309	62	0.492063	0.106346
GCA_000688135.1-Ani_JARK01001551.1_i000_031158	370	498	128	1.01587	0.161412
GCA_905397405.1-Ani_CAJPVJ010059466.1_i000_023183	1	96	95	0.753968	0.646259
GCA_900617895.1-Ani_UZAF01017529.1_i000_011045	53	150	97	0.769841	0.340351
GCA_000004555.3-Ani_FR847112.2_i000_001591	340	471	131	1.03968	0.161928
GCA_003427335.1-Ani_BEZZ01231925.1_i000_031802	144	189	45	0.357143	0.238095
GCA_013358835.1-Ani_JABSTQ010011531.1_i000_027769	20	76	56	0.444444	0.293194
STSU001.0722.00023.C001_01491	11	48	37	0.293651	0.111446
GCA_000344595.1-Ani_KB530134.1_i000_007659	33	90	57	0.452381	0.606383
GCA_011764185.1-Fun_JAANRA010010354.1_i000_019318	152	186	34	0.269841	0.182796
GCA_905231915.1-Pro_CAJNJA010005373.1_i000_001041	430	490	60	0.47619	0.115607
GCA_003018175.1-Ani_PYGN01000022.1_i000_001110	454	518	64	0.507937	0.0891365
GCA_001186125.1-Pro_KQ243609.1_i000_011982	57	191	134	1.06349	0.563025
GCA_015852435.1-Fun_JAAAIJ010001805.1_i000_003562	49	176	127	1.00794	0.150831
MIAE001.0722.00001.C001_03461	1	84	83	0.65873	0.638462
