#target	target_begin	target_end	hit_len	query_cov	target_cov
GCA_013154205_02036	104	413	309	0.936364	0.730496
GCF_000015945_01286	95	405	310	0.939394	0.756098
GCF_000092465_01161	95	407	312	0.945455	0.757282
GCF_001719125_00349	90	404	314	0.951515	0.767726
GCF_009729015_00358	87	404	317	0.960606	0.775061
GCA_003086435_01392	87	404	317	0.960606	0.775061
GCF_000223395_01809	99	412	313	0.948485	0.748804
GCF_009729545_00209	87	405	318	0.963636	0.777506
GCA_013152575_00756	90	403	313	0.948485	0.754217
GCA_011373965_01247	96	408	312	0.945455	0.759124
GCF_002214385_01418	89	415	326	0.987879	0.759907
GCF_000816105_01208	90	412	322	0.975758	0.763033
GCA_009889605_00077	95	402	307	0.930303	0.752451
GCA_002507245_00932	94	406	312	0.945455	0.764706
GCF_000018365_01318	89	412	323	0.978788	0.769048
GCA_003649235_00146	94	402	308	0.933333	0.758621
GCF_000022365_00468	88	412	324	0.981818	0.767773
GCF_001592435_00627	88	411	323	0.978788	0.758216
GCF_000769655_00116	89	412	323	0.978788	0.776442
GCF_000009965_00185	88	413	325	0.984848	0.77381
GCA_011373445_00465	92	402	310	0.939394	0.767327
GCA_003661945_01007	94	405	311	0.942424	0.764128
GCF_001462395_00558	93	413	320	0.969697	0.758294
GCF_000258515_01760	90	411	321	0.972727	0.755294
GCF_001412615_00592	93	416	323	0.978788	0.770883
GCA_000565255_01211	91	406	315	0.954545	0.770171
GCF_000017945_00070	107	424	317	0.960606	0.732102
GCA_011364715_00794	98	402	304	0.921212	0.754342
GCA_011055445_00520	84	393	309	0.936364	0.770574
GCA_003601875_00554	88	394	306	0.927273	0.772727
GCF_003201835_02134	91	414	323	0.978788	0.77458
GCA_000508305_01231	90	410	320	0.969697	0.776699
GCA_001399795_00622	95	400	305	0.924242	0.753086
GCA_013153145_00541	93	407	314	0.951515	0.760291
GCF_000015225_00375	95	408	313	0.948485	0.763415
GCF_000517445_01398	61	410	349	1.05758	0.845036
GCF_000012285_01293	90	410	320	0.969697	0.776699
GCF_002116695_02269	88	415	327	0.990909	0.782297
GCF_013343295_00437	90	406	316	0.957576	0.770732
GCA_011053655_00398	90	397	307	0.930303	0.763682
GCA_003601605_00543	94	404	310	0.939394	0.763547
GCF_009729055_01431	91	405	314	0.951515	0.767726
GCA_011372935_00160	92	400	308	0.933333	0.760494
GCF_000016605_01759	90	406	316	0.957576	0.772616
GCF_012027395_01425	89	412	323	0.978788	0.767221
GCF_000011205_01388	90	405	315	0.954545	0.770171
GCF_000151205_02074	89	412	323	0.978788	0.765403
GCF_012027635_00546	89	412	323	0.978788	0.765403
GCF_000585495_01657	89	412	323	0.978788	0.767221
GCA_011375875_00028	95	401	306	0.927273	0.759305
GCF_900198835_02004	89	412	323	0.978788	0.765403
GCF_012027555_00102	88	412	324	0.981818	0.760563
GCA_013153105_01241	99	425	326	0.987879	0.756381
GCF_000011125_01451	99	405	306	0.927273	0.73031
GCF_002214545_01918	88	411	323	0.978788	0.763593
GCA_013388895_01333	95	404	309	0.936364	0.753659
GCA_003660485_01505	7	308	301	0.912121	0.970968
GCF_012222305_01696	91	405	314	0.951515	0.767726
GCA_013540595_00525	93	407	314	0.951515	0.760291
GCF_000591035_01373	100	406	306	0.927273	0.728571
GCF_003201765_01892	87	415	328	0.993939	0.786571
GCF_012027495_01670	89	412	323	0.978788	0.76
GCF_012027355_01641	88	412	324	0.981818	0.765957
GCF_000015145_00030	125	438	313	0.948485	0.703371
GCF_001647085_00478	89	412	323	0.978788	0.76
GCF_000011105_00047	90	399	309	0.936364	0.768657
GCA_011333245_00139	94	408	314	0.951515	0.751196
GCF_000813245_01583	99	415	316	0.957576	0.747045
GCF_900079115_00943	90	406	316	0.957576	0.768856
GCF_000151105_01282	89	411	322	0.975758	0.779661
GCF_000263735_00129	92	401	309	0.936364	0.764851
GCF_002214605_00144	91	400	309	0.936364	0.766749
GCF_000246985_02139	89	411	322	0.975758	0.777778
GCF_009601705_01443	90	407	317	0.960606	0.77129
GCF_001577775_01373	90	400	310	0.939394	0.771144
GCA_011372985_01318	94	402	308	0.933333	0.758621
GCA_011364585_01100	95	403	308	0.933333	0.754902
GCA_011363115_00049	93	404	311	0.942424	0.764128
GCA_002855745_00701	97	407	310	0.939394	0.757946
GCF_000022485_01520	91	407	316	0.957576	0.76699
GCA_000389735_00809	90	417	327	0.990909	0.776722
GCA_003662645_00843	100	405	305	0.924242	0.749386
GCF_000430485_01933	89	413	324	0.981818	0.776978
GCF_001481685_00663	103	425	322	0.975758	0.748837
GCA_011380195_00010	94	403	309	0.936364	0.762963
GCF_002214525_00435	93	411	318	0.963636	0.766265
GCF_002214485_00110	88	414	326	0.987879	0.761682
GCF_002214565_01321	88	412	324	0.981818	0.765957
GCF_002214465_01442	88	416	328	0.993939	0.773585
GCF_012027305_00785	88	411	323	0.978788	0.763593
GCA_011047595_00155	94	404	310	0.939394	0.761671
GCF_000243315_02514	91	406	315	0.954545	0.768293
GCF_012027615_00843	88	412	324	0.981818	0.765957
GCF_904067545_01762	89	412	323	0.978788	0.763593
GCF_000215995_01468	90	400	310	0.939394	0.771144
GCF_002214365_00913	86	412	326	0.987879	0.767059
GCA_011364805_00326	132	444	312	0.945455	0.697987
GCF_000221185_01787	90	412	322	0.975758	0.757647
GCA_013154085_00154	117	431	314	0.951515	0.712018
GCA_002254745_00704	96	403	307	0.930303	0.7543
GCF_012027645_00343	90	412	322	0.975758	0.757647
GCF_000265525_01442	89	416	327	0.990909	0.771226
GCF_000211475_00577	89	396	307	0.930303	0.771357
GCF_009729035_00850	90	407	317	0.960606	0.775061
GCF_002214585_01963	89	414	325	0.984848	0.757576
GCF_012027325_01975	61	410	349	1.05758	0.845036
GCA_002899805_01207	93	406	313	0.948485	0.747017
GCA_011369665_00228	90	396	306	0.927273	0.761194
GCF_006274605_02156	90	412	322	0.975758	0.759434
GCA_011380285_00270	96	407	311	0.942424	0.758537
GCF_000993805_01592	96	407	311	0.942424	0.758537
GCA_011373895_00644	93	402	309	0.936364	0.764851
GCF_001484195_00753	90	412	322	0.975758	0.757647
GCA_011363945_00370	94	400	306	0.927273	0.763092
GCF_000007305_00064	88	399	311	0.942424	0.773632
GCF_002214505_00142	89	419	330	1	0.778302
GCA_011375895_00843	93	407	314	0.951515	0.765854
GCF_000264495_00057	94	401	307	0.930303	0.761787
GCA_003661825_00420	49	353	304	0.921212	0.856338
GCA_003086555_00630	90	408	318	0.963636	0.77561
GCA_002009975_01745	89	411	322	0.975758	0.775904
GCA_013388905_01287	96	404	308	0.933333	0.75122
GCA_011366735_00688	94	395	301	0.912121	0.758186
GCF_003201675_01994	90	404	314	0.951515	0.769608
GCF_012027595_02055	87	414	327	0.990909	0.760465
GCA_013154335_00891	93	408	315	0.954545	0.737705
GCA_011364525_00750	98	405	307	0.930303	0.752451
GCF_002201895_00891	93	408	315	0.954545	0.75
GCA_002495025_00258	97	401	304	0.921212	0.743276
GCF_000513855_00985	109	415	306	0.927273	0.726841
GCF_000204925_00502	90	403	313	0.948485	0.767157
GCF_000007185_00596	93	408	315	0.954545	0.75
GCA_002506595_01442	92	408	316	0.957576	0.76699
GCF_000195935_00067	88	402	314	0.951515	0.777228
GCA_003649085_01249	94	400	306	0.927273	0.763092
GCF_001484685_01010	90	412	322	0.975758	0.777778
GCF_000632495_01042	90	408	318	0.963636	0.769976
GCA_003650925_01315	95	401	306	0.927273	0.755556
GCA_003649445_01003	95	402	307	0.930303	0.759901
GCA_011364825_00136	95	403	308	0.933333	0.760494
GCA_001399805_00217	95	394	299	0.906061	0.732843
GCF_000092185_00156	94	400	306	0.927273	0.757426
GCF_012027425_00682	84	411	327	0.990909	0.791768
GCF_001317345_01575	83	408	325	0.984848	0.792683
GCA_009903825_01760	97	408	311	0.942424	0.756691
GCA_011057405_00746	113	423	310	0.939394	0.7277
GCA_011375785_00142	98	406	308	0.933333	0.753056
GCA_003096255_00594	94	410	316	0.957576	0.761446
GCF_000725425_00937	90	416	326	0.987879	0.767059
GCA_011053435_00907	93	404	311	0.942424	0.76601
GCA_003601835_00047	87	402	315	0.954545	0.779703
GCA_003601785_00260	1	302	301	0.912121	0.990132
GCA_011380215_01236	93	405	312	0.945455	0.764706
GCA_011053855_00306	94	400	306	0.927273	0.757426
GCF_000022545_00791	88	411	323	0.978788	0.780193
GCF_000317795_00319	93	408	315	0.954545	0.764563
GCA_003661745_00811	96	397	301	0.912121	0.735941
GCA_003152955_02308	105	405	300	0.909091	0.738916
GCA_003649185_00606	97	406	309	0.936364	0.757353
GCF_003431325_01525	97	408	311	0.942424	0.747596
GCF_000186365_00865	94	402	308	0.933333	0.758621
GCF_000258425_01189	94	420	326	0.987879	0.768868
GCA_004348015_00363	92	387	295	0.893939	0.762274
GCA_011364565_00188	97	403	306	0.927273	0.73913
GCA_011358085_00891	91	392	301	0.912121	0.765903
GCA_011055355_00568	99	405	306	0.927273	0.751843
GCA_003056265_01203	99	413	314	0.951515	0.751196
GCA_002877855_00275	98	415	317	0.960606	0.760192
GCA_013153595_00225	92	412	320	0.969697	0.737327
GCF_000144915_01300	95	404	309	0.936364	0.746377
GCA_003663535_00828	91	411	320	0.969697	0.772947
GCA_002496425_00174	95	411	316	0.957576	0.738318
GCF_008326425_01033	90	418	328	0.993939	0.748858
GCA_004376645_00230	93	406	313	0.948485	0.767157
GCA_003649495_00247	91	391	300	0.909091	0.75188
GCA_000145985_00023	99	408	309	0.936364	0.753659
GCA_002495845_00790	90	416	326	0.987879	0.747706
GCA_003661775_00089	97	408	311	0.942424	0.756691
GCA_003601725_00620	94	408	314	0.951515	0.765854
GCA_004347955_00034	91	395	304	0.921212	0.767677
GCA_004376295_01216	95	401	306	0.927273	0.757426
GCA_003650815_00465	95	400	305	0.924242	0.753086
GCA_011362965_00597	90	395	305	0.924242	0.770202
GCA_003663525_00628	91	411	320	0.969697	0.772947
GCA_003649145_00084	104	408	304	0.921212	0.739659
GCA_003661865_00362	97	405	308	0.933333	0.754902
GCA_001593925_00985	94	408	314	0.951515	0.76399
GCA_003660495_00229	90	415	325	0.984848	0.777512
GCA_014361445_00813	91	395	304	0.921212	0.767677
GCA_011337845_00345	95	401	306	0.927273	0.761194
GCA_011364225_00182	94	401	307	0.930303	0.761787
GCA_003096235_01252	99	412	313	0.948485	0.745238
GCA_003649205_00054	100	400	300	0.909091	0.742574
GCA_011380145_01129	96	406	310	0.939394	0.757946
GCA_011366425_00781	97	401	304	0.921212	0.752475
GCA_011375725_00719	98	407	309	0.936364	0.741007
GCA_011367065_00914	92	401	309	0.936364	0.757353
GCA_003650785_00842	83	389	306	0.927273	0.784615
GCA_003663695_00277	1	309	308	0.933333	0.987179
GCF_000966265_01987	93	411	318	0.963636	0.75895
GCA_004376385_01314	94	399	305	0.924242	0.736715
GCA_003661975_00895	102	402	300	0.909091	0.744417
GCA_003649225_00607	94	402	308	0.933333	0.762376
GCA_009889585_00119	95	401	306	0.927273	0.751843
GCF_000214415_01218	82	410	328	0.993939	0.784689
GCA_002254975_00526	41	345	304	0.921212	0.878613
GCA_003601695_00953	97	398	301	0.912121	0.754386
GCA_011362275_00898	99	402	303	0.918182	0.75
GCA_011366635_01708	99	405	306	0.927273	0.748166
GCA_011375585_00782	99	407	308	0.933333	0.747573
GCA_003650625_00418	104	407	303	0.918182	0.739024
GCA_011051215_00108	93	413	320	0.969697	0.771084
GCF_003589585_01365	98	412	314	0.951515	0.697778
GCA_011361755_00423	99	401	302	0.915152	0.751244
GCA_011375535_00651	88	386	298	0.90303	0.75827
GCA_011334665_00899	95	414	319	0.966667	0.764988
GCA_009778385_00722	93	415	322	0.975758	0.693966
GCA_011040545_00860	99	382	283	0.857576	0.740838
GCA_003661965_00696	86	388	302	0.915152	0.77635
GCA_012513715_01901	93	415	322	0.975758	0.723596
GCA_004028775_00850	93	402	309	0.936364	0.762963
GCA_011367965_01990	93	416	323	0.978788	0.702174
GCA_013154145_00411	1	287	286	0.866667	0.993056
GCA_001717015_00571	92	402	310	0.939394	0.765432
GCF_003116855_01669	98	408	310	0.939394	0.754258
GCA_001593855_00317	95	402	307	0.930303	0.761787
GCA_002490245_00486	95	381	286	0.866667	0.750656
GCA_011364865_00250	97	398	301	0.912121	0.754386
GCF_000739065_01242	92	420	328	0.993939	0.76815
GCF_000025525_01528	79	407	328	0.993939	0.792271
GCA_011056395_02193	100	405	305	0.924242	0.747549
GCA_011367155_00946	99	404	305	0.924242	0.753086
GCA_012515445_01191	93	408	315	0.954545	0.646817
GCA_009904015_00872	93	404	311	0.942424	0.758537
GCA_011332615_02683	127	439	312	0.945455	0.63286
GCA_003662305_00457	95	401	306	0.927273	0.759305
GCF_003351865_00389	81	410	329	0.99697	0.794686
GCF_000091665_00742	78	408	330	1	0.797101
GCA_014361455_01629	92	403	311	0.942424	0.767901
GCA_001593845_00596	95	396	301	0.912121	0.758186
GCA_000015805_01162	96	396	300	0.909091	0.721154
GCF_000023985_00107	79	410	331	1.00303	0.79759
GCA_003133625_01485	104	424	320	0.969697	0.722348
GCA_013154035_00523	1	296	295	0.893939	0.989933
GCA_007050895_01404	70	397	327	0.990909	0.815461
GCA_002255065_00860	93	402	309	0.936364	0.762963
GCA_011373125_00586	88	388	300	0.909091	0.759494
GCA_005191415_01503	54	382	328	0.993939	0.854167
GCA_011370995_00184	95	374	279	0.845455	0.745989
GCA_002779555_01590	19	352	333	1.00909	0.932773
GCF_000243455_00019	81	412	331	1.00303	0.795673
GCA_002254895_00579	95	399	304	0.921212	0.756219
GCF_000019805_01708	97	399	302	0.915152	0.719048
GCA_004376975_00318	100	409	309	0.936364	0.751825
GCA_000495735_00538	156	466	310	0.939394	0.63655
GCA_011329225_01465	91	418	327	0.990909	0.769412
GCF_000148385_00308	96	418	322	0.975758	0.764846
GCA_003164295_00181	92	409	317	0.960606	0.71236
GCF_000253055_01602	95	398	303	0.918182	0.726619
GCA_009787585_00813	98	418	320	0.969697	0.567376
GCA_001189275_01840	102	398	296	0.89697	0.703088
GCA_000375685_00232	87	391	304	0.921212	0.777494
GCA_007050885_01647	94	398	304	0.921212	0.761905
GCA_011369655_00918	89	386	297	0.9	0.767442
GCA_011366545_00081	99	404	305	0.924242	0.749386
GCA_011355205_01416	93	396	303	0.918182	0.763224
GCA_009781395_01319	96	417	321	0.972727	0.586837
GCF_000193375_01821	96	403	307	0.930303	0.73445
GCA_012511995_00782	93	416	323	0.978788	0.674322
GCA_003165195_01127	93	404	311	0.942424	0.710046
GCA_001315985_00272	98	419	321	0.972727	0.760664
GCA_011372955_00242	93	398	305	0.924242	0.764411
GCA_001316265_01679	96	416	320	0.969697	0.761905
GCA_009776805_01896	94	417	323	0.978788	0.643426
GCA_011370515_00695	93	398	305	0.924242	0.764411
GCA_011605825_00342	93	398	305	0.924242	0.764411
GCA_001316285_03219	95	411	316	0.957576	0.734884
GCA_013153895_01213	98	408	310	0.939394	0.722611
GCA_003650865_00015	95	403	308	0.933333	0.760494
GCA_011375775_00913	91	383	292	0.884848	0.762402
GCA_003649565_00134	96	405	309	0.936364	0.759214
GCA_009779045_01386	95	405	310	0.939394	0.515807
GCA_013154355_01481	98	408	310	0.939394	0.724299
GCF_003967175_01007	90	408	318	0.963636	0.768116
GCF_004310395_00041	83	410	327	0.990909	0.789855
GCA_013330975_00770	92	414	322	0.975758	0.516854
GCF_000016385_01459	95	398	303	0.918182	0.718009
GCA_000247545_00837	95	398	303	0.918182	0.718009
GCF_000376965_00444	84	410	326	0.987879	0.713348
GCA_001316005_02445	95	418	323	0.978788	0.724215
GCA_011054345_00527	87	393	306	0.927273	0.765
GCF_000015205_00426	95	398	303	0.918182	0.721429
GCA_011338225_01647	91	388	297	0.9	0.763496
GCA_011363825_01076	89	400	311	0.942424	0.773632
GCA_003151735_03567	93	407	314	0.951515	0.665254
GCA_009787175_01075	121	441	320	0.969697	0.632411
GCF_013340765_01521	86	396	310	0.939394	0.765432
GCA_001775955_00587	94	398	304	0.921212	0.761905
GCA_011358735_00459	90	397	307	0.930303	0.771357
GCF_000007225_02284	98	398	300	0.909091	0.712589
GCA_001316245_01090	95	418	323	0.978788	0.767221
GCA_009903945_01372	103	404	301	0.912121	0.714964
GCF_002077075_00758	100	401	301	0.912121	0.720096
GCA_002506645_01072	95	417	322	0.975758	0.764846
GCA_009781675_01030	93	416	323	0.978788	0.697624
GCA_011375845_01505	89	397	308	0.933333	0.77193
GCA_013153845_00944	79	413	334	1.01212	0.795238
GCF_000024625_00346	79	413	334	1.01212	0.795238
GCA_001775995_00180	95	408	313	0.948485	0.759709
GCF_000234805_01470	99	399	300	0.909091	0.712589
GCA_001717035_01554	92	408	316	0.957576	0.644898
GCA_003650675_00752	96	407	311	0.942424	0.758537
GCA_011375665_01171	98	407	309	0.936364	0.75
GCF_001748385_01261	92	403	311	0.942424	0.760391
GCA_000960885_00352	97	395	298	0.90303	0.716346
GCA_003019595_01653	69	369	300	0.909091	0.810811
GCA_009783705_00410	93	415	322	0.975758	0.659836
GCA_011355215_01275	88	401	313	0.948485	0.778607
GCF_000190315_01374	95	417	322	0.975758	0.764846
GCA_013153275_01268	97	408	311	0.942424	0.726636
GCA_001593865_01563	94	381	287	0.869697	0.753281
GCA_011362255_01150	87	390	303	0.918182	0.772959
GCA_003141855_01787	93	407	314	0.951515	0.688596
GCA_903901015_01033	93	407	314	0.951515	0.668085
GCA_011367275_00093	92	383	291	0.881818	0.759791
GCA_005882905_01497	95	419	324	0.981818	0.743119
GCA_011605775_00887	86	391	305	0.924242	0.778061
GCA_003660555_00860	78	363	285	0.863636	0.782967
GCA_011369595_00791	96	383	287	0.869697	0.749347
GCA_011374155_00737	96	383	287	0.869697	0.749347
GCF_002945325_00385	83	405	322	0.975758	0.676471
GCA_001915065_01212	95	419	324	0.981818	0.743119
GCF_000092305_00942	76	388	312	0.945455	0.802057
GCA_013375455_00111	95	419	324	0.981818	0.769596
GCF_000371805_01034	77	387	310	0.939394	0.798969
GCA_000405685_01008	89	397	308	0.933333	0.77193
GCA_011337925_01711	89	397	308	0.933333	0.77193
GCA_001273385_00445	92	417	325	0.984848	0.775656
GCF_000179575_01373	87	413	326	0.987879	0.708696
GCF_000016125_01037	82	403	321	0.972727	0.66875
GCF_000018485_00309	83	406	323	0.978788	0.667355
GCA_014361095_00944	92	383	291	0.881818	0.759791
GCA_011334935_00406	72	377	305	0.924242	0.806878
GCA_002011035_01339	93	400	307	0.930303	0.759901
GCF_000017225_01642	83	404	321	0.972727	0.661856
GCA_011361905_00165	97	383	286	0.866667	0.746736
GCA_001516585_00811	96	409	313	0.948485	0.752404
GCA_001515205_00229	92	382	290	0.878788	0.75718
GCA_011056475_00632	77	371	294	0.890909	0.792453
GCA_011364235_00999	94	396	302	0.915152	0.760705
GCA_011389385_01048	95	395	300	0.909091	0.757576
GCA_011362245_00899	92	394	302	0.915152	0.764557
GCA_003662205_00272	102	392	290	0.878788	0.739796
GCA_011370445_00372	92	380	288	0.872727	0.757895
GCA_002496475_00670	96	415	319	0.966667	0.75772
GCA_013166775_03291	90	402	312	0.945455	0.730679
GCA_001316025_02287	98	419	321	0.972727	0.757075
GCA_002505645_00274	90	410	320	0.969697	0.752941
GCF_000017165_01511	94	408	314	0.951515	0.628
GCA_001940665_01039	97	415	318	0.963636	0.764423
GCA_002508315_00234	97	410	313	0.948485	0.748804
GCA_004347965_01405	94	403	309	0.936364	0.764851
GCA_011367225_00903	93	382	289	0.875758	0.756545
GCF_000018305_01309	101	406	305	0.924242	0.742092
GCA_003056285_00584	93	395	302	0.915152	0.762626
GCA_011362155_00425	94	404	310	0.939394	0.763547
GCA_002506515_00484	100	409	309	0.936364	0.744578
GCA_003661605_00014	96	394	298	0.90303	0.752525
GCA_003601775_00807	105	393	288	0.872727	0.732824
GCA_011364985_01243	94	412	318	0.963636	0.76259
GCA_011605835_00116	94	402	308	0.933333	0.764268
GCA_011333845_00224	87	406	319	0.966667	0.764988
GCA_011363045_01177	94	396	302	0.915152	0.760705
GCF_902812495_01283	69	376	307	0.930303	0.814324
GCA_001919285_00080	95	415	320	0.969697	0.733945
GCF_001663375_00633	113	419	306	0.927273	0.71831
GCA_003661465_00016	87	379	292	0.884848	0.770449
GCA_001940755_01342	90	410	320	0.969697	0.745921
GCA_003164815_00522	78	402	324	0.981818	0.780723
GCA_005888635_00195	94	413	319	0.966667	0.731651
GCA_000494185_00250	87	386	299	0.906061	0.77261
GCA_013375405_04064	54	378	324	0.981818	0.854881
GCA_001918745_01233	106	427	321	0.972727	0.716518
GCA_004375695_00199	92	384	292	0.884848	0.760417
GCA_005882955_00434	94	413	319	0.966667	0.731651
GCA_005888745_00830	94	413	319	0.966667	0.731651
GCA_003019535_00952	67	378	311	0.942424	0.803618
GCA_003663585_00356	77	366	289	0.875758	0.783198
GCF_000006175_00866	124	438	314	0.951515	0.591337
GCA_011373645_00609	84	386	302	0.915152	0.778351
GCA_002495315_01391	90	397	307	0.930303	0.763682
GCA_000380705_00357	80	385	305	0.924242	0.792208
GCA_003663565_00862	74	366	292	0.884848	0.793478
GCA_005888755_02015	94	409	315	0.954545	0.722477
GCA_004524445_01473	94	402	308	0.933333	0.764268
GCA_001563325_00123	135	443	308	0.933333	0.681416
GCA_005881695_01239	110	424	314	0.951515	0.696231
GCA_013821245_01482	92	423	331	1.00303	0.752273
GCA_011042755_00637	94	384	290	0.878788	0.755208
GCA_011773785_01259	96	422	326	0.987879	0.737557
GCA_001593875_00793	4	288	284	0.860606	0.982699
GCA_005798405_00009	83	403	320	0.969697	0.715884
GCA_013538805_00450	93	404	311	0.942424	0.764128
GCA_013288145_00516	84	401	317	0.960606	0.728736
GCA_011373385_00518	88	387	299	0.906061	0.768638
GCA_011369545_00278	94	405	311	0.942424	0.764128
GCA_003352285_01006	83	407	324	0.981818	0.640316
GCA_002506605_00122	85	386	301	0.912121	0.777778
GCA_001717025_00373	1	256	255	0.772727	0.852843
GCA_014361085_00022	96	398	302	0.915152	0.756892
GCA_902606945_00618	83	409	326	0.987879	0.789346
GCA_005883075_00170	152	465	313	0.948485	0.634888
GCA_001940705_01832	91	395	304	0.921212	0.743276
GCA_004297665_01573	82	405	323	0.978788	0.751163
GCF_014078545_01005	83	407	324	0.981818	0.736364
GCA_009903795_01411	79	374	295	0.893939	0.78877
GCF_900696045_02540	95	425	330	1	0.736607
GCF_900248165_00710	114	433	319	0.966667	0.72009
GCA_002898655_01290	33	352	319	0.966667	0.873973
GCA_002011075_00478	81	380	299	0.906061	0.784777
GCA_009697485_00212	67	404	337	1.02121	0.684959
GCA_013375355_00776	93	420	327	0.990909	0.776722
GCA_004524565_00307	94	407	313	0.948485	0.743468
GCA_005888735_00841	95	414	319	0.966667	0.728311
GCF_003175215_01086	83	403	320	0.969697	0.778589
GCA_011362025_00637	94	396	302	0.915152	0.758794
GCA_013203245_00898	84	404	320	0.969697	0.701754
GCA_002825465_02378	95	407	312	0.945455	0.748201
GCA_002825535_00126	95	407	312	0.945455	0.748201
GCA_013867245_01177	84	406	322	0.975758	0.728507
GCA_002495905_00685	88	402	314	0.951515	0.777228
GCA_013538675_00469	94	417	323	0.978788	0.711454
GCA_003702495_00116	84	406	322	0.975758	0.7471
GCA_001515185_00085	92	384	292	0.884848	0.760417
GCF_000303155_03424	90	416	326	0.987879	0.75463
GCA_005888695_01295	95	412	317	0.960606	0.698238
GCF_000812185_01064	84	408	324	0.981818	0.788321
GCF_014078525_01964	83	402	319	0.966667	0.707317
GCA_002898395_00179	87	388	301	0.912121	0.771795
GCA_011364305_01145	93	396	303	0.918182	0.761307
GCA_000484975_01149	83	408	325	0.984848	0.750577
GCA_002709285_00477	83	396	313	0.948485	0.784461
GCA_000746705_00002	82	396	314	0.951515	0.786967
GCF_013407185_02126	84	404	320	0.969697	0.649087
GCA_000746685_00570	8	330	322	0.975758	0.933333
GCF_000242875_00877	83	381	298	0.90303	0.780105
GCF_000956175_00480	83	403	320	0.969697	0.57554
GCF_000018465_01488	84	407	323	0.978788	0.687234
GCA_002501845_01258	90	415	325	0.984848	0.752315
GCA_002698885_00719	82	411	329	0.99697	0.792771
GCA_902606965_00470	90	404	314	0.951515	0.771499
GCA_902566725_00402	83	409	326	0.987879	0.793187
GCA_013911135_01227	83	408	325	0.984848	0.750577
GCA_000746765_01118	84	406	322	0.975758	0.74023
GCA_001627235_00913	83	409	326	0.987879	0.793187
GCA_013043295_00620	84	401	317	0.960606	0.740654
GCA_005877345_02550	85	409	324	0.981818	0.788321
GCA_902590655_00928	90	404	314	0.951515	0.771499
GCF_007826885_00691	67	425	358	1.08485	0.804494
GCA_003702545_00281	84	407	323	0.978788	0.742529
GCA_003331425_00991	83	401	318	0.963636	0.75895
GCA_005223125_02833	76	400	324	0.981818	0.80798
GCA_004376265_03202	117	421	304	0.921212	0.697248
GCA_011331095_01860	89	411	322	0.975758	0.772182
GCA_002788515_01588	83	404	321	0.972727	0.746512
GCF_000730285_00609	93	412	319	0.966667	0.723356
GCA_001543015_00579	84	401	317	0.960606	0.579525
GCA_013138615_00241	96	397	301	0.912121	0.721823
GCA_014523495_00366	86	410	324	0.981818	0.786408
GCA_004212155_00940	77	362	285	0.863636	0.785124
GCF_002156965_00340	84	401	317	0.960606	0.635271
GCA_009889515_01862	86	388	302	0.915152	0.774359
GCA_002693165_00160	89	404	315	0.954545	0.773956
GCF_011319475_01008	82	397	315	0.954545	0.737705
GCA_000746785_00800	84	388	304	0.921212	0.779487
GCF_000299365_01555	83	402	319	0.966667	0.750588
GCA_003144275_01937	98	428	330	1	0.755149
GCA_013867335_00818	84	405	321	0.972727	0.722973
GCA_013140415_00163	81	405	324	0.981818	0.726457
GCA_008080735_00085	95	393	298	0.90303	0.75827
GCF_000299395_01567	84	407	323	0.978788	0.747685
GCA_012964965_00662	87	401	314	0.951515	0.777228
GCA_011372835_00520	77	362	285	0.863636	0.785124
GCA_013114705_00163	94	425	331	1.00303	0.738839
GCA_005877225_01974	81	389	308	0.933333	0.777778
GCA_005888675_01532	96	412	316	0.957576	0.696035
GCF_000698785_01662	83	402	319	0.966667	0.74359
GCA_013114725_00952	87	407	320	0.969697	0.747664
GCA_007280465_00974	82	395	313	0.948485	0.722864
GCF_000875775_01960	84	407	323	0.978788	0.648594
GCA_902514095_00317	84	375	291	0.881818	0.776
GCA_005877365_00212	82	389	307	0.930303	0.775253
GCF_900143675_01217	79	405	326	0.987879	0.770686
GCA_009712615_00919	93	411	318	0.963636	0.771845
GCA_003569705_00107	83	406	323	0.978788	0.54932
GCF_900167955_00387	82	395	313	0.948485	0.71954
GCA_005877075_01977	85	408	323	0.978788	0.787805
GCF_006740685_01398	84	405	321	0.972727	0.663223
GCA_013378385_00021	88	401	313	0.948485	0.776675
GCF_001870125_01994	93	425	332	1.00606	0.741071
GCF_000723185_01245	83	402	319	0.966667	0.731651
GCA_003164415_01685	93	404	311	0.942424	0.767901
GCA_001940655_01812	96	421	325	0.984848	0.720621
GCA_013306035_00576	87	401	314	0.951515	0.779156
GCF_013407145_01507	84	396	312	0.945455	0.617822
GCA_005877205_01792	82	410	328	0.993939	0.786571
GCA_013287585_01178	96	415	319	0.966667	0.705752
GCA_014523525_01364	85	409	324	0.981818	0.788321
GCA_003345555_00459	82	393	311	0.942424	0.76601
GCA_011373505_01354	85	386	301	0.912121	0.775773
GCA_005877185_00259	76	378	302	0.915152	0.794737
GCA_002825515_00225	91	390	299	0.906061	0.732843
GCA_002737445_01228	83	406	323	0.978788	0.780193
GCA_013330055_00154	83	391	308	0.933333	0.783715
GCA_002011085_00478	82	395	313	0.948485	0.786432
GCA_014075315_00354	84	404	320	0.969697	0.73903
GCA_001723835_00123	77	361	284	0.860606	0.786704
GCA_001723855_01818	77	361	284	0.860606	0.786704
GCF_001541925_00644	83	401	318	0.963636	0.714607
GCA_005877305_01126	101	427	326	0.987879	0.724444
GCA_004524535_01826	95	402	307	0.930303	0.761787
GCA_003702465_00993	83	402	319	0.966667	0.72009
GCA_003344655_00883	91	379	288	0.872727	0.757895
GCF_000220175_01438	83	404	321	0.972727	0.560209
GCA_009379865_00367	96	424	328	0.993939	0.735426
GCA_000270325_00287	83	386	303	0.918182	0.782946
GCF_013390375_01248	82	396	314	0.951515	0.786967
GCA_013215285_01565	84	404	320	0.969697	0.725624
GCF_008389435_01089	95	423	328	0.993939	0.727273
GCF_013390905_00622	83	407	324	0.981818	0.75
GCF_902812485_01284	76	402	326	0.987879	0.781775
GCA_011364605_00361	87	390	303	0.918182	0.772959
GCF_013407165_01478	84	396	312	0.945455	0.608187
GCF_900177045_01258	82	401	319	0.966667	0.75772
GCA_000402075_00684	90	404	314	0.951515	0.771499
GCA_003151535_03776	92	404	312	0.945455	0.77037
GCA_002737455_00482	84	404	320	0.969697	0.672269
GCA_014523685_00433	88	414	326	0.987879	0.680585
GCA_002507085_00880	83	385	302	0.915152	0.780362
GCA_002504725_00253	93	406	313	0.948485	0.770936
GCA_014384555_01000	84	396	312	0.945455	0.755448
GCA_001917995_00872	83	409	326	0.987879	0.781775
GCA_004524595_01822	96	416	320	0.969697	0.760095
GCA_003661505_00231	81	388	307	0.930303	0.789203
GCA_900299125_01285	83	406	323	0.978788	0.681435
GCA_011364905_01097	91	398	307	0.930303	0.750611
GCF_000191585_00306	94	411	317	0.960606	0.769417
GCA_013288545_00782	83	398	315	0.954545	0.737705
GCA_013114715_01562	91	416	325	0.984848	0.775656
GCA_004524515_02761	95	404	309	0.936364	0.761084
GCA_013388945_01973	91	419	328	0.993939	0.497724
GCA_008080815_01022	84	407	323	0.978788	0.725843
GCA_014523515_00245	93	423	330	1	0.776471
GCA_002897955_00407	75	349	274	0.830303	0.7851
GCF_900065925_01572	83	398	315	0.954545	0.737705
GCA_008974855_00365	82	397	315	0.954545	0.781638
GCF_013390745_00829	82	396	314	0.951515	0.786967
GCA_007280335_00200	50	415	365	1.10606	0.807522
GCA_007571135_01441	84	404	320	0.969697	0.732265
GCA_003158115_00713	95	404	309	0.936364	0.762963
GCA_013388835_00071	94	401	307	0.930303	0.739759
GCA_003162115_00756	94	404	310	0.939394	0.765432
GCA_004347925_00566	91	374	283	0.857576	0.756684
GCA_005240025_00022	76	394	318	0.963636	0.789082
GCA_002499005_00679	85	388	303	0.918182	0.776923
GCA_000802205_01989	95	426	331	1.00303	0.747178
GCA_009665115_02406	119	444	325	0.984848	0.725446
GCA_001563335_00757	91	396	305	0.924242	0.747549
GCF_002787055_00040	83	401	318	0.963636	0.636
GCA_011364965_02056	88	415	327	0.990909	0.78043
GCA_002501855_02975	119	444	325	0.984848	0.725446
GCA_013375485_00533	94	400	306	0.927273	0.763092
GCA_011056255_00514	89	382	293	0.887879	0.765013
GCA_002505765_00929	93	402	309	0.936364	0.766749
GCA_003345595_00222	95	411	316	0.957576	0.755981
GCA_002713205_00496	87	413	326	0.987879	0.785542
GCA_002499525_00287	86	401	315	0.954545	0.775862
GCA_001443365_00378	45	395	350	1.06061	0.866337
GCA_001723845_00754	82	362	280	0.848485	0.773481
GCA_001437625_01190	83	404	321	0.972727	0.74478
GCF_000017185_00771	85	406	321	0.972727	0.651116
GCA_002254545_00358	142	416	274	0.830303	0.658654
GCF_000019605_01573	88	381	293	0.887879	0.767016
GCF_000685395_01892	83	399	316	0.957576	0.721461
GCA_002255045_00786	70	353	283	0.857576	0.799435
GCF_900095295_02050	94	404	310	0.939394	0.765432
GCF_000308215_00711	66	355	289	0.875758	0.75853
GCF_013407275_01554	83	395	312	0.945455	0.712329
GCA_008080745_01166	95	409	314	0.951515	0.760291
GCF_000214725_02146	94	405	311	0.942424	0.76601
GCA_003661385_00146	91	398	307	0.930303	0.7675
GCA_002506665_01489	84	405	321	0.972727	0.782927
GCA_014523485_00258	88	417	329	0.99697	0.785203
GCA_004524365_01450	93	384	291	0.881818	0.757812
GCA_009843815_01155	82	409	327	0.990909	0.79562
GCF_008000775_00281	96	428	332	1.00606	0.739421
GCA_004322465_01404	83	402	319	0.966667	0.731651
GCA_001510295_00344	83	409	326	0.987879	0.791262
GCF_000499765_01701	93	400	307	0.930303	0.763682
GCA_002317795_01375	84	404	320	0.969697	0.658436
GCF_000745485_03209	93	402	309	0.936364	0.766749
GCF_000744455_02296	93	404	311	0.942424	0.767901
GCA_003345545_02107	94	411	317	0.960606	0.747642
GCF_900095815_01573	87	373	286	0.866667	0.764706
GCA_014381835_01085	101	386	285	0.863636	0.738342
GCA_004524725_00381	95	406	311	0.942424	0.762255
GCA_002509745_01907	93	400	307	0.930303	0.765586
GCF_000145295_01552	87	368	281	0.851515	0.761518
GCA_011332645_00359	106	392	286	0.866667	0.727735
GCA_010028495_00483	86	404	318	0.963636	0.441054
GCA_002839705_00322	93	400	307	0.930303	0.765586
GCA_002067325_00556	92	398	306	0.927273	0.765
GCA_014523695_00691	90	398	308	0.933333	0.685969
GCA_013538715_00894	78	383	305	0.924242	0.792208
GCA_903884505_00742	1	296	295	0.893939	0.927673
GCA_009377575_03350	90	397	307	0.930303	0.689888
GCA_011370395_00882	89	366	277	0.839394	0.756831
GCA_012518185_01531	63	354	291	0.881818	0.812849
GCA_002502855_01362	45	351	306	0.927273	0.866856
GCA_011333035_00369	81	353	272	0.824242	0.770538
GCA_011373345_01047	90	391	301	0.912121	0.765903
GCA_002495625_01643	92	398	306	0.927273	0.765
GCA_002494885_01216	80	390	310	0.939394	0.792839
GCA_003663045_00450	81	357	276	0.836364	0.773109
GCA_009840065_00616	81	408	327	0.990909	0.797561
GCF_001639295_00140	120	441	321	0.972727	0.690323
GCF_011319465_01673	84	349	265	0.80303	0.757143
GCA_902784195_00822	92	408	316	0.957576	0.772616
GCA_011334735_01240	63	343	280	0.848485	0.816327
GCA_003600755_01679	94	399	305	0.924242	0.7625
GCA_011380095_00198	80	359	279	0.845455	0.777159
GCF_000008645_01189	87	369	282	0.854545	0.762162
GCF_000404225_01546	70	360	290	0.878788	0.801105
GCA_014361295_01475	29	342	313	0.948485	0.912536
GCA_001774245_02178	95	386	291	0.881818	0.753886
GCA_002498385_00795	114	420	306	0.927273	0.726841
GCF_002287175_01608	93	402	309	0.936364	0.766749
GCA_902801725_00765	86	382	296	0.89697	0.772846
GCA_011333475_01634	75	386	311	0.942424	0.783375
GCF_002813695_01562	93	400	307	0.930303	0.763682
GCF_000828575_01121	87	369	282	0.854545	0.762162
GCA_002509665_03185	110	419	309	0.936364	0.735714
GCA_013403005_00978	93	400	307	0.930303	0.765586
GCA_012519255_01717	64	358	294	0.890909	0.792453
GCA_009777005_01887	92	402	310	0.939394	0.769231
GCA_003663325_00508	5	89	84	0.254545	0.235294
GCA_003663325_00508	85	357	272	0.824242	0.761905
GCA_002713325_00064	90	414	324	0.981818	0.77327
GCA_902789505_01448	84	381	297	0.9	0.775457
GCF_003264935_01202	96	372	276	0.836364	0.741935
GCA_002726865_00586	101	382	281	0.851515	0.727979
GCF_001639265_01332	128	447	319	0.966667	0.708889
GCA_003491285_00792	93	405	312	0.945455	0.768473
GCA_001587715_00776	80	396	316	0.957576	0.79397
GCA_004553595_01250	93	408	315	0.954545	0.770171
GCA_008080765_00997	95	394	299	0.906061	0.756962
GCA_003491305_01803	94	400	306	0.927273	0.761194
GCA_011620845_00780	92	398	306	0.927273	0.765
GCA_902795935_00588	92	406	314	0.951515	0.771499
GCA_011358645_00744	1	282	281	0.851515	0.989437
GCA_011364975_00341	95	406	311	0.942424	0.764128
GCA_003153895_00879	65	358	293	0.887879	0.811634
GCA_003135935_00979	64	354	290	0.878788	0.805556
GCA_002504525_00896	65	352	287	0.869697	0.782016
GCA_011332735_00641	1	266	265	0.80303	0.996241
GCA_013166835_02727	90	400	310	0.939394	0.761671
GCA_003166335_01307	93	399	306	0.927273	0.763092
GCA_011364925_01045	94	406	312	0.945455	0.766585
GCA_002496805_01398	93	398	305	0.924242	0.7625
GCA_003663345_00501	87	353	266	0.806061	0.753541
GCA_902771435_01578	80	381	301	0.912121	0.785901
GCA_902774685_01111	95	409	314	0.951515	0.765854
GCA_002067565_01606	93	399	306	0.927273	0.763092
GCA_001800675_00701	62	346	284	0.860606	0.818444
GCA_002494495_00714	92	398	306	0.927273	0.765
GCA_013375475_00644	95	406	311	0.942424	0.764128
GCA_011335015_01005	2	258	256	0.775758	0.992248
GCA_002067065_01556	94	398	304	0.921212	0.76
GCA_003558235_00684	1	267	266	0.806061	0.996255
GCA_012838205_00799	93	400	307	0.930303	0.763682
GCA_002508545_02281	72	356	284	0.860606	0.757333
GCA_900321995_00828	93	412	319	0.966667	0.770531
GCF_000024185_02009	115	430	315	0.954545	0.730858
GCA_002898355_00209	88	388	300	0.909091	0.769231
GCA_013619005_01719	89	367	278	0.842424	0.755435
GCA_013178285_01334	80	394	314	0.951515	0.792929
GCA_000008085_00354	71	340	269	0.815152	0.788856
GCA_000309865_00009	94	405	311	0.942424	0.764128
GCF_001548675_01900	80	382	302	0.915152	0.788512
GCA_002067635_01478	70	362	292	0.884848	0.774536
GCA_002498285_00886	64	354	290	0.878788	0.801105
GCA_001421185_00394	65	369	304	0.921212	0.59144
GCA_902764455_01485	84	381	297	0.9	0.775457
GCA_012840175_00689	89	361	272	0.824242	0.753463
GCA_001512965_01341	64	357	293	0.887879	0.807163
GCA_001507955_00580	89	362	273	0.827273	0.754144
GCA_900318035_00295	86	381	295	0.893939	0.770235
GCA_004524425_00293	94	401	307	0.930303	0.763682
GCF_000302455_01793	94	405	311	0.942424	0.764128
GCA_900314615_01168	81	382	301	0.912121	0.785901
GCA_012719175_02151	68	356	288	0.872727	0.763926
GCA_001800815_00013	62	346	284	0.860606	0.818444
GCA_011355145_00473	56	351	295	0.893939	0.833333
GCA_012520845_01304	69	350	281	0.851515	0.796034
GCF_000970325_02190	59	351	292	0.884848	0.822535
GCA_003558085_01856	82	377	295	0.893939	0.780423
GCF_000217995_01948	51	342	291	0.881818	0.848397
GCA_003663115_00450	83	350	267	0.809091	0.762857
GCA_902769175_01443	93	406	313	0.948485	0.769042
GCA_902785855_00982	75	379	304	0.921212	0.7979
GCA_900319985_00305	78	381	303	0.918182	0.791123
GCA_013425405_00358	2	257	255	0.772727	0.992218
GCF_900103415_01439	72	375	303	0.918182	0.803714
GCA_011365055_02713	93	416	323	0.978788	0.772727
GCA_001587575_00621	106	418	312	0.945455	0.741093
GCF_001477655_02074	74	375	301	0.912121	0.798408
GCA_001595885_00256	76	346	270	0.818182	0.780347
GCF_000016525_01052	84	385	301	0.912121	0.777778
GCA_902782595_00516	84	382	298	0.90303	0.778068
GCA_902384555_01129	2	294	292	0.884848	0.707022
GCA_003584625_01206	87	362	275	0.833333	0.759669
GCA_002011125_02057	60	350	290	0.878788	0.823864
GCA_001742785_01224	81	361	280	0.848485	0.775623
GCA_001940645_00059	82	409	327	0.990909	0.767606
GCF_900114585_00967	94	406	312	0.945455	0.764706
GCA_011523285_00288	82	407	325	0.984848	0.697425
GCA_000402775_01171	81	362	281	0.851515	0.776243
GCA_013152685_01001	61	339	278	0.842424	0.820059
GCA_004377185_02215	69	347	278	0.842424	0.801153
GCA_902770715_02120	78	380	302	0.915152	0.790576
GCA_013415695_00136	67	345	278	0.842424	0.805797
GCA_902783085_01469	78	378	300	0.909091	0.789474
GCA_003661365_01324	97	383	286	0.866667	0.746736
GCA_011331665_00008	62	339	277	0.839394	0.817109
GCA_900320955_01383	38	342	304	0.921212	0.883721
GCA_001316125_01425	95	344	249	0.754545	0.723837
GCA_902777885_00287	72	375	303	0.918182	0.803714
GCA_003661265_00417	97	386	289	0.875758	0.748705
GCA_902774605_00229	82	381	299	0.906061	0.780679
GCA_900314695_00312	80	381	301	0.912121	0.785901
GCA_013791785_01667	70	352	282	0.854545	0.798867
GCA_013415865_00807	66	359	293	0.887879	0.811634
GCA_013329105_01063	69	353	284	0.860606	0.80226
GCA_900322125_01736	101	421	320	0.969697	0.754717
GCA_002509095_00769	100	418	318	0.963636	0.757143
GCA_902763935_01624	78	375	297	0.9	0.787798
GCA_902768765_00832	78	375	297	0.9	0.787798
GCA_902788255_00413	85	381	296	0.89697	0.772846
GCA_013425335_00608	2	257	255	0.772727	0.992218
GCA_003557905_00408	69	353	284	0.860606	0.8
GCF_900111645_01647	46	337	291	0.881818	0.855882
GCA_002496385_01225	73	346	273	0.827273	0.789017
GCA_002506905_00910	76	362	286	0.866667	0.785714
GCA_004524545_00287	94	426	332	1.00606	0.775701
GCA_900313645_00706	82	382	300	0.909091	0.78329
GCA_009786295_00006	77	359	282	0.854545	0.783333
GCA_002495685_00329	99	408	309	0.936364	0.753659
GCA_014361205_01362	47	339	292	0.884848	0.853801
GCA_011047985_00053	22	302	280	0.848485	0.924092
GCA_900317865_01035	72	375	303	0.918182	0.803714
GCA_013426015_00675	2	258	256	0.775758	0.992248
GCA_902772665_02252	75	382	307	0.930303	0.801567
GCF_003814835_00184	79	382	303	0.918182	0.791123
GCF_000166095_01169	82	359	277	0.839394	0.771588
GCA_011361945_00158	1	219	218	0.660606	0.951965
GCA_900314635_00669	93	409	316	0.957576	0.770732
GCA_007116915_00664	70	353	283	0.857576	0.797183
GCA_902384455_02499	74	353	279	0.845455	0.790368
GCA_011041895_00220	77	366	289	0.875758	0.789617
GCF_002252585_01491	88	386	298	0.90303	0.770026
GCA_009776495_01363	96	402	306	0.927273	0.759305
GCA_900319535_01840	78	375	297	0.9	0.787798
GCA_002067275_00609	47	356	309	0.936364	0.844262
GCF_001639285_00131	102	419	317	0.960606	0.754762
GCA_002508425_02172	47	356	309	0.936364	0.844262
GCA_002508425_01504	47	356	309	0.936364	0.844262
GCF_002208625_01338	92	398	306	0.927273	0.766917
GCA_003560875_00270	72	354	282	0.854545	0.789916
GCF_000621965_00609	92	400	308	0.933333	0.766169
GCF_000800805_01085	75	358	283	0.857576	0.786111
GCA_006954405_00015	66	355	289	0.875758	0.811798
GCA_007570915_00206	83	374	291	0.881818	0.771883
GCA_002067865_00398	68	358	290	0.878788	0.803324
GCF_001639275_01963	80	382	302	0.915152	0.788512
GCA_002254405_00920	85	356	271	0.821212	0.761236
GCA_011334385_00312	84	358	274	0.830303	0.765363
GCA_013329135_00970	63	346	283	0.857576	0.813218
GCF_000320505_00743	93	404	311	0.942424	0.767901
GCF_900774055_00357	59	349	290	0.878788	0.82153
GCA_003663175_00468	82	348	266	0.806061	0.764368
GCF_003111605_00624	90	387	297	0.9	0.763496
GCA_002497075_01294	67	358	291	0.881818	0.803867
GCA_900320515_01932	81	381	300	0.909091	0.78329
GCA_004524435_00249	92	403	311	0.942424	0.762255
GCA_001587675_01378	80	396	316	0.957576	0.79397
GCA_003266075_01805	87	403	316	0.957576	0.780247
GCF_002287235_01186	47	335	288	0.872727	0.857143
GCA_013331275_03019	47	335	288	0.872727	0.857143
GCF_000765475_01268	59	352	293	0.887879	0.825352
GCA_007127385_00459	51	342	291	0.881818	0.848397
GCF_000970305_02184	47	335	288	0.872727	0.857143
GCA_009778575_01136	77	358	281	0.851515	0.780556
GCF_003111625_01479	80	381	301	0.912121	0.785901
GCF_000328665_00056	47	356	309	0.936364	0.844262
GCA_902764015_00898	80	382	302	0.915152	0.784416
GCA_013330915_00332	87	405	318	0.963636	0.779412
GCA_013331465_00912	87	405	318	0.963636	0.779412
GCA_002778455_00113	1	305	304	0.921212	0.594912
GCA_012729095_00042	67	359	292	0.884848	0.80663
GCA_002763225_00914	1	272	271	0.821212	0.996324
GCA_013329565_00469	67	358	291	0.881818	0.803867
GCA_002498605_01062	72	354	282	0.854545	0.794366
GCA_009780575_00320	66	354	288	0.872727	0.811268
GCA_002499505_00485	1	306	305	0.924242	0.794271
GCA_902385155_00884	1	278	277	0.839394	0.97193
GCA_003266145_00437	89	408	319	0.966667	0.776156
GCA_003266105_00673	92	411	319	0.966667	0.770531
GCA_002507205_02251	7	300	293	0.887879	0.960656
GCF_000969965_00277	47	335	288	0.872727	0.857143
GCA_009776695_00250	42	336	294	0.890909	0.869822
GCA_001563305_00184	79	358	279	0.845455	0.775
GCA_003554965_01161	74	345	271	0.821212	0.785507
GCF_000300255_00225	74	364	290	0.878788	0.79235
GCA_003555025_01400	84	362	278	0.842424	0.763736
GCF_000970285_04096	47	335	288	0.872727	0.857143
GCA_003554235_00657	88	353	265	0.80303	0.750708
GCA_000200715_00503	81	385	304	0.921212	0.77551
GCA_902796575_00746	73	375	302	0.915152	0.803191
GCA_003724285_00698	119	429	310	0.939394	0.719258
GCA_902794475_00709	73	369	296	0.89697	0.797844
GCA_004525545_00985	65	360	295	0.893939	0.812672
GCF_003149675_00750	82	404	322	0.975758	0.791155
GCA_003558335_00826	81	394	313	0.948485	0.790404
GCA_013331925_00982	1	296	295	0.893939	0.986622
GCF_900100715_01733	33	334	301	0.912121	0.893175
GCA_012799835_00176	1	266	265	0.80303	0.992509
GCA_903923795_00129	2	291	289	0.875758	0.76455
GCA_003553905_00314	89	353	264	0.8	0.747875
GCA_002506175_00041	76	358	282	0.854545	0.783333
GCF_900767505_00523	76	360	284	0.860606	0.782369
GCF_003268005_01745	98	415	317	0.960606	0.760192
GCF_000970205_03294	47	335	288	0.872727	0.857143
GCA_902384585_00945	2	269	267	0.809091	0.992565
GCF_000196655_02204	47	327	280	0.848485	0.856269
GCA_001896725_01549	46	355	309	0.936364	0.844262
GCA_009777615_00171	78	357	279	0.845455	0.775
GCA_011335085_00179	82	358	276	0.836364	0.77095
GCA_000402355_00825	1	302	301	0.912121	0.640426
GCF_006546655_00500	72	372	300	0.909091	0.8
GCA_003662765_00077	89	405	316	0.957576	0.77451
GCF_000350305_00237	75	358	283	0.857576	0.783934
GCA_003550625_00423	89	353	264	0.8	0.747875
GCF_001481295_01048	77	364	287	0.869697	0.779891
GCA_002499085_01039	77	346	269	0.815152	0.777457
GCF_001304615_00969	47	334	287	0.869697	0.854167
GCA_003660965_00030	1	259	258	0.781818	0.996139
GCA_013329415_00570	48	335	287	0.869697	0.849112
GCF_900620265_01343	50	363	313	0.948485	0.683406
GCA_003663445_00510	47	314	267	0.809091	0.850318
GCA_001714685_02478	47	335	288	0.872727	0.857143
GCA_005878375_01752	79	348	269	0.815152	0.764205
GCA_902386535_01031	2	284	282	0.854545	0.87037
GCA_003663415_01100	114	384	270	0.818182	0.703125
GCA_003724325_00135	104	414	310	0.939394	0.745192
GCA_002503545_00557	75	363	288	0.872727	0.786885
GCF_000979455_02234	47	334	287	0.869697	0.854167
GCA_002779065_00111	1	264	263	0.79697	0.996212
GCA_011046235_01418	62	351	289	0.875758	0.818697
GCF_000504205_01281	15	314	299	0.906061	0.943218
GCA_001784635_00413	76	346	270	0.818182	0.780347
GCF_900766745_01654	86	390	304	0.921212	0.777494
GCA_013331625_00617	1	307	306	0.927273	0.628337
GCF_002243045_02726	51	345	294	0.890909	0.842407
GCA_002506425_01309	71	360	289	0.875758	0.793956
GCA_002505345_00215	73	359	286	0.866667	0.792244
GCA_011362635_00343	73	353	280	0.848485	0.79096
GCA_903921825_01316	1	287	286	0.866667	0.882716
GCA_002509405_01149	73	359	286	0.866667	0.792244
GCF_000969885_02301	48	334	286	0.866667	0.85119
GCF_004099695_01609	48	335	287	0.869697	0.854167
GCA_900316895_01013	1	254	253	0.766667	0.988281
GCA_003551675_01221	6	118	112	0.339394	0.326531
GCA_003551675_01221	86	343	257	0.778788	0.749271
GCF_000012545_01426	91	407	316	0.957576	0.772616
GCF_001560915_01620	71	361	290	0.878788	0.788043
GCA_009784745_01051	67	356	289	0.875758	0.809524
GCA_014238095_00515	84	357	273	0.827273	0.764706
GCA_002498365_00685	73	359	286	0.866667	0.792244
GCA_013202845_00176	1	244	243	0.736364	0.995902
GCF_902763685_00062	52	339	287	0.869697	0.839181
GCF_902787415_01298	72	361	289	0.875758	0.785326
GCF_000970045_03357	48	335	287	0.869697	0.849112
GCF_000513315_00969	103	417	314	0.951515	0.751196
GCA_003565715_00135	67	366	299	0.906061	0.810298
GCF_000007345_00352	47	334	287	0.869697	0.854167
GCF_900114835_02746	28	351	323	0.978788	0.907303
GCA_903930485_01027	85	384	299	0.906061	0.764706
GCA_011331255_00640	70	353	283	0.857576	0.797183
GCF_000970025_00531	47	334	287	0.869697	0.854167
GCF_000195895_00845	47	334	287	0.869697	0.854167
GCF_001729965_01049	90	410	320	0.969697	0.772947
GCF_000013725_01658	62	352	290	0.878788	0.819209
GCA_903892905_00828	1	274	273	0.827273	0.98913
GCF_009911715_00251	76	360	284	0.860606	0.78453
GCA_000830275_00030	1	277	276	0.836364	0.99639
GCA_002504405_00246	73	359	286	0.866667	0.792244
GCA_002509325_00442	48	335	287	0.869697	0.854167
GCA_005878915_00736	68	355	287	0.869697	0.799443
GCA_013331265_01221	47	335	288	0.872727	0.857143
GCA_002505485_02116	48	334	286	0.866667	0.85119
GCA_002789635_00886	61	340	279	0.845455	0.820588
GCA_013151465_00229	86	365	279	0.845455	0.764384
GCA_013329855_01253	72	351	279	0.845455	0.790368
GCF_000970265_00214	47	334	287	0.869697	0.854167
GCA_011358475_00802	2	268	266	0.806061	0.992537
GCA_902797085_00281	88	404	316	0.957576	0.778325
GCA_002504495_01434	72	360	288	0.872727	0.791209
GCA_002495325_00213	71	369	298	0.90303	0.801075
GCA_005239845_01246	1	297	296	0.89697	0.961039
GCA_002496565_03026	48	335	287	0.869697	0.854167
GCA_009778265_00243	69	358	289	0.875758	0.802778
GCF_002072215_00804	110	431	321	0.972727	0.743056
GCF_000970085_00304	47	335	288	0.872727	0.857143
GCA_002254565_01243	84	356	272	0.824242	0.764045
GCA_011334515_00187	2	261	259	0.784848	0.992337
GCA_002499405_00721	18	302	284	0.860606	0.940397
GCA_002067045_01423	1	237	236	0.715152	0.979253
GCA_002763335_00309	86	339	253	0.766667	0.741935
GCA_002792915_00490	20	305	285	0.863636	0.934426
GCA_003568775_00051	61	332	271	0.821212	0.816265
GCA_012522645_01431	69	359	290	0.878788	0.796703
GCA_002502965_00869	66	362	296	0.89697	0.808743
GCA_003551065_01017	76	341	265	0.80303	0.777126
GCA_014384375_00307	1	244	243	0.736364	0.995902
GCA_013331315_00325	65	322	257	0.778788	0.6781
GCA_002499445_00723	47	335	288	0.872727	0.857143
GCA_903851445_01118	2	289	287	0.869697	0.698297
GCA_005878515_01585	73	354	281	0.851515	0.789326
GCA_005878415_00171	71	353	282	0.854545	0.792135
GCA_003663225_00735	67	334	267	0.809091	0.794643
GCA_005878615_01830	83	352	269	0.815152	0.755618
GCA_009776625_00516	87	357	270	0.818182	0.75
GCA_005878985_00743	73	354	281	0.851515	0.789326
GCA_012515075_00880	75	365	290	0.878788	0.77957
GCA_011363135_00006	82	359	277	0.839394	0.771588
GCA_003554845_00243	85	353	268	0.812121	0.759207
GCA_009780795_00967	68	355	287	0.869697	0.80618
GCF_013388255_02489	54	342	288	0.872727	0.837209
GCA_900314605_00993	91	406	315	0.954545	0.773956
GCA_013152995_00097	55	313	258	0.781818	0.819048
GCA_005878955_00084	68	352	284	0.860606	0.797753
GCA_002506595_00655	56	328	272	0.824242	0.829268
GCA_003164755_01353	47	339	292	0.884848	0.858824
GCF_003947435_00885	93	374	281	0.851515	0.751337
GCA_002501695_01225	10	304	294	0.890909	0.957655
GCA_902384675_00867	77	346	269	0.815152	0.777457
GCA_003560595_00451	70	335	265	0.80303	0.791045
GCA_007129655_00935	67	335	268	0.812121	0.8
GCA_007133925_00707	67	319	252	0.763636	0.789969
GCA_002506255_00859	71	364	293	0.887879	0.800546
GCF_000969905_03266	47	334	287	0.869697	0.854167
GCA_003552585_01570	75	341	266	0.806061	0.780059
GCA_002762865_00866	72	340	268	0.812121	0.788235
GCA_002926195_01165	46	351	305	0.924242	0.864023
GCA_001871535_00157	1	258	257	0.778788	0.996124
GCA_002728275_01349	72	357	285	0.863636	0.793872
GCA_002686295_00126	1	244	243	0.736364	0.995902
GCA_003564925_00926	52	316	264	0.8	0.835443
GCA_013139905_00433	16	126	110	0.333333	0.275689
GCA_013139905_00433	81	395	314	0.951515	0.786967
GCA_013152905_00615	54	320	266	0.806061	0.83125
GCA_003266165_00957	93	407	314	0.951515	0.767726
GCA_001421175_00544	69	363	294	0.890909	0.803279
GCA_002688265_00521	40	317	277	0.839394	0.873817
GCA_011334955_00308	1	262	261	0.790909	0.996183
GCA_011358535_00225	2	279	277	0.839394	0.992832
GCA_002838935_00801	74	371	297	0.9	0.775457
GCF_004137855_01047	48	317	269	0.815152	0.84858
GCF_004745425_01300	50	344	294	0.890909	0.847262
GCA_003660975_00433	1	242	241	0.730303	0.995868
GCA_001940725_00809	76	388	312	0.945455	0.795918
GCA_001800825_00766	71	349	278	0.842424	0.789773
GCA_001871475_01013	2	259	257	0.778788	0.992278
GCA_011367145_00600	90	364	274	0.830303	0.752747
GCA_014237145_00355	46	328	282	0.854545	0.859756
GCF_900215215_00317	48	317	269	0.815152	0.84858
GCA_009649835_01667	46	328	282	0.854545	0.859756
GCA_013203345_01555	56	318	262	0.793939	0.823899
GCA_005878485_00414	76	351	275	0.833333	0.772472
GCA_005878525_00672	74	353	279	0.845455	0.783708
GCF_003722075_00179	48	317	269	0.815152	0.84858
GCA_005878665_00199	77	354	277	0.839394	0.77809
GCF_002761295_01094	47	316	269	0.815152	0.851266
GCA_003553085_01439	74	336	262	0.793939	0.779762
GCA_903835385_00277	1	269	268	0.812121	0.996283
GCA_000306725_01807	30	323	293	0.887879	0.896024
GCA_903835325_00511	1	272	271	0.821212	0.981884
GCA_001552015_00034	55	327	272	0.824242	0.831804
GCA_013374385_00586	34	318	284	0.860606	0.893082
GCA_005878995_00200	76	352	276	0.836364	0.775281
GCA_003695265_00233	40	300	260	0.787879	0.863787
GCF_001889405_00544	48	317	269	0.815152	0.84858
GCA_902386385_00176	1	284	283	0.857576	0.996479
GCA_001800745_00422	70	353	283	0.857576	0.794944
GCA_005239615_00305	1	304	303	0.918182	0.63522
GCA_903907555_00857	51	318	267	0.809091	0.839623
GCA_902386555_00809	8	308	300	0.909091	0.958466
GCA_013331595_00533	1	282	281	0.851515	0.667458
GCA_002762705_00006	55	322	267	0.809091	0.829193
GCA_011049195_00319	57	341	284	0.860606	0.825581
GCA_001761425_00432	1	248	247	0.748485	0.995968
GCA_013202955_00661	25	299	274	0.830303	0.916388
GCF_000025865_00131	47	317	270	0.818182	0.851735
GCA_013331635_00620	43	305	262	0.793939	0.859016
GCA_011366665_00937	96	334	238	0.721212	0.712575
GCA_002762985_00327	75	353	278	0.842424	0.785311
GCA_013331455_01376	1	270	269	0.815152	0.996296
GCA_002687795_00742	1	246	245	0.742424	0.995935
GCA_003086415_00298	56	327	271	0.821212	0.828746
GCA_903893865_00371	2	307	305	0.924242	0.758706
GCA_005879015_01514	77	353	276	0.836364	0.777465
GCA_002687775_00278	44	302	258	0.781818	0.851485
GCA_013331805_00386	2	267	265	0.80303	0.992509
GCA_011372335_00668	2	250	248	0.751515	0.992
GCA_001871595_00405	1	231	230	0.69697	0.995671
GCA_014189685_00304	85	357	272	0.824242	0.759777
GCA_000387965_00027	57	327	270	0.818182	0.825688
GCA_001595785_00146	1	244	243	0.736364	0.995902
GCA_005879065_00427	72	354	282	0.854545	0.792135
GCA_005879045_01396	74	353	279	0.845455	0.783708
GCA_013331615_00588	90	352	262	0.793939	0.744318
GCA_005878385_00168	73	350	277	0.839394	0.77809
GCA_002688775_00210	49	315	266	0.806061	0.844444
GCA_013329495_00051	66	344	278	0.842424	0.80814
GCA_001871495_00435	1	261	260	0.787879	0.996169
GCA_011366705_00290	52	327	275	0.833333	0.840979
GCA_002011395_01296	60	302	242	0.733333	0.793443
GCA_002763025_00485	47	309	262	0.793939	0.847896
GCA_003561825_00489	72	335	263	0.79697	0.785075
GCA_000494145_00549	1	211	210	0.636364	0.976744
GCA_902384795_00181	2	251	249	0.754545	0.992032
GCA_011368255_00167	12	274	262	0.793939	0.956204
GCA_013331695_00247	35	322	287	0.869697	0.891304
GCA_013331535_00759	8	307	299	0.906061	0.970779
GCA_013425425_00310	5	283	278	0.842424	0.982332
GCA_013204355_01076	48	308	260	0.787879	0.841424
GCA_014384455_00759	1	244	243	0.736364	0.995902
GCA_002867475_00289	31	309	278	0.842424	0.899676
GCA_903858385_00710	3	315	312	0.945455	0.923077
GCA_013425375_00080	6	297	291	0.881818	0.979798
GCA_001563995_00554	1	249	248	0.751515	0.995984
GCA_011605715_01716	51	337	286	0.866667	0.848665
GCF_902158745_01613	24	298	274	0.830303	0.919463
GCA_001873845_00099	99	383	284	0.860606	0.741514
GCA_013331965_00870	1	248	247	0.748485	0.995968
GCA_011362975_00385	1	258	257	0.778788	0.996124
GCA_013138805_00585	80	349	269	0.815152	0.770774
GCA_903904885_00336	65	325	260	0.787879	0.795107
GCA_014361245_00932	62	146	84	0.254545	0.272727
GCA_014361245_00932	140	308	168	0.509091	0.545455
GCA_013425455_00846	43	324	281	0.851515	0.864615
GCA_002498125_00160	6	259	253	0.766667	0.973077
GCA_005222965_00404	1	238	237	0.718182	0.995798
GCA_002083985_00639	87	369	282	0.854545	0.764228
GCA_903920925_00750	36	310	274	0.830303	0.881029
GCA_013425325_00970	1	265	264	0.8	0.996226
GCA_003009795_00529	1	252	251	0.760606	0.996032
GCA_002762845_00136	30	284	254	0.769697	0.894366
GCA_004212085_00396	24	298	274	0.830303	0.919463
GCA_002688925_00049	49	316	267	0.809091	0.839623
GCA_013330825_00679	47	308	261	0.790909	0.847403
GCA_902384935_00192	148	421	273	0.827273	0.648456
GCA_013331845_00343	1	209	208	0.630303	0.995215
GCA_013331555_01390	49	311	262	0.793939	0.839744
GCA_013330215_00057	1	291	290	0.878788	0.938511
GCA_005878325_00691	80	324	244	0.739394	0.753086
GCA_000806115_00764	65	321	256	0.775758	0.797508
GCA_011333755_00247	71	337	266	0.806061	0.789318
GCA_014297435_00235	1	249	248	0.751515	0.995984
GCA_011363705_00080	96	309	213	0.645455	0.68932
GCA_003695045_00753	72	340	268	0.812121	0.788235
GCA_004193545_00154	49	317	268	0.812121	0.845426
GCA_002792115_00579	28	290	262	0.793939	0.903448
GCA_902552015_00606	64	313	249	0.754545	0.795527
GCA_003650545_00741	1	230	229	0.693939	0.991342
GCA_003695435_00548	1	239	238	0.721212	0.995816
GCA_002255135_00163	31	301	270	0.818182	0.888158
GCA_903828955_00539	1	267	266	0.806061	0.988848
GCA_902386255_02623	45	303	258	0.781818	0.851485
GCF_013343275_00650	1	253	252	0.763636	0.996047
GCA_002501775_00023	1	281	280	0.848485	0.996441
GCA_004212095_00741	49	317	268	0.812121	0.845426
GCA_002762785_00570	29	287	258	0.781818	0.898955
GCA_013331575_00846	33	309	276	0.836364	0.890323
GCA_013329175_00223	45	315	270	0.818182	0.851735
GCA_003009815_00822	1	249	248	0.751515	0.995984
GCA_001563875_00197	2	254	252	0.763636	0.992126
GCA_003561665_00009	72	352	280	0.848485	0.793201
GCA_002254825_00966	1	242	241	0.730303	0.983673
GCA_902385515_00296	2	292	290	0.878788	0.585859
GCA_011358415_00268	1	246	245	0.742424	0.995935
GCF_002487355_01375	48	145	97	0.293939	0.316993
GCF_002487355_01375	127	306	179	0.542424	0.584967
GCA_903842985_00727	1	234	233	0.706061	0.991489
GCA_000204585_01787	1	206	205	0.621212	0.615616
GCA_007133845_00336	60	319	259	0.784848	0.811912
GCA_903884115_00130	1	287	286	0.866667	0.80112
GCA_008297865_00444	71	158	87	0.263636	0.270186
GCA_008297865_00444	154	322	168	0.509091	0.521739
GCA_012962055_00696	91	318	227	0.687879	0.713836
GCF_000685155_01286	44	122	78	0.236364	0.263514
GCF_000685155_01286	135	296	161	0.487879	0.543919
GCA_013330875_00485	33	294	261	0.790909	0.887755
GCA_003009755_00100	75	349	274	0.830303	0.782857
GCA_002496065_01281	1	227	226	0.684848	0.9869
GCA_902384525_03133	47	138	91	0.275758	0.292605
GCA_902384525_03133	128	311	183	0.554545	0.588424
GCA_000220375_01327	1	250	249	0.754545	0.992032
GCA_011389055_00031	2	295	293	0.887879	0.896024
GCA_011363025_00304	72	328	256	0.775758	0.778116
GCA_002502135_00709	1	275	274	0.830303	0.978571
GCF_004363215_00408	63	328	265	0.80303	0.807927
GCA_003555465_00306	1	188	187	0.566667	0.994681
GCF_000011005_01586	1	229	228	0.690909	0.974359
GCA_002839545_01504	45	144	99	0.3	0.331104
GCA_002839545_01504	139	299	160	0.484848	0.535117
GCF_009617975_00246	1	249	248	0.751515	0.995984
GCA_013335235_01585	56	320	264	0.8	0.825
GCF_009789175_01110	32	126	94	0.284848	0.333333
GCF_009789175_01110	111	282	171	0.518182	0.606383
GCF_008122205_02318	32	130	98	0.29697	0.333333
GCF_008122205_02318	126	293	167	0.506061	0.568027
GCA_001889985_00127	1	296	295	0.893939	0.986622
GCF_007833275_01457	26	118	92	0.278788	0.333333
GCF_007833275_01457	108	276	168	0.509091	0.608696
GCF_001315925_03449	1	188	187	0.566667	0.921182
GCA_002011355_00227	59	161	102	0.309091	0.321767
GCA_002011355_00227	148	317	169	0.512121	0.533123
GCA_013138765_00996	81	348	267	0.809091	0.767241
GCA_002688315_00004	66	320	254	0.769697	0.79375
GCA_003724275_00596	83	322	239	0.724242	0.742236
GCA_013331515_01022	84	348	264	0.8	0.758621
GCF_001971705_01117	32	126	94	0.284848	0.316498
GCF_001971705_01117	120	294	174	0.527273	0.585859
GCF_013402815_00880	28	132	104	0.315152	0.352542
GCF_013402815_00880	123	294	171	0.518182	0.579661
GCA_003694965_00388	1	281	280	0.848485	0.989399
GCA_012026795_00386	45	142	97	0.293939	0.324415
GCA_012026795_00386	123	299	176	0.533333	0.588629
GCF_900112205_03353	32	125	93	0.281818	0.312081
GCF_900112205_03353	119	295	176	0.533333	0.590604
GCA_014189675_00584	62	321	259	0.784848	0.806854
GCA_902386115_01147	45	143	98	0.29697	0.335616
GCA_902386115_01147	129	292	163	0.493939	0.558219
GCA_011371845_00438	94	376	282	0.854545	0.75
GCA_001563885_01786	32	135	103	0.312121	0.351536
GCA_001563885_01786	127	291	164	0.49697	0.559727
GCF_003675855_01955	28	120	92	0.278788	0.329749
GCF_003675855_01955	112	279	167	0.506061	0.598566
GCA_003560545_00166	1	238	237	0.718182	0.995798
GCF_900108095_01007	33	132	99	0.3	0.333333
GCF_900108095_01007	124	289	165	0.5	0.555556
GCF_000337675_04190	32	125	93	0.281818	0.313131
GCF_000337675_04190	134	294	160	0.484848	0.538721
GCF_900104065_00073	32	132	100	0.30303	0.344828
GCF_900104065_00073	124	289	165	0.5	0.568966
GCA_002503705_00852	1	249	248	0.751515	0.988048
GCF_003675875_02922	28	122	94	0.284848	0.336918
GCF_003675875_02922	121	279	158	0.478788	0.566308
GCA_003649915_00791	79	149	70	0.212121	0.228758
GCA_003649915_00791	142	306	164	0.49697	0.535948
GCF_003841465_03637	32	124	92	0.278788	0.313993
GCF_003841465_03637	108	292	184	0.557576	0.627986
GCF_000337195_03602	28	132	104	0.315152	0.357388
GCF_000337195_03602	120	289	169	0.512121	0.580756
GCF_900116205_03967	32	131	99	0.3	0.327815
GCF_900116205_03967	123	298	175	0.530303	0.57947
GCF_000337575_00705	50	135	85	0.257576	0.264798
GCF_000337575_00705	135	319	184	0.557576	0.573209
GCA_007122455_01696	62	156	94	0.284848	0.305195
GCA_007122455_01696	151	308	157	0.475758	0.50974
GCF_900110535_02976	27	120	93	0.281818	0.33574
GCF_900110535_02976	112	277	165	0.5	0.595668
GCA_002495465_00319	63	321	258	0.781818	0.803738
GCF_006543045_00742	58	153	95	0.287879	0.286145
GCF_006543045_00742	167	331	164	0.49697	0.493976
GCA_902385045_00089	2	253	251	0.760606	0.992095
GCF_004681185_00804	29	126	97	0.293939	0.345196
GCF_004681185_00804	117	281	164	0.49697	0.58363
GCF_002214165_00690	1	311	310	0.939394	0.925373
GCA_012719315_01044	1	186	185	0.560606	0.973684
GCA_012518265_00099	72	362	290	0.878788	0.801105
GCF_003610195_01604	62	158	96	0.290909	0.296296
GCF_003610195_01604	148	323	175	0.530303	0.540123
GCF_900196725_00355	44	123	79	0.239394	0.265993
GCF_900196725_00355	135	297	162	0.490909	0.545455
GCF_000517625_01619	32	130	98	0.29697	0.324503
GCF_000517625_01619	124	299	175	0.530303	0.57947
GCA_003650975_00589	64	315	251	0.760606	0.796825
GCF_002156705_02532	33	130	97	0.293939	0.324415
GCF_002156705_02532	122	296	174	0.527273	0.58194
GCF_000383975_03776	32	129	97	0.293939	0.323333
GCF_000383975_03776	128	295	167	0.506061	0.556667
GCA_012026835_03425	44	142	98	0.29697	0.327759
GCA_012026835_03425	137	299	162	0.490909	0.541806
GCF_004785955_03125	31	125	94	0.284848	0.333333
GCF_004785955_03125	123	282	159	0.481818	0.56383
GCA_007117735_00348	6	259	253	0.766667	0.976834
GCF_000337615_00628	32	136	104	0.315152	0.352542
GCF_000337615_00628	126	293	167	0.506061	0.566102
GCF_000731985_03651	28	132	104	0.315152	0.357388
GCF_000731985_03651	122	289	167	0.506061	0.573883
GCF_004698125_03299	28	314	286	0.866667	0.888199
GCA_009784005_00027	193	459	266	0.806061	0.578261
GCA_902386135_01796	44	124	80	0.242424	0.26936
GCA_902386135_01796	131	297	166	0.50303	0.558923
GCA_903832205_01082	2	296	294	0.890909	0.53945
GCA_007135505_00641	32	125	93	0.281818	0.311037
GCA_007135505_00641	126	296	170	0.515152	0.568562
GCF_900100335_02771	33	126	93	0.281818	0.31
GCF_900100335_02771	129	297	168	0.509091	0.56
GCA_001563915_00450	2	246	244	0.739394	0.99187
GCF_000226975_03179	32	126	94	0.284848	0.315436
GCF_000226975_03179	119	295	176	0.533333	0.590604
GCF_900129775_02768	36	130	94	0.284848	0.316498
GCF_900129775_02768	125	292	167	0.506061	0.56229
GCA_001564035_00692	2	248	246	0.745455	0.991935
GCA_002687935_00519	63	321	258	0.781818	0.803738
GCF_000455345_02103	34	127	93	0.281818	0.315254
GCF_000455345_02103	125	292	167	0.506061	0.566102
GCA_003023565_00965	32	126	94	0.284848	0.332155
GCA_003023565_00965	125	283	158	0.478788	0.558304
GCA_002779235_00383	68	319	251	0.760606	0.786834
GCF_900110865_00617	32	134	102	0.309091	0.345763
GCF_900110865_00617	130	294	164	0.49697	0.555932
GCF_000328685_03771	33	130	97	0.293939	0.337979
GCF_000328685_03771	123	285	162	0.490909	0.56446
GCF_000337695_00191	33	124	91	0.275758	0.311644
GCF_000337695_00191	117	290	173	0.524242	0.592466
GCF_008245225_03274	31	301	270	0.818182	0.873786
GCF_900113245_01922	33	125	92	0.278788	0.323944
GCF_900113245_01922	119	284	165	0.5	0.580986
GCA_003694385_00897	1	218	217	0.657576	0.995413
GCA_003661905_01146	97	310	213	0.645455	0.687097
GCA_011772645_00869	91	192	101	0.306061	0.297935
GCA_011772645_00869	187	339	152	0.460606	0.448378
GCF_001488575_01427	27	130	103	0.312121	0.371841
GCF_001488575_01427	112	277	165	0.5	0.595668
GCF_000337535_03223	49	143	94	0.284848	0.300319
GCF_000337535_03223	138	311	173	0.524242	0.552716
GCF_000337135_01700	48	134	86	0.260606	0.269592
GCF_000337135_01700	123	315	192	0.581818	0.601881
GCF_000376445_00538	36	130	94	0.284848	0.328671
GCF_000376445_00538	124	286	162	0.490909	0.566434
GCF_009791395_00562	29	122	93	0.281818	0.312081
GCF_009791395_00562	113	285	172	0.521212	0.577181
GCF_000337475_02320	28	123	95	0.287879	0.324232
GCF_000337475_02320	121	292	171	0.518182	0.583618
GCA_003104905_00883	37	125	88	0.266667	0.296296
GCA_003104905_00883	121	297	176	0.533333	0.592593
GCF_004765785_02431	35	130	95	0.287879	0.323129
GCF_004765785_02431	128	293	165	0.5	0.561224
GCF_000063445_02809	36	297	261	0.790909	0.878788
GCA_000405245_00047	63	331	268	0.812121	0.809668
GCF_000337215_01611	34	127	93	0.281818	0.30897
GCF_000337215_01611	128	296	168	0.509091	0.55814
GCA_014647235_00645	26	121	95	0.287879	0.341727
GCA_014647235_00645	118	277	159	0.481818	0.571942
GCF_005576615_01948	28	130	102	0.309091	0.352941
GCF_005576615_01948	120	287	167	0.506061	0.577855
GCF_002844195_03400	27	122	95	0.287879	0.296875
GCF_002844195_03400	121	313	192	0.581818	0.6
GCF_900110455_04027	28	127	99	0.3	0.339041
GCF_900110455_04027	115	290	175	0.530303	0.599315
GCA_000830295_00381	60	316	256	0.775758	0.810127
GCA_003021085_02961	32	109	77	0.233333	0.27305
GCA_003021085_02961	122	282	160	0.484848	0.567376
GCF_900115675_01172	28	125	97	0.293939	0.326599
GCF_900115675_01172	104	295	191	0.578788	0.643098
GCF_003977755_00235	32	132	100	0.30303	0.338983
GCF_003977755_00235	120	293	173	0.524242	0.586441
GCF_003670115_03926	32	127	95	0.287879	0.316667
GCF_003670115_03926	122	299	177	0.536364	0.59
GCF_902158735_01504	49	129	80	0.242424	0.282686
GCF_902158735_01504	120	283	163	0.493939	0.575972
GCF_005954745_01927	32	128	96	0.290909	0.339223
GCF_005954745_01927	117	283	166	0.50303	0.586572
GCF_000337095_00418	33	127	94	0.284848	0.330986
GCF_000337095_00418	116	284	168	0.509091	0.591549
GCF_002572525_03858	28	130	102	0.309091	0.343434
GCF_002572525_03858	121	295	174	0.527273	0.585859
GCF_000379085_03471	26	119	93	0.281818	0.333333
GCF_000379085_03471	111	277	166	0.50303	0.594982
GCA_003021785_02146	31	125	94	0.284848	0.32526
GCA_003021785_02146	116	288	172	0.521212	0.595156
GCF_004944975_00239	32	126	94	0.284848	0.333333
GCF_004944975_00239	117	282	165	0.5	0.585106
GCA_903891505_00258	2	254	252	0.763636	0.992126
GCA_001564135_00718	30	119	89	0.269697	0.317857
GCA_001564135_00718	119	280	161	0.487879	0.575
GCA_000690595_02787	33	134	101	0.306061	0.341216
GCA_000690595_02787	127	294	167	0.506061	0.564189
GCA_003023785_02335	28	121	93	0.281818	0.318493
GCA_003023785_02335	134	292	158	0.478788	0.541096
GCA_013152845_01159	63	142	79	0.239394	0.240122
GCA_013152845_01159	141	324	183	0.554545	0.556231
GCF_900188065_03121	35	128	93	0.281818	0.313131
GCF_900188065_03121	118	296	178	0.539394	0.599327
GCF_009690625_01124	28	122	94	0.284848	0.336918
GCF_009690625_01124	113	279	166	0.50303	0.594982
GCF_009834785_00600	32	126	94	0.284848	0.318644
GCF_009834785_00600	127	293	166	0.50303	0.562712
GCF_003841505_00064	32	130	98	0.29697	0.317152
GCF_003841505_00064	117	305	188	0.569697	0.608414
GCF_013839425_01764	28	123	95	0.287879	0.340502
GCF_013839425_01764	123	279	156	0.472727	0.55914
GCF_013342135_03070	32	126	94	0.284848	0.311258
GCF_013342135_03070	122	300	178	0.539394	0.589404
GCF_000230735_02124	33	127	94	0.284848	0.314381
GCF_000230735_02124	126	296	170	0.515152	0.568562
GCA_014361195_00625	61	144	83	0.251515	0.267742
GCA_014361195_00625	150	310	160	0.484848	0.516129
GCF_000337595_02483	49	143	94	0.284848	0.300319
GCF_000337595_02483	134	311	177	0.536364	0.565495
GCF_900112175_01052	33	119	86	0.260606	0.302817
GCF_900112175_01052	111	284	173	0.524242	0.609155
GCF_003382685_01503	32	127	95	0.287879	0.320946
GCF_003382685_01503	117	293	176	0.533333	0.594595
GCF_009617995_01549	26	119	93	0.281818	0.333333
GCF_009617995_01549	104	277	173	0.524242	0.620072
GCA_007135435_00229	33	308	275	0.833333	0.892857
GCF_013456555_00081	28	130	102	0.309091	0.343434
GCF_013456555_00081	120	295	175	0.530303	0.589226
GCF_003730195_03613	33	133	100	0.30303	0.334448
GCF_003730195_03613	121	296	175	0.530303	0.585284
GCF_002177135_01581	38	134	96	0.290909	0.322148
GCF_002177135_01581	130	296	166	0.50303	0.557047
GCF_013342525_02042	27	121	94	0.284848	0.335714
GCF_013342525_02042	112	280	168	0.509091	0.6
GCF_004799685_02586	32	110	78	0.236364	0.265306
GCF_004799685_02586	138	294	156	0.472727	0.530612
GCF_002494345_00952	33	135	102	0.309091	0.344595
GCF_002494345_00952	126	294	168	0.509091	0.567568
GCF_009392895_03159	32	128	96	0.290909	0.33218
GCF_009392895_03159	129	288	159	0.481818	0.550173
GCF_001307315_02563	29	108	79	0.239394	0.268707
GCF_001307315_02563	106	293	187	0.566667	0.636054
GCF_013415905_04471	28	124	96	0.290909	0.323232
GCF_013415905_04471	120	292	172	0.521212	0.579125
GCF_900115785_01034	32	126	94	0.284848	0.332155
GCF_900115785_01034	113	283	170	0.515152	0.600707
GCF_001282785_01970	29	125	96	0.290909	0.333333
GCF_001282785_01970	119	288	169	0.512121	0.586806
GCA_011373045_00577	61	326	265	0.80303	0.810398
GCF_008831545_01269	34	128	94	0.284848	0.314381
GCF_008831545_01269	126	297	171	0.518182	0.571906
GCF_001485535_01497	27	121	94	0.284848	0.33935
GCF_001485535_01497	112	277	165	0.5	0.595668
GCF_000230715_00185	533	638	105	0.318182	0.132576
GCF_000230715_00185	626	791	165	0.5	0.208333
GCA_011055275_00778	1	161	160	0.484848	0.981595
GCF_004217335_03152	28	130	102	0.309091	0.351724
GCF_004217335_03152	122	289	167	0.506061	0.575862
GCF_000172995_01516	33	125	92	0.278788	0.323944
GCF_000172995_01516	116	284	168	0.509091	0.591549
GCA_011052825_01242	60	316	256	0.775758	0.810127
GCF_001861355_03130	44	121	77	0.233333	0.243671
GCF_001861355_03130	132	314	182	0.551515	0.575949
GCF_000337555_01894	49	149	100	0.30303	0.319489
GCF_000337555_01894	143	312	169	0.512121	0.539936
GCF_000337775_03282	26	128	102	0.309091	0.364286
GCF_000337775_03282	111	280	169	0.512121	0.603571
GCF_009741925_02615	32	126	94	0.284848	0.336918
GCF_009741925_02615	120	279	159	0.481818	0.569892
GCA_003139855_01143	45	125	80	0.242424	0.265781
GCA_003139855_01143	140	301	161	0.487879	0.534884
GCF_004765815_03700	33	127	94	0.284848	0.312292
GCF_004765815_03700	119	299	180	0.545455	0.598007
GCF_003430825_01327	30	131	101	0.306061	0.353147
GCF_003430825_01327	124	283	159	0.481818	0.555944
GCF_001989615_00314	27	126	99	0.3	0.349823
GCF_001989615_00314	120	283	163	0.493939	0.575972
GCF_000023965_02257	26	119	93	0.281818	0.333333
GCF_000023965_02257	105	277	172	0.521212	0.616487
GCA_002763265_00956	31	307	276	0.836364	0.899023
GCA_001563805_01875	30	125	95	0.287879	0.332168
GCA_001563805_01875	115	284	169	0.512121	0.590909
GCF_004143485_02280	32	124	92	0.278788	0.30363
GCF_004143485_02280	115	300	185	0.560606	0.610561
GCA_001564285_01829	20	118	98	0.29697	0.355072
GCA_001564285_01829	122	276	154	0.466667	0.557971
GCF_000217715_00224	33	127	94	0.284848	0.313333
GCF_000217715_00224	131	292	161	0.487879	0.536667
GCF_013402875_02404	27	120	93	0.281818	0.327465
GCF_013402875_02404	110	282	172	0.521212	0.605634
GCA_003559215_02040	32	129	97	0.293939	0.332192
GCA_003559215_02040	121	289	168	0.509091	0.575342
GCF_003665925_01025	32	112	80	0.242424	0.282686
GCF_003665925_01025	127	283	156	0.472727	0.551237
GCF_001625445_00050	31	126	95	0.287879	0.338078
GCF_001625445_00050	117	281	164	0.49697	0.58363
GCF_000025325_02104	32	127	95	0.287879	0.322034
GCF_000025325_02104	121	292	171	0.518182	0.579661
GCF_900111485_02604	28	130	102	0.309091	0.355401
GCF_900111485_02604	120	285	165	0.5	0.574913
GCF_004799645_03093	32	133	101	0.306061	0.348276
GCF_004799645_03093	127	286	159	0.481818	0.548276
GCF_010119205_00666	29	281	252	0.763636	0.896797
GCF_003781945_03576	43	137	94	0.284848	0.301282
GCF_003781945_03576	135	311	176	0.533333	0.564103
GCF_000403645_02202	31	124	93	0.281818	0.313131
GCF_000403645_02202	129	296	167	0.506061	0.56229
GCF_001953745_01687	32	125	93	0.281818	0.311037
GCF_001953745_01687	116	297	181	0.548485	0.605351
GCF_000337175_00363	32	136	104	0.315152	0.352542
GCF_000337175_00363	126	294	168	0.509091	0.569492
GCF_004087835_00099	36	129	93	0.281818	0.315254
GCF_004087835_00099	121	294	173	0.524242	0.586441
GCF_000337495_02779	32	126	94	0.284848	0.318644
GCF_000337495_02779	123	286	163	0.493939	0.552542
GCF_005938085_01453	28	130	102	0.309091	0.356643
GCF_005938085_01453	121	285	164	0.49697	0.573427
GCF_000025625_00686	47	133	86	0.260606	0.267913
GCF_000025625_00686	124	319	195	0.590909	0.607477
GCF_001950595_00238	29	123	94	0.284848	0.332155
GCF_001950595_00238	114	283	169	0.512121	0.597173
GCA_003021285_00064	31	126	95	0.287879	0.338078
GCA_003021285_00064	123	281	158	0.478788	0.562278
GCA_902386205_01500	44	143	99	0.3	0.331104
GCA_902386205_01500	139	299	160	0.484848	0.535117
GCF_900110215_00670	27	120	93	0.281818	0.326316
GCF_900110215_00670	112	284	172	0.521212	0.603509
GCA_001316325_01579	2	159	157	0.475758	0.987421
GCF_000739555_00085	29	125	96	0.290909	0.31068
GCF_000739555_00085	119	307	188	0.569697	0.608414
GCF_009831575_01025	33	124	91	0.275758	0.323843
GCF_009831575_01025	119	281	162	0.490909	0.576512
GCF_011734195_02558	27	129	102	0.309091	0.368231
GCF_011734195_02558	112	277	165	0.5	0.595668
GCF_000251105_01856	6	77	71	0.215152	0.288618
GCF_000251105_01856	87	245	158	0.478788	0.642276
GCF_001011115_01597	27	122	95	0.287879	0.341727
GCF_001011115_01597	111	278	167	0.506061	0.600719
GCF_006861665_02380	29	124	95	0.287879	0.323129
GCF_006861665_02380	115	289	174	0.527273	0.591837
GCF_000710615_01734	30	127	97	0.293939	0.345196
GCF_000710615_01734	114	281	167	0.506061	0.594306
GCA_003023465_00339	36	298	262	0.793939	0.831746
GCF_000455365_00325	32	125	93	0.281818	0.321799
GCF_000455365_00325	131	288	157	0.475758	0.543253
GCF_900100875_01762	31	125	94	0.284848	0.333333
GCF_900100875_01762	112	282	170	0.515152	0.602837
GCF_000224475_01792	31	135	104	0.315152	0.356164
GCF_000224475_01792	108	292	184	0.557576	0.630137
GCF_001469955_00501	27	120	93	0.281818	0.332143
GCF_001469955_00501	108	280	172	0.521212	0.614286
GCA_003021015_01345	32	125	93	0.281818	0.329787
GCA_003021015_01345	115	282	167	0.506061	0.592199
GCF_001886955_00563	25	119	94	0.284848	0.34058
GCF_001886955_00563	119	276	157	0.475758	0.568841
GCF_000470655_00350	28	121	93	0.281818	0.333333
GCF_000470655_00350	112	279	167	0.506061	0.598566
GCF_009831625_01229	37	130	93	0.281818	0.317406
GCF_009831625_01229	126	290	164	0.49697	0.559727
GCA_011362045_00345	85	186	101	0.306061	0.302395
GCA_011362045_00345	180	334	154	0.466667	0.461078
GCA_004212035_01065	48	304	256	0.775758	0.842105
GCA_007122875_01739	30	281	251	0.760606	0.893238
GCF_003605575_02287	31	125	94	0.284848	0.317568
GCF_003605575_02287	116	289	173	0.524242	0.584459
GCF_013391085_00399	31	109	78	0.236364	0.278571
GCF_013391085_00399	120	280	160	0.484848	0.571429
GCF_900156425_01274	30	124	94	0.284848	0.33452
GCF_900156425_01274	109	281	172	0.521212	0.6121
GCA_008297795_00185	64	144	80	0.242424	0.25641
GCA_008297795_00185	149	312	163	0.493939	0.522436
GCF_009184545_02526	29	123	94	0.284848	0.332155
GCF_009184545_02526	114	283	169	0.512121	0.597173
GCF_900215575_02460	31	123	92	0.278788	0.326241
GCF_900215575_02460	109	282	173	0.524242	0.613475
GCF_900156475_00201	32	130	98	0.29697	0.333333
GCF_900156475_00201	125	291	166	0.50303	0.564626
GCA_003022725_01726	33	130	97	0.293939	0.343972
GCA_003022725_01726	117	281	164	0.49697	0.58156
GCF_900103505_00190	39	119	80	0.242424	0.27027
GCF_900103505_00190	123	295	172	0.521212	0.581081
GCA_003021105_01028	26	115	89	0.269697	0.3213
GCA_003021105_01028	110	277	167	0.506061	0.602888
GCF_002286985_01538	37	131	94	0.284848	0.30719
GCF_002286985_01538	122	305	183	0.554545	0.598039
GCA_903825675_00468	59	323	264	0.8	0.817337
GCF_004765795_00678	38	130	92	0.278788	0.319444
GCF_004765795_00678	119	288	169	0.512121	0.586806
GCF_002025255_00824	32	129	97	0.293939	0.324415
GCF_002025255_00824	126	297	171	0.518182	0.571906
GCA_003551265_02145	31	126	95	0.287879	0.338078
GCA_003551265_02145	124	281	157	0.475758	0.558719
GCF_013415885_03559	28	123	95	0.287879	0.322034
GCF_013415885_03559	120	292	172	0.521212	0.583051
GCF_900102305_02443	27	130	103	0.312121	0.362676
GCF_900102305_02443	128	284	156	0.472727	0.549296
GCF_009674625_00167	26	109	83	0.251515	0.297491
GCF_009674625_00167	114	279	165	0.5	0.591398
GCF_000337895_01968	32	132	100	0.30303	0.342466
GCF_000337895_01968	124	290	166	0.50303	0.568493
GCF_000739575_01506	32	110	78	0.236364	0.267123
GCF_000739575_01506	137	292	155	0.469697	0.530822
GCA_003552325_01046	20	118	98	0.29697	0.360294
GCA_003552325_01046	122	272	150	0.454545	0.551471
GCF_003298465_01638	29	123	94	0.284848	0.335714
GCF_003298465_01638	117	278	161	0.487879	0.575
GCF_001462205_03096	27	120	93	0.281818	0.324042
GCF_001462205_03096	114	286	172	0.521212	0.599303
GCF_005239175_00178	27	119	92	0.278788	0.328571
GCF_005239175_00178	111	279	168	0.509091	0.6
GCF_008729015_00731	26	118	92	0.278788	0.329749
GCF_008729015_00731	111	279	168	0.509091	0.602151
GCF_005406125_00200	26	125	99	0.3	0.354839
GCF_005406125_00200	111	279	168	0.509091	0.602151
GCF_005239435_04638	36	130	94	0.284848	0.318644
GCF_005239435_04638	124	294	170	0.515152	0.576271
GCF_003439925_00075	27	122	95	0.287879	0.339286
GCF_003439925_00075	112	280	168	0.509091	0.6
GCA_011389375_00800	93	192	99	0.3	0.290323
GCA_011389375_00800	190	341	151	0.457576	0.442815
GCA_003021335_01615	38	119	81	0.245455	0.28223
GCA_003021335_01615	115	287	172	0.521212	0.599303
GCF_004015825_00462	32	130	98	0.29697	0.347518
GCF_004015825_00462	120	282	162	0.490909	0.574468
GCA_002495645_00246	68	335	267	0.809091	0.797015
GCF_009674585_01971	26	109	83	0.251515	0.297491
GCF_009674585_01971	115	279	164	0.49697	0.587814
GCA_009776675_01169	85	348	263	0.79697	0.755747
GCA_004212075_01278	21	297	276	0.836364	0.929293
GCA_003021235_02792	32	132	100	0.30303	0.346021
GCA_003021235_02792	112	288	176	0.533333	0.608997
GCF_005543295_00239	27	120	93	0.281818	0.332143
GCF_005543295_00239	113	280	167	0.506061	0.596429
GCF_012726115_01298	26	129	103	0.312121	0.369176
GCF_012726115_01298	111	279	168	0.509091	0.602151
GCA_007121575_01030	33	140	107	0.324242	0.375439
GCA_007121575_01030	133	285	152	0.460606	0.533333
GCF_000337455_02233	31	128	97	0.293939	0.324415
GCF_000337455_02233	123	296	173	0.524242	0.578595
GCF_009762275_00935	31	117	86	0.260606	0.30605
GCF_009762275_00935	111	281	170	0.515152	0.604982
GCF_001485575_03313	26	125	99	0.3	0.354839
GCF_001485575_03313	111	279	168	0.509091	0.602151
GCF_004118325_04109	27	120	93	0.281818	0.327465
GCF_004118325_04109	112	281	169	0.512121	0.59507
GCA_902386085_01402	54	156	102	0.309091	0.332248
GCA_902386085_01402	140	306	166	0.50303	0.540717
GCA_014647475_01098	30	122	92	0.278788	0.319444
GCA_014647475_01098	112	286	174	0.527273	0.604167
GCF_013391635_02243	32	130	98	0.29697	0.351254
GCF_013391635_02243	122	279	157	0.475758	0.562724
GCF_001469875_00378	26	119	93	0.281818	0.332143
GCF_001469875_00378	114	280	166	0.50303	0.592857
GCF_000336615_01554	26	124	98	0.29697	0.351254
GCF_000336615_01554	114	279	165	0.5	0.591398
GCF_003841485_00819	34	303	269	0.815152	0.881967
GCF_004116405_03884	28	121	93	0.281818	0.314189
GCF_004116405_03884	115	292	177	0.536364	0.597973
GCF_011043775_04085	38	130	92	0.278788	0.308725
GCF_011043775_04085	131	295	164	0.49697	0.550336
GCA_003020925_01404	31	124	93	0.281818	0.329787
GCA_003020925_01404	131	281	150	0.454545	0.531915
GCF_002844335_01496	26	125	99	0.3	0.353571
GCF_002844335_01496	111	280	169	0.512121	0.603571
GCA_007131205_00658	3	246	243	0.736364	0.983806
GCF_003058365_00820	28	125	97	0.293939	0.352727
GCF_003058365_00820	119	275	156	0.472727	0.567273
GCF_004114995_02057	39	139	100	0.30303	0.325733
GCF_004114995_02057	124	304	180	0.545455	0.586319
GCF_900880625_00147	31	125	94	0.284848	0.33452
GCF_900880625_00147	116	281	165	0.5	0.587189
GCF_000306765_01776	27	109	82	0.248485	0.293907
GCF_000306765_01776	112	279	167	0.506061	0.598566
GCF_009674605_02427	26	109	83	0.251515	0.297491
GCF_009674605_02427	115	279	164	0.49697	0.587814
GCF_001469865_00253	26	109	83	0.251515	0.297491
GCF_001469865_00253	115	279	164	0.49697	0.587814
GCA_003021655_01396	31	290	259	0.784848	0.893103
GCA_011363915_01074	85	187	102	0.309091	0.305389
GCA_011363915_01074	180	334	154	0.466667	0.461078
GCA_003158275_02104	45	125	80	0.242424	0.265781
GCA_003158275_02104	140	301	161	0.487879	0.534884
GCA_011049295_01063	3	157	154	0.466667	0.980892
GCF_000025685_01656	26	119	93	0.281818	0.332143
GCF_000025685_01656	118	279	161	0.487879	0.575
GCF_009806985_01168	42	134	92	0.278788	0.304636
GCF_009806985_01168	127	301	174	0.527273	0.576159
GCF_005049285_00765	27	116	89	0.269697	0.318996
GCF_005049285_00765	117	278	161	0.487879	0.577061
GCF_000336895_01112	26	125	99	0.3	0.354839
GCF_000336895_01112	111	279	168	0.509091	0.602151
GCA_001564275_01740	21	116	95	0.287879	0.317726
GCA_001564275_01740	109	295	186	0.563636	0.622074
GCA_003020945_00400	31	125	94	0.284848	0.320819
GCA_003020945_00400	123	288	165	0.5	0.56314
GCA_002685855_00766	1	205	204	0.618182	0.995122
GCA_003601535_00848	16	92	76	0.230303	0.296875
GCA_003601535_00848	100	256	156	0.472727	0.609375
GCF_900107195_01943	33	126	93	0.281818	0.328622
GCF_900107195_01943	128	283	155	0.469697	0.547703
GCF_900113615_01189	33	127	94	0.284848	0.324138
GCF_900113615_01189	119	290	171	0.518182	0.589655
GCA_002067315_00442	35	122	87	0.263636	0.302083
GCA_002067315_00442	128	287	159	0.481818	0.552083
GCA_001564115_00606	31	108	77	0.233333	0.234043
GCA_001564115_00606	120	310	190	0.575758	0.577508
GCF_010119195_02391	26	118	92	0.278788	0.33213
GCF_010119195_02391	110	277	167	0.506061	0.602888
GCF_000336755_02235	26	109	83	0.251515	0.297491
GCF_000336755_02235	114	279	165	0.5	0.591398
GCF_000336775_02909	26	109	83	0.251515	0.296429
GCF_000336775_02909	115	280	165	0.5	0.589286
GCF_900114455_04152	33	125	92	0.278788	0.315068
GCF_900114455_04152	118	291	173	0.524242	0.592466
GCA_003022925_02832	33	127	94	0.284848	0.332155
GCA_003022925_02832	125	283	158	0.478788	0.558304
GCF_000336635_02218	26	123	97	0.293939	0.346429
GCF_000336635_02218	111	280	169	0.512121	0.603571
GCF_000336815_01718	26	108	82	0.248485	0.292857
GCF_000336815_01718	115	280	165	0.5	0.589286
GCA_903930505_00210	66	150	84	0.254545	0.281879
GCA_903930505_00210	142	298	156	0.472727	0.52349
GCF_900103715_02776	27	121	94	0.284848	0.33452
GCF_900103715_02776	115	281	166	0.50303	0.590747
GCF_000023945_00410	28	121	93	0.281818	0.333333
GCF_000023945_00410	116	279	163	0.493939	0.584229
GCF_000336955_00982	26	109	83	0.251515	0.297491
GCF_000336955_00982	114	279	165	0.5	0.591398
GCA_003021685_00012	26	121	95	0.287879	0.340502
GCA_003021685_00012	112	279	167	0.506061	0.598566
GCF_003990725_01072	37	131	94	0.284848	0.316498
GCF_003990725_01072	122	296	174	0.527273	0.585859
GCA_012329085_00336	45	138	93	0.281818	0.327465
GCA_012329085_00336	143	284	141	0.427273	0.496479
GCA_000496235_01967	31	124	93	0.281818	0.327465
GCA_000496235_01967	117	284	167	0.506061	0.588028
GCF_002727125_00998	39	133	94	0.284848	0.311258
GCF_002727125_00998	124	300	176	0.533333	0.582781
GCF_001542905_01380	31	124	93	0.281818	0.316327
GCF_001542905_01380	125	293	168	0.509091	0.571429
GCA_003554605_02586	33	125	92	0.278788	0.306667
GCA_003554605_02586	112	298	186	0.563636	0.62
GCA_000496215_02363	31	123	92	0.278788	0.311864
GCA_000496215_02363	115	293	178	0.539394	0.60339
GCF_000337795_03209	26	106	80	0.242424	0.285714
GCF_000337795_03209	116	280	164	0.49697	0.585714
GCA_007129135_01366	27	118	91	0.275758	0.32852
GCA_007129135_01366	112	277	165	0.5	0.595668
GCF_900100385_01127	32	115	83	0.251515	0.295374
GCF_900100385_01127	111	281	170	0.515152	0.604982
GCF_000337355_03416	37	131	94	0.284848	0.309211
GCF_000337355_03416	122	303	181	0.548485	0.595395
GCF_001482285_01891	26	109	83	0.251515	0.296429
GCF_001482285_01891	115	280	165	0.5	0.589286
GCF_000223905_01495	26	125	99	0.3	0.354839
GCF_000223905_01495	111	279	168	0.509091	0.602151
GCF_000337835_01435	26	106	80	0.242424	0.285714
GCF_000337835_01435	116	280	164	0.49697	0.585714
GCF_000337915_03081	40	133	93	0.281818	0.300971
GCF_000337915_03081	131	304	173	0.524242	0.559871
GCF_009176545_02446	33	113	80	0.242424	0.273973
GCF_009176545_02446	118	290	172	0.521212	0.589041
GCF_000011085_00791	26	122	96	0.290909	0.342857
GCF_000011085_00791	111	280	169	0.512121	0.603571
GCF_000495475_00817	5	102	97	0.293939	0.34767
GCF_000495475_00817	90	269	179	0.542424	0.641577
GCF_007655485_00948	32	111	79	0.239394	0.270548
GCF_007655485_00948	140	292	152	0.460606	0.520548
GCF_001316045_00442	90	297	207	0.627273	0.692308
GCF_007671685_00583	39	132	93	0.281818	0.298077
GCF_007671685_00583	124	305	181	0.548485	0.580128
GCF_000026045_01024	32	112	80	0.242424	0.285714
GCF_000026045_01024	117	280	163	0.493939	0.582143
GCF_007671725_02026	37	130	93	0.281818	0.304918
GCF_007671725_02026	123	303	180	0.545455	0.590164
GCF_011440375_00257	27	110	83	0.251515	0.285223
GCF_011440375_00257	114	288	174	0.527273	0.597938
GCA_011045925_00197	24	291	267	0.809091	0.917526
GCF_000337115_03158	1	75	74	0.224242	0.309623
GCF_000337115_03158	60	237	177	0.536364	0.740586
GCF_003665935_00596	31	110	79	0.239394	0.280142
GCF_003665935_00596	116	282	166	0.50303	0.588652
GCF_900182635_02441	31	125	94	0.284848	0.323024
GCF_900182635_02441	116	289	173	0.524242	0.594502
GCA_011605725_00716	87	185	98	0.29697	0.294294
GCA_011605725_00716	184	332	148	0.448485	0.444444
GCF_000336995_01103	38	131	93	0.281818	0.30897
GCF_000336995_01103	126	300	174	0.527273	0.578073
GCF_000336915_00112	32	125	93	0.281818	0.314189
GCF_000336915_00112	126	295	169	0.512121	0.570946
GCF_000336715_03198	24	102	78	0.236364	0.280576
GCF_000336715_03198	113	277	164	0.49697	0.589928
GCF_008124605_01630	27	119	92	0.278788	0.33213
GCF_008124605_01630	112	277	165	0.5	0.595668
GCF_000337815_00053	26	109	83	0.251515	0.297491
GCF_000337815_00053	114	278	164	0.49697	0.587814
GCF_001280425_00433	26	119	93	0.281818	0.332143
GCF_001280425_00433	111	280	169	0.512121	0.603571
GCF_013401515_00912	31	286	255	0.772727	0.888502
GCA_000220355_00561	2	246	244	0.739394	0.99187
GCA_003022945_00588	29	118	89	0.269697	0.316726
GCA_003022945_00588	126	281	155	0.469697	0.551601
GCF_001368915_01294	26	109	83	0.251515	0.296429
GCF_001368915_01294	115	280	165	0.5	0.589286
GCF_003856835_01771	29	122	93	0.281818	0.333333
GCF_003856835_01771	115	279	164	0.49697	0.587814
GCF_900110465_04182	30	128	98	0.29697	0.34507
GCF_900110465_04182	118	283	165	0.5	0.580986
GCA_009903905_00444	100	307	207	0.627273	0.674267
GCA_003022815_01768	32	125	93	0.281818	0.333333
GCA_003022815_01768	114	279	165	0.5	0.591398
GCF_000336695_01583	27	121	94	0.284848	0.33452
GCF_000336695_01583	116	280	164	0.49697	0.58363
GCA_014647155_01586	33	122	89	0.269697	0.310105
GCA_014647155_01586	118	286	168	0.509091	0.585366
GCF_003697845_02572	31	125	94	0.284848	0.30719
GCF_003697845_02572	126	301	175	0.530303	0.571895
GCA_003022745_00902	28	121	93	0.281818	0.334532
GCA_003022745_00902	116	278	162	0.490909	0.582734
GCF_003721435_00182	35	130	95	0.287879	0.315615
GCF_003721435_00182	120	300	180	0.545455	0.598007
GCA_014647455_00406	33	135	102	0.309091	0.356643
GCA_014647455_00406	118	285	167	0.506061	0.583916
GCF_000327505_00916	38	114	76	0.230303	0.276364
GCF_000327505_00916	110	275	165	0.5	0.6
GCF_000337375_00881	39	133	94	0.284848	0.302251
GCF_000337375_00881	124	307	183	0.554545	0.588424
GCF_010747475_02154	51	144	93	0.281818	0.28882
GCF_010747475_02154	129	318	189	0.572727	0.586957
GCF_000336935_02346	31	125	94	0.284848	0.318644
GCF_000336935_02346	126	294	168	0.509091	0.569492
GCF_002252755_00437	37	131	94	0.284848	0.312292
GCF_002252755_00437	122	300	178	0.539394	0.591362
GCF_002906575_02187	33	126	93	0.281818	0.319588
GCF_002906575_02187	116	289	173	0.524242	0.594502
GCF_003369835_01621	35	130	95	0.287879	0.315615
GCF_003369835_01621	121	299	178	0.539394	0.591362
GCA_002762915_00387	2	243	241	0.730303	0.99177
GCA_013329865_00754	72	338	266	0.806061	0.786982
GCA_003023535_00631	30	121	91	0.275758	0.323843
GCA_003023535_00631	114	281	167	0.506061	0.594306
GCA_003020985_01180	32	111	79	0.239394	0.266892
GCA_003020985_01180	127	294	167	0.506061	0.564189
GCA_001564205_01137	42	134	92	0.278788	0.306667
GCA_001564205_01137	123	299	176	0.533333	0.586667
GCF_002153915_00154	57	129	72	0.218182	0.236842
GCF_002153915_00154	133	304	171	0.518182	0.5625
GCA_003021725_00103	33	127	94	0.284848	0.332155
GCA_003021725_00103	133	283	150	0.454545	0.530035
GCA_007119345_02010	34	112	78	0.236364	0.259136
GCA_007119345_02010	117	299	182	0.551515	0.604651
GCF_000014945_00849	39	119	80	0.242424	0.280702
GCF_000014945_00849	128	285	157	0.475758	0.550877
GCF_002252985_00743	31	124	93	0.281818	0.32069
GCF_002252985_00743	122	288	166	0.50303	0.572414
GCF_002355655_00364	55	149	94	0.284848	0.297468
GCF_002355655_00364	141	314	173	0.524242	0.547468
GCF_900107665_01952	26	120	94	0.284848	0.34058
GCF_900107665_01952	111	276	165	0.5	0.597826
GCA_013152815_00398	50	339	289	0.875758	0.793956
GCA_003034855_00170	59	134	75	0.227273	0.246711
GCA_003034855_00170	135	304	169	0.512121	0.555921
GCA_003021175_00934	29	122	93	0.281818	0.330961
GCA_003021175_00934	114	281	167	0.506061	0.594306
GCF_000025665_00113	36	109	73	0.221212	0.278626
GCF_000025665_00113	106	262	156	0.472727	0.59542
GCA_003022085_01392	33	124	91	0.275758	0.322695
GCA_003022085_01392	110	281	171	0.518182	0.606383
GCF_003287355_00419	31	125	94	0.284848	0.309211
GCF_003287355_00419	117	302	185	0.560606	0.608553
GCA_002506025_00582	58	326	268	0.812121	0.822086
GCF_003344565_04320	28	120	92	0.278788	0.323944
GCF_003344565_04320	127	281	154	0.466667	0.542254
GCA_003554115_00184	33	132	99	0.3	0.342561
GCA_003554115_00184	123	289	166	0.50303	0.574394
GCA_002725275_01155	69	335	266	0.806061	0.79403
GCA_002779595_00584	1	241	240	0.727273	0.995851
GCA_014647115_01225	33	111	78	0.236364	0.269896
GCA_014647115_01225	121	289	168	0.509091	0.581315
GCA_002702945_00547	66	337	271	0.821212	0.804154
GCF_006861655_02240	31	126	95	0.287879	0.320946
GCF_006861655_02240	119	291	172	0.521212	0.581081
GCA_003021705_00770	33	126	93	0.281818	0.328622
GCA_003021705_00770	112	283	171	0.518182	0.60424
GCF_001593955_00690	26	124	98	0.29697	0.355072
GCF_001593955_00690	120	276	156	0.472727	0.565217
GCF_004765805_02985	40	136	96	0.290909	0.327645
GCF_004765805_02985	130	293	163	0.493939	0.556314
GCF_000755245_00424	24	118	94	0.284848	0.338129
GCF_000755245_00424	114	275	161	0.487879	0.579137
GCF_000739595_03290	39	134	95	0.287879	0.303514
GCF_000739595_03290	127	308	181	0.548485	0.578275
GCF_004799665_03189	32	125	93	0.281818	0.328622
GCF_004799665_03189	117	283	166	0.50303	0.586572
GCA_003170935_01283	45	128	83	0.251515	0.281356
GCA_003170935_01283	137	295	158	0.478788	0.535593
GCF_000334895_02592	32	110	78	0.236364	0.254902
GCF_000334895_02592	131	302	171	0.518182	0.558824
GCA_003020965_02053	29	128	99	0.3	0.351064
GCA_003020965_02053	121	282	161	0.487879	0.570922
GCA_002721085_00619	74	337	263	0.79697	0.780415
GCA_003602575_00161	69	336	267	0.809091	0.792285
GCF_000427685_01683	31	126	95	0.287879	0.338078
GCF_000427685_01683	122	281	159	0.481818	0.565836
GCF_000022205_01042	27	120	93	0.281818	0.324042
GCF_000022205_01042	110	286	176	0.533333	0.61324
GCA_003022905_00290	32	124	92	0.278788	0.329749
GCA_003022905_00290	120	279	159	0.481818	0.569892
GCF_013839515_02277	32	125	93	0.281818	0.332143
GCF_013839515_02277	117	280	163	0.493939	0.582143
GCA_013330155_00183	76	335	259	0.784848	0.773134
GCA_003022685_02404	32	126	94	0.284848	0.317568
GCA_003022685_02404	121	294	173	0.524242	0.584459
GCA_003551945_01374	30	111	81	0.245455	0.289286
GCA_003551945_01374	129	280	151	0.457576	0.539286
GCA_007118975_00462	30	107	77	0.233333	0.275986
GCA_007118975_00462	125	279	154	0.466667	0.551971
GCA_011364155_00776	1	139	138	0.418182	0.978723
GCA_012961645_01190	17	109	92	0.278788	0.348485
GCA_012961645_01190	104	264	160	0.484848	0.606061
GCA_003162175_01635	45	125	80	0.242424	0.271186
GCA_003162175_01635	140	295	155	0.469697	0.525424
GCA_013154005_01025	35	109	74	0.224242	0.275093
GCA_013154005_01025	107	269	162	0.490909	0.60223
GCA_002704515_00896	75	335	260	0.787879	0.776119
GCA_002696315_00221	62	335	273	0.827273	0.814925
GCF_001261915_02995	37	130	93	0.281818	0.305921
GCF_001261915_02995	122	300	178	0.539394	0.585526
GCA_013329045_01457	50	308	258	0.781818	0.834951
GCA_000496175_00216	41	136	95	0.287879	0.324232
GCA_000496175_00216	129	293	164	0.49697	0.559727
GCF_000296615_00599	55	149	94	0.284848	0.281437
GCF_000296615_00599	143	330	187	0.566667	0.55988
GCA_902625885_00842	70	335	265	0.80303	0.791045
GCA_002506335_00562	39	119	80	0.242424	0.253165
GCA_002506335_00562	128	309	181	0.548485	0.572785
GCF_005239135_00628	30	123	93	0.281818	0.33574
GCF_005239135_00628	122	277	155	0.469697	0.559567
GCF_000230955_02032	279	372	93	0.281818	0.175803
GCF_000230955_02032	364	529	165	0.5	0.311909
GCA_002699515_00712	64	335	271	0.821212	0.808955
GCA_002506015_02312	16	94	78	0.236364	0.293233
GCA_002506015_02312	90	266	176	0.533333	0.661654
GCA_003022005_02486	36	129	93	0.281818	0.313131
GCA_003022005_02486	127	295	168	0.509091	0.565657
GCF_007004735_03998	33	121	88	0.266667	0.30662
GCF_007004735_03998	118	286	168	0.509091	0.585366
GCA_003602535_00351	69	335	266	0.806061	0.79403
GCF_000746205_00120	31	120	89	0.269697	0.295681
GCF_000746205_00120	114	297	183	0.554545	0.607973
GCF_002952775_02620	39	122	83	0.251515	0.280405
GCF_002952775_02620	134	294	160	0.484848	0.540541
GCA_001563795_01380	33	127	94	0.284848	0.323024
GCA_001563795_01380	116	291	175	0.530303	0.601375
GCF_009831455_00967	33	110	77	0.233333	0.276978
GCF_009831455_00967	116	278	162	0.490909	0.582734
GCA_004297575_00678	1	162	161	0.487879	0.993827
GCA_002505355_01437	71	337	266	0.806061	0.789318
GCA_003023185_00549	29	116	87	0.263636	0.309609
GCA_003023185_00549	121	281	160	0.484848	0.569395
GCF_000591055_01273	30	126	96	0.290909	0.345324
GCF_000591055_01273	120	278	158	0.478788	0.568345
GCA_002726495_00461	79	349	270	0.818182	0.773639
GCF_005435165_01924	35	129	94	0.284848	0.310231
GCF_005435165_01924	120	295	175	0.530303	0.577558
GCF_007421925_00702	32	118	86	0.260606	0.294521
GCF_007421925_00702	126	290	164	0.49697	0.561644
GCA_011367165_00781	1	139	138	0.418182	0.992806
GCF_900109065_03192	31	124	93	0.281818	0.324042
GCF_900109065_03192	115	287	172	0.521212	0.599303
GCF_001280455_03494	32	126	94	0.284848	0.313333
GCF_001280455_03494	117	298	181	0.548485	0.603333
GCF_000237865_01770	32	130	98	0.29697	0.34386
GCF_000237865_01770	117	285	168	0.509091	0.589474
GCF_002114285_00605	51	146	95	0.287879	0.304487
GCF_002114285_00605	136	311	175	0.530303	0.560897
GCA_003021045_00153	26	307	281	0.851515	0.841317
GCA_002715725_01712	70	335	265	0.80303	0.791045
GCF_000337075_02691	50	144	94	0.284848	0.29375
GCF_000337075_02691	137	317	180	0.545455	0.5625
GCA_002170315_01509	72	337	265	0.80303	0.78635
GCF_000336675_01760	25	118	93	0.281818	0.33574
GCF_000336675_01760	116	277	161	0.487879	0.581227
GCA_003023405_01006	50	144	94	0.284848	0.291925
GCA_003023405_01006	135	320	185	0.560606	0.574534
GCF_003697815_02104	36	113	77	0.233333	0.269231
GCF_003697815_02104	121	286	165	0.5	0.576923
GCF_000337515_00303	30	107	77	0.233333	0.267361
GCF_000337515_00303	114	287	173	0.524242	0.600694
GCF_000337335_01942	55	149	94	0.284848	0.289231
GCF_000337335_01942	149	322	173	0.524242	0.532308
GCF_000337035_01704	53	147	94	0.284848	0.299363
GCF_000337035_01704	141	313	172	0.521212	0.547771
GCF_000337415_01096	48	143	95	0.287879	0.299685
GCF_000337415_01096	133	312	179	0.542424	0.564669
GCA_002506745_00573	69	146	77	0.233333	0.260135
GCA_002506745_00573	144	296	152	0.460606	0.513514
GCA_002494645_01304	64	336	272	0.824242	0.809524
GCA_003602645_01019	69	337	268	0.812121	0.795252
GCA_002728035_00417	62	335	273	0.827273	0.814925
GCA_002687075_00094	133	401	268	0.812121	0.668329
GCF_004114375_01304	50	143	93	0.281818	0.295238
GCF_004114375_01304	135	314	179	0.542424	0.568254
GCF_003342675_02073	31	124	93	0.281818	0.330961
GCF_003342675_02073	116	281	165	0.5	0.587189
GCF_000474235_01459	33	126	93	0.281818	0.32069
GCF_000474235_01459	118	289	171	0.518182	0.589655
GCF_009900715_00782	25	111	86	0.260606	0.307143
GCF_009900715_00782	114	280	166	0.50303	0.592857
GCA_011526375_01242	70	337	267	0.809091	0.792285
GCA_003021005_00988	41	127	86	0.260606	0.298611
GCA_003021005_00988	131	288	157	0.475758	0.545139
GCA_003602485_00480	67	336	269	0.815152	0.800595
GCA_002839675_02078	61	162	101	0.306061	0.312693
GCA_002839675_02078	150	321	171	0.518182	0.529412
GCF_000328525_01401	30	122	92	0.278788	0.319444
GCF_000328525_01401	114	287	173	0.524242	0.600694
GCA_003602605_00532	74	337	263	0.79697	0.780415
GCF_000204415_01287	41	129	88	0.266667	0.296296
GCF_000204415_01287	121	295	174	0.527273	0.585859
GCA_003602475_01062	71	336	265	0.80303	0.78869
GCF_900108505_01403	32	126	94	0.284848	0.323024
GCF_900108505_01403	113	290	177	0.536364	0.608247
GCF_003336245_00099	31	124	93	0.281818	0.330961
GCF_003336245_00099	119	281	162	0.490909	0.576512
GCA_002719475_00928	75	346	271	0.821212	0.78098
GCA_003022865_01446	27	103	76	0.230303	0.269504
GCA_003022865_01446	109	281	172	0.521212	0.609929
GCF_003862495_02560	32	134	102	0.309091	0.355401
GCF_003862495_02560	138	287	149	0.451515	0.519164
GCA_002710015_00717	65	335	270	0.818182	0.80597
GCA_011620785_01527	41	128	87	0.263636	0.292929
GCA_011620785_01527	119	295	176	0.533333	0.592593
GCF_009741825_02483	2	103	101	0.306061	0.405622
GCF_009741825_02483	82	249	167	0.506061	0.670683
GCA_902563095_01037	73	335	262	0.793939	0.78209
GCA_001914405_01406	53	135	82	0.248485	0.277966
GCA_001914405_01406	128	295	167	0.506061	0.566102
GCA_002505935_01063	75	346	271	0.821212	0.78098
GCA_009937025_01180	72	337	265	0.80303	0.78635
GCA_002506705_00946	67	335	268	0.812121	0.8
GCA_011525095_01267	68	335	267	0.809091	0.797015
GCA_002499545_01041	72	337	265	0.80303	0.78635
GCA_002507425_00024	67	335	268	0.812121	0.8
GCA_009889625_01019	26	104	78	0.236364	0.281588
GCA_009889625_01019	122	277	155	0.469697	0.559567
GCA_004211975_01893	18	116	98	0.29697	0.367041
GCA_004211975_01893	110	267	157	0.475758	0.588015
GCA_002495945_00072	67	337	270	0.818182	0.801187
GCA_002503045_01305	58	333	275	0.833333	0.825826
GCA_001871415_00578	73	325	252	0.763636	0.775385
GCA_002702985_00663	70	333	263	0.79697	0.78979
GCF_001017125_00349	38	124	86	0.260606	0.300699
GCF_001017125_00349	134	283	149	0.451515	0.520979
GCA_902385255_00207	23	289	266	0.806061	0.920415
GCA_013331375_01484	31	188	157	0.475758	0.835106
GCA_011522915_00995	115	383	268	0.812121	0.699739
GCA_002923215_00547	134	318	184	0.557576	0.575
GCF_003605635_02042	223	317	94	0.284848	0.195833
GCF_003605635_02042	308	480	172	0.521212	0.358333
GCA_002689565_01505	68	335	267	0.809091	0.797015
GCA_002727485_00770	67	337	270	0.818182	0.801187
GCA_902520595_00265	92	352	260	0.787879	0.738636
GCF_900102375_02780	55	149	94	0.284848	0.297468
GCF_900102375_02780	138	314	176	0.533333	0.556962
GCA_002499705_01613	90	355	265	0.80303	0.746479
GCA_002900535_01626	65	147	82	0.248485	0.276094
GCA_002900535_01626	144	296	152	0.460606	0.511785
GCF_900111935_00008	42	135	93	0.281818	0.298077
GCF_900111935_00008	127	309	182	0.551515	0.583333
GCA_002706615_00414	65	334	269	0.815152	0.805389
GCA_002506275_00117	74	337	263	0.79697	0.780415
GCA_002727695_00289	54	335	281	0.851515	0.838806
GCA_009889685_00042	31	124	93	0.281818	0.329787
GCA_009889685_00042	110	282	172	0.521212	0.609929
GCA_902384685_01153	73	151	78	0.236364	0.262626
GCA_902384685_01153	146	297	151	0.457576	0.508418
GCA_002502605_01166	81	347	266	0.806061	0.766571
GCF_900114435_01148	26	124	98	0.29697	0.35
GCF_900114435_01148	111	280	169	0.512121	0.603571
GCA_002498185_00820	63	335	272	0.824242	0.81194
GCA_002495405_01495	61	334	273	0.827273	0.817365
GCA_002718195_00350	61	334	273	0.827273	0.817365
GCF_009742825_00491	1	58	57	0.172727	0.241525
GCF_009742825_00491	50	235	185	0.560606	0.783898
GCF_002355635_00485	32	126	94	0.284848	0.326389
GCF_002355635_00485	113	288	175	0.530303	0.607639
GCA_012511245_02356	38	124	86	0.260606	0.300699
GCA_012511245_02356	140	283	143	0.433333	0.5
GCA_003660925_00358	27	273	246	0.745455	0.894545
GCA_002900555_01857	74	149	75	0.227273	0.253378
GCA_002900555_01857	143	296	153	0.463636	0.516892
GCA_002496955_01250	77	347	270	0.818182	0.778098
GCA_000415965_02362	32	122	90	0.272727	0.314685
GCA_000415965_02362	108	286	178	0.539394	0.622378
GCA_012521035_01865	38	124	86	0.260606	0.300699
GCA_012521035_01865	140	283	143	0.433333	0.5
GCA_002710205_00452	62	335	273	0.827273	0.814925
GCF_900095385_00131	38	136	98	0.29697	0.342657
GCF_900095385_00131	139	284	145	0.439394	0.506993
GCA_013330285_00955	83	351	268	0.812121	0.763533
GCA_002708695_01317	214	481	267	0.809091	0.555094
GCA_009936765_01048	37	300	263	0.79697	0.876667
GCA_902605365_00424	68	335	267	0.809091	0.797015
GCA_002722615_00661	77	335	258	0.781818	0.770149
GCA_013329455_00552	57	134	77	0.233333	0.25
GCA_013329455_00552	138	308	170	0.515152	0.551948
GCA_002503845_01054	32	124	92	0.278788	0.326241
GCA_002503845_01054	109	282	173	0.524242	0.613475
GCA_002709705_00725	65	335	270	0.818182	0.80597
GCA_002506535_01896	56	131	75	0.227273	0.236593
GCA_002506535_01896	137	315	178	0.539394	0.561514
GCA_003162615_02386	39	129	90	0.272727	0.310345
GCA_003162615_02386	116	290	174	0.527273	0.6
GCF_000196895_01575	26	121	95	0.287879	0.344203
GCF_000196895_01575	119	276	157	0.475758	0.568841
GCA_002508495_00820	37	124	87	0.263636	0.303136
GCA_002508495_00820	119	284	165	0.5	0.574913
GCA_002692465_00228	65	335	270	0.818182	0.80597
GCA_013329255_00222	71	337	266	0.806061	0.789318
GCA_001509375_02306	55	131	76	0.230303	0.248366
GCA_001509375_02306	142	305	163	0.493939	0.53268
GCA_002502785_01482	53	131	78	0.236364	0.255738
GCA_002502785_01482	135	304	169	0.512121	0.554098
GCA_002712285_00872	57	333	276	0.836364	0.828829
GCA_003649715_00810	75	150	75	0.227273	0.252525
GCA_003649715_00810	144	297	153	0.463636	0.515152
GCA_002503105_01723	42	128	86	0.260606	0.296552
GCA_002503105_01723	133	289	156	0.472727	0.537931
GCA_003157895_01908	38	137	99	0.3	0.344948
GCA_003157895_01908	130	286	156	0.472727	0.543554
GCA_014646875_02829	32	109	77	0.233333	0.263699
GCA_014646875_02829	137	292	155	0.469697	0.530822
GCA_011524855_01137	64	336	272	0.824242	0.809524
GCA_002502625_00639	68	333	265	0.80303	0.795796
GCA_002706065_00336	84	349	265	0.80303	0.757143
GCA_003023195_00510	35	128	93	0.281818	0.259053
GCA_003023195_00510	161	325	164	0.49697	0.456825
GCA_002839645_01943	38	124	86	0.260606	0.300699
GCA_002839645_01943	140	281	141	0.427273	0.493007
GCA_002503885_01472	38	124	86	0.260606	0.300699
GCA_002503885_01472	140	282	142	0.430303	0.496503
GCA_012798365_02022	40	127	87	0.263636	0.291946
GCA_012798365_02022	122	296	174	0.527273	0.583893
GCF_000691865_01928	38	124	86	0.260606	0.300699
GCF_000691865_01928	134	284	150	0.454545	0.524476
GCA_002498065_01138	38	124	86	0.260606	0.299652
GCA_002498065_01138	134	285	151	0.457576	0.526132
GCF_001602375_02443	38	124	86	0.260606	0.300699
GCF_001602375_02443	140	283	143	0.433333	0.5
GCA_013572355_00419	43	127	84	0.254545	0.291667
GCA_013572355_00419	134	283	149	0.451515	0.517361
GCF_000015825_00533	38	124	86	0.260606	0.300699
GCF_000015825_00533	134	284	150	0.454545	0.524476
GCA_002697105_00668	62	333	271	0.821212	0.813814
GCA_002499455_01716	38	124	86	0.260606	0.300699
GCA_002499455_01716	141	283	142	0.430303	0.496503
GCA_003230355_01253	50	122	72	0.218182	0.22291
GCA_003230355_01253	146	321	175	0.530303	0.541796
GCA_002505685_00339	64	325	261	0.790909	0.803077
GCA_002719815_00588	67	335	268	0.812121	0.8
GCF_001571405_01342	38	126	88	0.266667	0.307692
GCF_001571405_01342	141	283	142	0.430303	0.496503
GCA_002254385_00328	90	365	275	0.833333	0.727513
GCA_002501765_00900	39	115	76	0.230303	0.273381
GCA_002501765_00900	116	278	162	0.490909	0.582734
GCF_000337735_03185	1	39	38	0.115152	0.188119
GCF_000337735_03185	37	201	164	0.49697	0.811881
GCA_003602415_00463	69	335	266	0.806061	0.79403
GCA_903832665_00764	56	158	102	0.309091	0.321767
GCA_903832665_00764	147	315	168	0.509091	0.529968
GCA_002505405_00410	70	335	265	0.80303	0.791045
GCA_003315655_02066	1	179	178	0.539394	0.988889
GCA_002839575_00377	38	124	86	0.260606	0.300699
GCA_002839575_00377	134	283	149	0.451515	0.520979
GCA_000415985_01130	32	130	98	0.29697	0.34386
GCA_000415985_01130	116	285	169	0.512121	0.592982
GCF_009914725_01736	38	138	100	0.30303	0.350877
GCF_009914725_01736	124	285	161	0.487879	0.564912
GCA_014523665_01600	1	170	169	0.512121	0.804762
GCA_002722595_01012	112	376	264	0.8	0.702128
GCA_003194445_01558	21	117	96	0.290909	0.352941
GCA_003194445_01558	104	270	166	0.50303	0.610294
GCA_003695745_00716	152	320	168	0.509091	0.521739
GCA_002501655_00814	38	125	87	0.263636	0.304196
GCA_002501655_00814	141	283	142	0.430303	0.496503
GCA_003651045_01208	65	148	83	0.251515	0.280405
GCA_003651045_01208	145	296	151	0.457576	0.510135
GCF_004102725_01144	37	126	89	0.269697	0.312281
GCF_004102725_01144	133	285	152	0.460606	0.533333
GCA_001412355_00397	47	148	101	0.306061	0.34471
GCA_001412355_00397	129	291	162	0.490909	0.552901
GCA_002688355_01080	1	224	223	0.675758	0.995536
GCA_002692685_00292	65	335	270	0.818182	0.80597
GCA_002496355_00150	76	153	77	0.233333	0.254967
GCA_002496355_00150	149	302	153	0.463636	0.506623
GCF_000304355_01665	38	126	88	0.266667	0.307692
GCF_000304355_01665	139	282	143	0.433333	0.5
GCA_003661905_01346	1	130	129	0.390909	0.977273
GCA_002731395_01106	94	358	264	0.8	0.735376
GCA_001602645_00859	44	121	77	0.233333	0.254967
GCA_001602645_00859	126	300	174	0.527273	0.576159
GCA_012270265_00643	65	335	270	0.818182	0.80597
GCA_001512375_02054	38	125	87	0.263636	0.304196
GCA_001512375_02054	140	282	142	0.430303	0.496503
GCA_002497965_01174	39	125	86	0.260606	0.299652
GCA_002497965_01174	142	287	145	0.439394	0.505226
GCA_003170075_01420	37	139	102	0.309091	0.342282
GCA_003170075_01420	145	297	152	0.460606	0.510067
GCF_009741975_03010	3	160	157	0.475758	0.98125
GCF_000243255_00939	37	126	89	0.269697	0.295681
GCF_000243255_00939	125	299	174	0.527273	0.578073
GCA_002718215_00478	61	333	272	0.824242	0.816817
GCA_002503595_01242	1	68	67	0.20303	0.305936
GCA_002503595_01242	67	214	147	0.445455	0.671233
GCA_002506585_00595	38	124	86	0.260606	0.300699
GCA_002506585_00595	141	283	142	0.430303	0.496503
GCA_002171315_01227	70	335	265	0.80303	0.791045
GCF_000235565_00085	50	128	78	0.236364	0.249201
GCF_000235565_00085	133	303	170	0.515152	0.543131
GCA_002508705_01170	38	124	86	0.260606	0.300699
GCA_002508705_01170	140	284	144	0.436364	0.503497
GCA_002720095_00172	64	335	271	0.821212	0.808955
GCA_000246735_01438	72	337	265	0.80303	0.78635
GCA_002495055_01184	38	138	100	0.30303	0.348432
GCA_002495055_01184	130	287	157	0.475758	0.547038
GCA_002067365_01675	69	158	89	0.269697	0.281646
GCA_002067365_01675	148	316	168	0.509091	0.531646
GCA_002502215_01084	66	335	269	0.815152	0.802985
GCA_009887135_00453	69	335	266	0.806061	0.79403
GCA_002495535_00631	90	351	261	0.790909	0.74359
GCA_014384685_00438	65	333	268	0.812121	0.804805
GCA_009887195_00056	80	347	267	0.809091	0.769452
GCA_003602665_00017	68	335	267	0.809091	0.797015
GCA_003942085_01246	71	147	76	0.230303	0.256757
GCA_003942085_01246	144	296	152	0.460606	0.513514
GCA_013329925_00363	81	347	266	0.806061	0.766571
GCA_012797575_00325	38	125	87	0.263636	0.304196
GCA_012797575_00325	128	283	155	0.469697	0.541958
GCF_000711215_00199	66	169	103	0.312121	0.282192
GCF_000711215_00199	151	357	206	0.624242	0.564384
GCA_013178225_00180	44	129	85	0.257576	0.297203
GCA_013178225_00180	137	286	149	0.451515	0.520979
GCA_002726395_00982	70	337	267	0.809091	0.792285
GCA_014240385_01296	75	347	272	0.824242	0.783862
GCA_012959275_00601	76	347	271	0.821212	0.78098
GCA_004195515_01347	71	335	264	0.8	0.78806
GCA_013331015_00925	37	124	87	0.263636	0.303136
GCA_013331015_00925	119	284	165	0.5	0.574913
GCA_012959845_01513	69	339	270	0.818182	0.79646
GCA_002496635_00848	69	335	266	0.806061	0.79403
GCA_003661105_00644	41	137	96	0.290909	0.328767
GCA_003661105_00644	124	290	166	0.50303	0.568493
GCA_002502245_02064	41	142	101	0.306061	0.347079
GCA_002502245_02064	135	290	155	0.469697	0.532646
GCA_003650585_00649	72	323	251	0.760606	0.77709
GCF_000789255_01210	33	112	79	0.239394	0.306202
GCF_000789255_01210	102	258	156	0.472727	0.604651
GCA_013415665_00420	37	125	88	0.266667	0.307692
GCA_013415665_00420	120	285	165	0.5	0.576923
GCA_002503665_00213	61	333	272	0.824242	0.816817
GCA_007116295_00287	1	235	234	0.709091	0.995745
GCA_002498455_00372	56	327	271	0.821212	0.828746
GCA_903915225_00212	65	318	253	0.766667	0.795597
GCA_001595945_01317	72	146	74	0.224242	0.249158
GCA_001595945_01317	144	297	153	0.463636	0.515152
GCF_000017625_00525	36	136	100	0.30303	0.346021
GCF_000017625_00525	138	283	145	0.439394	0.50173
GCA_004195635_00703	95	363	268	0.812121	0.738292
GCA_003602635_00451	61	333	272	0.824242	0.814371
GCA_902529885_00267	5	257	252	0.763636	0.980545
GCA_002496845_00390	60	333	273	0.827273	0.817365
GCA_002506875_00474	62	333	271	0.821212	0.813814
GCA_002685895_01036	64	332	268	0.812121	0.807229
GCA_001595915_01169	68	149	81	0.245455	0.274576
GCA_001595915_01169	144	295	151	0.457576	0.511864
GCA_003141335_00291	38	138	100	0.30303	0.348432
GCA_003141335_00291	127	287	160	0.484848	0.557491
GCA_012959435_00922	65	333	268	0.812121	0.804805
GCF_000327485_02600	37	130	93	0.281818	0.325175
GCF_000327485_02600	129	286	157	0.475758	0.548951
GCA_002068885_00835	1	60	59	0.178788	0.172515
GCA_002068885_00835	56	255	199	0.60303	0.581871
GCA_002713585_00483	60	333	273	0.827273	0.81982
GCA_002698145_00477	66	335	269	0.815152	0.802985
GCA_002499195_01131	67	335	268	0.812121	0.8
GCA_002497905_01260	61	333	272	0.824242	0.816817
GCA_002725475_01152	63	332	269	0.815152	0.810241
GCA_002502735_00124	37	136	99	0.3	0.331104
GCA_002502735_00124	144	290	146	0.442424	0.488294
GCA_002067035_02713	37	138	101	0.306061	0.351916
GCA_002067035_02713	125	286	161	0.487879	0.560976
GCF_001006045_01787	30	110	80	0.242424	0.310078
GCF_001006045_01787	101	258	157	0.475758	0.608527
GCA_002839605_00140	37	124	87	0.263636	0.303136
GCA_002839605_00140	119	286	167	0.506061	0.581882
GCA_902385025_00302	44	131	87	0.263636	0.304196
GCA_902385025_00302	127	286	159	0.481818	0.555944
GCA_002694585_00749	87	358	271	0.821212	0.754875
GCA_003650935_00054	70	153	83	0.251515	0.279461
GCA_003650935_00054	150	297	147	0.445455	0.494949
GCA_002726845_00826	67	335	268	0.812121	0.8
GCA_003662985_01695	42	123	81	0.245455	0.285211
GCA_003662985_01695	113	284	171	0.518182	0.602113
GCA_002503135_01102	53	146	93	0.281818	0.31
GCA_002503135_01102	157	297	140	0.424242	0.466667
GCA_013330925_00130	65	332	267	0.809091	0.799401
GCF_000147875_00396	38	140	102	0.309091	0.350515
GCF_000147875_00396	131	286	155	0.469697	0.532646
GCA_013330595_00653	4	229	225	0.681818	0.982533
GCA_011364265_00781	1	142	141	0.427273	0.972414
GCA_011391755_01294	44	132	88	0.266667	0.305556
GCA_011391755_01294	122	288	166	0.50303	0.576389
GCA_002714305_00346	71	335	264	0.8	0.78806
GCA_002505495_00455	67	333	266	0.806061	0.798799
GCA_003154335_00968	37	138	101	0.306061	0.351916
GCA_003154335_00968	131	286	155	0.469697	0.54007
GCF_013391105_00228	1	38	37	0.112121	0.193717
GCF_013391105_00228	30	191	161	0.487879	0.842932
GCA_002701145_00720	67	335	268	0.812121	0.8
GCA_003021755_00856	4	154	150	0.454545	0.974026
GCF_000784355_02099	38	138	100	0.30303	0.343643
GCF_000784355_02099	126	286	160	0.484848	0.549828
GCA_013329165_01808	38	125	87	0.263636	0.302083
GCA_013329165_01808	132	282	150	0.454545	0.520833
GCA_011357905_01349	33	108	75	0.227273	0.285171
GCA_011357905_01349	105	263	158	0.478788	0.60076
GCA_002502295_00983	7	170	163	0.493939	0.958824
GCA_002727515_00920	68	335	267	0.809091	0.797015
GCA_009937205_00085	73	338	265	0.80303	0.784024
GCA_002494725_01126	31	107	76	0.230303	0.294574
GCA_002494725_01126	105	258	153	0.463636	0.593023
GCA_011045995_00899	39	127	88	0.266667	0.30662
GCA_011045995_00899	128	286	158	0.478788	0.550523
GCA_012964335_01136	74	333	259	0.784848	0.777778
GCF_009831555_03249	1	144	143	0.433333	0.993056
GCA_003136075_00043	37	139	102	0.309091	0.346939
GCA_003136075_00043	137	294	157	0.475758	0.534014
GCA_003838065_01125	40	127	87	0.263636	0.3
GCA_003838065_01125	134	289	155	0.469697	0.534483
GCA_003857025_02350	46	135	89	0.269697	0.304795
GCA_003857025_02350	126	292	166	0.50303	0.568493
GCA_013153555_00022	64	325	261	0.790909	0.803077
GCA_003650935_00531	73	153	80	0.242424	0.268456
GCA_003650935_00531	144	298	154	0.466667	0.516779
GCF_014212355_02958	1	23	22	0.0666667	0.106796
GCF_014212355_02958	51	206	155	0.469697	0.752427
GCA_001940805_01053	29	116	87	0.263636	0.297945
GCA_001940805_01053	127	291	164	0.49697	0.561644
GCA_002723635_00501	60	332	272	0.824242	0.814371
GCA_002496395_00681	39	125	86	0.260606	0.298611
GCA_002496395_00681	132	283	151	0.457576	0.524306
GCA_002011235_00259	42	124	82	0.248485	0.294964
GCA_002011235_00259	113	278	165	0.5	0.593525
GCA_001412335_00232	36	140	104	0.315152	0.364912
GCA_001412335_00232	132	284	152	0.460606	0.533333
GCA_002499015_00545	72	338	266	0.806061	0.786982
GCA_013415595_01910	38	118	80	0.242424	0.285714
GCA_013415595_01910	126	279	153	0.463636	0.546429
GCA_903871465_02003	40	126	86	0.260606	0.300699
GCA_903871465_02003	116	286	170	0.515152	0.594406
GCA_002694245_01008	68	335	267	0.809091	0.797015
GCA_002505805_01103	41	123	82	0.248485	0.285714
GCA_002505805_01103	122	286	164	0.49697	0.571429
GCA_002724815_00953	66	333	267	0.809091	0.801802
GCA_002067795_00189	51	127	76	0.230303	0.245955
GCA_002067795_00189	141	308	167	0.506061	0.540453
GCA_012798025_01457	17	107	90	0.272727	0.322581
GCA_012798025_01457	98	277	179	0.542424	0.641577
GCA_903877165_00743	72	152	80	0.242424	0.268456
GCA_903877165_00743	149	298	149	0.451515	0.5
GCA_002010305_02114	33	117	84	0.254545	0.316981
GCA_002010305_02114	106	265	159	0.481818	0.6
GCA_002067705_02181	49	130	81	0.245455	0.276451
GCA_002067705_02181	125	293	168	0.509091	0.573379
GCF_000021965_02712	39	129	90	0.272727	0.313589
GCF_000021965_02712	135	283	148	0.448485	0.515679
GCA_006954465_01244	1	139	138	0.418182	0.965035
GCA_002505945_01055	65	332	267	0.809091	0.801802
GCF_000336875_00108	1	39	38	0.115152	0.184466
GCF_000336875_00108	30	205	175	0.530303	0.849515
GCF_000691505_00298	32	126	94	0.284848	0.353383
GCF_000691505_00298	124	244	120	0.363636	0.451128
GCF_900107205_00510	1	38	37	0.112121	0.18408
GCF_900107205_00510	30	201	171	0.518182	0.850746
GCA_002727675_00469	102	364	262	0.793939	0.71978
GCA_002067895_00173	38	139	101	0.306061	0.353147
GCA_002067895_00173	127	283	156	0.472727	0.545455
GCF_000015765_01703	47	145	98	0.29697	0.332203
GCF_000015765_01703	138	295	157	0.475758	0.532203
GCF_009898475_00245	1	161	160	0.484848	0.981595
GCA_903900025_00210	37	140	103	0.312121	0.361404
GCA_903900025_00210	131	283	152	0.460606	0.533333
GCF_003666015_01205	1	38	37	0.112121	0.173709
GCF_003666015_01205	31	211	180	0.545455	0.84507
GCA_003651105_00194	67	145	78	0.236364	0.268041
GCA_003651105_00194	141	291	150	0.454545	0.515464
GCA_007128515_01086	16	181	165	0.5	0.906593
GCA_002494625_00260	37	119	82	0.248485	0.307116
GCA_002494625_00260	111	267	156	0.472727	0.58427
GCA_011361745_00895	30	110	80	0.242424	0.311284
GCA_011361745_00895	95	257	162	0.490909	0.63035
GCA_002256595_00940	43	128	85	0.257576	0.294118
GCA_002256595_00940	124	289	165	0.5	0.570934
GCA_002498315_00287	19	119	100	0.30303	0.355872
GCA_002498315_00287	133	278	145	0.439394	0.516014
GCF_000025505_02143	32	113	81	0.245455	0.316406
GCF_000025505_02143	104	256	152	0.460606	0.59375
GCA_002503825_01552	37	123	86	0.260606	0.301754
GCA_002503825_01552	131	281	150	0.454545	0.526316
GCA_002686525_00125	64	333	269	0.815152	0.807808
GCA_003315675_00859	29	129	100	0.30303	0.361011
GCA_003315675_00859	120	277	157	0.475758	0.566787
GCA_001766815_00025	1	63	62	0.187879	0.275556
GCA_001766815_00025	55	223	168	0.509091	0.746667
GCF_001571385_00636	34	119	85	0.257576	0.302491
GCF_001571385_00636	129	277	148	0.448485	0.52669
GCA_007118075_00378	27	105	78	0.236364	0.280576
GCA_007118075_00378	130	277	147	0.445455	0.528777
GCA_902385225_00138	1	60	59	0.178788	0.178248
GCA_902385225_00138	55	253	198	0.6	0.598187
GCA_013330015_00565	1	152	151	0.457576	0.993421
GCA_002506085_01384	28	131	103	0.312121	0.371841
GCA_002506085_01384	121	277	156	0.472727	0.563177
GCA_003023485_00819	1	147	146	0.442424	0.993197
GCA_002010285_01218	40	117	77	0.233333	0.286245
GCA_002010285_01218	113	269	156	0.472727	0.579926
GCF_000275865_00423	35	118	83	0.251515	0.295374
GCF_000275865_00423	129	278	149	0.451515	0.530249
GCA_012799645_00661	1	60	59	0.178788	0.202055
GCA_012799645_00661	55	260	205	0.621212	0.702055
GCF_013377755_00982	35	118	83	0.251515	0.295374
GCF_013377755_00982	129	277	148	0.448485	0.52669
GCA_002011215_01622	39	120	81	0.245455	0.303371
GCA_002011215_01622	111	267	156	0.472727	0.58427
GCA_002010215_01010	49	129	80	0.242424	0.291971
GCA_002010215_01010	118	274	156	0.472727	0.569343
GCA_002498375_01239	29	126	97	0.293939	0.350181
GCA_002498375_01239	121	277	156	0.472727	0.563177
GCF_002287215_01644	29	127	98	0.29697	0.353791
GCF_002287215_01644	120	276	156	0.472727	0.563177
GCA_003838185_00276	38	124	86	0.260606	0.297578
GCA_003838185_00276	132	288	156	0.472727	0.539792
GCA_002067755_01096	16	107	91	0.275758	0.326165
GCA_002067755_01096	97	277	180	0.545455	0.645161
GCA_002504905_00893	60	333	273	0.827273	0.81982
GCA_002254885_00585	71	146	75	0.227273	0.245902
GCA_002254885_00585	144	305	161	0.487879	0.527869
GCA_013329355_00756	73	300	227	0.687879	0.756667
GCA_002457595_00799	53	326	273	0.827273	0.837423
GCA_000235685_01436	48	134	86	0.260606	0.288591
GCA_000235685_01436	150	296	146	0.442424	0.489933
GCA_903828975_00129	37	123	86	0.260606	0.301754
GCA_903828975_00129	139	282	143	0.433333	0.501754
GCA_003663055_00588	24	103	79	0.239394	0.316
GCA_003663055_00588	92	250	158	0.478788	0.632
GCA_007117755_00216	2	233	231	0.7	0.991416
GCF_000194625_01281	33	106	73	0.221212	0.281853
GCF_000194625_01281	100	259	159	0.481818	0.6139
GCA_903819595_02111	37	124	87	0.263636	0.305263
GCA_903819595_02111	139	281	142	0.430303	0.498246
GCA_000806155_01031	1	213	212	0.642424	0.995305
GCF_000025285_00699	36	117	81	0.245455	0.306818
GCF_000025285_00699	107	264	157	0.475758	0.594697
GCA_011333375_01249	34	105	71	0.215152	0.275194
GCA_011333375_01249	103	258	155	0.469697	0.600775
GCF_004297185_00171	46	129	83	0.251515	0.284247
GCF_004297185_00171	148	288	140	0.424242	0.479452
GCA_013330385_00616	62	334	272	0.824242	0.814371
GCA_004347865_01354	30	107	77	0.233333	0.299611
GCA_004347865_01354	95	257	162	0.490909	0.63035
GCA_002010195_01780	38	124	86	0.260606	0.322097
GCA_002010195_01780	110	267	157	0.475758	0.588015
GCA_002497245_00825	73	351	278	0.842424	0.792023
GCA_003649845_01517	68	145	77	0.233333	0.260135
GCA_003649845_01517	143	295	152	0.460606	0.513514
GCA_002495525_00023	78	351	273	0.827273	0.777778
GCA_002509495_00697	38	124	86	0.260606	0.300699
GCA_002509495_00697	111	277	166	0.50303	0.58042
GCA_002683155_00136	77	348	271	0.821212	0.778736
GCA_012516785_00756	48	136	88	0.266667	0.297297
GCA_012516785_00756	144	290	146	0.442424	0.493243
GCA_003663355_00553	39	117	78	0.236364	0.309524
GCA_003663355_00553	63	252	189	0.572727	0.75
GCA_002713185_00588	61	333	272	0.824242	0.816817
GCA_002697065_00682	59	322	263	0.79697	0.81677
GCA_002503985_00504	102	361	259	0.784848	0.709589
GCA_002499905_01017	45	129	84	0.254545	0.286689
GCA_002499905_01017	133	291	158	0.478788	0.539249
GCA_002172185_00233	68	333	265	0.80303	0.795796
GCF_000008665_02144	30	111	81	0.245455	0.313953
GCF_000008665_02144	103	258	155	0.469697	0.600775
GCA_001628485_00376	63	334	271	0.821212	0.811377
GCA_002507545_01175	32	112	80	0.242424	0.307692
GCA_002507545_01175	104	260	156	0.472727	0.6
GCA_902593945_00120	65	355	290	0.878788	0.816901
GCA_902511005_00850	80	351	271	0.821212	0.77208
GCA_002712575_01288	66	334	268	0.812121	0.802395
GCA_013415575_00450	36	123	87	0.263636	0.306338
GCA_013415575_00450	121	276	155	0.469697	0.545775
GCA_013415565_00347	35	123	88	0.266667	0.309859
GCA_013415565_00347	117	283	166	0.50303	0.584507
GCA_002723045_00332	67	333	266	0.806061	0.798799
GCA_002720055_00770	69	333	264	0.8	0.792793
GCA_902573015_00401	68	334	266	0.806061	0.796407
GCA_002502175_00045	80	352	272	0.824242	0.772727
GCA_003602595_00186	62	334	272	0.824242	0.814371
GCA_001629235_00524	96	363	267	0.809091	0.735537
GCA_902625325_00916	64	334	270	0.818182	0.808383
GCA_002718695_00950	66	334	268	0.812121	0.802395
GCA_002068435_02348	48	135	87	0.263636	0.293919
GCA_002068435_02348	144	292	148	0.448485	0.5
GCA_002506755_01038	61	332	271	0.821212	0.816265
GCA_902531985_00477	12	87	75	0.227273	0.321888
GCA_902531985_00477	103	232	129	0.390909	0.553648
GCF_000711905_01567	51	123	72	0.218182	0.258993
GCF_000711905_01567	125	276	151	0.457576	0.543165
GCA_004332335_00290	39	125	86	0.260606	0.301754
GCA_004332335_00290	136	283	147	0.445455	0.515789
GCF_000385565_00229	31	108	77	0.233333	0.291667
GCF_000385565_00229	104	264	160	0.484848	0.606061
GCA_002779075_00073	2	284	282	0.854545	0.986014
GCA_002497895_00237	43	312	269	0.815152	0.862179
GCA_002010045_00494	31	120	89	0.269697	0.343629
GCA_002010045_00494	105	259	154	0.466667	0.594595
GCA_003662995_01993	36	112	76	0.230303	0.287879
GCA_003662995_01993	107	264	157	0.475758	0.594697
GCA_013329905_00305	63	334	271	0.821212	0.811377
GCA_013331125_01451	50	249	199	0.60303	0.799197
GCA_002688965_00347	10	107	97	0.293939	0.375969
GCA_002688965_00347	109	258	149	0.451515	0.577519
GCA_002496485_00281	66	334	268	0.812121	0.802395
GCA_012960975_00789	59	333	274	0.830303	0.822823
GCA_002502365_00915	56	326	270	0.818182	0.828221
GCA_002506105_02141	29	125	96	0.290909	0.335664
GCA_002506105_02141	134	284	150	0.454545	0.524476
GCA_002067095_00352	38	125	87	0.263636	0.304196
GCA_002067095_00352	130	281	151	0.457576	0.527972
GCA_003162655_01611	1	149	148	0.448485	0.880952
GCA_001629205_01161	62	334	272	0.824242	0.814371
GCA_013330315_01568	1	131	130	0.393939	0.984848
GCA_011523055_00900	65	334	269	0.815152	0.805389
GCA_013415575_00024	45	130	85	0.257576	0.290102
GCA_013415575_00024	133	290	157	0.475758	0.535836
GCA_002496905_00030	62	334	272	0.824242	0.814371
GCA_002495675_00558	88	359	271	0.821212	0.754875
GCA_001629255_00079	72	334	262	0.793939	0.784431
GCA_003602515_00957	69	137	68	0.206061	0.204204
GCA_003602515_00957	170	333	163	0.493939	0.489489
GCA_003251955_01733	48	146	98	0.29697	0.329966
GCA_003251955_01733	134	297	163	0.493939	0.548822
GCA_002687355_00859	8	84	76	0.230303	0.31405
GCA_002687355_00859	80	239	159	0.481818	0.657025
GCA_002497025_00574	80	352	272	0.824242	0.772727
GCA_002503285_00838	64	335	271	0.821212	0.808955
GCA_002730445_00387	72	333	261	0.790909	0.783784
GCA_013153395_00508	1	84	83	0.251515	0.359307
GCA_013153395_00508	79	231	152	0.460606	0.658009
GCA_012729995_00293	48	141	93	0.281818	0.315254
GCA_012729995_00293	136	293	157	0.475758	0.532203
GCA_902560445_00769	85	352	267	0.809091	0.758523
GCA_002719615_00973	66	334	268	0.812121	0.802395
GCA_011055585_01232	82	281	199	0.60303	0.708185
GCA_002505695_00095	60	334	274	0.830303	0.820359
GCA_002505455_00829	55	323	268	0.812121	0.829721
GCA_012728895_02158	40	125	85	0.257576	0.298246
GCA_012728895_02158	141	283	142	0.430303	0.498246
GCA_902627615_00910	16	92	76	0.230303	0.317992
GCA_902627615_00910	96	239	143	0.433333	0.598326
GCA_014239955_00582	67	333	266	0.806061	0.798799
GCA_002498725_00621	60	334	274	0.830303	0.820359
GCA_002731655_00789	8	83	75	0.227273	0.297619
GCA_002731655_00789	80	240	160	0.484848	0.634921
GCA_009758405_00043	45	147	102	0.309091	0.368231
GCA_009758405_00043	142	276	134	0.406061	0.483755
GCA_003662515_00953	1	108	107	0.324242	0.981651
GCA_903916665_00358	1	269	268	0.812121	0.98893
GCA_002724775_00220	15	95	80	0.242424	0.338983
GCA_002724775_00220	101	236	135	0.409091	0.572034
GCA_013044425_01316	93	163	70	0.212121	0.202899
GCA_013044425_01316	155	343	188	0.569697	0.544928
GCA_002501605_00831	62	334	272	0.824242	0.814371
GCA_002501965_00182	38	124	86	0.260606	0.300699
GCA_002501965_00182	136	281	145	0.439394	0.506993
GCA_002499585_00137	72	334	262	0.793939	0.784431
GCA_002502045_00491	1	248	247	0.748485	0.995968
GCA_002507175_00943	63	334	271	0.821212	0.811377
GCA_002731195_00092	67	334	267	0.809091	0.799401
GCF_003173355_00478	48	138	90	0.272727	0.30303
GCF_003173355_00478	149	297	148	0.448485	0.498316
GCA_000416085_00908	1	119	118	0.357576	0.991597
GCA_002457155_00674	64	333	269	0.815152	0.807808
GCA_002457555_00561	81	352	271	0.821212	0.769886
GCA_002495185_01106	93	347	254	0.769697	0.729885
GCA_002717835_00992	99	368	269	0.815152	0.730978
GCA_013290045_01356	79	156	77	0.233333	0.217514
GCA_013290045_01356	179	349	170	0.515152	0.480226
GCA_002504845_00021	85	353	268	0.812121	0.759207
GCA_002499325_01081	61	334	273	0.827273	0.817365
GCA_002498525_00266	75	347	272	0.824242	0.783862
GCA_002505775_00232	63	334	271	0.821212	0.811377
GCA_002712645_01029	86	353	267	0.809091	0.756374
GCA_004347825_00592	30	100	70	0.212121	0.273438
GCA_004347825_00592	97	256	159	0.481818	0.621094
GCA_002457145_00451	66	334	268	0.812121	0.802395
GCA_003193925_01247	62	334	272	0.824242	0.814371
GCA_002497295_00341	66	334	268	0.812121	0.802395
GCA_002501805_00344	61	334	273	0.827273	0.817365
GCA_002067155_01955	39	124	85	0.257576	0.297203
GCA_002067155_01955	137	281	144	0.436364	0.503497
GCA_002067485_01475	38	125	87	0.263636	0.304196
GCA_002067485_01475	130	284	154	0.466667	0.538462
GCA_011605865_00606	31	100	69	0.209091	0.269531
GCA_011605865_00606	97	256	159	0.481818	0.621094
GCA_002716085_00922	79	334	255	0.772727	0.763473
GCA_002011165_01402	100	241	141	0.427273	0.585062
GCA_002170775_00687	66	334	268	0.812121	0.802395
GCA_011773475_00827	165	310	145	0.439394	0.467742
GCA_003649745_00797	1	114	113	0.342424	0.991228
GCA_002506485_00660	24	131	107	0.324242	0.433198
GCA_002506485_00660	124	247	123	0.372727	0.497976
GCA_002498925_00435	57	326	269	0.815152	0.825153
GCA_002502095_00150	61	334	273	0.827273	0.817365
GCA_902533295_00130	15	93	78	0.236364	0.325
GCA_902533295_00130	108	240	132	0.4	0.55
GCA_002499865_00960	61	334	273	0.827273	0.817365
GCA_009779205_00040	23	109	86	0.260606	0.315018
GCA_009779205_00040	123	264	141	0.427273	0.516484
GCA_002789275_00156	2	243	241	0.730303	0.99177
GCA_002501885_00524	52	323	271	0.821212	0.839009
GCA_002698225_00501	49	323	274	0.830303	0.848297
GCA_002730095_00826	66	334	268	0.812121	0.802395
GCA_002725315_00070	66	334	268	0.812121	0.802395
GCA_009778275_00144	1	121	120	0.363636	0.983607
GCA_002718915_00450	13	101	88	0.266667	0.372881
GCA_002718915_00450	101	236	135	0.409091	0.572034
GCA_002715545_00342	70	337	267	0.809091	0.792285
GCA_002504435_00663	66	334	268	0.812121	0.802395
GCA_002722735_00907	125	387	262	0.793939	0.677003
GCA_011048195_00987	29	100	71	0.215152	0.278431
GCA_011048195_00987	94	255	161	0.487879	0.631373
GCA_002503055_00931	51	323	272	0.824242	0.842105
GCA_014361165_00663	102	242	140	0.424242	0.578512
GCF_000013445_02462	50	128	78	0.236364	0.264407
GCF_000013445_02462	132	293	161	0.487879	0.545763
GCA_004195615_00974	65	333	268	0.812121	0.804805
GCA_014240055_00041	20	97	77	0.233333	0.316872
GCA_014240055_00041	103	243	140	0.424242	0.576132
GCA_001875345_00178	10	94	84	0.254545	0.357447
GCA_001875345_00178	103	235	132	0.4	0.561702
GCA_002718995_00930	67	334	267	0.809091	0.799401
GCA_002509165_00973	5	60	55	0.166667	0.25
GCA_002509165_00973	58	217	159	0.481818	0.722727
GCA_002010075_00417	32	118	86	0.260606	0.34127
GCA_002010075_00417	108	250	142	0.430303	0.563492
GCA_003559395_00057	1	255	254	0.769697	0.996078
GCA_002506825_00937	63	334	271	0.821212	0.811377
GCA_014240255_00898	21	96	75	0.227273	0.308642
GCA_014240255_00898	105	243	138	0.418182	0.567901
GCA_011367245_01146	28	101	73	0.221212	0.287402
GCA_011367245_01146	95	254	159	0.481818	0.625984
GCA_003663295_00326	99	253	154	0.466667	0.608696
GCA_002731655_00521	6	60	54	0.163636	0.243243
GCA_002731655_00521	58	217	159	0.481818	0.716216
GCA_002505325_00306	76	349	273	0.827273	0.782235
GCA_012030815_00441	57	277	220	0.666667	0.794224
GCA_002719635_00400	68	326	258	0.781818	0.791411
GCA_012729535_02427	23	105	82	0.248485	0.30597
GCA_012729535_02427	118	266	148	0.448485	0.552239
GCF_003173335_01264	46	127	81	0.245455	0.276451
GCF_003173335_01264	134	289	155	0.469697	0.52901
GCA_002878135_00687	44	148	104	0.315152	0.37276
GCA_002878135_00687	138	279	141	0.427273	0.505376
GCA_009392915_00602	1	250	249	0.754545	0.996
GCA_002495735_00073	61	333	272	0.824242	0.816817
GCA_001875365_00566	11	97	86	0.260606	0.364407
GCA_001875365_00566	107	236	129	0.390909	0.54661
GCA_011380495_00564	1	56	55	0.166667	0.237069
GCA_011380495_00564	74	232	158	0.478788	0.681034
GCA_014240285_00964	61	333	272	0.824242	0.816817
GCA_011370275_00195	69	233	164	0.49697	0.697872
GCA_002498845_00754	110	267	157	0.475758	0.588015
GCA_011334705_01398	23	182	159	0.481818	0.873626
GCA_002204705_00453	50	205	155	0.469697	0.756098
GCA_004195715_00707	61	333	272	0.824242	0.816817
GCA_002496725_00346	66	334	268	0.812121	0.802395
GCA_002503395_01685	98	324	226	0.684848	0.576531
GCF_001315945_00495	2	88	86	0.260606	0.445596
GCF_001315945_00495	74	193	119	0.360606	0.61658
GCA_002503215_00706	8	266	258	0.781818	0.969925
GCF_900769095_00040	1	130	129	0.390909	0.984733
GCF_000011185_00369	34	183	149	0.451515	0.814208
GCA_003193815_00321	1	109	108	0.327273	0.947368
GCF_003205235_01339	41	190	149	0.451515	0.784211
GCF_000195915_01305	46	190	144	0.436364	0.757895
GCA_012030815_00442	1	130	129	0.390909	0.816456
GCA_012520015_01886	1	121	120	0.363636	0.97561
GCA_014523665_00214	90	276	186	0.563636	0.673913
GCF_001402945_00045	16	167	151	0.457576	0.904192
GCA_011620765_00993	3	215	212	0.642424	0.559367
GCA_002505185_01183	41	189	148	0.448485	0.778947
GCA_000496135_01076	30	99	69	0.209091	0.253676
GCA_000496135_01076	130	272	142	0.430303	0.522059
GCA_013331125_01027	1	88	87	0.263636	0.988636
GCA_011620825_00060	72	252	180	0.545455	0.714286
GCA_000402515_00720	1	218	217	0.657576	0.995413
GCA_001856825_00300	120	266	146	0.442424	0.548872
GCA_011358095_00852	105	263	158	0.478788	0.60076
GCA_013329215_00521	41	177	136	0.412121	0.768362
GCA_002727275_00368	53	323	270	0.818182	0.835913
GCA_002503205_00491	119	279	160	0.484848	0.567376
GCA_002494765_00441	120	243	123	0.372727	0.506173
GCA_002687185_00445	1	228	227	0.687879	0.995614
GCA_002495235_00046	12	193	181	0.548485	0.501385
GCF_900176435_01206	20	166	146	0.442424	0.879518
GCA_013330625_00442	1	90	89	0.269697	0.988889
GCA_003694495_00213	56	176	120	0.363636	0.681818
GCA_003662715_01461	94	237	143	0.433333	0.603376
GCA_003266065_00453	98	286	188	0.569697	0.626667
GCA_903828655_01002	2	68	66	0.2	0.289474
GCA_903828655_01002	82	226	144	0.436364	0.631579
GCA_003021745_01293	30	121	91	0.275758	0.752066
GCA_002780285_00597	2	95	93	0.281818	0.400862
GCA_002780285_00597	103	231	128	0.387879	0.551724
GCF_900083515_01487	109	262	153	0.463636	0.581749
GCA_003161815_01534	1	107	106	0.321212	0.963636
GCA_002172375_00701	69	334	265	0.80303	0.793413
GCA_007117735_00751	49	202	153	0.463636	0.742718
GCA_002503985_01446	169	307	138	0.418182	0.449511
GCA_011605715_00033	1	71	70	0.212121	0.972222
GCA_013044425_00333	82	232	150	0.454545	0.646552
GCA_013290045_02175	157	303	146	0.442424	0.481848
GCA_002495185_01404	171	307	136	0.412121	0.442997
GCA_003157235_01530	47	212	165	0.5	0.75
GCA_002841105_01122	85	258	173	0.524242	0.670543
GCF_009898475_00246	87	223	136	0.412121	0.529183
GCA_011056815_01145	99	205	106	0.321212	0.517073
GCA_013331225_01725	38	125	87	0.263636	0.412322
GCA_013331225_01725	140	210	70	0.212121	0.331754
GCA_003649515_00528	96	222	126	0.381818	0.567568
GCA_002502705_00609	1	74	73	0.221212	0.986486
GCF_001316045_00441	1	94	93	0.281818	0.911765
GCA_002499345_00487	63	249	186	0.563636	0.746988
GCA_001315965_03329	1	43	42	0.127273	0.230769
GCA_001315965_03329	86	161	75	0.227273	0.412088
GCA_001717025_00881	91	206	115	0.348485	0.558252
GCA_003135575_00626	78	207	129	0.390909	0.53527
GCA_004297575_00476	79	189	110	0.333333	0.582011
GCA_000204585_01786	102	219	117	0.354545	0.531818
GCA_000220375_01296	1	134	133	0.40303	0.898649
GCA_007117065_00225	56	198	142	0.430303	0.71
GCA_001316325_01578	94	200	106	0.321212	0.507177
GCA_012962055_00434	1	51	50	0.151515	0.980392
GCA_013215525_00634	156	244	88	0.266667	0.357724
GCA_013331415_01494	36	120	84	0.254545	0.182609
GCA_013331415_01494	132	193	61	0.184848	0.132609
GCA_012719315_00339	70	179	109	0.330303	0.60221
GCA_007128245_01049	95	199	104	0.315152	0.517413
GCA_007116645_01043	95	200	105	0.318182	0.519802
GCA_002508315_00133	1	69	68	0.206061	0.918919
GCA_003552885_01471	31	108	77	0.233333	0.484277
GCA_003552885_01471	120	159	39	0.118182	0.245283
GCF_009742825_00980	31	125	94	0.284848	0.598726
GCA_900316895_01502	88	160	72	0.218182	0.45
GCA_003161815_00357	1	46	45	0.136364	0.978261
GCA_003315655_01978	119	214	95	0.287879	0.443925
GCA_002495485_00100	94	173	79	0.239394	0.456647
GCA_005878635_00657	32	101	69	0.209091	0.209726
GCF_001316105_00086	126	197	71	0.215152	0.325688
GCA_002835825_02015	37	136	99	0.3	0.521053
GCA_001315965_03328	40	123	83	0.251515	0.509202
GCA_011362975_00721	6	153	147	0.445455	0.954545
GCA_013330625_00441	69	205	136	0.412121	0.377778
GCA_002502295_00984	71	171	100	0.30303	0.369004
GCA_011357905_01433	9	148	139	0.421212	0.902597
GCA_004524425_01826	1	54	53	0.160606	0.963636
GCF_003342675_02070	31	94	63	0.190909	0.670213
GCF_003666015_01190	55	119	64	0.193939	0.537815
GCF_000337175_00346	28	92	64	0.193939	0.695652
GCF_000337615_03440	28	92	64	0.193939	0.695652
GCA_003661905_01458	59	188	129	0.390909	0.474265
GCF_900880625_00157	32	96	64	0.193939	0.666667
GCA_002067045_01370	975	1079	104	0.315152	0.095941
GCF_002153915_00542	12	92	80	0.242424	0.869565
GCA_011055445_00187	12	73	61	0.184848	0.813333
GCF_001953745_01670	28	92	64	0.193939	0.695652
GCA_002067635_01574	31	150	119	0.360606	0.196046
GCA_002067635_01574	305	389	84	0.254545	0.138386
GCA_003650585_00699	439	514	75	0.227273	0.142315
GCA_013329295_01294	66	147	81	0.245455	0.543624
GCA_011364305_01900	13	74	61	0.184848	0.802632
GCF_000025505_00614	8	146	138	0.418182	0.901961
GCA_900322125_01216	12	106	94	0.284848	0.824561
GCF_007655485_00955	32	97	65	0.19697	0.637255
GCA_013415595_00598	101	203	102	0.309091	0.239437
GCA_013153105_00239	12	74	62	0.187879	0.815789
GCA_012719175_01115	323	435	112	0.339394	0.12514
GCA_012719175_01115	593	677	84	0.254545	0.0938547
GCA_011053655_01144	12	73	61	0.184848	0.813333
GCA_000375685_00183	4	122	118	0.357576	0.929134
GCA_012729535_02140	13	105	92	0.278788	0.438095
GCF_009742825_00977	34	97	63	0.190909	0.649485
GCF_001663375_01524	109	196	87	0.263636	0.155914
GCF_000015225_01338	21	67	46	0.139394	0.666667
GCF_003697845_02590	31	95	64	0.193939	0.673684
GCA_003020985_01168	29	92	63	0.190909	0.684783
GCF_004765785_02777	107	190	83	0.251515	0.380734
GCA_003649565_01313	13	75	62	0.187879	0.815789
GCA_903851445_00588	34	105	71	0.215152	0.212575
GCA_011370395_00479	3	132	129	0.390909	0.854305
GCA_003978865_00346	18	155	137	0.415152	0.825301
GCA_002506535_02033	150	222	72	0.218182	0.161798
GCA_011772645_00492	1	70	69	0.209091	0.958333
GCA_003663535_01811	12	74	62	0.187879	0.815789
GCA_003661945_00779	4	52	48	0.145455	0.923077
GCA_002506255_00877	38	86	48	0.145455	0.551724
GCA_011048195_00071	181	333	152	0.460606	0.449704
GCA_007117065_00382	2	121	119	0.360606	0.944444
GCA_000387965_00162	1	67	66	0.2	0.511628
GCA_000387965_00162	60	127	67	0.20303	0.51938
GCA_004376265_00428	100	171	71	0.215152	0.408046
GCA_004375715_01481	235	401	166	0.50303	0.361656
GCA_002688265_00642	38	176	138	0.418182	0.536965
GCA_004375715_01023	4	70	66	0.2	0.929577
GCF_000018305_00028	109	196	87	0.263636	0.156194
GCA_014361205_01332	99	213	114	0.345455	0.525346
GCF_001462395_00299	106	183	77	0.233333	0.401042
GCF_001315945_01738	2	129	127	0.384848	0.858108
GCF_001316045_01922	396	553	157	0.475758	0.223966
GCA_013415795_00607	60	185	125	0.378788	0.586854
GCA_009903905_00911	107	197	90	0.272727	0.240642
GCA_003662645_01302	3	126	123	0.372727	0.946154
GCA_000402355_00586	2	82	80	0.242424	0.540541
GCF_003201835_00853	229	311	82	0.248485	0.0860441
GCF_003201835_00853	459	558	99	0.3	0.103882
GCA_011362025_02173	13	73	60	0.181818	0.789474
GCA_903901015_01079	50	216	166	0.50303	0.761468
GCA_011373645_01128	2	95	93	0.281818	0.845455
GCA_002495885_00086	292	362	70	0.212121	0.142276
GCF_000015205_01637	7	75	68	0.206061	0.894737
GCA_004524565_01810	700	769	69	0.209091	0.0773543
GCF_000014945_00194	136	200	64	0.193939	0.150588
GCA_001564035_00531	163	285	122	0.369697	0.425087
GCA_002010305_02213	3	73	70	0.212121	0.945946
GCF_003947435_02755	10	134	124	0.375758	0.918519
GCF_012027325_00049	16	77	61	0.184848	0.772152
GCA_002505945_00032	11	112	101	0.306061	0.748148
GCA_003602595_00152	660	751	91	0.275758	0.0940083
GCA_013138765_00809	166	257	91	0.275758	0.352713
GCA_014361245_01344	8	79	71	0.215152	0.663551
GCA_011372985_00401	15	74	59	0.178788	0.75641
GCF_900100715_01800	52	208	156	0.472727	0.690265
GCA_000247545_01136	6	106	100	0.30303	0.478469
GCA_003694385_00721	77	148	71	0.215152	0.318386
GCF_002243045_02511	14	131	117	0.354545	0.726708
GCA_002009975_01842	13	74	61	0.184848	0.802632
GCA_013180565_02422	1	80	79	0.239394	0.731481
GCA_011355205_01673	2	121	119	0.360606	0.716867
GCA_013138805_00813	117	183	66	0.2	0.232394
GCA_003650815_01359	13	75	62	0.187879	0.815789
Asgard_ASG204_00269	24	123	99	0.3	0.240291
Asgard_ASG204_00269	95	410	315	0.954545	0.764563
Asgard_ASG205_01912	5	84	79	0.239394	0.192683
Asgard_ASG205_01912	93	409	316	0.957576	0.770732
Asgard_ASG235_01200	5	84	79	0.239394	0.192683
Asgard_ASG235_01200	93	409	316	0.957576	0.770732
Asgard_ASG043_01560	95	405	310	0.939394	0.761671
Asgard_ASG209_02382	95	405	310	0.939394	0.761671
Asgard_FWG130_00155	5	85	80	0.242424	0.195122
Asgard_FWG130_00155	93	409	316	0.957576	0.770732
Asgard_ASG042_00147	5	85	80	0.242424	0.195122
Asgard_ASG042_00147	93	409	316	0.957576	0.770732
Asgard_ASG206_00028	95	408	313	0.948485	0.759709
Asgard_ASG207_00540	95	408	313	0.948485	0.759709
Asgard_ASG034_01578	54	382	328	0.993939	0.854167
Asgard_ASG194_00207	16	106	90	0.272727	0.220588
Asgard_ASG194_00207	94	407	313	0.948485	0.767157
Asgard_ASG195_00259	16	106	90	0.272727	0.220588
Asgard_ASG195_00259	94	407	313	0.948485	0.767157
Asgard_ASG149_00857	93	413	320	0.969697	0.771084
Asgard_FWG138_01119	97	415	318	0.963636	0.764423
Asgard_ASG055_02165	94	425	331	1.00303	0.775176
Asgard_ASG150_02524	94	411	317	0.960606	0.7657
Asgard_ASG132_02486	96	421	325	0.984848	0.717439
Asgard_FWG139_01453	94	416	322	0.975758	0.772182
Asgard_ASG232_02282	93	411	318	0.963636	0.769976
Asgard_ASG143_01472	58	382	324	0.981818	0.84375
Asgard_ASG120_03551	106	417	311	0.942424	0.721578
Asgard_ASG101_00692	97	413	316	0.957576	0.761446
Asgard_ASG135_00375	90	410	320	0.969697	0.752941
Asgard_ASG140_00342	90	410	320	0.969697	0.752941
Asgard_ASG250_00285	90	410	320	0.969697	0.752941
Asgard_ASG002_01087	97	415	318	0.963636	0.764423
Asgard_ASG121_03810	96	403	307	0.930303	0.746959
Asgard_ASG203_02384	93	407	314	0.951515	0.756627
Asgard_ASG052_01520	90	409	319	0.966667	0.770531
Asgard_ASG108_02895	90	394	304	0.921212	0.729017
Asgard_ASG114_01060	92	398	306	0.927273	0.737349
Asgard_ASG056_00246	87	408	321	0.972727	0.775362
Asgard_ASG315_00784	94	412	318	0.963636	0.76259
Asgard_ASG051_00010	90	410	320	0.969697	0.745921
Asgard_ASG110_02353	93	398	305	0.924242	0.736715
Asgard_ASG113_02694	94	402	308	0.933333	0.740385
Asgard_ASG059_00262	89	409	320	0.969697	0.772947
Asgard_FWG001_01261	90	420	330	1	0.771028
Asgard_ASG010_01369	90	410	320	0.969697	0.745921
Asgard_ASG062_01588	88	395	307	0.930303	0.741546
Asgard_ASG045_01685	91	412	321	0.972727	0.773494
Asgard_ASG050_00542	89	407	318	0.963636	0.748235
Asgard_FWG166_01145	90	420	330	1	0.771028
Asgard_ASG060_00461	81	408	327	0.990909	0.793689
Asgard_ASG144_01220	54	378	324	0.981818	0.854881
Asgard_ASG190_00409	89	413	324	0.981818	0.776978
Asgard_ASG193_01843	89	413	324	0.981818	0.776978
Asgard_ASG191_02518	92	416	324	0.981818	0.77327
Asgard_ASG196_01842	92	413	321	0.972727	0.771635
Asgard_FWG136_01194	95	409	314	0.951515	0.76399
Asgard_ASG057_00712	88	407	319	0.966667	0.768675
Asgard_ASG058_00557	88	407	319	0.966667	0.768675
Asgard_ASG064_00848	88	407	319	0.966667	0.768675
Asgard_ASG237_00106	88	407	319	0.966667	0.768675
Asgard_ASG130_01688	95	413	318	0.963636	0.768116
Asgard_ASG065_00135	89	407	318	0.963636	0.766265
Asgard_ASG118_03143	95	412	317	0.960606	0.763855
Asgard_ASG102_00035	95	409	314	0.951515	0.752998
Asgard_ASG116_01911	95	403	308	0.933333	0.747573
Asgard_ASG245_00133	95	403	308	0.933333	0.747573
Asgard_ASG066_04763	1	262	261	0.790909	0.988636
Asgard_ASG289_01607	94	402	308	0.933333	0.764268
Asgard_ASG046_00786	90	415	325	0.984848	0.777512
Asgard_ASG126_00323	95	403	308	0.933333	0.747573
Asgard_ASG192_00965	90	413	323	0.978788	0.77458
Asgard_FWG161_00554	114	427	313	0.948485	0.714612
Asgard_ASG249_01893	66	370	304	0.921212	0.791667
Asgard_ASG197_00467	113	417	304	0.921212	0.702079
Asgard_ASG063_01053	88	411	323	0.978788	0.780193
Asgard_FWG135_02004	92	405	313	0.948485	0.767157
Asgard_ASG125_02716	95	412	317	0.960606	0.762019
Asgard_ASG122_03927	94	393	299	0.906061	0.722222
Asgard_ASG160_01961	95	400	305	0.924242	0.758706
Asgard_ASG061_01234	88	410	322	0.975758	0.772182
Asgard_ASG109_01897	92	393	301	0.912121	0.735941
Asgard_ASG145_04727	93	420	327	0.990909	0.776722
Asgard_ASG199_00617	96	402	306	0.927273	0.733813
Asgard_ASG294_00325	115	427	312	0.945455	0.705882
Asgard_ASG112_02583	92	401	309	0.936364	0.753659
Asgard_ASG146_01494	94	396	302	0.915152	0.758794
Asgard_ASG242_00607	94	396	302	0.915152	0.758794
Asgard_ASG075_03271	91	418	327	0.990909	0.764019
Asgard_ASG252_02456	95	407	312	0.945455	0.748201
Asgard_ASG254_00131	95	407	312	0.945455	0.748201
Asgard_ASG124_02442	91	394	303	0.918182	0.740831
Asgard_ASG201_00156	3	307	304	0.921212	0.932515
Asgard_ASG111_02076	94	416	322	0.975758	0.763033
Asgard_ASG106_01173	94	416	322	0.975758	0.763033
Asgard_ASG073_01957	94	406	312	0.945455	0.757282
Asgard_ASG147_00335	93	396	303	0.918182	0.761307
Asgard_ASG243_01376	93	396	303	0.918182	0.761307
Asgard_ASG119_00671	115	418	303	0.918182	0.687075
Asgard_ASG142_01080	93	422	329	0.99697	0.777778
Asgard_ASG136_01705	97	428	331	1.00303	0.757437
Asgard_ASG069_01898	88	404	316	0.957576	0.77451
Asgard_ASG307_02941	76	400	324	0.981818	0.80798
Asgard_ASG264_03412	117	421	304	0.921212	0.697248
Asgard_ASG107_00128	115	440	325	0.984848	0.730337
Asgard_ASG013_02100	98	428	330	1	0.755149
Asgard_ASG309_00087	95	393	298	0.90303	0.75827
Asgard_ASG072_05975	78	396	318	0.963636	0.773723
Asgard_ASG123_01325	91	396	305	0.924242	0.745721
Asgard_ASG074_00059	91	420	329	0.99697	0.768692
Asgard_ASG164_00082	95	406	311	0.942424	0.764128
Asgard_ASG186_00315	95	406	311	0.942424	0.764128
Asgard_ASG068_00878	91	420	329	0.99697	0.75286
Asgard_ASG071_01844	92	420	328	0.993939	0.766355
Asgard_ASG256_00494	95	406	311	0.942424	0.742243
Asgard_ASG039_01666	93	404	311	0.942424	0.764128
Asgard_ASG310_02352	95	388	293	0.887879	0.755155
Asgard_ASG253_00242	91	390	299	0.906061	0.732843
Asgard_ASG093_01719	95	395	300	0.909091	0.757576
Asgard_ASG105_00331	92	401	309	0.936364	0.753659
Asgard_ASG208_01170	94	396	302	0.915152	0.756892
Asgard_ASG283_00993	95	402	307	0.930303	0.761787
Asgard_ASG292_01879	95	402	307	0.930303	0.761787
Asgard_ASG077_00698	92	419	327	0.990909	0.769412
Asgard_ASG267_02649	94	400	306	0.927273	0.763092
Asgard_ASG200_00250	96	401	305	0.924242	0.731415
Asgard_ASG198_02526	96	403	307	0.930303	0.736211
Asgard_ASG169_02310	96	403	307	0.930303	0.759901
Asgard_ASG115_03188	92	394	302	0.915152	0.736585
Asgard_ASG141_01365	92	420	328	0.993939	0.750572
Asgard_ASG067_02584	90	415	325	0.984848	0.764706
Asgard_ASG295_01883	96	416	320	0.969697	0.760095
Asgard_ASG312_02368	91	398	307	0.930303	0.750611
Asgard_ASG291_02849	95	404	309	0.936364	0.761084
Asgard_FWG016_01684	97	413	316	0.957576	0.752381
Asgard_ASG185_01848	95	406	311	0.942424	0.764128
Asgard_ASG076_00317	92	419	327	0.990909	0.762238
Asgard_ASG103_00930	92	398	306	0.927273	0.748166
Asgard_FWG137_02824	94	407	313	0.948485	0.767157
Asgard_ASG117_01185	93	398	305	0.924242	0.745721
Asgard_ASG085_02817	72	372	300	0.909091	0.80429
Asgard_ASG088_04247	94	400	306	0.927273	0.763092
Asgard_ASG096_00888	94	400	306	0.927273	0.763092
Asgard_ASG246_00794	91	396	305	0.924242	0.747549
Asgard_ASG247_00309	91	396	305	0.924242	0.747549
Asgard_ASG282_01038	91	410	319	0.966667	0.768675
Asgard_ASG177_01645	58	365	307	0.930303	0.838798
Asgard_ASG187_02280	95	400	305	0.924242	0.760599
Asgard_ASG078_00242	88	415	327	0.990909	0.78043
Asgard_ASG086_02096	95	402	307	0.930303	0.761787
Asgard_ASG004_02246	88	415	327	0.990909	0.78043
Asgard_ASG297_00341	92	402	310	0.939394	0.769231
Asgard_ASG178_00613	95	402	307	0.930303	0.761787
Asgard_ASG257_00236	95	411	316	0.957576	0.755981
Asgard_ASG070_03118	85	409	324	0.981818	0.786408
Asgard_ASG157_03261	95	406	311	0.942424	0.764128
Asgard_ASG006_03164	95	406	311	0.942424	0.764128
Asgard_ASG154_01126	94	401	307	0.930303	0.763682
Asgard_ASG184_01567	2	304	302	0.915152	0.990164
Asgard_ASG180_02866	84	400	316	0.957576	0.78803
Asgard_ASG168_00075	2	304	302	0.915152	0.990164
Asgard_ASG001_01194	95	409	314	0.951515	0.760291
Asgard_ASG030_00881	92	416	324	0.981818	0.769596
Asgard_ASG260_00102	92	416	324	0.981818	0.769596
Asgard_ASG285_01498	93	384	291	0.881818	0.757812
Asgard_ASG003_00291	96	428	332	1.00606	0.739421
Asgard_ASG174_02209	105	415	310	0.939394	0.743405
Asgard_FWG037_02535	90	408	318	0.963636	0.773723
Asgard_ASG104_00594	94	396	302	0.915152	0.729469
Asgard_ASG007_03057	94	400	306	0.927273	0.763092
Asgard_ASG167_00191	95	406	311	0.942424	0.764128
Asgard_ASG255_02247	96	413	317	0.960606	0.744131
Asgard_ASG098_03314	95	385	290	0.878788	0.753247
Asgard_ASG302_00392	95	406	311	0.942424	0.762255
Asgard_ASG172_02386	2	287	285	0.863636	0.993031
Asgard_ASG048_00081	91	417	326	0.987879	0.774347
Asgard_ASG318_00081	91	417	326	0.987879	0.774347
Asgard_ASG090_02572	95	404	309	0.936364	0.761084
Asgard_ASG165_00800	1	266	265	0.80303	0.992509
Asgard_ASG298_00235	95	393	298	0.90303	0.75827
Asgard_ASG284_00886	95	404	309	0.936364	0.762963
Asgard_ASG049_00010	90	402	312	0.945455	0.762836
Asgard_FWG140_01437	93	416	323	0.978788	0.767221
Asgard_ASG139_01718	90	403	313	0.948485	0.769042
Asgard_ASG038_00643	94	395	301	0.912121	0.762025
Asgard_ASG089_00855	95	401	306	0.927273	0.761194
Asgard_ASG266_00956	90	400	310	0.939394	0.761671
Asgard_ASG100_01670	95	406	311	0.942424	0.764128
Asgard_ASG097_01539	95	400	305	0.924242	0.760599
Asgard_ASG156_01068	95	402	307	0.930303	0.761787
Asgard_ASG009_02597	76	405	329	0.99697	0.808354
Asgard_ASG151_00054	95	405	310	0.939394	0.761671
Asgard_ASG170_01153	89	396	307	0.930303	0.7733
Asgard_ASG159_03529	95	402	307	0.930303	0.761787
Asgard_ASG314_02803	90	412	322	0.975758	0.774038
Asgard_ASG137_03128	90	399	309	0.936364	0.759214
Asgard_ASG053_02513	1	251	250	0.757576	0.976562
Asgard_ASG181_02872	95	402	307	0.930303	0.761787
Asgard_ASG183_00103	95	406	311	0.942424	0.764128
Asgard_FWG128_01969	88	416	328	0.993939	0.780952
Asgard_ASG189_00227	95	402	307	0.930303	0.761787
Asgard_ASG087_03350	95	404	309	0.936364	0.762963
Asgard_ASG036_00807	95	394	299	0.906061	0.756962
Asgard_ASG095_02987	95	406	311	0.942424	0.764128
Asgard_ASG037_01949	95	406	311	0.942424	0.764128
Asgard_ASG099_03256	95	408	313	0.948485	0.765281
Asgard_ASG322_00490	90	400	310	0.939394	0.761671
Asgard_ASG133_01214	90	408	318	0.963636	0.77561
Asgard_ASG319_00365	90	401	311	0.942424	0.767901
Asgard_ASG313_03631	94	406	312	0.945455	0.766585
Asgard_ASG031_00219	93	423	330	1	0.776471
Asgard_ASG047_01064	89	407	318	0.963636	0.779412
Asgard_ASG321_00608	89	407	318	0.963636	0.779412
Asgard_ASG317_00331	90	413	323	0.978788	0.778313
Asgard_ASG155_03734	95	402	307	0.930303	0.761787
Asgard_FWG129_03319	97	415	318	0.963636	0.731034
Asgard_ASG084_03502	95	406	311	0.942424	0.764128
Asgard_ASG131_01613	88	412	324	0.981818	0.77327
Asgard_ASG134_03506	88	412	324	0.981818	0.77327
Asgard_ASG129_00899	69	344	275	0.833333	0.799419
Asgard_ASG008_03313	95	406	311	0.942424	0.764128
Asgard_ASG308_02252	99	420	321	0.972727	0.760664
Asgard_ASG287_00305	94	401	307	0.930303	0.763682
Asgard_ASG080_00854	94	407	313	0.948485	0.765281
Asgard_ASG081_03658	95	427	332	1.00606	0.772093
Asgard_FWG169_01090	94	426	332	1.00606	0.766744
Asgard_ASG082_01486	94	406	312	0.945455	0.764706
Asgard_ASG083_01944	94	406	312	0.945455	0.764706
Asgard_ASG005_00941	93	416	323	0.978788	0.772727
Asgard_ASG012_00062	82	409	327	0.990909	0.767606
Asgard_ASG171_01112	94	426	332	1.00606	0.773893
Asgard_ASG094_00851	94	398	304	0.921212	0.76
Asgard_ASG091_04206	94	398	304	0.921212	0.758105
Asgard_ASG158_05299	94	382	288	0.872727	0.753927
Asgard_ASG293_00298	94	426	332	1.00606	0.775701
Asgard_ASG320_01689	90	405	315	0.954545	0.772059
Asgard_ASG244_05173	95	399	304	0.921212	0.758105
Asgard_ASG014_02573	90	369	279	0.845455	0.756098
Asgard_ASG092_00889	95	426	331	1.00303	0.769767
Asgard_ASG288_00267	92	403	311	0.942424	0.762255
Asgard_ASG162_00276	94	382	288	0.872727	0.753927
Asgard_ASG182_00796	95	408	313	0.948485	0.763415
Asgard_ASG258_00080	89	405	316	0.957576	0.77451
Asgard_ASG259_00655	89	405	316	0.957576	0.77451
Asgard_FWG038_00161	95	405	310	0.939394	0.759804
Asgard_ASG210_00094	92	390	298	0.90303	0.760204
Asgard_ASG268_00665	89	336	247	0.748485	0.735119
Asgard_ASG079_01812	71	359	288	0.872727	0.802228
Asgard_ASG251_01369	72	357	285	0.863636	0.793872
Asgard_ASG011_00865	76	388	312	0.945455	0.795918
Asgard_ASG123_00040	94	339	245	0.742424	0.722714
Asgard_ASG202_01423	1	173	172	0.521212	0.919786
Asgard_ASG180_01134	1	164	163	0.493939	0.987879
Asgard_ASG233_00696	1	153	152	0.460606	0.980645
Asgard_ASG173_02279	1	120	119	0.360606	0.983471
Asgard_ASG128_01808	95	267	172	0.521212	0.644195
Asgard_ASG233_00695	92	247	155	0.469697	0.625
Asgard_ASG127_01110	135	269	134	0.406061	0.498141
Asgard_ASG185_00941	1	77	76	0.230303	0.974359
Asgard_ASG172_01717	1	63	62	0.187879	0.96875
Asgard_ASG202_01469	95	177	82	0.248485	0.463277
Asgard_ASG053_01869	88	164	76	0.230303	0.463415
Asgard_ASG014_02968	1	64	63	0.190909	0.969231
Asgard_ASG287_01906	1	54	53	0.160606	0.963636
Asgard_ASG147_01075	13	74	61	0.184848	0.802632
Asgard_ASG243_02000	13	74	61	0.184848	0.802632
Asgard_ASG284_00192	169	253	84	0.254545	0.242775
Asgard_ASG208_00901	12	74	62	0.187879	0.815789
Asgard_FWG135_00484	13	75	62	0.187879	0.815789
Asgard_ASG310_02083	12	103	91	0.275758	0.491892
Asgard_ASG123_02656	706	798	92	0.278788	0.104072
Asgard_FWG137_02953	121	198	77	0.233333	0.219373
Asgard_ASG201_00082	706	769	63	0.190909	0.0706278
Asgard_ASG304_00193	2	43	41	0.124242	0.129747
Asgard_FWG128_03235	144	268	124	0.375758	0.337875
Asgard_ASG264_00455	37	94	57	0.172727	0.327586
Asgard_ASG264_00455	100	171	71	0.215152	0.408046
Asgard_ASG263_01540	235	401	166	0.50303	0.361656
Asgard_ASG263_01058	4	70	66	0.2	0.929577
Asgard_FWG001_00763	2	127	125	0.378788	0.925926
Asgard_ASG126_00657	12	93	81	0.245455	0.852632
Asgard_ASG146_01698	13	73	60	0.181818	0.789474
Asgard_ASG294_01905	700	769	69	0.209091	0.0773543
Asgard_ASG073_04585	8	123	115	0.348485	0.49569
Asgard_ASG073_04585	120	192	72	0.218182	0.310345
Asgard_ASG090_01502	94	197	103	0.312121	0.520202
Asgard_ASG312_03140	97	173	76	0.230303	0.436782
Asgard_FWG130_02296	114	189	75	0.227273	0.218659
Asgard_FWG130_01064	2	54	52	0.157576	0.597701
Asgard_ASG014_02434	5	96	91	0.275758	0.791304
Asgard_ASG157_02798	1	102	101	0.306061	0.60119
Asgard_ASG150_02320	27	120	93	0.281818	0.768595
Asgard_ASG244_02508	115	204	89	0.269697	0.253561
Asgard_FWG138_01100	65	143	78	0.236364	0.0788675
Asgard_FWG138_01100	475	567	92	0.278788	0.0930233
Asgard_ASG160_03542	34	201	167	0.506061	0.445333
Asgard_ASG310_01705	88	237	149	0.451515	0.545788
Asgard_ASG006_00431	232	397	165	0.5	0.358696
Asgard_ASG088_04456	116	199	83	0.251515	0.236467
Asgard_ASG089_03094	51	125	74	0.224242	0.43787
Asgard_FWG161_02474	643	706	63	0.190909	0.0759952
Asgard_ASG244_04930	115	204	89	0.269697	0.253561
Asgard_ASG075_03047	20	148	128	0.387879	0.589862
Asgard_ASG116_02271	119	201	82	0.248485	0.403941
Asgard_ASG127_01687	119	201	82	0.248485	0.403941
Asgard_ASG245_02924	119	201	82	0.248485	0.403941
Asgard_ASG124_00920	738	826	88	0.266667	0.0961749
Asgard_ASG303_03385	224	290	66	0.2	0.160976
Asgard_ASG123_03772	97	173	76	0.230303	0.439306
Asgard_ASG132_02355	11	71	60	0.181818	0.833333
Asgard_ASG114_00926	703	769	66	0.2	0.0739082
Asgard_ASG187_00249	5	83	78	0.236364	0.876404
Asgard_FWG037_01557	306	443	137	0.415152	0.296537
Asgard_ASG119_01862	705	769	64	0.193939	0.0718294
Asgard_ASG316_03517	43	96	53	0.160606	0.304598
Asgard_ASG316_03517	101	167	66	0.2	0.37931
Asgard_ASG304_01107	2	45	43	0.130303	0.754386
Asgard_ASG146_00422	203	291	88	0.266667	0.243767
Asgard_ASG096_01928	5	60	55	0.166667	0.436508
Asgard_ASG096_01928	63	123	60	0.181818	0.47619
Asgard_ASG188_03806	24	89	65	0.19697	0.389222
Asgard_ASG304_01486	592	654	62	0.187879	0.0796915
Asgard_ASG189_01705	5	135	130	0.393939	0.742857
Asgard_ASG012_02243	4	128	124	0.375758	0.861111
Asgard_ASG177_00946	123	196	73	0.221212	0.349282
Asgard_ASG047_00786	409	550	141	0.427273	0.254513
Asgard_ASG249_01149	707	797	90	0.272727	0.10181
Asgard_ASG320_02819	164	231	67	0.20303	0.205521
Asgard_ASG320_02819	247	317	70	0.212121	0.214724
Asgard_ASG147_00509	123	157	34	0.10303	0.194286
Asgard_ASG243_01679	123	157	34	0.10303	0.194286
GCA_003260655.2-Pla_QGKV02000832.1_i000_049475	193	508	315	0.954545	0.321101
GCA_003260655.2-Pla_QGKV02000832.1_i000_049475	597	916	319	0.966667	0.325178
GCA_016771965.1-Pla_CM028690.1_i000_016919	133	459	326	0.987879	0.304673
GCA_016771965.1-Pla_CM028690.1_i000_016919	472	809	337	1.02121	0.314953
GCA_003260695.2-Pla_QGKY02000089.1_i000_006832	131	344	213	0.645455	0.244828
GCA_003260695.2-Pla_QGKY02000089.1_i000_006832	486	806	320	0.969697	0.367816
GCA_003112345.1-Pla_PKPP01003791.1_i000_029958	143	457	314	0.951515	0.3925
GCA_003112345.1-Pla_PKPP01003791.1_i000_029958	458	699	241	0.730303	0.30125
GCA_007844105.2-Pla_CM017578.2_i000_004274	1	68	67	0.20303	0.0822086
GCA_007844105.2-Pla_CM017578.2_i000_004274	66	233	167	0.506061	0.204908
GCA_007844105.2-Pla_CM017578.2_i000_004274	377	692	315	0.954545	0.386503
GCA_018994065.1-Fun_JAFKAH010000442.1_i000_011577	226	387	161	0.487879	0.20354
GCA_018994065.1-Fun_JAFKAH010000442.1_i000_011577	484	789	305	0.924242	0.385588
GCA_001633215.2-Pla_KV774956.1_i000_005785	126	460	334	1.01212	0.503771
GCA_001633215.2-Pla_KV774956.1_i000_005785	541	659	118	0.357576	0.177979
GCA_905250025.1-Ani_CAJNOJ010000001.1_i000_000109	133	449	316	0.957576	0.572464
GCA_905250025.1-Ani_CAJNOJ010000001.1_i000_000109	444	545	101	0.306061	0.182971
GCA_905231925.1-Pro_CAJNJV010007745.1_i000_008831	9	329	320	0.969697	0.613027
GCA_905231925.1-Pro_CAJNJV010007745.1_i000_008831	371	471	100	0.30303	0.191571
STMA002.0722.00001.C001_01329	94	404	310	0.939394	0.757946
STHE001.0722.00001.C001_01186	94	406	312	0.945455	0.759124
SUSP008.0722.00001.C001_00355	91	405	314	0.951515	0.765854
ACAM001.0722.00001.C001_00372	88	405	317	0.960606	0.773171
ACHO003.0722.00001.C001_01468	88	405	317	0.960606	0.773171
GCA_900617895.1-Ani_UZAF01016764.1_i000_007820	110	357	247	0.748485	0.471374
GCA_900617895.1-Ani_UZAF01016764.1_i000_007820	354	472	118	0.357576	0.225191
PYFU002.0722.00001.C001_01814	96	409	313	0.948485	0.754217
THGO001.0722.00001.C001_01449	89	415	326	0.987879	0.759907
SACA001.0722.00001.C001_00856	91	407	316	0.957576	0.772616
THGU001.0722.00001.C001_01232	90	412	322	0.975758	0.763033
THON001.0722.00001.C001_01342	89	412	323	0.978788	0.769048
THGA001.0722.00001.C001_00481	88	412	324	0.981818	0.767773
THPE003.0722.00001.C001_00627	88	411	323	0.978788	0.758216
THEU001.0722.00001.C001_00117	89	412	323	0.978788	0.776442
THKO001.0722.00001.C001_00188	88	413	325	0.984848	0.77381
PYDE001.0722.00001.C001_00597	93	416	323	0.978788	0.770883
IGHO001.0722.00001.C001_00075	107	424	317	0.960606	0.732102
ACBR001.0722.00001.C001_02161	91	414	323	0.978788	0.77458
THPE001.0722.00001.C001_00388	97	410	313	0.948485	0.759709
THPA003.0722.00001.C001_01417	61	410	349	1.05758	0.845036
SUAC003.0722.00001.C001_01361	90	410	320	0.969697	0.776699
SUAC003.0722.00002.C001_01365	90	410	320	0.969697	0.776699
SUAC003.0722.00003.C001_01389	90	410	320	0.969697	0.776699
SUAC003.0722.00004.C001_01331	90	410	320	0.969697	0.776699
SUAC003.0722.00005.C001_01331	90	410	320	0.969697	0.776699
ACMA004.0722.00001.C001_02297	88	415	327	0.990909	0.782297
METE001.0722.00001.C001_00447	90	406	316	0.957576	0.770732
SUOH001.0722.00001.C001_01486	91	405	314	0.951515	0.767726
MESE002.0722.00001.C001_01782	90	406	316	0.957576	0.772616
MESE002.0722.00002.C001_01782	90	406	316	0.957576	0.772616
MESE002.0722.00003.C001_01782	90	406	316	0.957576	0.772616
MESE002.0722.00004.C001_01781	90	406	316	0.957576	0.772616
MESE002.0722.00005.C001_01781	90	406	316	0.957576	0.772616
MESP038.0722.00001.C001_01849	90	406	316	0.957576	0.772616
SUTO001.0722.00001.C001_01439	91	406	315	0.954545	0.768293
THSP017.0722.00001.C001_02103	89	412	323	0.978788	0.765403
THNA002.0722.00001.C001_01692	89	412	323	0.978788	0.767221
THHE001.0722.00001.C001_02043	89	412	323	0.978788	0.765403
AEPE001.0722.00001.C001_01485	99	405	306	0.927273	0.73031
ACSP061.0722.00001.C001_02821	87	405	318	0.963636	0.77561
THTH003.0722.00001.C001_01947	88	411	323	0.978788	0.763593
AECA001.0722.00001.C001_01410	100	406	306	0.927273	0.728571
THSP013.0722.00001.C001_01672	90	412	322	0.975758	0.761229
ACSU001.0722.00001.C001_01932	88	416	328	0.993939	0.784689
HYBU002.0722.00001.C001_00032	93	407	314	0.951515	0.760291
THPI001.0722.00001.C001_00454	89	412	323	0.978788	0.76
THBA002.0722.00001.C001_01505	89	411	322	0.975758	0.779661
SASH001.0722.00002.C001_02403	91	408	317	0.960606	0.767554
PYHO001.0722.00001.C001_00049	89	398	309	0.936364	0.770574
THAD001.0722.00001.C001_00561	99	415	316	0.957576	0.747045
SASO001.0722.00001.C001_01987	91	407	316	0.957576	0.76699
SASO001.0722.00002.C001_01987	91	407	316	0.957576	0.76699
SASO001.0722.00003.C001_01987	91	407	316	0.957576	0.76699
SASO001.0722.00004.C001_01942	91	407	316	0.957576	0.76699
SASO001.0722.00005.C001_01937	91	407	316	0.957576	0.76699
SASO001.0722.00006.C001_01942	91	407	316	0.957576	0.76699
SASO001.0722.00007.C001_01939	91	407	316	0.957576	0.76699
SASO001.0722.00008.C001_01938	91	407	316	0.957576	0.76699
SASO001.0722.00009.C001_01942	91	407	316	0.957576	0.76699
SASO001.0722.00010.C001_01942	91	407	316	0.957576	0.76699
SASO001.0722.00011.C001_03190	91	407	316	0.957576	0.76699
SASO001.0722.00012.C001_00998	91	407	316	0.957576	0.76699
PYSP001.0722.00001.C001_00136	90	399	309	0.936364	0.768657
THCH001.0722.00001.C001_00146	91	400	309	0.936364	0.766749
THCH001.0722.00002.C001_00141	91	400	309	0.936364	0.766749
THLI001.0722.00001.C001_02134	89	411	322	0.975758	0.777778
SUSP017.0722.00001.C001_01443	91	408	317	0.960606	0.769417
SUSP018.0722.00001.C001_02547	91	408	317	0.960606	0.769417
PYKU001.0722.00001.C001_01408	90	400	310	0.939394	0.771144
SASH001.0722.00001.C001_02412	91	408	317	0.960606	0.767554
SUIS001.0722.00001.C001_01329	92	408	316	0.957576	0.765133
SUIS001.0722.00003.C001_01356	92	408	316	0.957576	0.765133
SUIS001.0722.00004.C001_01421	92	408	316	0.957576	0.765133
IGIS001.0722.00001.C001_00679	103	425	322	0.975758	0.748837
THSP005.0722.00001.C001_00456	93	411	318	0.963636	0.766265
THPA004.0722.00001.C001_00111	88	414	326	0.987879	0.761682
THRA001.0722.00001.C001_01348	88	412	324	0.981818	0.765957
THBA001.0722.00001.C001_01467	88	416	328	0.993939	0.773585
THCA004.0722.00001.C001_01785	89	412	323	0.978788	0.763593
PYYA001.0722.00001.C001_01516	90	400	310	0.939394	0.771144
THCE001.0722.00001.C001_00934	86	412	326	0.987879	0.767059
THSP001.0722.00001.C001_01818	90	412	322	0.975758	0.757647
STSP138.0722.00001.C001_02446	90	405	315	0.954545	0.773956
THAC003.0722.00001.C001_02198	90	412	322	0.975758	0.757647
THCL001.0722.00001.C001_01461	89	416	327	0.990909	0.771226
PYSP002.0722.00001.C001_00602	89	396	307	0.930303	0.771357
STAZ001.0722.00001.C001_00880	90	407	317	0.960606	0.775061
SUIS001.0722.00002.C001_01314	92	408	316	0.957576	0.765133
THPR002.0722.00001.C001_01998	89	414	325	0.984848	0.757576
THIN004.0722.00001.C001_02173	90	412	322	0.975758	0.759434
INUZ001.0722.00001.C001_01667	96	407	311	0.942424	0.758537
INLU001.0722.00001.C001_01135	97	407	310	0.939394	0.757946
PYFU001.0722.00001.C001_01600	88	399	311	0.942424	0.773632
PYFU001.0722.00002.C001_00045	88	399	311	0.942424	0.773632
THSI003.0722.00001.C001_00145	89	419	330	1	0.778302
THCA001.0722.00001.C001_00057	94	401	307	0.930303	0.761787
GCA_000715545.1-Ani_KL596796.1_i000_009507	59	335	276	0.836364	0.30838
GCA_000715545.1-Ani_KL596796.1_i000_009507	361	498	137	0.415152	0.153073
MEHA003.0722.00001.C001_02023	90	404	314	0.951515	0.769608
DEAM001.0722.00001.C001_00794	94	400	306	0.927273	0.753695
THSP032.0722.00001.C001_01431	83	408	325	0.984848	0.792683
THSP010.0722.00002.C001_01037	90	412	322	0.975758	0.777778
MEKA001.0722.00001.C001_00605	91	406	315	0.954545	0.753589
PYAB001.0722.00001.C001_00067	88	402	314	0.951515	0.777228
GCA_014871385.1-Pla_CM026433.1_i000_029980	125	457	332	1.00606	0.571429
GCA_014871845.1-Pla_CM026445.1_i000_029117	125	457	332	1.00606	0.571429
THSP010.0722.00001.C001_01040	90	412	322	0.975758	0.777778
THAG001.0722.00001.C001_00164	94	400	306	0.927273	0.757426
GCA_002245835.2-Pla_LHPG02000021.1_i000_004586	119	276	157	0.475758	0.299048
GCA_002245835.2-Pla_LHPG02000021.1_i000_004586	280	496	216	0.654545	0.411429
PAPA004.0722.00001.C001_00956	90	416	326	0.987879	0.767059
GCA_003614755.1-Fun_KZ989510.1_i000_002200	127	462	335	1.01515	0.672691
GCA_015679545.1-Fun_JAAAUZ010000340.1_i000_004647	130	455	325	0.984848	0.64741
GCA_000002425.2-Pla_CM009331.1_i000_020448	125	462	337	1.02121	0.571186
GCA_002127325.2-Pla_CM007905.2_i000_061569	134	460	326	0.987879	0.601476
GCA_003704095.1-Ani_RCHS01001528.1_i000_003342	115	445	330	1	0.649606
GCA_905397405.1-Ani_CAJPVJ010000897.1_i000_003165	118	317	199	0.60303	0.426124
GCA_905397405.1-Ani_CAJPVJ010000897.1_i000_003165	312	428	116	0.351515	0.248394
THSI001.0722.00001.C001_00801	88	411	323	0.978788	0.780193
GCA_001531365.1-Pla_CM009734.1_i000_006343	128	460	332	1.00606	0.6171
GCA_000739165.1-Fun_KN042423.1_i000_008074	128	456	328	0.993939	0.657315
GCA_003614735.1-Fun_KZ992562.1_i000_002347	123	449	326	0.987879	0.655936
GCA_015849335.1-Fun_JAAAIC010000583.1_i000_008473	135	455	320	0.969697	0.638723
GCA_015679695.1-Fun_JAAAVD010001529.1_i000_002408	132	456	324	0.981818	0.658537
CALA001.0722.00001.C001_00321	93	408	315	0.954545	0.764563
GCA_015502575.1-Fun_JAAAUR010001442.1_i000_002065	142	465	323	0.978788	0.644711
GCA_016098005.1-Fun_JAAAIS010000023.1_i000_004332	128	453	325	0.984848	0.651303
GCA_000739165.1-Fun_KN042421.1_i000_006231	130	454	324	0.981818	0.651911
GCA_015500005.1-Fun_JAAAUG010000481.1_i000_007555	132	457	325	0.984848	0.648703
GCA_015852495.1-Fun_JAAAIK010000138.1_i000_001746	130	457	327	0.990909	0.655311
GCA_002127325.2-Pla_CM007898.2_i000_034933	127	465	338	1.02424	0.624769
GCA_015529795.1-Fun_JAAAUH010000913.1_i000_010420	135	456	321	0.972727	0.640719
ACSP005.0722.00001.C001_01568	100	411	311	0.942424	0.742243
DEMU001.0722.00001.C001_00881	94	402	308	0.933333	0.758621
GCA_015679535.1-Fun_JAAAUX010000119.1_i000_000876	132	456	324	0.981818	0.653226
GCA_009363875.1-Pla_CM018690.1_i000_041095	120	462	342	1.03636	0.629834
GCA_016758905.1-Fun_JAEPQZ010000008.1_i000_007787	125	457	332	1.00606	0.51633
GCA_015852385.1-Fun_JAAAIE010000708.1_i000_009759	134	451	317	0.960606	0.653608
GCA_009363875.1-Pla_CM018690.1_i000_041082	127	463	336	1.01818	0.623377
FEFO001.0722.00001.C001_01216	93	419	326	0.987879	0.770686
GCA_015499975.1-Fun_JAAAUD010000157.1_i000_002441	138	460	322	0.975758	0.642715
GCA_015679485.1-Fun_JAAAUY010000070.1_i000_009426	131	453	322	0.975758	0.645291
GCA_015679595.1-Fun_JAAAVB010001372.1_i000_001942	133	456	323	0.978788	0.649899
GCA_015679535.1-Fun_JAAAUX010000004.1_i000_006861	130	453	323	0.978788	0.660532
GCA_015852425.1-Fun_JAAAIG010000421.1_i000_007213	132	456	324	0.981818	0.670807
GCA_015680655.1-Fun_JAABKD010000010.1_i000_000129	133	455	322	0.975758	0.638889
GCA_015679405.1-Fun_JAAAUU010000008.1_i000_010535	240	563	323	0.978788	0.539232
GCA_902860255.1-Pla_LR794324.1_i000_007787	140	462	322	0.975758	0.604128
GCA_015852385.1-Fun_JAAAIE010000239.1_i000_004428	132	456	324	0.981818	0.657201
ACSA002.0722.00001.C001_01354	95	404	309	0.936364	0.746377
GCA_004329165.1-Pla_QUWT01000781.1_i000_030570	122	460	338	1.02424	0.610108
GCA_002127325.2-Pla_CM007894.2_i000_019256	133	460	327	0.990909	0.608939
GCA_015847185.1-Fun_JAAAHX010000640.1_i000_008880	125	451	326	0.987879	0.661258
GCA_015849325.1-Fun_JAAAIB010000055.1_i000_007540	128	454	326	0.987879	0.657258
GCA_019788775.1-Fun_JAIFTL010000131.1_i000_001126	128	454	326	0.987879	0.657258
GCA_019671135.1-Fun_JAHRHY010000008.1_i000_011691	131	454	323	0.978788	0.657841
GCA_018446385.1-Pla_CM031521.1_i000_050230	127	457	330	1	0.570934
GCA_015502455.1-Fun_JAAAUM010000060.1_i000_008928	135	456	321	0.972727	0.642
GCA_015680625.1-Fun_JAAAXW010000007.1_i000_010639	129	454	325	0.984848	0.670103
SUTE001.0722.00002.C001_01026	90	418	328	0.993939	0.748858
GCA_003614735.1-Fun_KZ992546.1_i000_002167	133	442	309	0.936364	0.611881
SUTE001.0722.00001.C001_00980	90	418	328	0.993939	0.748858
GCA_002870075.2-Pla_CM022518.1_i000_000967	131	459	328	0.993939	0.614232
GCA_015849285.1-Fun_JAAAHZ010000367.1_i000_005721	131	454	323	0.978788	0.65121
GCA_015502445.1-Fun_JAAAUN010000317.1_i000_005977	127	448	321	0.972727	0.655102
GCA_002261195.1-Fun_MVBO01000035.1_i000_003562	125	453	328	0.993939	0.398542
GCA_015852435.1-Fun_JAAAIJ010000744.1_i000_010242	129	457	328	0.993939	0.665314
GCA_015680655.1-Fun_JAABKD010000240.1_i000_004297	128	455	327	0.990909	0.667347
GCA_000708835.1-Pla_DF236966.1_i000_014890	125	459	334	1.01212	0.629002
GCA_020891255.1-Fun_BQFW01000003.1_i000_002591	135	456	321	0.972727	0.661856
GCA_019671135.1-Fun_JAHRHY010000002.1_i000_005589	128	456	328	0.993939	0.672131
GCA_000510995.2-Pla_KQ152610.1_i000_011454	127	457	330	1	0.596745
GCA_015679515.1-Fun_JAAAVA010002323.1_i000_010995	187	519	332	1.00606	0.57539
GCA_015502445.1-Fun_JAAAUN010000490.1_i000_008080	127	457	330	1	0.674847
GCA_009733165.1-Ani_CM019151.1_i000_010764	124	452	328	0.993939	0.65996
GCA_000315625.1-Pro_JH993025.1_i000_014343	123	461	338	1.02424	0.699793
GCA_016097935.1-Fun_JAAAIP010000505.1_i000_007097	129	457	328	0.993939	0.666667
GCA_902860255.1-Pla_LR794327.1_i000_020248	128	459	331	1.00303	0.6141
GCA_015502455.1-Fun_JAAAUM010000629.1_i000_009133	129	455	326	0.987879	0.649402
GCA_013399555.1-Ani_VZZV01001644.1_i000_003116	54	391	337	1.02121	0.732609
GCA_013400935.1-Ani_VZTY01017724.1_i000_006400	53	387	334	1.01212	0.695833
GCA_018859375.1-Ani_JAHGAV010000159.1_i000_011284	122	455	333	1.00909	0.627119
GCA_020497155.1-Pla_CM035713.1_i000_018523	125	461	336	1.01818	0.48
GCA_016984175.1-Ani_JAAWVO010039273.1_i000_006950	164	474	310	0.939394	0.651261
GCA_910591765.1-Fun_CAJVPS010015411.1_i000_011042	129	459	330	1	0.669371
GCA_018446385.1-Pla_CM031520.1_i000_046330	128	458	330	1	0.508475
GCA_000004515.5-Pla_CM000840.4_i000_016670	124	464	340	1.0303	0.615942
GCA_000722935.2-Pla_KN643148.1_i000_004532	124	464	340	1.0303	0.615942
GCA_004193775.2-Pla_CM014363.1_i000_017439	124	464	340	1.0303	0.615942
GCA_014282095.1-Pla_CM024919.1_i000_018535	124	464	340	1.0303	0.615942
GCA_012273815.2-Pla_CM022565.2_i000_017960	125	464	339	1.02727	0.61413
GCA_015502505.1-Fun_JAAAUQ010001021.1_i000_000170	131	458	327	0.990909	0.674227
GCA_015679585.1-Fun_JAAAVF010002239.1_i000_004452	131	458	327	0.990909	0.659274
GCA_015500005.1-Fun_JAAAUG010000591.1_i000_008388	132	453	321	0.972727	0.642
GCA_015529795.1-Fun_JAAAUH010000141.1_i000_001826	132	453	321	0.972727	0.642
GCA_016097865.1-Fun_JAAAIN010000978.1_i000_006437	191	517	326	0.987879	0.598165
GCA_016098035.1-Fun_JAAAIV010000054.1_i000_007538	130	458	328	0.993939	0.66129
GCA_015847185.1-Fun_JAAAHX010000785.1_i000_009732	47	376	329	0.99697	0.798544
GCA_013396935.1-Ani_VWZK01000006.1_i000_000009	54	387	333	1.00909	0.69958
GCA_015502565.1-Fun_JAAAUS010000075.1_i000_008614	123	453	330	1	0.67623
GCA_016098155.1-Fun_JAAAJB010000025.1_i000_003519	123	453	330	1	0.67623
GCA_000612305.1-Pla_KK198763.1_i000_034143	127	460	333	1.00909	0.6
GCA_015679425.1-Fun_JAAAUV010001515.1_i000_002708	131	455	324	0.981818	0.668041
GCA_016098015.1-Fun_JAAAIT010000174.1_i000_002845	1	290	289	0.875758	0.889231
GCA_004798865.1-Ani_SJPD01000002.1_i000_006000	178	510	332	1.00606	0.560811
GCA_002105155.1-Fun_MCFF01000030.1_i000_005829	128	455	327	0.990909	0.650099
GCA_015847225.1-Fun_JAAAHT010000512.1_i000_003829	128	455	327	0.990909	0.650099
GCA_014282345.1-Pla_CM024974.1_i000_018001	157	496	339	1.02727	0.580479
GCA_014282035.1-Pla_CM024839.1_i000_006697	157	496	339	1.02727	0.579487
GCA_013397725.1-Ani_VZTD01001451.1_i000_002728	57	387	330	1	0.816832
GCA_013399455.1-Ani_VWYI01006412.1_i000_001814	60	389	329	0.99697	0.679752
GCA_020744185.1-Fun_JAGSXK010000014.1_i000_003562	130	453	323	0.978788	0.659184
GCA_014282145.1-Pla_CM024939.1_i000_018132	158	496	338	1.02424	0.577778
GCA_002197715.1-Ani_MUZQ01000149.1_i000_002538	31	361	330	1	0.728477
GCA_013400235.1-Ani_VXBT01004127.1_i000_004007	53	387	334	1.01212	0.713675
GCA_017552425.1-Pla_CM029800.1_i000_004116	125	460	335	1.01515	0.605787
GCA_013399475.1-Ani_VXAL01020572.1_i000_013027	54	386	332	1.00606	0.718615
GCA_016097945.1-Fun_JAAAIR010000001.1_i000_000011	169	495	326	0.987879	0.612782
GCA_001651415.1-Fun_KV442014.1_i000_001324	135	454	319	0.966667	0.645749
GCA_003112345.1-Pla_PKPP01004048.1_i000_031175	136	459	323	0.978788	0.604869
GCA_003112345.1-Pla_PKPP01005822.1_i000_038377	136	459	323	0.978788	0.604869
GCA_010080465.1-Ani_VULD01012471.1_i000_010217	6	333	327	0.990909	0.787952
GCA_013399755.1-Ani_VZTK01018589.1_i000_007922	53	388	335	1.01515	0.721983
GCA_021442195.1-Pla_CM038197.1_i000_006480	128	453	325	0.984848	0.547138
GCA_020536995.1-Ani_CM035924.1_i000_137299	115	446	331	1.00303	0.629278
GCA_013398555.1-Ani_VZSQ01000039.1_i000_003757	55	385	330	1	0.715835
GCA_016984135.1-Ani_JAAWVN010010170.1_i000_001998	100	424	324	0.981818	0.589091
GCA_013398475.1-Ani_VZSO01008843.1_i000_012386	55	386	331	1.00303	0.7103
GCA_017552425.1-Pla_CM029810.1_i000_021541	125	460	335	1.01515	0.604693
GCA_020744185.1-Fun_JAGSXK010000003.1_i000_008862	123	447	324	0.981818	0.677824
GCA_002870075.2-Pla_MU042616.1_i000_038098	128	459	331	1.00303	0.6141
GCA_003942145.1-Ani_QXTE01000420.1_i000_018151	126	461	335	1.01515	0.625
GCA_013399215.1-Ani_VXAF01001158.1_i000_000366	54	388	334	1.01212	0.715203
GCA_001651415.1-Fun_KV442072.1_i000_010918	128	457	329	0.99697	0.67418
GCA_021904315.1-Pla_CM038910.1_i000_006348	128	453	325	0.984848	0.546218
GCA_013398915.1-Ani_VYZM01004279.1_i000_002230	48	380	332	1.00606	0.707889
GCA_013399355.1-Ani_VXAJ01000986.1_i000_014089	54	386	332	1.00606	0.696017
GCA_003614705.1-Fun_KZ994111.1_i000_001057	133	457	324	0.981818	0.645418
GCA_021235465.1-Fun_JAJSME010000015.1_i000_002635	131	455	324	0.981818	0.657201
GCA_014058105.1-Pla_JACGCM010001129.1_i000_003844	124	459	335	1.01515	0.612431
GCA_013389845.1-Ani_VWPX01013435.1_i000_008858	54	364	310	0.939394	0.851648
GCA_014851425.1-Pla_CM026262.1_i000_006674	130	459	329	0.99697	0.596014
GCA_003990785.1-Fun_RBNK01007040.1_i000_007765	125	457	332	1.00606	0.638462
GCA_013399115.1-Ani_VXAA01004774.1_i000_009032	55	387	332	1.00606	0.713978
GCA_013397975.1-Ani_VZRQ01000068.1_i000_000087	55	388	333	1.00909	0.845178
GCA_013397155.1-Ani_VWZV01010241.1_i000_007874	57	386	329	0.99697	0.814356
GCA_020891255.1-Fun_BQFW01000005.1_i000_003727	130	456	326	0.987879	0.673554
GCA_013399135.1-Ani_VXBZ01007979.1_i000_008098	54	392	338	1.02424	0.714588
GCA_001865875.1-Pla_CM007361.1_i000_001890	128	463	335	1.01515	0.62037
GCA_013399655.1-Ani_VXAS01023220.1_i000_013421	53	386	333	1.00909	0.692308
GCA_013399435.1-Ani_VXAK01002383.1_i000_001112	54	386	332	1.00606	0.690229
GCA_013399335.1-Ani_VZZT01009338.1_i000_013222	53	386	333	1.00909	0.708511
GCA_016098015.1-Fun_JAAAIT010000563.1_i000_007925	128	454	326	0.987879	0.655936
GCA_015849275.1-Fun_JAAAIA010000331.1_i000_004465	137	448	311	0.942424	0.628283
GCA_013400315.1-Ani_VXBU01016673.1_i000_011818	54	386	332	1.00606	0.693111
GCA_006535985.1-Fun_QEAO01000017.1_i000_003307	125	456	331	1.00303	0.64902
GCA_013397375.1-Ani_VXBI01001115.1_i000_000934	55	377	322	0.975758	0.851852
GCA_016097855.1-Fun_JAAAIM010000369.1_i000_007195	126	455	329	0.99697	0.676955
GCA_013389965.1-Ani_WEIS01080820.1_i000_007580	54	387	333	1.00909	0.69958
GCA_013399015.1-Ani_VWZX01010411.1_i000_013225	54	386	332	1.00606	0.691667
GCA_003573695.1-Pla_CM010719.1_i000_017292	128	458	330	1	0.611111
GCA_013396505.1-Ani_VZRC01001240.1_i000_001474	54	386	332	1.00606	0.696017
GCA_015731905.1-Pla_CM027673.1_i000_022752	173	497	324	0.981818	0.549153
GCA_013398795.1-Ani_WBNG01001737.1_i000_012168	60	386	326	0.987879	0.673554
GCA_013396415.1-Ani_VWPT01000470.1_i000_009874	55	387	332	1.00606	0.715517
GCA_003024255.1-Pla_CM009679.1_i000_029205	126	459	333	1.00909	0.592527
GCA_013400035.1-Ani_VXBH01002016.1_i000_002970	55	386	331	1.00303	0.699789
GCA_013186435.1-Ani_PYHW01010656.1_i000_014390	123	456	333	1.00909	0.604356
GCA_013396615.1-Ani_VWZA01004294.1_i000_013103	53	388	335	1.01515	0.721983
GCA_013400295.1-Ani_WAAC01005225.1_i000_003007	70	391	321	0.972727	0.657787
GCA_001865875.1-Pla_CM007372.1_i000_019233	126	462	336	1.01818	0.616514
GCA_020497125.1-Ani_CM035637.1_i000_009358	123	456	333	1.00909	0.53451
GCA_016097885.1-Fun_JAAAIO010000807.1_i000_009431	126	453	327	0.990909	0.664634
GCA_020497125.1-Ani_CM035637.1_i000_009344	124	456	332	1.00606	0.532905
GCA_013401015.1-Ani_VZUC01000089.1_i000_008213	56	385	329	0.99697	0.681159
GCA_013398245.1-Ani_VZSD01007662.1_i000_005769	55	387	332	1.00606	0.696017
GCA_016097935.1-Fun_JAAAIP010000043.1_i000_006316	138	468	330	1	0.657371
GCA_010076225.1-Ani_VUKV01005381.1_i000_006161	54	386	332	1.00606	0.709402
GCA_014851425.1-Pla_CM026263.1_i000_008824	159	485	326	0.987879	0.567944
GCA_013401115.1-Ani_VZUG01035853.1_i000_012290	54	388	334	1.01212	0.710638
GCA_018320845.1-Ani_CM031334.1_i000_022943	125	460	335	1.01515	0.564924
GCA_009771035.1-Pla_CM020005.1_i000_011697	127	462	335	1.01515	0.609091
GCA_010261695.1-Pla_CM021009.1_i000_023897	127	462	335	1.01515	0.609091
GCA_015852605.2-Pla_CM027584.2_i000_025632	130	460	330	1	0.596745
GCA_010076325.1-Ani_VUKW01001545.1_i000_002094	54	386	332	1.00606	0.709402
GCA_019857665.1-Ani_WNTK01008177.1_i000_020733	121	452	331	1.00303	0.62218
GCA_010082375.1-Ani_VULI01002180.1_i000_001704	54	387	333	1.00909	0.711538
GCA_015731905.1-Pla_CM027670.1_i000_019029	224	558	334	1.01212	0.517028
GCA_003990765.1-Fun_RBNJ01002733.1_i000_003828	123	457	334	1.01212	0.639847
GCA_000182565.2-Fun_KQ257450.1_i000_000333	130	455	325	0.984848	0.634766
GCA_006535965.1-Fun_QEAR01000025.1_i000_003873	135	456	321	0.972727	0.629412
GCA_003614755.1-Fun_KZ989902.1_i000_003265	119	448	329	0.99697	0.659319
GCA_003692655.1-Ani_QRBI01000105.1_i000_006861	125	454	329	0.99697	0.598182
GCA_013396975.1-Ani_VWZO01014668.1_i000_009058	53	386	333	1.00909	0.695198
GCA_000340665.1-Pla_CM003608.1_i000_009987	122	460	338	1.02424	0.622468
GCA_000511025.2-Pla_CM002325.2_i000_010953	125	459	334	1.01212	0.643545
GCA_019788775.1-Fun_JAIFTL010000015.1_i000_001604	150	479	329	0.99697	0.645098
GCA_013401065.1-Ani_VZUD01000029.1_i000_003422	55	386	331	1.00303	0.69392
GCA_002174775.1-Pla_MVGT01000779.1_i000_002974	127	459	332	1.00606	0.604736
GCA_019669825.1-Fun_MU253914.1_i000_005026	140	461	321	0.972727	0.624514
GCA_013400795.1-Ani_VZTS01007716.1_i000_003452	55	386	331	1.00303	0.686722
GCA_013396915.1-Ani_VWZL01003872.1_i000_008392	54	387	333	1.00909	0.695198
GCA_018804465.1-Pla_CM031996.1_i000_013742	129	461	332	1.00606	0.638462
GCA_013398335.1-Ani_VZSH01000544.1_i000_010935	54	387	333	1.00909	0.707006
GCA_013400755.1-Ani_VZTQ01002941.1_i000_002721	54	389	335	1.01515	0.718884
GCA_016098105.1-Fun_JAAAIY010000218.1_i000_003066	124	459	335	1.01515	0.685072
GCA_016098135.1-Fun_JAAAIZ010000104.1_i000_000267	124	459	335	1.01515	0.685072
GCA_010085355.1-Ani_VULL01001874.1_i000_012311	55	387	332	1.00606	0.707889
GCA_010080425.1-Ani_VULF01007608.1_i000_006901	55	387	332	1.00606	0.707889
GCA_013397175.1-Ani_VYXC01000717.1_i000_000483	56	388	332	1.00606	0.84264
GCA_013400015.1-Ani_VXBG01015871.1_i000_012153	53	387	334	1.01212	0.721382
GCA_016098035.1-Fun_JAAAIV010000353.1_i000_005387	132	455	323	0.978788	0.670124
GCA_013400135.1-Ani_VXBO01006303.1_i000_005524	54	382	328	0.993939	0.700855
GCA_013397015.1-Ani_VWZQ01004206.1_i000_004023	56	389	333	1.00909	0.704017
GCA_013401055.1-Ani_VZUE01000006.1_i000_000463	54	387	333	1.00909	0.69958
GCA_013398195.1-Ani_VZSB01003474.1_i000_010187	56	387	331	1.00303	0.718004
GCA_001865875.1-Pla_CM007361.1_i000_001412	127	461	334	1.01212	0.611722
GCA_013397915.1-Ani_VZRO01006245.1_i000_009978	57	385	328	0.993939	0.696391
GCA_003573695.1-Pla_CM010721.1_i000_026643	126	461	335	1.01515	0.632075
GCA_015143295.1-Pla_CM026573.1_i000_028796	142	457	315	0.954545	0.570652
GCA_004329165.1-Pla_CM014734.1_i000_019461	126	460	334	1.01212	0.602888
GCA_013398035.1-Ani_VZRT01009222.1_i000_012102	60	385	325	0.984848	0.678497
GCA_013400275.1-Ani_VWYO01017904.1_i000_008654	58	386	328	0.993939	0.69936
GCA_013400735.1-Ani_VYZT01043122.1_i000_008662	59	386	327	0.990909	0.697228
GCA_013396675.1-Ani_VWZE01018308.1_i000_009822	53	383	330	1	0.684647
GCA_004837865.1-Pla_CM017196.1_i000_025187	128	460	332	1.00606	0.594982
GCA_005059845.1-Fun_NAJN01001336.1_i000_001990	135	464	329	0.99697	0.612663
GCA_013400375.1-Ani_VXBW01004873.1_i000_007732	55	385	330	1	0.693277
GCA_017552425.1-Pla_CM029813.1_i000_025655	128	459	331	1.00303	0.601818
GCA_009771035.1-Pla_CM020011.1_i000_020889	126	463	337	1.02121	0.626394
GCA_010261695.1-Pla_CM021002.1_i000_012088	126	463	337	1.02121	0.626394
GCA_013397295.1-Ani_VYXF01005679.1_i000_006089	9	330	321	0.972727	0.83812
GCA_013389845.1-Ani_VWPX01013435.1_i000_008859	54	387	333	1.00909	0.69958
GCA_013399495.1-Ani_VXAM01001555.1_i000_012983	55	387	332	1.00606	0.706383
GCA_004119895.1-Ani_SCEB01005903.1_i000_009552	125	459	334	1.01212	0.601802
GCA_000710275.1-Fun_CM002798.1_i000_001818	130	456	326	0.987879	0.635478
GCA_011058885.1-Fun_SWKS01000015.1_i000_002659	130	456	326	0.987879	0.635478
GCA_000004195.4-Ani_CM004443.2_i000_000023	123	454	331	1.00303	0.617537
GCA_013398225.1-Ani_VZSC01000688.1_i000_000654	54	386	332	1.00606	0.707889
GCA_011766145.1-Pla_BLLF01000053.1_i000_001211	125	455	330	1	0.662651
GCA_013399225.1-Ani_VXAC01001309.1_i000_002336	55	358	303	0.918182	0.846369
GCA_013399875.1-Ani_VXAZ01010495.1_i000_014081	57	385	328	0.993939	0.700855
GCA_013398435.1-Ani_VZSL01000014.1_i000_001602	53	386	333	1.00909	0.705508
GCA_013400575.1-Ani_WBNO01033415.1_i000_013434	62	386	324	0.981818	0.695279
GCA_020875875.1-Pla_CM037017.1_i000_008893	133	458	325	0.984848	0.574205
GCA_013398975.1-Ani_VWYD01021031.1_i000_009228	53	387	334	1.01212	0.698745
GCA_013398745.1-Ani_VZSY01000696.1_i000_009270	58	386	328	0.993939	0.689076
GCA_013397275.1-Ani_VYXH01012473.1_i000_013444	54	386	332	1.00606	0.687371
GCA_013399055.1-Ani_WBNM01001946.1_i000_000513	54	384	330	1	0.68323
GCA_014898295.1-Fun_RCSW01000022.1_i000_009523	139	464	325	0.984848	0.633528
GCA_900079185.1-Fun_LT554895.1_i000_010468	129	457	328	0.993939	0.66129
GCA_002994745.2-Pla_CM009588.1_i000_040165	130	460	330	1	0.6
GCA_015499985.1-Fun_JAAAUF010000038.1_i000_006578	814	1143	329	0.99697	0.280477
GCA_004786205.1-Fun_PQXM01000565.1_i000_009212	141	463	322	0.975758	0.62768
GCA_014898485.1-Fun_RCTC01000002.1_i000_001894	141	463	322	0.975758	0.62768
GCA_014898535.1-Fun_RCSX01000029.1_i000_009580	141	463	322	0.975758	0.62768
GCA_014898555.1-Fun_RCSY01000028.1_i000_007385	141	463	322	0.975758	0.62768
GCA_010085335.1-Ani_VULH01025065.1_i000_007708	55	387	332	1.00606	0.707889
GCA_013397775.1-Ani_VZTE01005230.1_i000_011234	62	387	325	0.984848	0.697425
GCA_000002775.3-Pla_CM009304.1_i000_034238	130	460	330	1	0.596745
GCA_007726485.1-Pla_CM017443.1_i000_024195	125	460	335	1.01515	0.616943
GCA_000143535.4-Fun_CP009806.1_i000_002022	144	461	317	0.960606	0.621569
GCA_019044685.2-Pla_JAGTXX020000006.1_i000_003369	120	458	338	1.02424	0.696907
GCA_019044685.2-Pla_JAGTXX020000013.1_i000_007198	120	458	338	1.02424	0.696907
GCA_019202925.1-Pla_JAHPZM010000016.1_i000_007432	120	458	338	1.02424	0.696907
GCA_013396835.1-Ani_VWZI01017907.1_i000_009885	53	380	327	0.990909	0.692797
GCA_004786275.1-Fun_PQXN01000295.1_i000_010362	144	463	319	0.966667	0.621832
GCA_000227075.1-Fun_FQ790256.1_i000_001419	144	463	319	0.966667	0.621832
GCA_000349525.1-Fun_KB707850.1_i000_004695	144	463	319	0.966667	0.621832
GCA_004786125.1-Fun_PQXH01000089.1_i000_006985	144	463	319	0.966667	0.621832
GCA_004786145.1-Fun_PQXI01000085.1_i000_006192	144	463	319	0.966667	0.621832
GCA_004786225.1-Fun_PQXJ01000012.1_i000_000805	144	463	319	0.966667	0.621832
GCA_004786245.1-Fun_PQXK01000012.1_i000_001388	144	463	319	0.966667	0.621832
GCA_004916875.1-Fun_PQXL01000262.1_i000_007852	144	463	319	0.966667	0.621832
GCA_013461495.1-Fun_JABFCT010000004.1_i000_003843	144	463	319	0.966667	0.621832
GCA_014898285.1-Fun_RCSV01000016.1_i000_011408	144	463	319	0.966667	0.621832
GCA_014898425.1-Fun_RCSZ01000018.1_i000_011484	144	463	319	0.966667	0.621832
GCA_014898465.1-Fun_RCTA01000002.1_i000_001207	144	463	319	0.966667	0.621832
GCA_013396895.1-Ani_VWZM01017277.1_i000_013762	56	385	329	0.99697	0.701493
GCA_015529505.1-Fun_JAAAUI010000427.1_i000_006221	125	453	328	0.993939	0.672131
GCA_015529515.1-Fun_JAAAUJ010000015.1_i000_001629	125	453	328	0.993939	0.672131
GCA_013400435.1-Ani_VWYP01023119.1_i000_008815	56	386	330	1	0.686071
GCA_000151685.2-Pla_EQ973773.1_i000_030072	132	460	328	0.993939	0.587814
GCA_013396365.1-Ani_VWPP01001457.1_i000_002523	57	386	329	0.99697	0.685417
GCA_016758895.1-Fun_JAEPRA010000004.1_i000_005883	129	459	330	1	0.483871
GCA_002335675.1-Pla_BEGY01000179.1_i000_012964	76	414	338	1.02424	0.7806
GCA_014898435.1-Fun_RCTB01000027.1_i000_010816	141	463	322	0.975758	0.62768
GCA_900079185.1-Fun_LT554760.1_i000_009253	165	485	320	0.969697	0.613027
GCA_016097895.1-Fun_JAAAIL010000152.1_i000_002035	128	457	329	0.99697	0.679752
GCA_004379285.1-Fun_PHWZ01000019.1_i000_001139	144	464	320	0.969697	0.623782
GCA_013400075.1-Ani_VWYN01003357.1_i000_001652	53	387	334	1.01212	0.712154
GCA_013400635.1-Ani_VYZP01034525.1_i000_005176	57	386	329	0.99697	0.701493
GCA_002072365.1-Fun_MLQL01000009.1_i000_003756	130	459	329	0.99697	0.641326
GCA_014362265.1-Pla_BJWL01000026.1_i000_037217	126	459	333	1.00909	0.592527
GCA_013397395.1-Ani_VXBN01003038.1_i000_002155	53	386	333	1.00909	0.716129
GCA_014858505.1-Pla_CM026419.1_i000_026330	128	461	333	1.00909	0.6
GCA_013397235.1-Ani_VYXG01002353.1_i000_002743	56	385	329	0.99697	0.702991
GCA_015847235.1-Fun_JAAAHU010000141.1_i000_001822	207	527	320	0.969697	0.573477
GCA_019176425.1-Ani_CM032878.1_i000_005797	124	453	329	0.99697	0.533225
GCA_013397935.1-Ani_VZRN01006269.1_i000_012880	59	389	330	1	0.699153
GCA_013398775.1-Ani_VZSX01000316.1_i000_007716	55	387	332	1.00606	0.712446
GCA_013397845.1-Ani_VZTG01009635.1_i000_012543	58	388	330	1	0.706638
GCA_011114355.1-Pla_CM022097.1_i000_016572	126	461	335	1.01515	0.63327
GCA_005239225.1-Pla_RCHU01000353.1_i000_017569	129	461	332	1.00606	0.600362
GCA_018804465.1-Pla_CM031997.1_i000_014790	129	461	332	1.00606	0.600362
GCA_013398275.1-Ani_VZSE01012720.1_i000_011406	60	385	325	0.984848	0.672878
GCA_013397075.1-Ani_VWZS01007276.1_i000_009342	59	386	327	0.990909	0.678423
GCA_013397795.1-Ani_VZTJ01005567.1_i000_011405	53	384	331	1.00303	0.698312
GCA_013398075.1-Ani_VZRX01003196.1_i000_001746	6	304	298	0.90303	0.980263
GCA_002104945.1-Fun_MCFH01000012.1_i000_001183	116	442	326	0.987879	0.654618
GCA_015847235.1-Fun_JAAAHU010000402.1_i000_007506	132	453	321	0.972727	0.663223
GCA_905250045.1-Ani_CAJNOG010001477.1_i000_040240	112	425	313	0.948485	0.595057
GCA_905250045.1-Ani_CAJNOG010001477.1_i000_040240	417	502	85	0.257576	0.161597
GCA_013400555.1-Ani_VZTM01025371.1_i000_007851	53	386	333	1.00909	0.690871
GCA_013397215.1-Ani_VYXE01012812.1_i000_007338	59	384	325	0.984848	0.692964
GCA_002029285.1-Ani_LSYS01001717.1_i000_002668	93	419	326	0.987879	0.623327
GCA_013399535.1-Ani_VZZW01002005.1_i000_010476	55	388	333	1.00909	0.689441
GCA_016413885.1-Pla_CM028177.1_i000_024721	128	462	334	1.01212	0.603978
GCA_002157105.1-Fun_KZ150985.1_i000_009381	115	447	332	1.00606	0.726477
GCA_013389925.1-Ani_WEIU01023497.1_i000_012344	57	387	330	1	0.688935
GCA_001876935.1-Pla_CM007385.1_i000_011558	129	457	328	0.993939	0.587814
GCA_004786265.1-Fun_PQXO01000142.1_i000_003810	144	463	319	0.966667	0.621832
GCA_003573695.1-Pla_CM010722.1_i000_031309	127	460	333	1.00909	0.623596
GCA_013399035.1-Ani_VWYF01003535.1_i000_001231	57	388	331	1.00303	0.678279
GCA_009771035.1-Pla_CM020010.1_i000_019464	127	461	334	1.01212	0.620818
GCA_010261695.1-Pla_CM021014.1_i000_032347	127	461	334	1.01212	0.620818
GCA_013399195.1-Ani_VXAD01001640.1_i000_001522	61	387	326	0.987879	0.692144
GCA_013397435.1-Ani_VZRG01003012.1_i000_010734	58	383	325	0.984848	0.691489
GCA_005549215.1-Pla_SSTE01006842.1_i000_009961	128	460	332	1.00606	0.459198
GCA_005549225.1-Pla_SSTD01018043.1_i000_033161	128	460	332	1.00606	0.459198
GCA_000151295.1-Fun_GG745331.1_i000_015724	116	455	339	1.02727	0.678
GCA_002105175.1-Fun_MCGE01000001.1_i000_000575	130	457	327	0.990909	0.656627
GCA_013401445.1-Pla_CM023886.1_i000_022319	136	459	323	0.978788	0.587273
GCA_013400055.1-Ani_VXBJ01003389.1_i000_006079	57	385	328	0.993939	0.676289
GCA_003370565.1-Pla_QJKJ01014244.1_i000_050117	60	391	331	1.00303	0.740492
GCA_002105155.1-Fun_MCFF01000003.1_i000_005262	121	450	329	0.99697	0.640078
GCA_015847225.1-Fun_JAAAHT010000816.1_i000_005063	121	450	329	0.99697	0.640078
GCA_001890705.1-Fun_KV878584.1_i000_004142	127	455	328	0.993939	0.644401
GCA_000003745.2-Pla_FN597042.1_i000_020197	132	459	327	0.990909	0.695745
GCA_016946835.1-Fun_JACVTC010000047.1_i000_018614	92	422	330	1	0.680412
GCA_002104975.1-Fun_MCOG01000349.1_i000_012222	116	446	330	1	0.64833
GCA_013397555.1-Ani_VZRH01001289.1_i000_001928	58	384	326	0.987879	0.695096
GCA_000499845.1-Pla_CM002290.1_i000_008375	125	460	335	1.01515	0.605787
GCA_013398295.1-Ani_VZSF01006486.1_i000_008124	54	386	332	1.00606	0.688797
GCA_013397415.1-Ani_VYZA01000849.1_i000_010332	60	384	324	0.981818	0.670807
GCA_016758965.1-Fun_JAEPRB010000016.1_i000_001828	120	447	327	0.990909	0.64881
GCA_000150275.1-Ani_DS985255.1_i000_002718	133	445	312	0.945455	0.672414
GCA_900411305.1-Pla_LS480641.1_i000_001123	104	437	333	1.00909	0.646602
GCA_000347455.1-Pla_KD283606.1_i000_023315	57	391	334	1.01212	0.712154
GCA_902713445.1-Pla_LR743777.1_i000_000910	129	457	328	0.993939	0.59745
GCA_902729315.2-Pla_LR746274.1_i000_015220	128	459	331	1.00303	0.602914
GCA_020921065.1-Pla_CM037159.1_i000_024963	131	460	329	0.99697	0.590664
GCA_000326865.1-Ani_KB097650.1_i000_020904	127	454	327	0.990909	0.718681
GCA_002104975.1-Fun_MCOG01000064.1_i000_017146	116	448	332	1.00606	0.656126
GCA_016946835.1-Fun_JACVTC010000089.1_i000_026261	116	448	332	1.00606	0.656126
GCA_013399855.1-Ani_VXAY01006789.1_i000_011972	55	383	328	0.993939	0.68476
GCA_013397715.1-Ani_WBNL01002054.1_i000_012680	62	386	324	0.981818	0.670807
GCA_016618255.1-Pla_VFSX01000041.1_i000_001156	122	467	345	1.04545	0.72479
GCA_013400115.1-Ani_VXBP01000619.1_i000_000946	55	384	329	0.99697	0.69556
GCA_016984155.1-Ani_JAAWVP010002545.1_i000_004070	126	459	333	1.00909	0.571184
GCA_002220415.3-Pla_CM022214.1_i000_014940	57	391	334	1.01212	0.710638
GCA_014905375.1-Pla_BMAC01000044.1_i000_003874	136	461	325	0.984848	0.625
GCA_002104895.1-Fun_MCFG01000054.1_i000_009877	114	449	335	1.01515	0.662055
GCA_900231445.1-Pla_LT934113.1_i000_009081	126	459	333	1.00909	0.617811
GCA_004114815.1-Pla_SDOW01000331.1_i000_025669	122	460	338	1.02424	0.617916
GCA_018804465.1-Pla_CM031991.1_i000_007718	127	460	333	1.00909	0.605455
GCA_013400095.1-Ani_VXBK01005790.1_i000_006623	54	387	333	1.00909	0.689441
GCA_013399275.1-Ani_VXAG01002620.1_i000_012934	55	387	332	1.00606	0.701903
GCA_013396755.1-Ani_VWZF01003788.1_i000_006778	59	384	325	0.984848	0.684211
GCA_001633215.2-Pla_KV774602.1_i000_005602	120	459	339	1.02727	0.620879
GCA_000763605.2-Pla_JRKL02000009.1_i000_000193	139	459	320	0.969697	0.588235
GCA_003958685.2-Pla_CP039350.1_i000_019361	126	459	333	1.00909	0.60217
GCA_003958685.2-Pla_CP039350.1_i000_019362	126	459	333	1.00909	0.60217
GCA_002220415.3-Pla_CM022216.1_i000_027037	128	461	333	1.00909	0.617811
GCA_018804465.1-Pla_CM031990.1_i000_006725	128	460	332	1.00606	0.602541
GCA_013399295.1-Ani_VXAH01000562.1_i000_009246	58	386	328	0.993939	0.679089
GCA_015502465.1-Fun_JAAAUP010000041.1_i000_006999	127	455	328	0.993939	0.668024
GCA_001190045.1-Pla_CM003375.1_i000_012097	126	459	333	1.00909	0.603261
GCA_004320505.1-Pla_AP015040.1_i000_020857	126	459	333	1.00909	0.603261
GCA_016808095.1-Pla_CM028995.1_i000_025841	126	459	333	1.00909	0.603261
GCA_016748015.1-Fun_JAAOMT010000566.1_i000_004874	129	455	326	0.987879	0.5
GCA_006535955.1-Fun_QEAN01000047.1_i000_001731	129	455	326	0.987879	0.702586
GCA_006536045.1-Fun_QEAM01000040.1_i000_001673	129	455	326	0.987879	0.702586
GCA_013401295.1-Ani_VWPO01004781.1_i000_011874	56	386	330	1	0.686071
GCA_013397695.1-Ani_VYZI01001847.1_i000_003953	55	386	331	1.00303	0.682474
GCA_001742945.1-Pla_DF974092.1_i000_033964	132	459	327	0.990909	0.630058
GCA_003713155.1-Pla_CP030983.1_i000_001672	142	459	317	0.960606	0.566071
GCA_002220415.3-Pla_CM022215.1_i000_021035	123	460	337	1.02121	0.624074
GCA_900231445.1-Pla_LT934114.1_i000_014421	123	460	337	1.02121	0.624074
GCA_003713155.1-Pla_CP030987.1_i000_033255	127	461	334	1.01212	0.618519
GCA_003713155.1-Pla_CP030997.1_i000_036699	127	461	334	1.01212	0.618519
GCA_004170445.1-Pla_CM014319.1_i000_030343	127	461	334	1.01212	0.618519
GCA_014170095.1-Ani_WKFB01000207.1_i000_008235	124	457	333	1.00909	0.678208
GCA_001663975.1-Ani_KV467223.1_i000_043791	123	454	331	1.00303	0.62218
GCA_016097945.1-Fun_JAAAIR010001920.1_i000_003202	132	457	325	0.984848	0.660569
GCA_910591945.1-Fun_CAJVPL010000503.1_i000_004403	128	461	333	1.00909	0.351637
GCA_003713155.1-Pla_CP030993.1_i000_005046	133	454	321	0.972727	0.573214
GCA_004170445.1-Pla_CM014325.1_i000_005158	133	454	321	0.972727	0.573214
GCA_013397055.1-Ani_VWZT01013348.1_i000_010477	55	358	303	0.918182	0.846369
GCA_013467485.1-Pla_CM025277.1_i000_011146	6	337	331	1.00303	0.803398
GCA_000696525.1-Pla_KK914632.1_i000_015784	133	459	326	0.987879	0.586331
GCA_004114815.1-Pla_SDOW01000647.1_i000_043151	125	460	335	1.01515	0.611314
GCA_015849335.1-Fun_JAAAIC010000092.1_i000_010698	120	451	331	1.00303	0.635317
GCA_013397465.1-Ani_VYZD01002185.1_i000_012785	60	386	326	0.987879	0.696581
GCA_005239225.1-Pla_RCHU01001198.1_i000_006959	128	460	332	1.00606	0.602541
GCA_019426215.1-Pla_CM033391.1_i000_003221	132	458	326	0.987879	0.624521
GCA_017589495.1-Ani_CM030057.1_i000_014781	127	457	330	1	0.562181
GCA_002105175.1-Fun_MCGE01000003.1_i000_007537	131	446	315	0.954545	0.531197
GCA_902806795.1-Ani_CADCXV010000446.1_i000_002262	120	447	327	0.990909	0.728285
GCA_009078355.1-Ani_CM018555.1_i000_012411	126	449	323	0.978788	0.568662
GCA_013487665.1-Pla_CM025186.1_i000_011019	6	311	305	0.924242	0.977564
GCA_900231445.1-Pla_LT934112.1_i000_007384	123	461	338	1.02424	0.614545
GCA_004011995.1-Pla_QGNW01000012.1_i000_005998	133	459	326	0.987879	0.585278
GCA_015852335.1-Fun_JAAAID010000405.1_i000_003608	120	452	332	1.00606	0.637236
GCA_016098045.1-Fun_JAAAIW010000431.1_i000_007277	126	457	331	1.00303	0.6853
GCA_900231445.1-Pla_LT934111.1_i000_003536	120	460	340	1.0303	0.620438
GCA_003369625.1-Fun_PVWQ01000003.1_i000_006087	127	460	333	1.00909	0.652941
GCA_006536005.1-Fun_QEAQ01000022.1_i000_002271	124	456	332	1.00606	0.66004
GCA_000281125.4-Ani_AKHW03001223.1_i000_004688	122	455	333	1.00909	0.615527
GCA_002812745.2-Fun_NCSJ02000090.1_i000_012317	133	466	333	1.00909	0.662028
GCA_012923435.1-Pla_JAATIP010000288.1_i000_016794	129	459	330	1	0.613383
GCA_013030025.1-Pla_JAATIQ010000041.1_i000_021181	129	459	330	1	0.613383
GCA_001890125.1-Fun_KV878127.1_i000_004260	129	457	328	0.993939	0.644401
GCA_002220415.3-Pla_CM022212.1_i000_008328	123	461	338	1.02424	0.615665
GCA_002220415.3-Pla_CM022213.1_i000_012991	120	461	341	1.03333	0.622263
GCA_003546025.1-Pla_QPKB01000006.1_i000_015042	123	456	333	1.00909	0.589381
GCA_000347455.1-Pla_KD031761.1_i000_002501	120	461	341	1.03333	0.622263
GCA_002220415.3-Pla_CM022211.1_i000_003714	120	461	341	1.03333	0.622263
GCA_013401445.1-Pla_CM023885.1_i000_021526	143	459	316	0.957576	0.577697
GCA_021307315.1-Fun_JAJSPD010000023.1_i000_006900	140	463	323	0.978788	0.62963
GCA_013390085.1-Ani_WEIX01003942.1_i000_003281	1	299	298	0.90303	0.776042
GCA_019650235.1-Pla_BNCP01000002.1_i000_001082	120	458	338	1.02424	0.671968
GCA_019650255.1-Pla_BNCQ01000005.1_i000_002825	120	458	338	1.02424	0.671968
GCA_015849275.1-Fun_JAAAIA010000010.1_i000_000110	125	450	325	0.984848	0.637255
GCA_002906115.4-Pla_PKMF03008894.1_i000_030126	134	460	326	0.987879	0.600368
GCA_000002775.3-Pla_CM009301.1_i000_029045	127	460	333	1.00909	0.604356
GCA_015852605.2-Pla_CM027581.2_i000_021753	127	460	333	1.00909	0.604356
GCA_013397455.1-Ani_VYZB01001053.1_i000_000528	56	387	331	1.00303	0.696842
GCA_015679695.1-Fun_JAAAVD010001340.1_i000_001651	124	452	328	0.993939	0.629559
GCA_002104905.1-Fun_MCFE01000314.1_i000_007196	123	455	332	1.00606	0.681725
GCA_013677265.1-Pla_CM025238.1_i000_009673	56	390	334	1.01212	0.71828
GCA_017607445.1-Fun_JAEVHH010000002.1_i000_002836	132	458	326	0.987879	0.624521
GCA_002914845.1-Pla_JXTC01000273.1_i000_025308	134	459	325	0.984848	0.595238
GCA_003549995.1-Fun_QKKE01000369.1_i000_012556	125	457	332	1.00606	0.600362
GCA_013396555.1-Ani_VZRD01000877.1_i000_013563	58	386	328	0.993939	0.681913
GCA_001632505.1-Ani_LRGB01002384.1_i000_014220	118	446	328	0.993939	0.635659
GCA_003344405.1-Ani_NOWV01000019.1_i000_003704	131	449	318	0.963636	0.521311
GCA_000149205.2-Fun_CH236922.1_i000_005759	102	432	330	1	0.430809
GCA_007990325.1-Pla_CM017698.1_i000_058275	126	460	334	1.01212	0.623134
GCA_013397995.1-Ani_VZRP01010431.1_i000_006208	56	385	329	0.99697	0.683992
GCA_010458925.1-Pla_CM021236.1_i000_026665	133	456	323	0.978788	0.503115
GCA_001876935.1-Pla_CM007382.1_i000_004960	144	459	315	0.954545	0.564516
GCA_013399975.1-Ani_VXBD01009548.1_i000_008057	55	384	329	0.99697	0.688285
GCA_008636005.1-Pla_BKCP01006848.1_i000_019555	159	488	329	0.99697	0.593863
GCA_002914805.1-Pla_JXTB01000014.1_i000_002969	132	459	327	0.990909	0.598901
GCA_021605115.1-Pla_BMAR01000006.1_i000_004359	120	458	338	1.02424	0.670635
GCA_016984195.1-Ani_JAAWVQ010037269.1_i000_003792	99	427	328	0.993939	0.618868
GCA_013396465.1-Ani_VWYW01002310.1_i000_013457	87	414	327	0.990909	0.641176
GCA_900659725.1-Ani_CAACVG010002643.1_i000_002226	126	462	336	1.01818	0.616514
GCA_022539455.1-Pla_CM039723.1_i000_007320	129	461	332	1.00606	0.593918
GCA_002174775.1-Pla_MVGT01000438.1_i000_008851	60	388	328	0.993939	0.670757
GCA_000327365.1-Pla_CM001746.1_i000_016416	128	461	333	1.00909	0.623596
GCA_002926015.1-Pla_KZ648039.1_i000_019066	126	460	334	1.01212	0.680244
GCA_001605985.2-Pla_KZ502134.1_i000_004917	129	461	332	1.00606	0.593918
GCA_000011425.1-Fun_BN001306.1_i000_006707	130	465	335	1.01515	0.656863
GCA_001659605.2-Pla_CM004400.2_i000_024905	133	459	326	0.987879	0.589512
GCA_013397515.1-Ani_VZRI01013885.1_i000_013058	54	386	332	1.00606	0.694561
GCA_002928715.1-Pla_KZ668476.1_i000_032802	126	459	333	1.00909	0.678208
GCA_016413895.1-Pla_CM028163.1_i000_024996	128	462	334	1.01212	0.603978
GCA_015680635.1-Fun_JAABOA010005701.1_i000_009907	1	289	288	0.872727	0.888889
GCA_007990325.1-Pla_CM017711.1_i000_062234	126	462	336	1.01818	0.626866
GCA_008761655.1-Pla_CM018225.1_i000_057651	126	462	336	1.01818	0.626866
GCA_000004075.3-Pla_CM002922.2_i000_000068	128	462	334	1.01212	0.605072
GCA_907169785.1-Ani_CAJRST010033334.1_i000_015585	128	459	331	1.00303	0.580702
GCA_007990345.1-Pla_CM017685.1_i000_065294	126	460	334	1.01212	0.623134
GCA_013677235.1-Pla_CM025199.1_i000_011824	127	459	332	1.00606	0.620561
GCA_013677245.1-Pla_CM025212.1_i000_011360	127	459	332	1.00606	0.620561
GCA_013677275.1-Pla_CM025251.1_i000_011414	127	459	332	1.00606	0.620561
GCA_910592225.1-Fun_CAJVPR010000281.1_i000_004716	123	457	334	1.01212	0.601802
GCA_020496765.1-Pla_CM035626.1_i000_019902	126	461	335	1.01515	0.626168
GCA_013511315.1-Pla_CM025264.1_i000_010371	128	461	333	1.00909	0.62243
GCA_007990455.1-Pla_CM017659.1_i000_059111	126	461	335	1.01515	0.623836
GCA_002966975.2-Pla_PJQY01003962.1_i000_040657	131	459	328	0.993939	0.595281
GCA_000150275.1-Ani_DS985248.1_i000_004291	127	455	328	0.993939	0.604052
GCA_001659605.2-Pla_CM004392.2_i000_011925	134	459	325	0.984848	0.607477
GCA_000219495.2-Pla_CM001220.2_i000_024503	125	460	335	1.01515	0.639313
GCA_003473485.2-Pla_CM010651.1_i000_022820	125	460	335	1.01515	0.639313
GCA_006535975.1-Fun_QEAP01000104.1_i000_003841	238	576	338	1.02424	0.564274
GCA_000004515.5-Pla_CM000850.4_i000_043996	127	460	333	1.00909	0.606557
GCA_004193775.2-Pla_CM014373.1_i000_045672	127	460	333	1.00909	0.606557
GCA_012273815.2-Pla_CM022575.2_i000_047120	127	460	333	1.00909	0.606557
GCA_014282035.1-Pla_CM024849.1_i000_035995	127	460	333	1.00909	0.606557
GCA_014282085.1-Pla_CM024909.1_i000_020553	127	460	333	1.00909	0.606557
GCA_014282095.1-Pla_CM024929.1_i000_047831	127	460	333	1.00909	0.606557
GCA_014282145.1-Pla_CM024949.1_i000_047252	127	460	333	1.00909	0.606557
GCA_014282345.1-Pla_CM024984.1_i000_047053	127	460	333	1.00909	0.606557
GCA_020497155.1-Pla_CM035723.1_i000_047561	127	460	333	1.00909	0.606557
GCA_903114435.1-Pla_CAEKKB010000005.1_i000_019005	132	460	328	0.993939	0.595281
GCA_020424065.1-Pla_CM035471.1_i000_023448	132	460	328	0.993939	0.595281
GCA_903112645.1-Pla_CAEKDK010000005.1_i000_019166	132	460	328	0.993939	0.595281
GCA_003046395.2-Pla_CM009690.2_i000_001519	125	460	335	1.01515	0.607985
GCA_003046395.2-Pla_CM009691.2_i000_007572	125	460	335	1.01515	0.607985
GCA_007990485.1-Pla_CM017633.1_i000_062161	127	459	332	1.00606	0.622889
GCA_003203555.1-Fun_BEXD01004253.1_i000_025747	123	458	335	1.01515	0.499255
GCA_015698045.1-Fun_BLAL01000044.1_i000_006710	123	458	335	1.01515	0.499255
GCA_010458925.1-Pla_CM021241.1_i000_040262	133	459	326	0.987879	0.430079
GCA_001883825.1-Fun_LGRN01000097.1_i000_008862	133	459	326	0.987879	0.635478
GCA_014362265.1-Pla_BJWL01000016.1_i000_023612	126	460	334	1.01212	0.597496
GCA_008638375.1-Pla_CM018036.1_i000_024665	129	460	331	1.00303	0.585841
GCA_014282095.1-Pla_CM024917.1_i000_012130	129	461	332	1.00606	0.603636
GCA_014282345.1-Pla_CM024972.1_i000_011691	129	461	332	1.00606	0.603636
GCA_012432095.1-Ani_CM022805.1_i000_020803	123	447	324	0.981818	0.597786
GCA_002072425.1-Fun_MOOB01000002.1_i000_000837	130	459	329	0.99697	0.641326
GCA_013401035.1-Ani_VZUA01397592.1_i000_008383	8	333	325	0.984848	0.846354
GCA_003344405.1-Ani_NOWV01000064.1_i000_010030	130	457	327	0.990909	0.611215
GCA_013400955.1-Ani_VZTZ01042376.1_i000_010901	56	387	331	1.00303	0.6853
GCA_018691285.1-Pla_CM031891.1_i000_017167	126	460	334	1.01212	0.603978
GCA_014805685.1-Ani_CM025899.1_i000_012987	179	485	306	0.927273	0.509151
GCA_021399445.1-Fun_JAJTUQ010000001.1_i000_000673	133	469	336	1.01818	0.669323
GCA_006937295.1-Pla_CM017328.1_i000_018857	136	459	323	0.978788	0.580935
GCA_005966545.1-Pro_SPLM01000072.1_i000_004081	127	456	329	0.99697	0.664646
GCA_001584585.1-Pla_LSYV01000009.1_i000_004134	119	458	339	1.02727	0.675299
GCA_903231485.1-Fun_CAFBRS010000001.1_i000_000442	125	457	332	1.00606	0.526149
GCA_001593155.1-Fun_LLXL01000143.1_i000_003879	153	485	332	1.00606	0.530351
GCA_015847235.1-Fun_JAAAHU010000024.1_i000_004556	121	450	329	0.99697	0.655378
GCA_013397665.1-Ani_VYZH01003310.1_i000_009793	54	388	334	1.01212	0.710638
GCA_002072265.1-Fun_MDYM01000001.1_i000_000655	139	459	320	0.969697	0.626223
GCA_000439145.3-Fun_AUPC02000095.1_i000_025754	125	457	332	1.00606	0.520376
GCA_000597685.1-Fun_JEMT01029692.1_i000_026226	125	457	332	1.00606	0.520376
GCA_001593205.1-Fun_LLXJ01000842.1_i000_012342	125	457	332	1.00606	0.520376
GCA_002897155.2-Fun_BDIQ02000106.1_i000_022311	125	457	332	1.00606	0.51875
GCA_903470525.1-Fun_CAGKOT010000056.1_i000_019569	125	457	332	1.00606	0.51875
MEIG001.0722.00001.C001_01233	82	410	328	0.993939	0.784689
GCA_013390045.1-Ani_WEKY01052081.1_i000_011107	59	386	327	0.990909	0.682672
GCA_903189815.1-Fun_CAEVNS010000006.1_i000_004511	125	457	332	1.00606	0.51633
GCA_003369635.1-Fun_PDLN01000010.1_i000_001333	139	464	325	0.984848	0.642292
GCA_019845555.1-Pla_CM034081.1_i000_013277	133	457	324	0.981818	0.588022
GCA_013401135.1-Ani_VZUI01054035.1_i000_009436	58	388	330	1	0.686071
GCA_014080715.1-Pla_JACERP010000028.1_i000_009148	123	484	361	1.09394	0.726358
GCA_016097895.1-Fun_JAAAIL010002666.1_i000_010896	122	448	326	0.987879	0.644269
GCA_902201215.1-Pla_LR694010.1_i000_016192	132	460	328	0.993939	0.59745
GCA_903189765.1-Fun_CAEVNM010000032.1_i000_017520	125	457	332	1.00606	0.51633
GCA_903470595.1-Fun_CAGKPD010000001.1_i000_000469	125	457	332	1.00606	0.51633
GCA_013399835.1-Ani_VXAX01005718.1_i000_009441	57	388	331	1.00303	0.699789
GCA_015502445.1-Fun_JAAAUN010000376.1_i000_006691	122	446	324	0.981818	0.641584
GCA_015502475.1-Fun_JAAAUL010000197.1_i000_003909	122	446	324	0.981818	0.641584
GCA_016098085.1-Fun_JAAAIX010000048.1_i000_008152	122	446	324	0.981818	0.641584
GCA_013398955.1-Ani_VWPU01006265.1_i000_004141	62	386	324	0.981818	0.679245
GCA_014805685.1-Ani_CM025885.1_i000_000150	133	443	310	0.939394	0.556553
GCA_002083735.1-Fun_KV921292.1_i000_002942	125	454	329	0.99697	0.665992
GCA_003325435.1-Fun_PJQL01000013.1_i000_000236	125	454	329	0.99697	0.665992
GCA_011762625.1-Fun_JAANIL010000014.1_i000_001391	125	454	329	0.99697	0.665992
GCA_011762635.1-Fun_JAANIK010000160.1_i000_001698	125	454	329	0.99697	0.665992
GCA_011763475.1-Fun_JAANIM010000157.1_i000_001562	125	454	329	0.99697	0.665992
GCA_011763565.1-Fun_JAANIN010000118.1_i000_003248	125	454	329	0.99697	0.665992
GCA_011764045.1-Fun_JAANQQ010000123.1_i000_002991	125	454	329	0.99697	0.665992
GCA_000346465.2-Pla_CM007655.1_i000_016779	132	459	327	0.990909	0.595628
GCA_013398675.1-Ani_WBNF01000245.1_i000_000002	56	386	330	1	0.681818
GCA_000376725.2-Ani_KZ308157.1_i000_001513	113	450	337	1.02121	0.638258
GCA_002104895.1-Fun_MCFG01000011.1_i000_000529	120	452	332	1.00606	0.672065
GCA_000504015.1-Pla_KI632182.1_i000_022543	136	457	321	0.972727	0.618497
GCA_000722935.2-Pla_KN661865.1_i000_034998	126	459	333	1.00909	0.606557
GCA_002762385.1-Pla_NKXS01000445.1_i000_003025	131	451	320	0.969697	0.704846
GCA_004115385.1-Pla_CM014062.1_i000_032731	133	460	327	0.990909	0.597806
GCA_013399935.1-Ani_VWYM01002981.1_i000_001530	58	384	326	0.987879	0.686316
GCA_000143455.1-Pla_GL378357.1_i000_007798	121	460	339	1.02727	0.673956
GCA_019721115.1-Ani_CM033908.1_i000_018348	155	489	334	1.01212	0.566102
GCA_001593125.1-Fun_LLXH01000069.1_i000_002592	153	485	332	1.00606	0.496263
GCA_000005505.4-Pla_CM000880.3_i000_002340	132	458	326	0.987879	0.610487
GCA_903189775.1-Fun_CAEVNN010000059.1_i000_002750	125	457	332	1.00606	0.51633
GCA_008761655.1-Pla_CM018212.1_i000_054042	126	460	334	1.01212	0.623134
GCA_016808335.1-Pla_CM029053.1_i000_039027	125	460	335	1.01515	0.607985
GCA_001593145.1-Fun_LLXI01000799.1_i000_012662	132	464	332	1.00606	0.512346
GCA_013398885.1-Ani_VYZL01003715.1_i000_008558	59	386	327	0.990909	0.694268
GCA_019512145.1-Ani_WNYA01001492.1_i000_021686	3	313	310	0.939394	0.796915
GCA_003731715.1-Ani_RJVU01035392.1_i000_007963	136	467	331	1.00303	0.592129
GCA_905066765.1-Fun_CAJHIA010000037.1_i000_010203	142	461	319	0.966667	0.614644
GCA_015847185.1-Fun_JAAAHX010000112.1_i000_000581	126	450	324	0.981818	0.63035
GCA_015849325.1-Fun_JAAAIB010000205.1_i000_002975	126	450	324	0.981818	0.63035
GCA_019788775.1-Fun_JAIFTL010000039.1_i000_005654	126	450	324	0.981818	0.63035
GCA_013398175.1-Ani_VZRZ01000983.1_i000_001292	60	386	326	0.987879	0.673554
GCA_001513925.1-Fun_LLXE01000151.1_i000_002050	135	458	323	0.978788	0.632094
GCA_015847195.1-Fun_JAAAHV010000161.1_i000_002246	127	475	348	1.05455	0.728033
GCA_013397495.1-Ani_VYZC01001903.1_i000_003694	8	332	324	0.981818	0.760563
GCA_000787975.1-Pla_KN403932.1_i000_009385	126	461	335	1.01515	0.627341
GCA_007990455.1-Pla_CM017646.1_i000_055405	126	461	335	1.01515	0.627341
GCA_013397955.1-Ani_VZRM01007610.1_i000_011774	64	385	321	0.972727	0.731207
GCA_008932095.1-Pla_CM018518.1_i000_032744	133	460	327	0.990909	0.596715
GCA_007990345.1-Pla_CM017672.1_i000_027159	126	461	335	1.01515	0.626168
GCA_007990485.1-Pla_CM017620.1_i000_058210	126	461	335	1.01515	0.626168
GCA_013467495.1-Pla_CM025147.1_i000_008457	126	461	335	1.01515	0.626168
GCA_002220235.1-Pla_FO082275.1_i000_001974	124	459	335	1.01515	0.696466
GCA_001890725.1-Fun_KV878210.1_i000_003049	137	461	324	0.981818	0.624277
GCA_000414095.2-Pla_KE345144.1_i000_016352	127	460	333	1.00909	0.608775
GCA_016097885.1-Fun_JAAAIO010001555.1_i000_002172	1	290	289	0.875758	0.897516
GCA_008638375.1-Pla_CM018035.1_i000_023293	130	428	298	0.90303	0.696262
GCA_014282245.1-Pla_CM024960.1_i000_019360	182	513	331	1.00303	0.543514
GCA_004837865.1-Pla_CM017192.1_i000_012187	128	460	332	1.00606	0.597122
GCA_005393395.2-Pla_CM016624.1_i000_022724	126	461	335	1.01515	0.626168
GCA_013400855.1-Ani_VZTT01045877.1_i000_005216	57	387	330	1	0.688935
GCA_000513335.1-Fun_HG793134.1_i000_000584	139	459	320	0.969697	0.626223
GCA_003184585.1-Fun_KZ821257.1_i000_008135	129	457	328	0.993939	0.630769
GCA_001638985.2-Fun_KV440989.1_i000_011420	130	458	328	0.993939	0.666667
GCA_000504015.1-Pla_KI630265.1_i000_003621	127	458	331	1.00303	0.636538
GCA_013398455.1-Ani_VZSM01004797.1_i000_009885	56	385	329	0.99697	0.688285
GCA_015502455.1-Fun_JAAAUM010000636.1_i000_009198	123	451	328	0.993939	0.633205
GCA_022539455.1-Pla_CM039723.1_i000_007323	129	461	332	1.00606	0.594982
GCA_000005505.4-Pla_CM000880.3_i000_004078	124	460	336	1.01818	0.61426
GCA_009193525.1-Fun_ML741815.1_i000_009366	129	460	331	1.00303	0.631679
GCA_019857665.1-Ani_WNTK01000015.1_i000_013621	116	445	329	0.99697	0.609259
GCA_014773175.1-Ani_VXCM01001619.1_i000_011120	133	448	315	0.954545	0.588785
GCA_013398575.1-Ani_WBNC01024961.1_i000_011782	59	385	326	0.987879	0.676349
GCA_019776745.2-Pla_CM034156.1_i000_036180	127	459	332	1.00606	0.572414
GCA_016858145.1-Pla_JAEHOE010000008.1_i000_003111	120	458	338	1.02424	0.671968
GCA_013400715.1-Ani_VZTP01000911.1_i000_000340	62	386	324	0.981818	0.669421
GCA_001598015.1-Pla_KV014877.1_i000_037096	128	458	330	1	0.638298
GCA_013397095.1-Ani_VWZU01015577.1_i000_010120	52	385	333	1.00909	0.69375
GCA_000945115.1-Fun_LK023315.1_i000_001899	120	445	325	0.984848	0.655242
GCA_013398635.1-Ani_WBNE01000014.1_i000_010790	54	386	332	1.00606	0.691667
GCA_015680655.1-Fun_JAABKD010000146.1_i000_001765	124	450	326	0.987879	0.634241
GCA_013398835.1-Ani_VYZJ01005368.1_i000_012848	59	386	327	0.990909	0.685535
GCA_902713445.1-Pla_LR743787.1_i000_015363	133	459	326	0.987879	0.580071
GCA_013399995.1-Ani_VXBF01004021.1_i000_003243	55	387	332	1.00606	0.691667
GCA_902713445.1-Pla_CACTIH010007391.1_i000_047634	137	459	322	0.975758	0.572954
GCA_013396995.1-Ani_VWZP01006251.1_i000_007374	7	330	323	0.978788	0.765403
GCA_013398495.1-Ani_WBNB01000658.1_i000_002396	58	384	326	0.987879	0.674948
GCA_000149335.2-Fun_GG704911.1_i000_007899	127	456	329	0.99697	0.627863
GCA_000149895.1-Fun_DS028093.1_i000_010184	127	456	329	0.99697	0.627863
GCA_000150085.1-Fun_DS268233.1_i000_000528	127	456	329	0.99697	0.627863
GCA_004115165.2-Fun_RHJW02000001.1_i000_000778	127	456	329	0.99697	0.627863
GCA_002104945.1-Fun_MCFH01000015.1_i000_001957	121	452	331	1.00303	0.67004
GCA_001890905.1-Fun_KV878978.1_i000_006050	130	455	325	0.984848	0.625
GCA_016808335.1-Pla_CM029054.1_i000_077679	125	460	335	1.01515	0.607985
GCA_008636005.1-Pla_BKCP01008292.1_i000_024105	133	460	327	0.990909	0.621673
GCA_000004255.1-Pla_GL348713.1_i000_005085	130	462	332	1.00606	0.636015
GCA_015679415.1-Fun_JAAAUT010000706.1_i000_009078	161	486	325	0.984848	0.590909
GCA_000372725.1-Pro_KB865021.1_i000_014419	128	462	334	1.01212	0.701681
GCA_013401235.1-Ani_WEIY01001127.1_i000_011079	60	386	326	0.987879	0.683438
GCA_013398995.1-Ani_VWYE01009513.1_i000_004530	56	384	328	0.993939	0.677686
GCA_021028975.1-Ani_CM037623.1_i000_020866	126	435	309	0.936364	0.575419
GCA_000695605.1-Pla_KK785030.1_i000_017192	64	392	328	0.993939	0.666667
GCA_002072235.1-Fun_MDYO01000001.1_i000_000915	135	458	323	0.978788	0.632094
GCA_013138035.1-Fun_JAASRZ010000051.1_i000_005584	135	458	323	0.978788	0.632094
GCA_003061485.1-Pla_CM009757.1_i000_031499	125	460	335	1.01515	0.609091
GCA_013398715.1-Ani_VZSU01002064.1_i000_010236	57	386	329	0.99697	0.679752
GCA_013399795.1-Ani_VWYL01014125.1_i000_005764	58	385	327	0.990909	0.68125
GCA_013398535.1-Ani_VZSP01000663.1_i000_004320	56	385	329	0.99697	0.67418
GCA_002157105.1-Fun_KZ150841.1_i000_005551	118	454	336	1.01818	0.680162
GCA_015847195.1-Fun_JAAAHV010000005.1_i000_007424	772	1096	324	0.981818	0.280035
GCA_000723665.1-Fun_CBTN010000010.1_i000_003225	120	445	325	0.984848	0.653924
GCA_017357885.1-Fun_CP063406.1_i000_002776	139	461	322	0.975758	0.626459
GCA_001717485.1-Fun_JXNT01000005.1_i000_008386	129	453	324	0.981818	0.621881
GCA_013397115.1-Ani_VWZW01005705.1_i000_009153	35	338	303	0.918182	0.89645
GCA_013390105.1-Ani_WAAG01087397.1_i000_010397	56	386	330	1	0.680412
GCA_013400585.1-Ani_WEZZ01025122.1_i000_007743	55	358	303	0.918182	0.846369
GCA_000002865.1-Pro_CH991567.1_i000_002214	125	460	335	1.01515	0.664683
GCA_007252995.1-Ani_SWJQ01000195.1_i000_008008	125	458	333	1.00909	0.606557
GCA_000956085.1-Fun_JZEE01000597.1_i000_005812	128	462	334	1.01212	0.639847
GCA_002749805.1-Fun_NEXV01000110.1_i000_010050	128	462	334	1.01212	0.639847
GCA_009176385.1-Fun_ML734990.1_i000_009074	128	462	334	1.01212	0.639847
GCA_009176405.1-Fun_ML733460.1_i000_009093	128	462	334	1.01212	0.639847
GCA_009193505.1-Fun_ML738334.1_i000_008008	128	462	334	1.01212	0.639847
GCA_009193545.1-Fun_ML737166.1_i000_009420	128	462	334	1.01212	0.639847
GCA_003184925.1-Fun_KZ821652.1_i000_011775	8	333	325	0.984848	0.826972
GCA_002211085.2-Pla_CM008054.2_i000_031930	125	460	335	1.01515	0.609091
GCA_009193445.1-Fun_ML743585.1_i000_007736	129	457	328	0.993939	0.628352
GCA_000003525.2-Fun_EQ999985.1_i000_009208	134	458	324	0.981818	0.631579
GCA_000151595.1-Fun_GG749464.1_i000_003407	134	458	324	0.981818	0.631579
GCA_000166155.1-Fun_GL538387.1_i000_003967	134	458	324	0.981818	0.631579
GCA_013400915.1-Ani_VZTX01005982.1_i000_002357	58	384	326	0.987879	0.689218
GCA_003184695.1-Fun_KZ825360.1_i000_007921	129	459	330	1	0.634615
GCA_003184765.1-Fun_KZ824978.1_i000_008776	129	459	330	1	0.634615
GCA_003184825.1-Fun_KZ824636.1_i000_004220	129	459	330	1	0.634615
GCA_013397895.1-Ani_VZRL01002953.1_i000_005956	56	386	330	1	0.684647
GCA_013401095.1-Ani_WBNP01053825.1_i000_012502	62	386	324	0.981818	0.679245
GCA_000170175.2-Fun_GL636496.1_i000_006642	127	456	329	0.99697	0.627863
GCA_018416015.1-Fun_CP075068.1_i000_001297	127	456	329	0.99697	0.627863
GCA_013401155.1-Ani_VZUF01140395.1_i000_003987	57	388	331	1.00303	0.678279
GCA_003184685.1-Fun_KZ825527.1_i000_007314	129	459	330	1	0.634615
GCA_003184705.1-Fun_KZ825132.1_i000_005209	129	459	330	1	0.634615
GCA_015679545.1-Fun_JAAAUZ010001244.1_i000_009357	122	450	328	0.993939	0.634429
GCA_015849305.1-Fun_JAAAHY010000139.1_i000_001671	126	449	323	0.978788	0.628405
GCA_000151295.1-Fun_GG745349.1_i000_006953	116	447	331	1.00303	0.738839
GCA_002571385.1-Ani_LSMT01000240.1_i000_012647	140	459	319	0.966667	0.567616
GCA_000150055.1-Fun_DS268109.1_i000_007920	129	459	330	1	0.622642
GCA_000151335.1-Fun_ACFW01000049.1_i000_000392	129	459	330	1	0.622642
GCA_022478865.1-Ani_JAHXPS010004637.1_i000_022026	115	444	329	0.99697	0.611524
GCA_015847195.1-Fun_JAAAHV010000263.1_i000_004247	120	448	328	0.993939	0.696391
GCA_002847485.1-Fun_MSFM01000001.1_i000_000599	126	455	329	0.99697	0.638835
GCA_001883805.1-Fun_LGTZ01000284.1_i000_005314	139	461	322	0.975758	0.631373
GCA_000375325.1-Pla_KB870805.1_i000_004276	152	480	328	0.993939	0.602941
GCA_003184845.1-Fun_KZ824444.1_i000_006700	130	454	324	0.981818	0.612476
GCA_015500005.1-Fun_JAAAUG010000073.1_i000_009380	124	452	328	0.993939	0.635659
GCA_002083745.1-Fun_KV921927.1_i000_005915	126	455	329	0.99697	0.665992
GCA_002708625.1-Fun_KZ303856.1_i000_007908	126	455	329	0.99697	0.665992
GCA_003184865.1-Fun_KZ824292.1_i000_006972	128	461	333	1.00909	0.640385
GCA_000341285.1-Pro_KB454500.1_i000_002237	125	462	337	1.02121	0.638258
GCA_009078355.1-Ani_CM018542.1_i000_001816	131	441	310	0.939394	0.554562
GCA_000150115.1-Fun_GG663365.1_i000_006470	132	459	327	0.990909	0.630058
GCA_017355575.1-Fun_CP069118.1_i000_002256	132	459	327	0.990909	0.630058
GCA_017607465.1-Fun_JAEVHI010000001.1_i000_001310	132	459	327	0.990909	0.630058
GCA_000209225.1-Ani_DS469511.1_i000_023766	121	446	325	0.984848	0.632296
GCA_022201065.1-Pla_CM039172.1_i000_006791	133	460	327	0.990909	0.582888
GCA_000493195.1-Pla_KI536661.1_i000_006452	133	460	327	0.990909	0.581851
GCA_006381635.2-Pla_VEPZ02001604.1_i000_070522	126	460	334	1.01212	0.624299
GCA_000769765.1-Fun_JQGA01001044.1_i000_007481	133	458	325	0.984848	0.636008
GCA_004115005.2-Pla_CM032144.1_i000_013987	128	463	335	1.01515	0.606884
GCA_018691285.1-Pla_CM031890.1_i000_014818	128	463	335	1.01515	0.606884
GCA_015849285.1-Fun_JAAAHZ010000197.1_i000_003033	125	451	326	0.987879	0.634241
GCA_007726485.1-Pla_CM017442.1_i000_016449	124	460	336	1.01818	0.607595
GCA_000825725.1-Fun_CDGI01000041.1_i000_002566	125	454	329	0.99697	0.665992
GCA_000146945.2-Fun_CH476640.1_i000_002246	142	463	321	0.972727	0.622093
GCA_001857865.1-Fun_CP017825.1_i000_009126	142	463	321	0.972727	0.622093
GCA_022539455.1-Pla_CM039720.1_i000_003099	128	461	333	1.00909	0.606557
GCA_015529795.1-Fun_JAAAUH010000122.1_i000_001065	124	450	326	0.987879	0.636719
GCA_002850765.1-Fun_KZ559547.1_i000_005311	128	455	327	0.990909	0.64497
GCA_001278595.1-Fun_LHQQ01000220.1_i000_005021	136	459	323	0.978788	0.628405
GCA_006547085.1-Pla_VIEB01000374.1_i000_021230	133	459	326	0.987879	0.546064
GCA_002847045.1-Fun_KZ559123.1_i000_002031	130	455	325	0.984848	0.631068
GCA_000478725.1-Pla_KI517809.1_i000_022847	133	459	326	0.987879	0.619772
GCA_009193595.1-Fun_ML736186.1_i000_003880	128	456	328	0.993939	0.666667
GCA_007844105.2-Pla_CM017585.2_i000_021260	138	460	322	0.975758	0.613333
GCA_000269785.2-Fun_AKHY01000110.1_i000_002542	128	458	330	1	0.632184
GCA_000691885.1-Fun_AMCJ01000112.1_i000_005008	128	458	330	1	0.632184
GCA_009176375.1-Fun_ML734594.1_i000_006507	128	458	330	1	0.632184
GCA_014621375.1-Fun_JAAOZQ010000087.1_i000_009846	140	458	318	0.963636	0.622309
GCA_019176425.1-Ani_CM032880.1_i000_007576	124	456	332	1.00606	0.557047
GCA_001185155.1-Pla_LFYR01000981.1_i000_006473	125	458	333	1.00909	0.566327
GCA_006535975.1-Fun_QEAP01000017.1_i000_001097	669	1002	333	1.00909	0.32393
GCA_001638985.2-Fun_KV441025.1_i000_014350	130	456	326	0.987879	0.661258
GCA_020796205.1-Pla_CM036894.1_i000_009274	137	461	324	0.981818	0.588022
GCA_902713445.1-Pla_CACTIH010005898.1_i000_045243	132	459	327	0.990909	0.59132
GCA_003709025.1-Fun_QQZZ01000196.1_i000_004540	130	459	329	0.99697	0.626667
GCA_014784225.2-Fun_CP061804.2_i000_000992	130	459	329	0.99697	0.626667
GCA_000945115.1-Fun_LK023323.1_i000_004139	130	456	326	0.987879	0.652
GCA_001263275.1-Ani_KQ414663.1_i000_006047	116	443	327	0.990909	0.55802
GCA_019202795.1-Pla_CM032918.1_i000_030449	128	460	332	1.00606	0.633588
GCA_003325435.1-Fun_PJQL01002463.1_i000_012786	126	455	329	0.99697	0.665992
GCA_900000135.1-Fun_CCYT01000018.1_i000_007025	126	455	329	0.99697	0.665992
GCA_000151005.2-Fun_DS990636.1_i000_009243	132	461	329	0.99697	0.637597
GCA_000151035.1-Fun_GG692420.1_i000_007893	132	461	329	0.99697	0.637597
GCA_017310615.1-Fun_CP069103.1_i000_002643	132	461	329	0.99697	0.637597
GCA_013467495.1-Pla_CM025141.1_i000_000324	59	390	331	1.00303	0.714903
GCA_018687715.1-Pla_CM031819.1_i000_022576	128	460	332	1.00606	0.603636
GCA_003184745.1-Fun_KZ821753.1_i000_010632	128	431	303	0.918182	0.703016
GCA_018688675.1-Pla_CM031835.1_i000_022350	128	460	332	1.00606	0.602541
GCA_003427395.1-Pla_BFEA01000001.1_i000_000147	134	467	333	1.00909	0.611009
GCA_002897195.1-Pla_BDQV01000067.1_i000_013123	133	459	326	0.987879	0.589512
GCA_003704095.1-Ani_RCHS01000010.1_i000_000012	157	480	323	0.978788	0.54932
GCA_011752425.2-Ani_CACVKT020009086.1_i000_052245	149	479	330	1	0.608856
GCA_004786185.1-Ani_CM015716.1_i000_005258	123	455	332	1.00606	0.584507
GCA_013398685.1-Ani_VZST01004016.1_i000_011200	53	358	305	0.924242	0.851955
GCA_022478865.1-Ani_JAHXPS010006170.1_i000_029983	125	459	334	1.01212	0.630189
GCA_000004515.5-Pla_CM000838.3_i000_010658	129	461	332	1.00606	0.603636
GCA_000722935.2-Pla_KN649024.1_i000_014752	129	461	332	1.00606	0.603636
GCA_012273815.2-Pla_CM022563.2_i000_011583	129	461	332	1.00606	0.603636
GCA_014282035.1-Pla_CM024837.1_i000_000438	129	461	332	1.00606	0.603636
GCA_014282145.1-Pla_CM024937.1_i000_011798	129	461	332	1.00606	0.603636
GCA_020497155.1-Pla_CM035711.1_i000_012123	129	461	332	1.00606	0.603636
GCA_002261195.1-Fun_MVBO01000022.1_i000_002431	118	450	332	1.00606	0.652259
GCA_003032435.1-Pla_KZ772741.1_i000_011699	132	459	327	0.990909	0.571678
GCA_009936355.2-Pla_AP019867.1_i000_005231	132	459	327	0.990909	0.571678
GCA_014180765.2-Pla_MUAA02000157.1_i000_017233	127	455	328	0.993939	0.572426
GCA_010723975.1-Fun_BLKD01000005.1_i000_001287	128	455	327	0.990909	0.633721
GCA_010724455.1-Fun_BLKH01000025.1_i000_004840	128	455	327	0.990909	0.633721
GCA_010724575.1-Fun_BLKI01000025.1_i000_004974	128	455	327	0.990909	0.633721
GCA_010724635.1-Fun_BLKJ01000007.1_i000_002108	128	455	327	0.990909	0.633721
GCA_012656335.1-Fun_JAAAPU010000178.1_i000_002607	128	455	327	0.990909	0.633721
GCA_012656375.1-Fun_JAAAPT010000112.1_i000_000547	128	455	327	0.990909	0.633721
GCA_012656395.1-Fun_JAAAPS010000115.1_i000_000621	128	455	327	0.990909	0.633721
GCA_012656435.1-Fun_JAAAPP010000118.1_i000_000763	128	455	327	0.990909	0.633721
GCA_012656445.1-Fun_JAAAPR010000124.1_i000_001063	128	455	327	0.990909	0.633721
GCA_012656455.1-Fun_JAAAPQ010000119.1_i000_000739	128	455	327	0.990909	0.633721
GCA_001889945.1-Fun_KV878684.1_i000_006645	128	458	330	1	0.635838
GCA_000503235.1-Fun_KI628572.1_i000_002795	139	467	328	0.993939	0.669388
GCA_014281905.1-Fun_JACBAD010001921.1_i000_003285	130	459	329	0.99697	0.637597
GCA_014281935.1-Fun_JACBAF010001944.1_i000_005662	130	459	329	0.99697	0.637597
GCA_019202805.1-Pla_CM032905.1_i000_030474	138	461	323	0.978788	0.616412
GCA_002245815.2-Pla_LHPF02000003.1_i000_005094	123	467	344	1.04242	0.709278
GCA_001632505.1-Ani_LRGB01001361.1_i000_009748	130	460	330	1	0.582011
GCA_905216605.1-Pla_LR999451.1_i000_003716	136	459	323	0.978788	0.616412
GCA_014905175.1-Ani_CM026524.1_i000_007941	128	460	332	1.00606	0.657426
GCA_014300015.1-Ani_CM025008.1_i000_000296	123	446	323	0.978788	0.569665
GCA_003344505.1-Fun_KZ851849.1_i000_004136	128	459	331	1.00303	0.637765
GCA_003427355.1-Ani_BFAA01019326.1_i000_021240	134	455	321	0.972727	0.577338
GCA_905332335.1-Ani_CAJOBX010027779.1_i000_029539	139	462	323	0.978788	0.525203
GCA_020004445.1-Ani_JAATJV010179054.1_i000_003071	124	455	331	1.00303	0.554439
GCA_002573605.1-Fun_PDNA01000056.1_i000_007667	129	460	331	1.00303	0.651575
GCA_004379255.2-Pla_CM031477.1_i000_017060	130	444	314	0.951515	0.704036
GCA_927797965.1-Ani_OV696688.1_i000_006116	124	457	333	1.00909	0.558725
GCA_910591835.1-Fun_CAJVPV010002311.1_i000_004317	122	456	334	1.01212	0.537842
GCA_016906325.1-Fun_RKRL01000042.1_i000_008694	141	462	321	0.972727	0.629412
GCA_018404265.1-Fun_BOPL01000003.1_i000_003505	129	458	329	0.99697	0.637597
GCA_014170095.1-Ani_WKFB01000039.1_i000_002018	74	404	330	1	0.666667
GCA_003018175.1-Ani_PYGN01000356.1_i000_010363	126	458	332	1.00606	0.678937
GCA_016098135.1-Fun_JAAAIZ010000056.1_i000_006893	121	451	330	1	0.642023
GCA_921294245.1-Ani_OV121132.1_i000_001301	115	446	331	1.00303	0.594255
GCA_000230395.2-Fun_ACJE01000013.1_i000_004247	128	459	331	1.00303	0.637765
GCA_000239835.2-Fun_DF126452.1_i000_003036	128	459	331	1.00303	0.637765
GCA_001515345.1-Fun_BCMY01000009.1_i000_005824	128	459	331	1.00303	0.637765
GCA_001602395.1-Fun_BCWF01000018.1_i000_010694	128	459	331	1.00303	0.637765
GCA_001890685.1-Fun_KV878241.1_i000_006433	128	459	331	1.00303	0.637765
GCA_001890745.1-Fun_KV878203.1_i000_007295	128	459	331	1.00303	0.637765
GCA_002211485.2-Fun_NKJJ02000008.1_i000_009879	128	459	331	1.00303	0.637765
GCA_003184595.1-Fun_KZ821339.1_i000_002212	128	459	331	1.00303	0.637765
GCA_003184755.1-Fun_KZ825073.1_i000_009667	128	459	331	1.00303	0.637765
GCA_003184835.1-Fun_KZ824540.1_i000_002935	128	459	331	1.00303	0.637765
GCA_003344705.1-Fun_KZ851947.1_i000_010514	128	459	331	1.00303	0.637765
GCA_003344945.1-Fun_KZ852043.1_i000_005419	128	459	331	1.00303	0.637765
GCA_003850985.1-Fun_BDHI01000021.1_i000_008087	128	459	331	1.00303	0.637765
GCA_013340325.1-Fun_BLWE01000011.1_i000_009580	128	459	331	1.00303	0.637765
GCA_016861625.1-Fun_AP024431.1_i000_010438	128	459	331	1.00303	0.637765
GCA_016865315.1-Fun_AP024440.1_i000_009402	128	459	331	1.00303	0.637765
GCA_900248155.1-Fun_OGUI01000010.1_i000_006933	128	459	331	1.00303	0.637765
GCA_001270105.1-Ani_LHQP01028177.1_i000_036250	129	453	324	0.981818	0.591241
GCA_001443705.1-Ani_LJIG01022687.1_i000_007695	2	308	306	0.927273	0.905325
GCA_012184315.1-Fun_LDDX01000033.1_i000_010075	135	463	328	0.993939	0.606285
GCA_007825345.1-Fun_QGMK01000050.1_i000_000745	141	467	326	0.987879	0.640472
GCA_900079185.1-Fun_LT554895.1_i000_010283	120	452	332	1.00606	0.654832
GCA_021432655.1-Fun_MU271814.1_i000_015755	117	467	350	1.06061	0.724638
GCA_009805615.1-Ani_VIIS01000371.1_i000_004552	124	485	361	1.09394	0.702335
GCA_002104975.1-Fun_MCOG01000296.1_i000_010575	123	455	332	1.00606	0.676171
GCA_016946835.1-Fun_JACVTC010000075.1_i000_024080	123	455	332	1.00606	0.676171
GCA_001445615.2-Fun_BCLY01000004.1_i000_001814	128	454	326	0.987879	0.631783
GCA_001006345.1-Fun_LCWF01000196.1_i000_002701	80	406	326	0.987879	0.680585
GCA_016098105.1-Fun_JAAAIY010000088.1_i000_007994	122	452	330	1	0.645793
GCA_006542485.1-Fun_VIFY01000041.1_i000_005619	131	454	323	0.978788	0.610586
GCA_000751015.1-Pla_LK034306.1_i000_052502	132	459	327	0.990909	0.627639
GCA_003434825.1-Pla_CM010633.1_i000_019187	132	459	327	0.990909	0.627639
GCA_900412535.3-Pla_LS974621.2_i000_026380	132	459	327	0.990909	0.627639
GCA_001641455.1-Pla_LVLJ01002571.1_i000_006001	178	505	327	0.990909	0.529126
GCA_000187875.1-Ani_GL732609.1_i000_018958	128	461	333	1.00909	0.590426
GCA_001014755.1-Fun_LDEV01002583.1_i000_005356	138	461	323	0.978788	0.633333
GCA_013467465.1-Pla_CM025160.1_i000_010656	126	460	334	1.01212	0.625468
GCA_019176455.1-Ani_CM032855.1_i000_002858	132	447	315	0.954545	0.59322
GCA_022201045.1-Pla_CM039163.1_i000_006190	133	457	324	0.981818	0.526829
GCA_000723665.1-Fun_CBTN010000003.1_i000_000974	133	457	324	0.981818	0.648
GCA_001663975.1-Ani_CM004483.1_i000_040764	112	441	329	0.99697	0.692632
GCA_015679585.1-Fun_JAAAVF010001543.1_i000_002414	79	408	329	0.99697	0.692632
GCA_009176455.1-Fun_ML732799.1_i000_006710	128	462	334	1.01212	0.639847
GCA_009193485.1-Fun_ML738625.1_i000_005987	128	462	334	1.01212	0.639847
GCA_011066845.1-Fun_JAABOJ010000054.1_i000_009100	129	460	331	1.00303	0.594255
GCA_900059795.1-Pla_HG974431.1_i000_012236	125	458	333	1.00909	0.594643
GCA_016881025.1-Ani_JAESOR010003700.1_i000_018216	128	457	329	0.99697	0.551089
GCA_022085475.1-Pla_JAIUZE010008707.1_i000_009796	132	457	325	0.984848	0.583483
GCA_002572885.1-Fun_PDNC01000054.1_i000_005880	139	465	326	0.987879	0.639216
GCA_015679405.1-Fun_JAAAUU010000110.1_i000_000640	121	449	328	0.993939	0.640625
GCA_016098005.1-Fun_JAAAIS010000295.1_i000_005510	121	449	328	0.993939	0.640625
GCA_003184785.1-Fun_KZ824830.1_i000_009569	138	463	325	0.984848	0.625
GCA_011068445.1-Fun_JAAGKP010000016.1_i000_002853	130	461	331	1.00303	0.594255
GCA_004354835.1-Ani_CM014938.1_i000_003836	150	481	331	1.00303	0.558179
GCA_019512145.1-Ani_CM033648.1_i000_015547	114	447	333	1.00909	0.624765
GCA_003260565.1-Fun_QKRW01000013.1_i000_003965	145	465	320	0.969697	0.620155
GCA_003427335.1-Ani_BEZZ01000489.1_i000_011528	132	445	313	0.948485	0.595057
GCA_003325415.1-Fun_PJQM01002968.1_i000_008120	119	452	333	1.00909	0.69375
GCA_007825325.1-Fun_QGMG01000084.1_i000_001677	133	465	332	1.00606	0.665331
GCA_003357145.1-Fun_NPIC01000011.1_i000_004475	144	464	320	0.969697	0.626223
GCA_003369665.1-Fun_PDLM01000010.1_i000_002297	139	464	325	0.984848	0.642292
GCA_001005745.2-Ani_JARO02001644.1_i000_005520	125	454	329	0.99697	0.583333
GCA_001204775.2-Fun_JNOM01000053.1_i000_003308	128	459	331	1.00303	0.6341
GCA_009176395.1-Fun_ML734289.1_i000_006119	128	459	331	1.00303	0.6341
GCA_009193645.1-Fun_ML736749.1_i000_002803	128	459	331	1.00303	0.6341
GCA_014905635.1-Pla_CM026547.1_i000_000687	122	458	336	1.01818	0.687117
GCA_012184305.1-Fun_LDUB01000189.1_i000_004037	129	460	331	1.00303	0.587922
GCA_020499035.1-Fun_JAIBQD010000707.1_i000_008582	128	451	323	0.978788	0.714602
GCA_020499245.1-Fun_JAIBQI010001268.1_i000_001241	128	451	323	0.978788	0.714602
GCA_020499355.1-Fun_JAIBQU010000892.1_i000_009266	128	451	323	0.978788	0.714602
GCA_020500235.1-Fun_JAIBSM010000244.1_i000_004348	128	451	323	0.978788	0.714602
GCA_020501355.1-Fun_JAIBUQ010000493.1_i000_006949	128	451	323	0.978788	0.714602
GCA_020502385.1-Fun_JAIBWO010001019.1_i000_000205	128	451	323	0.978788	0.714602
GCA_000005425.2-Pla_AP008209.2_i000_008783	125	460	335	1.01515	0.606884
GCA_000149285.1-Pla_CM000140.1_i000_010334	125	460	335	1.01515	0.606884
GCA_001433935.1-Pla_AP014959.1_i000_012757	125	460	335	1.01515	0.606884
GCA_009797565.1-Pla_CM020523.1_i000_010571	125	460	335	1.01515	0.606884
GCA_014170095.1-Ani_WKFB01000039.1_i000_002010	113	445	332	1.00606	0.619403
GCA_001661175.1-Pla_LSRQ01001480.1_i000_008472	86	420	334	1.01212	0.651072
GCA_001185155.1-Pla_LFYR01000981.1_i000_006472	124	458	334	1.01212	0.572899
GCA_019059645.1-Ani_JAFELL010003276.1_i000_029436	134	448	314	0.951515	0.591337
GCA_000004655.2-Pla_CM000128.1_i000_011117	125	462	337	1.02121	0.610507
GCA_015473125.1-Pla_BNJQ01000029.1_i000_009123	231	557	326	0.987879	0.541528
GCA_016861865.1-Fun_AP024445.1_i000_005061	127	458	331	1.00303	0.658052
GCA_016771965.1-Pla_CM028692.1_i000_025505	132	458	326	0.987879	0.646825
GCA_004354835.1-Ani_CM014958.1_i000_021153	122	446	324	0.981818	0.610169
GCA_004007595.1-Pla_CM012943.1_i000_010163	125	460	335	1.01515	0.59292
GCA_010015445.1-Ani_CM020932.1_i000_023781	122	446	324	0.981818	0.609023
GCA_003184535.1-Fun_MSFU01000013.1_i000_001932	131	459	328	0.993939	0.631985
GCA_004379255.2-Pla_CM031492.1_i000_051151	164	474	310	0.939394	0.648536
GCA_005125345.1-Ani_RWIC01000160.1_i000_005484	125	455	330	1	0.697674
GCA_001411555.2-Pla_CM023842.1_i000_003319	126	460	334	1.01212	0.606171
GCA_015529785.1-Fun_JAAAUK010001547.1_i000_002507	121	448	327	0.990909	0.639922
GCA_000388065.2-Pro_KB932209.1_i000_004859	120	453	333	1.00909	0.671371
GCA_003788565.2-Fun_ML119685.1_i000_007609	139	461	322	0.975758	0.632613
GCA_009193585.1-Fun_ML737573.1_i000_001462	131	461	330	1	0.632184
GCA_009193665.1-Fun_ML735742.1_i000_006906	131	461	330	1	0.632184
GCA_000346795.1-Fun_KB644412.1_i000_004951	139	462	323	0.978788	0.628405
GCA_021218885.1-Ani_MU269961.1_i000_008136	127	455	328	0.993939	0.551261
GCA_901343595.1-Ani_CABDUW010000015.1_i000_001135	127	455	328	0.993939	0.551261
GCA_015679485.1-Fun_JAAAUY010000300.1_i000_005296	121	453	332	1.00606	0.652259
GCA_009746105.1-Pla_CM019264.1_i000_000550	131	464	333	1.00909	0.596774
GCA_015680635.1-Fun_JAABOA010001080.1_i000_004412	121	452	331	1.00303	0.641473
GCA_000006275.3-Fun_AAIH03000072.1_i000_001360	128	462	334	1.01212	0.639847
GCA_000184455.3-Fun_BA000049.1_i000_000926	128	462	334	1.01212	0.639847
GCA_000952835.1-Fun_JZDT01000200.1_i000_000948	128	462	334	1.01212	0.639847
GCA_002007945.1-Fun_MKZY01000002.1_i000_001849	128	462	334	1.01212	0.639847
GCA_002443195.2-Fun_NWUI02000293.1_i000_003605	128	462	334	1.01212	0.639847
GCA_002443215.2-Fun_NWUG02001141.1_i000_005471	128	462	334	1.01212	0.639847
GCA_002456175.2-Fun_NWUH02000014.1_i000_006033	128	462	334	1.01212	0.639847
GCA_009017415.1-Fun_CP044619.1_i000_001325	128	462	334	1.01212	0.639847
GCA_014117465.1-Fun_CP059866.1_i000_000920	128	462	334	1.01212	0.639847
GCA_014117485.1-Fun_CP059858.1_i000_000995	128	462	334	1.01212	0.639847
GCA_000005005.6-Pla_CM007647.1_i000_001556	126	460	334	1.01212	0.608379
GCA_008369825.1-Ani_CM017898.1_i000_005263	124	454	330	1	0.620301
GCA_002104975.1-Fun_MCOG01000039.1_i000_013211	122	454	332	1.00606	0.676171
GCA_016946835.1-Fun_JACVTC010000072.1_i000_023612	122	454	332	1.00606	0.676171
GCA_011066875.1-Fun_JAABOE010000017.1_i000_003308	128	459	331	1.00303	0.61183
GCA_000092065.1-Pla_CP000588.1_i000_003726	123	459	336	1.01818	0.713376
GCA_000263155.2-Pla_CM003529.1_i000_008020	179	515	336	1.01818	0.557214
GCA_005223365.2-Pla_SPHZ02000012.1_i000_038429	125	460	335	1.01515	0.607985
GCA_902713445.1-Pla_CACTIH010003849.1_i000_038381	129	457	328	0.993939	0.59745
GCA_001483705.1-Ani_KQ762400.1_i000_007066	101	433	332	1.00606	0.709402
GCA_002846915.2-Fun_MSFN02000010.1_i000_002107	144	461	317	0.960606	0.602662
GCA_900079185.1-Fun_LT554356.1_i000_005725	134	461	327	0.990909	0.634951
GCA_000986665.1-Fun_JYKN01002707.1_i000_003786	130	442	312	0.945455	0.609375
GCA_013389885.1-Ani_VWPV01018733.1_i000_006523	1	291	290	0.878788	0.749354
GCA_002072405.1-Fun_MDDG01000001.1_i000_000781	138	459	321	0.972727	0.62818
GCA_015502565.1-Fun_JAAAUS010000188.1_i000_002321	121	450	329	0.99697	0.636364
GCA_002837095.1-Pla_PGOL01004226.1_i000_041541	133	460	327	0.990909	0.587074
GCA_004768765.1-Fun_SOZJ01000002.1_i000_002996	128	460	332	1.00606	0.599278
GCA_011066565.1-Fun_WIRA01000002.1_i000_003966	128	460	332	1.00606	0.599278
GCA_011066575.1-Fun_WIQW01000045.1_i000_007641	128	460	332	1.00606	0.599278
GCA_011066585.1-Fun_WIQY01000064.1_i000_009598	128	460	332	1.00606	0.599278
GCA_011066595.1-Fun_WIQZ01000058.1_i000_008395	128	460	332	1.00606	0.599278
GCA_011066605.1-Fun_WIQX01000018.1_i000_003760	128	460	332	1.00606	0.599278
GCA_011066695.1-Fun_WIRB01000039.1_i000_006877	128	460	332	1.00606	0.599278
GCA_011066715.1-Fun_WIWQ01000010.1_i000_000391	128	460	332	1.00606	0.599278
GCA_011066735.1-Fun_JAABOI010000019.1_i000_003715	128	460	332	1.00606	0.599278
GCA_011066745.1-Fun_JAABOH010000035.1_i000_006455	128	460	332	1.00606	0.599278
GCA_011066795.1-Fun_WIWR01000033.1_i000_005933	128	460	332	1.00606	0.599278
GCA_011067015.1-Fun_JAABLO010000014.1_i000_002332	128	460	332	1.00606	0.599278
GCA_007726485.1-Pla_RWGY01000913.1_i000_054621	122	461	339	1.02727	0.61413
GCA_018127125.1-Pla_CM030795.1_i000_024232	131	464	333	1.00909	0.595707
GCA_016098155.1-Fun_JAAAJB010000237.1_i000_003301	121	451	330	1	0.638298
GCA_011066885.1-Fun_WIWS01000017.1_i000_003213	128	461	333	1.00909	0.607664
GCA_011066905.1-Fun_WIWT01000042.1_i000_007266	128	461	333	1.00909	0.607664
GCA_011066925.1-Fun_WIPF01000045.1_i000_007230	128	461	333	1.00909	0.607664
GCA_011066985.1-Fun_WIPG01000002.1_i000_004139	128	461	333	1.00909	0.607664
GCA_903813345.1-Ani_CAIIXF010000001.1_i000_002324	126	459	333	1.00909	0.644101
GCA_001792695.1-Fun_LYCR01000038.1_i000_005612	130	462	332	1.00606	0.636015
GCA_000003855.2-Fun_GG657448.1_i000_000463	131	434	303	0.918182	0.696552
GCA_015529505.1-Fun_JAAAUI010000044.1_i000_006337	121	449	328	0.993939	0.644401
GCA_015529515.1-Fun_JAAAUJ010000074.1_i000_008733	121	449	328	0.993939	0.644401
GCA_002847465.1-Fun_MSZS01000006.1_i000_009418	129	460	331	1.00303	0.641473
GCA_003614145.1-Fun_KZ987821.1_i000_000975	125	458	333	1.00909	0.705508
GCA_004379255.2-Pla_CM031493.1_i000_052912	137	458	321	0.972727	0.625731
GCA_001661175.1-Pla_LSRQ01004843.1_i000_017538	124	459	335	1.01515	0.605787
GCA_005223365.2-Pla_SPHZ02000007.1_i000_024863	126	460	334	1.01212	0.603978
GCA_013400535.1-Ani_VZTL01044801.1_i000_006573	56	406	350	1.06061	0.715746
GCA_016098015.1-Fun_JAAAIT010001534.1_i000_002226	121	451	330	1	0.642023
GCA_016098165.1-Fun_JAAAJA010000305.1_i000_004585	123	449	326	0.987879	0.637965
GCA_000375325.1-Pla_KB870807.1_i000_008114	129	457	328	0.993939	0.65996
GCA_000334495.1-Ani_KB364366.1_i000_017357	73	400	327	0.990909	0.605556
GCA_000149645.3-Fun_DS027690.1_i000_006225	130	458	328	0.993939	0.635659
GCA_016748045.1-Fun_WHVT01000010.1_i000_000299	130	458	328	0.993939	0.635659
GCA_014462685.1-Ani_JAACXV010000399.1_i000_008685	120	445	325	0.984848	0.575221
GCA_000751015.1-Pla_LK032004.1_i000_003227	132	457	325	0.984848	0.633528
GCA_006346445.1-Ani_VEVO01000002.1_i000_002799	133	447	314	0.951515	0.591337
GCA_003185045.1-Pla_CM009906.1_i000_001505	126	460	334	1.01212	0.612844
GCA_007821545.1-Fun_QGMJ01000405.1_i000_005260	139	468	329	0.99697	0.654076
GCA_016861735.1-Fun_AP024417.1_i000_002847	131	457	326	0.987879	0.628131
GCA_012656225.1-Fun_JAAAPY010000150.1_i000_002024	128	458	330	1	0.635838
GCA_012656285.1-Fun_JAAAPX010000138.1_i000_001626	128	458	330	1	0.635838
GCA_012656295.1-Fun_JAAAPW010000152.1_i000_002137	128	458	330	1	0.635838
GCA_012656325.1-Fun_JAAAPV010000157.1_i000_002321	128	458	330	1	0.635838
GCA_019650175.1-Pla_BNCO01000004.1_i000_002251	120	469	349	1.05758	0.691089
GCA_016097945.1-Fun_JAAAIR010000044.1_i000_005416	120	448	328	0.993939	0.700855
GCA_003999625.1-Ani_CM012441.1_i000_003845	151	482	331	1.00303	0.530449
GCA_000002715.1-Fun_DS027056.1_i000_003277	129	460	331	1.00303	0.642718
GCA_005286985.1-Pla_CM016553.1_i000_008960	179	515	336	1.01818	0.557214
GCA_000149925.1-Fun_DS178276.1_i000_010345	124	456	332	1.00606	0.598198
GCA_008520325.1-Fun_VDEP01000005.1_i000_001497	124	456	332	1.00606	0.598198
GCA_008520325.1-Fun_VDEP01000206.1_i000_015048	124	456	332	1.00606	0.598198
GCA_008522505.1-Fun_VSWC01000016.1_i000_005594	124	456	332	1.00606	0.598198
GCA_008522505.1-Fun_VSWC01000184.1_i000_033802	124	456	332	1.00606	0.598198
GCA_013400975.1-Ani_WBMZ01003497.1_i000_002907	64	382	318	0.963636	0.665272
GCA_000355655.1-Ani_KB741211.1_i000_010531	122	454	332	1.00606	0.6171
GCA_000346045.2-Ani_KB632263.1_i000_008234	122	454	332	1.00606	0.61825
GCA_015679595.1-Fun_JAAAVB010000877.1_i000_011352	124	449	325	0.984848	0.638507
GCA_020379485.1-Pla_CM035458.1_i000_057709	141	469	328	0.993939	0.615385
GCA_019202795.1-Pla_CM032920.1_i000_034448	129	452	323	0.978788	0.647295
GCA_002105175.1-Fun_MCGE01000004.1_i000_009779	128	448	320	0.969697	0.646465
GCA_013400775.1-Ani_VZTR01003775.1_i000_001510	55	358	303	0.918182	0.846369
GCA_002249905.1-Ani_NNAY01001214.1_i000_007587	147	478	331	1.00303	0.637765
GCA_000258705.1-Pla_AGSI01000013.1_i000_006651	133	457	324	0.981818	0.580645
GCA_905216605.1-Pla_LR999453.1_i000_006970	124	452	328	0.993939	0.65996
GCA_007825375.1-Fun_QGML01000033.1_i000_000378	133	465	332	1.00606	0.661355
GCA_001974825.1-Pla_AWUE01019747.1_i000_025601	131	459	328	0.993939	0.681913
GCA_003186165.1-Ani_CP026243.1_i000_000070	134	444	310	0.939394	0.373045
GCA_006547085.1-Pla_VIEB01001477.1_i000_042515	122	459	337	1.02121	0.514504
GCA_019722365.1-Pla_JADFUC010000514.1_i000_014692	124	459	335	1.01515	0.649225
GCA_001972305.1-Pla_BDDD01000624.1_i000_011734	132	461	329	0.99697	0.629063
GCA_003999625.1-Ani_CM012438.1_i000_001515	117	445	328	0.993939	0.61194
GCA_014773175.1-Ani_VXCM01000848.1_i000_006789	126	455	329	0.99697	0.567241
GCA_015679535.1-Fun_JAAAUX010000215.1_i000_003688	122	449	327	0.990909	0.639922
GCA_016098035.1-Fun_JAAAIV010000027.1_i000_004154	948	1271	323	0.978788	0.241586
GCA_000769735.1-Fun_JQFY01000144.1_i000_001008	135	458	323	0.978788	0.632094
GCA_000769745.1-Fun_JQFZ01000170.1_i000_005124	135	458	323	0.978788	0.632094
GCA_000769755.1-Fun_JQFX01000717.1_i000_002519	135	458	323	0.978788	0.632094
GCA_016808215.1-Pla_CM029006.1_i000_022280	128	460	332	1.00606	0.602541
GCA_018689175.1-Pla_CM031851.1_i000_021256	128	460	332	1.00606	0.602541
GCA_900005705.1-Ani_HG973536.1_i000_001676	129	463	334	1.01212	0.608379
GCA_013054445.1-Fun_JAAMPI010000139.1_i000_002661	138	464	326	0.987879	0.635478
GCA_007990455.1-Pla_CM017642.1_i000_033104	129	461	332	1.00606	0.622889
GCA_013396355.1-Ani_VWPS01000834.1_i000_013418	62	386	324	0.981818	0.661224
GCA_007821495.1-Fun_QGMH01000122.1_i000_006559	139	468	329	0.99697	0.654076
GCA_020726485.1-Fun_JAHEWH010000007.1_i000_016107	142	460	318	0.963636	0.621094
GCA_002873125.1-Fun_PGCI01000042.1_i000_004486	132	455	323	0.978788	0.628405
GCA_013677265.1-Pla_CM025232.1_i000_000357	59	390	331	1.00303	0.742152
GCA_019722365.1-Pla_JADFUC010002331.1_i000_021610	123	460	337	1.02121	0.644359
GCA_000225545.1-Fun_JH119053.1_i000_003297	127	459	332	1.00606	0.59605
GCA_000315645.2-Fun_JH993675.1_i000_007605	130	460	330	1	0.642023
GCA_000315665.1-Fun_JH993736.1_i000_006669	130	460	330	1	0.642023
GCA_012295545.2-Fun_JAAQRF020000011.1_i000_001706	130	460	330	1	0.642023
GCA_016767815.1-Fun_CP060774.1_i000_001521	130	460	330	1	0.642023
GCA_013677275.1-Pla_JABFAF010274546.1_i000_026101	59	389	330	1	0.712743
GCA_015529505.1-Fun_JAAAUI010000042.1_i000_006129	122	447	325	0.984848	0.632296
GCA_001651475.1-Pla_CM004359.1_i000_004603	131	458	327	0.990909	0.626437
GCA_019202795.1-Pla_CM032913.1_i000_004558	131	458	327	0.990909	0.626437
GCA_019202805.1-Pla_CM032900.1_i000_004434	131	458	327	0.990909	0.626437
GCA_902651935.1-Pla_CACRSJ010000104.1_i000_004753	131	458	327	0.990909	0.626437
GCA_902705455.1-Pla_CACSHJ010000087.1_i000_004640	131	458	327	0.990909	0.626437
GCA_020498725.1-Fun_JAIBPO010000177.1_i000_002725	129	454	325	0.984848	0.626204
GCA_020498735.1-Fun_JAIBPN010000193.1_i000_002856	129	454	325	0.984848	0.626204
GCA_020498745.1-Fun_JAIBPM010000215.1_i000_003571	129	454	325	0.984848	0.626204
GCA_020498905.1-Fun_JAIBPX010000047.1_i000_006500	129	454	325	0.984848	0.626204
GCA_020498945.1-Fun_JAIBPY010000162.1_i000_002471	129	454	325	0.984848	0.626204
GCA_020498985.1-Fun_JAIBQA010000156.1_i000_002264	129	454	325	0.984848	0.626204
GCA_020499075.1-Fun_JAIBQF010000193.1_i000_003113	129	454	325	0.984848	0.626204
GCA_020499135.1-Fun_JAIBQJ010000199.1_i000_003299	129	454	325	0.984848	0.626204
GCA_020499475.1-Fun_JAIBQZ010000194.1_i000_002875	129	454	325	0.984848	0.626204
GCA_020499565.1-Fun_JAIBRD010000196.1_i000_003089	129	454	325	0.984848	0.626204
GCA_020499585.1-Fun_JAIBRG010000223.1_i000_003838	129	454	325	0.984848	0.626204
GCA_020499695.1-Fun_JAIBRY010000160.1_i000_002507	129	454	325	0.984848	0.626204
GCA_020499715.1-Fun_JAIBSB010000151.1_i000_002341	129	454	325	0.984848	0.626204
GCA_020499975.1-Fun_JAIBRN010000173.1_i000_002856	129	454	325	0.984848	0.626204
GCA_020499985.1-Fun_JAIBRO010000048.1_i000_006413	129	454	325	0.984848	0.626204
GCA_020499995.1-Fun_JAIBRP010000175.1_i000_002912	129	454	325	0.984848	0.626204
GCA_020500025.1-Fun_JAIBRQ010000317.1_i000_004977	129	454	325	0.984848	0.626204
GCA_020500065.1-Fun_JAIBRT010000250.1_i000_004179	129	454	325	0.984848	0.626204
GCA_020500075.1-Fun_JAIBRR010000368.1_i000_005892	129	454	325	0.984848	0.626204
GCA_020500105.1-Fun_JAIBRU010000037.1_i000_005904	129	454	325	0.984848	0.626204
GCA_020500165.1-Fun_JAIBRW010000191.1_i000_003068	129	454	325	0.984848	0.626204
GCA_020500195.1-Fun_JAIBRX010000218.1_i000_003842	129	454	325	0.984848	0.626204
GCA_020500205.1-Fun_JAIBSJ010000010.1_i000_000360	129	454	325	0.984848	0.626204
GCA_020500275.1-Fun_JAIBSO010000167.1_i000_002610	129	454	325	0.984848	0.626204
GCA_020500485.1-Fun_JAIBSZ010000162.1_i000_002528	129	454	325	0.984848	0.626204
GCA_020500545.1-Fun_JAIBTC010000242.1_i000_003783	129	454	325	0.984848	0.626204
GCA_020500765.1-Fun_JAIBTA010000148.1_i000_001988	129	454	325	0.984848	0.626204
GCA_020500775.1-Fun_JAIBTM010000020.1_i000_003397	129	454	325	0.984848	0.626204
GCA_020500865.1-Fun_JAIBTS010000148.1_i000_002162	129	454	325	0.984848	0.626204
GCA_020500935.1-Fun_JAIBTU010000139.1_i000_001700	129	454	325	0.984848	0.626204
GCA_020500995.1-Fun_JAIBTY010000188.1_i000_002864	129	454	325	0.984848	0.626204
GCA_020501095.1-Fun_JAIBUC010000182.1_i000_002964	129	454	325	0.984848	0.626204
GCA_020501105.1-Fun_JAIBUE010000195.1_i000_003206	129	454	325	0.984848	0.626204
GCA_020501185.1-Fun_JAIBUI010000169.1_i000_002620	129	454	325	0.984848	0.626204
GCA_020501255.1-Fun_JAIBUO010000226.1_i000_003799	129	454	325	0.984848	0.626204
GCA_020501335.1-Fun_JAIBUN010000191.1_i000_003088	129	454	325	0.984848	0.626204
GCA_020501545.1-Fun_JAIBUZ010000198.1_i000_003017	129	454	325	0.984848	0.626204
GCA_020501555.1-Fun_JAIBVA010000191.1_i000_003022	129	454	325	0.984848	0.626204
GCA_020501575.1-Fun_JAIBVB010000184.1_i000_002974	129	454	325	0.984848	0.626204
GCA_020501605.1-Fun_JAIBVC010000046.1_i000_006424	129	454	325	0.984848	0.626204
GCA_020501645.1-Fun_JAIBVF010000173.1_i000_002749	129	454	325	0.984848	0.626204
GCA_020501715.1-Fun_JAIBVH010000186.1_i000_002886	129	454	325	0.984848	0.626204
GCA_020501805.1-Fun_JAIBVM010000180.1_i000_002788	129	454	325	0.984848	0.626204
GCA_020501885.1-Fun_JAIBVR010000171.1_i000_002631	129	454	325	0.984848	0.626204
GCA_020501895.1-Fun_JAIBVQ010000183.1_i000_002876	129	454	325	0.984848	0.626204
GCA_020502025.1-Fun_JAIBVX010000175.1_i000_002764	129	454	325	0.984848	0.626204
GCA_020502035.1-Fun_JAIBVY010000196.1_i000_003339	129	454	325	0.984848	0.626204
GCA_020502225.1-Fun_JAIBWH010000187.1_i000_002886	129	454	325	0.984848	0.626204
GCA_020502325.1-Fun_JAIBWK010000182.1_i000_002900	129	454	325	0.984848	0.626204
GCA_020502375.1-Fun_JAIBWN010000194.1_i000_003063	129	454	325	0.984848	0.626204
GCA_020502455.1-Fun_JAIBWR010000196.1_i000_003065	129	454	325	0.984848	0.626204
GCA_020502495.1-Fun_JAIBWT010000253.1_i000_004375	129	454	325	0.984848	0.626204
GCA_020502575.1-Fun_JAIBWW010000197.1_i000_003092	129	454	325	0.984848	0.626204
GCA_020502625.1-Fun_JAIBXA010000201.1_i000_003360	129	454	325	0.984848	0.626204
GCA_020502715.1-Fun_JAIBXE010000203.1_i000_003376	129	454	325	0.984848	0.626204
GCA_020502875.1-Fun_JAIBXG010000207.1_i000_003326	129	454	325	0.984848	0.626204
GCA_020503065.1-Fun_JAIBXL010000188.1_i000_003002	129	454	325	0.984848	0.626204
GCA_020503095.1-Fun_JAIBXN010000180.1_i000_002687	129	454	325	0.984848	0.626204
GCA_020503205.1-Fun_JAIBXS010000214.1_i000_003665	129	454	325	0.984848	0.626204
GCA_020503365.1-Fun_JAIBYA010000194.1_i000_003141	129	454	325	0.984848	0.626204
GCA_020503395.1-Fun_JAIBYC010000186.1_i000_002766	129	454	325	0.984848	0.626204
GCA_020503435.1-Fun_JAIBYE010000188.1_i000_002990	129	454	325	0.984848	0.626204
GCA_020503515.1-Fun_JAIBYH010000256.1_i000_004352	129	454	325	0.984848	0.626204
GCA_020503635.1-Fun_JAIBYN010000268.1_i000_004325	129	454	325	0.984848	0.626204
GCA_020503725.1-Fun_JAIBYS010000186.1_i000_002966	129	454	325	0.984848	0.626204
GCA_020503735.1-Fun_JAIBYT010000155.1_i000_002267	129	454	325	0.984848	0.626204
GCA_020503825.1-Fun_JAIBYY010000199.1_i000_003384	129	454	325	0.984848	0.626204
GCA_020503885.1-Fun_JAIBYZ010000171.1_i000_002931	129	454	325	0.984848	0.626204
GCA_019176455.1-Ani_CM032857.1_i000_005085	131	456	325	0.984848	0.573192
GCA_013634535.1-Ani_JACDTQ010000823.1_i000_018682	141	473	332	1.00606	0.540717
GCA_009193565.1-Fun_ML739191.1_i000_006040	131	461	330	1	0.632184
GCA_004303085.2-Pla_SDAM02000105.1_i000_008585	134	458	324	0.981818	0.623077
GCA_003550305.1-Fun_QKYT01000095.1_i000_020688	122	455	333	1.00909	0.5
GCA_020536995.1-Ani_CM035922.1_i000_117881	55	390	335	1.01515	0.717345
GCA_020496765.1-Pla_CM035620.1_i000_000674	129	458	329	0.99697	0.623106
GCA_021365295.1-Fun_JAJTIW010000019.1_i000_004310	142	464	322	0.975758	0.628906
GCA_013358835.1-Ani_JABSTQ010010062.1_i000_015920	147	448	301	0.912121	0.671875
GCA_015679405.1-Fun_JAAAUU010000052.1_i000_008306	124	449	325	0.984848	0.638507
GCA_004119915.2-Ani_CM014078.1_i000_000239	131	446	315	0.954545	0.590994
GCA_905250105.1-Ani_CAJNOC010000567.1_i000_005272	112	441	329	0.99697	0.726269
GCA_016098005.1-Fun_JAAAIS010000851.1_i000_011026	97	421	324	0.981818	0.676409
GCA_000230445.1-Ani_JH168482.1_i000_007067	128	454	326	0.987879	0.547899
GCA_022085475.1-Pla_JAIUZE010021015.1_i000_012945	131	456	325	0.984848	0.605214
GCA_013487665.1-Pla_CM025180.1_i000_000414	9	311	302	0.915152	0.967949
GCA_011752425.2-Ani_CACVKT020004335.1_i000_024417	121	445	324	0.981818	0.621881
GCA_002572855.1-Fun_PDND01000012.1_i000_000944	131	462	331	1.00303	0.650295
GCA_019512045.2-Pla_QIYW02000003.1_i000_009712	134	460	326	0.987879	0.62572
GCA_001625215.1-Pla_CM004283.1_i000_020979	130	462	332	1.00606	0.59605
GCA_011764265.1-Fun_JAANRE010008462.1_i000_010834	42	365	323	0.978788	0.785888
GCA_000803125.3-Ani_CM016645.2_i000_014627	69	401	332	1.00606	0.613678
GCA_017524585.1-Ani_CM029831.1_i000_012196	128	456	328	0.993939	0.550336
GCA_910592215.1-Fun_CAJVPN010000071.1_i000_000968	124	414	290	0.878788	0.700483
GCA_910592255.1-Fun_CAJVPO010002354.1_i000_009951	124	414	290	0.878788	0.700483
GCA_020501405.1-Fun_JAIBUS010000179.1_i000_002853	129	458	329	0.99697	0.612663
GCA_014281895.1-Fun_JACBAE010001174.1_i000_003961	135	456	321	0.972727	0.622093
GCA_014281915.1-Fun_JACBAG010001878.1_i000_007388	135	456	321	0.972727	0.622093
GCA_020499785.1-Fun_JAIBSE010000170.1_i000_002794	134	458	324	0.981818	0.617143
GCA_020499935.1-Fun_JAIBRM010000198.1_i000_003242	134	458	324	0.981818	0.617143
GCA_020501045.1-Fun_JAIBUA010000182.1_i000_002862	134	458	324	0.981818	0.617143
GCA_020510485.1-Fun_JAIBQR010000150.1_i000_002086	134	458	324	0.981818	0.617143
GCA_000471905.1-Pla_KI393866.1_i000_013811	122	463	341	1.03333	0.613309
GCA_009176365.1-Fun_ML733125.1_i000_011515	128	457	329	0.99697	0.633911
GCA_009193605.1-Fun_ML735276.1_i000_008137	128	457	329	0.99697	0.633911
GCA_013421405.2-Fun_SPNV01000206.1_i000_004341	128	457	329	0.99697	0.633911
GCA_001625215.1-Pla_CM004282.1_i000_015916	129	460	331	1.00303	0.594255
GCA_019669835.1-Fun_MU251683.1_i000_009466	142	463	321	0.972727	0.618497
GCA_001675575.1-Ani_LZPO01117186.1_i000_023879	123	444	321	0.972727	0.554404
GCA_016771965.1-Pla_CM028702.1_i000_081148	130	457	327	0.990909	0.627639
GCA_015679485.1-Fun_JAAAUY010000484.1_i000_007477	121	449	328	0.993939	0.641879
GCA_000412655.1-Ani_KE163658.1_i000_011931	121	450	329	0.99697	0.559524
GCA_016618375.1-Pro_JADEVP010000007.1_i000_020224	124	459	335	1.01515	0.653021
GCA_001078395.2-Fun_BBXM02000002.1_i000_002690	131	452	321	0.972727	0.622093
GCA_010723835.1-Fun_BLKC01000085.1_i000_008991	131	452	321	0.972727	0.622093
GCA_010724135.1-Fun_BLKE01000079.1_i000_004780	131	452	321	0.972727	0.622093
GCA_010724255.1-Fun_BLKF01000071.1_i000_007166	131	452	321	0.972727	0.622093
GCA_010724335.1-Fun_BLKG01000098.1_i000_007386	131	452	321	0.972727	0.622093
GCA_010724795.1-Fun_BLKK01000121.1_i000_005389	131	452	321	0.972727	0.622093
GCA_000751015.1-Pla_LK033727.1_i000_049969	132	458	326	0.987879	0.63301
GCA_020379485.1-Pla_CM035461.1_i000_070270	132	458	326	0.987879	0.63301
GCA_012274485.2-Pla_MU108389.1_i000_046498	131	459	328	0.993939	0.633205
GCA_000149755.2-Pro_JH159152.1_i000_005247	122	457	335	1.01515	0.647969
GCA_905146905.1-Ani_CAJHUB010000653.1_i000_002381	133	457	324	0.981818	0.542714
GCA_020501445.1-Fun_JAIBUU010000196.1_i000_003322	131	460	329	0.99697	0.626667
GCA_020502425.1-Fun_JAIBWP010000028.1_i000_004901	131	460	329	0.99697	0.626667
GCA_020503165.1-Fun_JAIBXQ010000119.1_i000_000945	131	460	329	0.99697	0.626667
GCA_012184295.1-Fun_LDUD01000131.1_i000_003266	129	461	332	1.00606	0.6171
GCA_000004335.1-Ani_GL192628.1_i000_005781	125	455	330	1	0.552764
GCA_000985935.1-Fun_CVMT01000002.1_i000_002663	132	450	318	0.963636	0.625984
GCA_000002335.3-Ani_CM000278.3_i000_003149	116	446	330	1	0.593525
GCA_010015445.1-Ani_CM020912.1_i000_003623	66	395	329	0.99697	0.648915
GCA_013841205.1-Ani_JACDQY010000123.1_i000_006112	115	443	328	0.993939	0.567474
GCA_013841245.2-Ani_CM034066.1_i000_003817	115	443	328	0.993939	0.567474
GCA_014108245.1-Ani_JACAGB010000006.1_i000_016231	124	452	328	0.993939	0.556876
GCA_002234965.2-Fun_NKHV02000049.1_i000_006652	128	454	326	0.987879	0.635478
GCA_002234975.2-Fun_NIDN02000023.1_i000_003960	128	454	326	0.987879	0.635478
GCA_007821535.1-Fun_QGMI01000364.1_i000_005201	136	468	332	1.00606	0.66004
GCA_000401635.1-Fun_KE123950.1_i000_004680	130	455	325	0.984848	0.659229
GCA_014108235.1-Ani_JABWUV010000009.1_i000_020955	127	456	329	0.99697	0.553872
GCA_007990325.1-Pla_CM017694.1_i000_034728	129	460	331	1.00303	0.621013
GCA_002873275.1-Fun_PGCJ01000110.1_i000_007786	124	457	333	1.00909	0.474359
GCA_005393395.2-Pla_CM016620.1_i000_013629	129	458	329	0.99697	0.617261
GCA_000327365.1-Pla_CM001740.1_i000_000611	129	460	331	1.00303	0.621013
GCA_004000055.1-Fun_SAEB01000012.1_i000_003031	132	464	332	1.00606	0.5918
GCA_905319865.3-Ani_CAJNRD030001114.1_i000_000941	7	337	330	1	0.909091
GCA_013467465.1-Pla_CM025154.1_i000_000381	129	459	330	1	0.619137
GCA_015502485.1-Fun_JAAAUO010002030.1_i000_005223	120	448	328	0.993939	0.649505
GCA_014108255.1-Ani_JACAGC010000023.1_i000_010949	131	452	321	0.972727	0.538591
GCA_000230795.1-Ani_CM001262.1_i000_008847	128	456	328	0.993939	0.552189
GCA_000327345.1-Ani_KB103138.1_i000_004177	130	461	331	1.00303	0.551667
GCA_002105175.1-Fun_MCGE01000023.1_i000_006308	118	448	330	1	0.672098
GCA_019097595.1-Ani_CM032604.1_i000_010227	133	446	313	0.948485	0.566004
GCA_001638945.1-Fun_AMYB01000006.1_i000_007659	132	460	328	0.993939	0.665314
GCA_010203745.1-Fun_JAAECE010000012.1_i000_002476	132	460	328	0.993939	0.665314
GCA_000981605.1-Fun_HF935394.1_i000_003963	144	457	313	0.948485	0.605416
GCA_002891735.1-Pla_PGGS01000433.1_i000_008995	120	456	336	1.01818	0.660118
GCA_008124465.1-Pla_CM017875.1_i000_006869	129	459	330	1	0.589286
GCA_015849325.1-Fun_JAAAIB010000424.1_i000_006254	119	448	329	0.99697	0.650198
GCA_000263155.2-Pla_CM003536.1_i000_032481	125	460	335	1.01515	0.606884
GCA_005286985.1-Pla_CM016560.1_i000_036405	125	460	335	1.01515	0.606884
GCA_000002655.1-Fun_CM000171.1_i000_004036	130	460	330	1	0.632184
GCA_000150145.1-Fun_DS499596.1_i000_005732	130	460	330	1	0.632184
GCA_001029325.1-Fun_KQ087362.1_i000_003402	130	460	330	1	0.632184
GCA_002234955.1-Fun_NKHT01000250.1_i000_004237	130	460	330	1	0.632184
GCA_012656115.1-Fun_JAAAQC010000252.1_i000_003843	130	460	330	1	0.632184
GCA_012656125.1-Fun_JAAAQD010000212.1_i000_003215	130	460	330	1	0.632184
GCA_012656165.1-Fun_JAAAQB010000265.1_i000_003398	130	460	330	1	0.632184
GCA_012656185.1-Fun_JAAAQA010000738.1_i000_007865	130	460	330	1	0.632184
GCA_012656215.1-Fun_JAAAPZ010000249.1_i000_003505	130	460	330	1	0.632184
GCA_020498755.1-Fun_JAIBPP010000189.1_i000_002520	130	460	330	1	0.632184
GCA_020498765.1-Fun_JAIBPQ010000247.1_i000_004029	130	460	330	1	0.632184
GCA_020498815.1-Fun_JAIBPS010000193.1_i000_003452	130	460	330	1	0.632184
GCA_020498895.1-Fun_JAIBPU010000242.1_i000_003922	130	460	330	1	0.632184
GCA_020498965.1-Fun_JAIBPZ010000137.1_i000_001629	130	460	330	1	0.632184
GCA_020499005.1-Fun_JAIBQC010000314.1_i000_005565	130	460	330	1	0.632184
GCA_020499015.1-Fun_JAIBQB010000173.1_i000_002918	130	460	330	1	0.632184
GCA_020499045.1-Fun_JAIBQE010000264.1_i000_004367	130	460	330	1	0.632184
GCA_020499115.1-Fun_JAIBQG010000203.1_i000_003555	130	460	330	1	0.632184
GCA_020499185.1-Fun_JAIBQL010000226.1_i000_003904	130	460	330	1	0.632184
GCA_020499195.1-Fun_JAIBQM010000223.1_i000_003784	130	460	330	1	0.632184
GCA_020499225.1-Fun_JAIBQN010000210.1_i000_003617	130	460	330	1	0.632184
GCA_020499325.1-Fun_JAIBQS010000209.1_i000_003501	130	460	330	1	0.632184
GCA_020499335.1-Fun_JAIBQT010000151.1_i000_002064	130	460	330	1	0.632184
GCA_020499405.1-Fun_JAIBQW010000185.1_i000_002757	130	460	330	1	0.632184
GCA_020499415.1-Fun_JAIBQX010000189.1_i000_003059	130	460	330	1	0.632184
GCA_020499455.1-Fun_JAIBQY010000186.1_i000_002764	130	460	330	1	0.632184
GCA_020499485.1-Fun_JAIBRA010000198.1_i000_003226	130	460	330	1	0.632184
GCA_020499495.1-Fun_JAIBRB010000144.1_i000_001660	130	460	330	1	0.632184
GCA_020499505.1-Fun_JAIBRC010000202.1_i000_003475	130	460	330	1	0.632184
GCA_020499645.1-Fun_JAIBRJ010000208.1_i000_003493	130	460	330	1	0.632184
GCA_020499675.1-Fun_JAIBRZ010000072.1_i000_008113	130	460	330	1	0.632184
GCA_020499685.1-Fun_JAIBSA010000155.1_i000_002269	130	460	330	1	0.632184
GCA_020499755.1-Fun_JAIBSC010000024.1_i000_003789	130	460	330	1	0.632184
GCA_020499775.1-Fun_JAIBSD010000016.1_i000_002347	130	460	330	1	0.632184
GCA_020499805.1-Fun_JAIBSF010000160.1_i000_002490	130	460	330	1	0.632184
GCA_020499815.1-Fun_JAIBSG010000077.1_i000_008217	130	460	330	1	0.632184
GCA_020499825.1-Fun_JAIBSH010000149.1_i000_002215	130	460	330	1	0.632184
GCA_020499865.1-Fun_JAIBSI010000163.1_i000_002398	130	460	330	1	0.632184
GCA_020499885.1-Fun_JAIBRH010000190.1_i000_003085	130	460	330	1	0.632184
GCA_020499905.1-Fun_JAIBRK010000175.1_i000_002880	130	460	330	1	0.632184
GCA_020499915.1-Fun_JAIBRL010000024.1_i000_003998	130	460	330	1	0.632184
GCA_020500085.1-Fun_JAIBRS010000151.1_i000_002199	130	460	330	1	0.632184
GCA_020500115.1-Fun_JAIBRV010000165.1_i000_002600	130	460	330	1	0.632184
GCA_020500185.1-Fun_JAIBSL010000048.1_i000_006243	130	460	330	1	0.632184
GCA_020500285.1-Fun_JAIBSP010000142.1_i000_001865	130	460	330	1	0.632184
GCA_020500295.1-Fun_JAIBSN010000128.1_i000_001507	130	460	330	1	0.632184
GCA_020500355.1-Fun_JAIBSS010000145.1_i000_001975	130	460	330	1	0.632184
GCA_020500365.1-Fun_JAIBSR010000143.1_i000_001996	130	460	330	1	0.632184
GCA_020500385.1-Fun_JAIBST010000135.1_i000_001599	130	460	330	1	0.632184
GCA_020500395.1-Fun_JAIBSU010000162.1_i000_002531	130	460	330	1	0.632184
GCA_020500445.1-Fun_JAIBSV010000151.1_i000_002260	130	460	330	1	0.632184
GCA_020500455.1-Fun_JAIBSW010000132.1_i000_001672	130	460	330	1	0.632184
GCA_020500465.1-Fun_JAIBSY010000032.1_i000_004820	130	460	330	1	0.632184
GCA_020500475.1-Fun_JAIBSX010000140.1_i000_001956	130	460	330	1	0.632184
GCA_020500555.1-Fun_JAIBTD010000155.1_i000_002387	130	460	330	1	0.632184
GCA_020500565.1-Fun_JAIBTE010000172.1_i000_002755	130	460	330	1	0.632184
GCA_020500595.1-Fun_JAIBTF010000141.1_i000_001824	130	460	330	1	0.632184
GCA_020500605.1-Fun_JAIBTG010000090.1_i000_009165	130	460	330	1	0.632184
GCA_020500645.1-Fun_JAIBTH010000030.1_i000_004542	130	460	330	1	0.632184
GCA_020500655.1-Fun_JAIBTI010000137.1_i000_001683	130	460	330	1	0.632184
GCA_020500685.1-Fun_JAIBTJ010000155.1_i000_002326	130	460	330	1	0.632184
GCA_020500695.1-Fun_JAIBTK010000161.1_i000_002394	130	460	330	1	0.632184
GCA_020500705.1-Fun_JAIBTL010000072.1_i000_008100	130	460	330	1	0.632184
GCA_020500785.1-Fun_JAIBTN010000075.1_i000_008207	130	460	330	1	0.632184
GCA_020500805.1-Fun_JAIBTO010000071.1_i000_007864	130	460	330	1	0.632184
GCA_020500815.1-Fun_JAIBTP010000128.1_i000_001447	130	460	330	1	0.632184
GCA_020500845.1-Fun_JAIBTQ010000124.1_i000_001364	130	460	330	1	0.632184
GCA_020500875.1-Fun_JAIBTR010000139.1_i000_001676	130	460	330	1	0.632184
GCA_020500945.1-Fun_JAIBTV010000248.1_i000_004540	130	460	330	1	0.632184
GCA_020501075.1-Fun_JAIBUB010000157.1_i000_002296	130	460	330	1	0.632184
GCA_020501175.1-Fun_JAIBUH010000219.1_i000_003470	130	460	330	1	0.632184
GCA_020501245.1-Fun_JAIBUK010000214.1_i000_003748	130	460	330	1	0.632184
GCA_020501265.1-Fun_JAIBUM010000160.1_i000_002509	130	460	330	1	0.632184
GCA_020501375.1-Fun_JAIBUR010000202.1_i000_003370	130	460	330	1	0.632184
GCA_020501425.1-Fun_JAIBUT010000155.1_i000_002248	130	460	330	1	0.632184
GCA_020501465.1-Fun_JAIBUV010000220.1_i000_003664	130	460	330	1	0.632184
GCA_020501475.1-Fun_JAIBUX010000200.1_i000_003401	130	460	330	1	0.632184
GCA_020501495.1-Fun_JAIBUW010000171.1_i000_002832	130	460	330	1	0.632184
GCA_020501535.1-Fun_JAIBUY010000128.1_i000_001484	130	460	330	1	0.632184
GCA_020501615.1-Fun_JAIBVD010000211.1_i000_003816	130	460	330	1	0.632184
GCA_020501695.1-Fun_JAIBVG010000215.1_i000_003766	130	460	330	1	0.632184
GCA_020501705.1-Fun_JAIBVI010000248.1_i000_004247	130	460	330	1	0.632184
GCA_020501735.1-Fun_JAIBVJ010000216.1_i000_003763	130	460	330	1	0.632184
GCA_020501765.1-Fun_JAIBVK010000193.1_i000_003168	130	460	330	1	0.632184
GCA_020501785.1-Fun_JAIBVL010000279.1_i000_004796	130	460	330	1	0.632184
GCA_020501835.1-Fun_JAIBVN010000231.1_i000_004104	130	460	330	1	0.632184
GCA_020501875.1-Fun_JAIBVP010000055.1_i000_007394	130	460	330	1	0.632184
GCA_020501905.1-Fun_JAIBVS010000182.1_i000_003384	130	460	330	1	0.632184
GCA_020501935.1-Fun_JAIBVT010000072.1_i000_008166	130	460	330	1	0.632184
GCA_020501995.1-Fun_JAIBVV010000215.1_i000_004453	130	460	330	1	0.632184
GCA_020502045.1-Fun_JAIBVZ010000177.1_i000_002903	130	460	330	1	0.632184
GCA_020502095.1-Fun_JAIBWA010000179.1_i000_002791	130	460	330	1	0.632184
GCA_020502105.1-Fun_JAIBWB010000153.1_i000_002165	130	460	330	1	0.632184
GCA_020502115.1-Fun_JAIBWC010000219.1_i000_003581	130	460	330	1	0.632184
GCA_020502215.1-Fun_JAIBWG010000226.1_i000_003978	130	460	330	1	0.632184
GCA_020502235.1-Fun_JAIBWJ010000211.1_i000_003848	130	460	330	1	0.632184
GCA_020502245.1-Fun_JAIBWI010000209.1_i000_003475	130	460	330	1	0.632184
GCA_020502335.1-Fun_JAIBWL010000072.1_i000_008315	130	460	330	1	0.632184
GCA_020502365.1-Fun_JAIBWM010000225.1_i000_003795	130	460	330	1	0.632184
GCA_020502435.1-Fun_JAIBWQ010000187.1_i000_002884	130	460	330	1	0.632184
GCA_020502485.1-Fun_JAIBWS010000134.1_i000_001350	130	460	330	1	0.632184
GCA_020502545.1-Fun_JAIBWV010000185.1_i000_002937	130	460	330	1	0.632184
GCA_020502605.1-Fun_JAIBWY010000203.1_i000_003414	130	460	330	1	0.632184
GCA_020502615.1-Fun_JAIBWZ010000186.1_i000_002862	130	460	330	1	0.632184
GCA_020502675.1-Fun_JAIBXB010000210.1_i000_003520	130	460	330	1	0.632184
GCA_020502695.1-Fun_JAIBXC010000019.1_i000_003279	130	460	330	1	0.632184
GCA_020502725.1-Fun_JAIBXF010000195.1_i000_002894	130	460	330	1	0.632184
GCA_020502985.1-Fun_JAIBXH010000249.1_i000_004212	130	460	330	1	0.632184
GCA_020503055.1-Fun_JAIBXK010000403.1_i000_006418	130	460	330	1	0.632184
GCA_020503085.1-Fun_JAIBXM010000222.1_i000_003525	130	460	330	1	0.632184
GCA_020503105.1-Fun_JAIBXO010000229.1_i000_004031	130	460	330	1	0.632184
GCA_020503175.1-Fun_JAIBXP010000188.1_i000_003061	130	460	330	1	0.632184
GCA_020503185.1-Fun_JAIBXR010000186.1_i000_002911	130	460	330	1	0.632184
GCA_020503245.1-Fun_JAIBXU010000198.1_i000_003059	130	460	330	1	0.632184
GCA_020503265.1-Fun_JAIBXV010000188.1_i000_002801	130	460	330	1	0.632184
GCA_020503275.1-Fun_JAIBXW010000221.1_i000_003629	130	460	330	1	0.632184
GCA_020503295.1-Fun_JAIBXX010000304.1_i000_004154	130	460	330	1	0.632184
GCA_020503305.1-Fun_JAIBXY010000177.1_i000_002623	130	460	330	1	0.632184
GCA_020503345.1-Fun_JAIBXZ010000223.1_i000_003783	130	460	330	1	0.632184
GCA_020503375.1-Fun_JAIBYB010000178.1_i000_002783	130	460	330	1	0.632184
GCA_020503445.1-Fun_JAIBYF010000210.1_i000_003789	130	460	330	1	0.632184
GCA_020503455.1-Fun_JAIBYD010000203.1_i000_003445	130	460	330	1	0.632184
GCA_020503465.1-Fun_JAIBYG010000238.1_i000_003928	130	460	330	1	0.632184
GCA_020503535.1-Fun_JAIBYI010000229.1_i000_003757	130	460	330	1	0.632184
GCA_020503545.1-Fun_JAIBYK010000218.1_i000_003628	130	460	330	1	0.632184
GCA_020503555.1-Fun_JAIBYJ010000246.1_i000_004184	130	460	330	1	0.632184
GCA_020503565.1-Fun_JAIBYL010000223.1_i000_003596	130	460	330	1	0.632184
GCA_020503595.1-Fun_JAIBYM010000220.1_i000_003840	130	460	330	1	0.632184
GCA_020503665.1-Fun_JAIBYP010000225.1_i000_003724	130	460	330	1	0.632184
GCA_020503705.1-Fun_JAIBYQ010000191.1_i000_003205	130	460	330	1	0.632184
GCA_020503745.1-Fun_JAIBYU010000187.1_i000_003001	130	460	330	1	0.632184
GCA_020503795.1-Fun_JAIBYX010000190.1_i000_003377	130	460	330	1	0.632184
GCA_020503805.1-Fun_JAIBYW010000227.1_i000_003803	130	460	330	1	0.632184
GCA_020503815.1-Fun_JAIBYV010000214.1_i000_003665	130	460	330	1	0.632184
GCA_020503895.1-Fun_JAIBZA010000177.1_i000_002860	130	460	330	1	0.632184
GCA_020503905.1-Fun_JAIBZB010000176.1_i000_002954	130	460	330	1	0.632184
GCA_020503915.1-Fun_JAIBZC010000177.1_i000_002831	130	460	330	1	0.632184
GCA_003184525.1-Fun_MSFK01000013.1_i000_001958	130	461	331	1.00303	0.629278
GCA_003184635.1-Fun_KZ826341.1_i000_005254	128	459	331	1.00303	0.629278
GCA_014839625.1-Fun_WIWV01000013.1_i000_001397	139	462	323	0.978788	0.628405
GCA_014839855.1-Fun_WIWU01000094.1_i000_007984	139	462	323	0.978788	0.628405
GCA_020536995.1-Ani_CM035924.1_i000_137331	224	518	294	0.890909	0.490818
GCA_008782695.1-Ani_CM018502.1_i000_012369	126	451	325	0.984848	0.546218
GCA_000739165.1-Fun_KN042426.1_i000_010042	127	450	323	0.978788	0.637081
GCA_015500155.1-Fun_JAAAUE010002984.1_i000_004485	127	450	323	0.978788	0.637081
GCA_008787405.2-Ani_CM018479.1_i000_003742	126	451	325	0.984848	0.546218
GCA_015847185.1-Fun_JAAAHX010000076.1_i000_009628	119	446	327	0.990909	0.638672
GCA_000151315.2-Pro_KE346369.1_i000_006319	79	396	317	0.960606	0.667368
GCA_015680905.1-Pla_CM027382.1_i000_025117	125	460	335	1.01515	0.576592
GCA_019788775.1-Fun_JAIFTL010000038.1_i000_005582	126	450	324	0.981818	0.632812
GCA_900661375.1-Ani_CAAGRJ010027723.1_i000_015460	126	455	329	0.99697	0.551089
GCA_019155715.1-Pro_JAGDFM010000022.1_i000_005153	125	458	333	1.00909	0.652941
GCA_000223135.1-Ani_JH000136.1_i000_004544	129	457	328	0.993939	0.554054
GCA_003426965.1-Fun_QUQM01000007.1_i000_009918	127	455	328	0.993939	0.622391
GCA_004798825.1-Fun_SOSA01000040.1_i000_007714	127	455	328	0.993939	0.622391
GCA_014300015.1-Ani_CM025021.1_i000_014325	125	454	329	0.99697	0.592793
GCA_000448345.1-Ani_KE681346.1_i000_016822	135	465	330	1	0.55
GCA_002946385.1-Fun_NJPR01000025.1_i000_004903	139	464	325	0.984848	0.64741
GCA_003184625.1-Fun_KZ821446.1_i000_000696	132	465	333	1.00909	0.634286
GCA_001008285.1-Fun_LCZI01001656.1_i000_009102	137	463	326	0.987879	0.640472
GCA_000003515.2-Fun_CH476618.1_i000_006666	127	463	336	1.01818	0.657534
GCA_015499975.1-Fun_JAAAUD010000391.1_i000_006811	122	450	328	0.993939	0.639376
GCA_007990455.1-Pla_CM017655.1_i000_035738	129	460	331	1.00303	0.621013
GCA_021604985.1-Pla_BQKI01000084.1_i000_048992	124	461	337	1.02121	0.613843
GCA_002290385.1-Ani_KZ288387.1_i000_008558	129	445	316	0.957576	0.54766
GCA_000731615.1-Fun_JHOI01000506.1_i000_002612	130	460	330	1	0.632184
GCA_002234985.1-Fun_NKHS01000237.1_i000_003711	130	460	330	1	0.632184
GCA_020498805.1-Fun_JAIBPR010000204.1_i000_003659	130	460	330	1	0.632184
GCA_020498865.1-Fun_JAIBPV010000185.1_i000_003021	130	460	330	1	0.632184
GCA_020498875.1-Fun_JAIBPW010000171.1_i000_002733	130	460	330	1	0.632184
GCA_020498885.1-Fun_JAIBPT010000193.1_i000_002921	130	460	330	1	0.632184
GCA_020499155.1-Fun_JAIBQK010000067.1_i000_007810	130	460	330	1	0.632184
GCA_020499255.1-Fun_JAIBQP010000208.1_i000_003475	130	460	330	1	0.632184
GCA_020499265.1-Fun_JAIBQO010000188.1_i000_003031	130	460	330	1	0.632184
GCA_020499315.1-Fun_JAIBQQ010000124.1_i000_001127	130	460	330	1	0.632184
GCA_020499395.1-Fun_JAIBQV010000274.1_i000_004695	130	460	330	1	0.632184
GCA_020499575.1-Fun_JAIBRE010000230.1_i000_004073	130	460	330	1	0.632184
GCA_020499595.1-Fun_JAIBRF010000210.1_i000_003578	130	460	330	1	0.632184
GCA_020499605.1-Fun_JAIBRI010000040.1_i000_006222	130	460	330	1	0.632184
GCA_020500215.1-Fun_JAIBSK010000105.1_i000_000571	130	460	330	1	0.632184
GCA_020500305.1-Fun_JAIBSQ010000010.1_i000_000366	130	460	330	1	0.632184
GCA_020500535.1-Fun_JAIBTB010000007.1_i000_008238	130	460	330	1	0.632184
GCA_020500905.1-Fun_JAIBTT010000078.1_i000_008209	130	460	330	1	0.632184
GCA_020500965.1-Fun_JAIBTW010000202.1_i000_003552	130	460	330	1	0.632184
GCA_020500975.1-Fun_JAIBTX010000233.1_i000_003997	130	460	330	1	0.632184
GCA_020501005.1-Fun_JAIBTZ010000159.1_i000_002385	130	460	330	1	0.632184
GCA_020501115.1-Fun_JAIBUD010000224.1_i000_003610	130	460	330	1	0.632184
GCA_020501135.1-Fun_JAIBUF010000238.1_i000_004129	130	460	330	1	0.632184
GCA_020501145.1-Fun_JAIBUG010000201.1_i000_003287	130	460	330	1	0.632184
GCA_020501235.1-Fun_JAIBUJ010000207.1_i000_003161	130	460	330	1	0.632184
GCA_020501325.1-Fun_JAIBUL010000044.1_i000_006500	130	460	330	1	0.632184
GCA_020501345.1-Fun_JAIBUP010000039.1_i000_006154	130	460	330	1	0.632184
GCA_020501635.1-Fun_JAIBVE010000074.1_i000_008165	130	460	330	1	0.632184
GCA_020501815.1-Fun_JAIBVO010000119.1_i000_001006	130	460	330	1	0.632184
GCA_020501985.1-Fun_JAIBVU010000049.1_i000_006485	130	460	330	1	0.632184
GCA_020502005.1-Fun_JAIBVW010000189.1_i000_003062	130	460	330	1	0.632184
GCA_020502125.1-Fun_JAIBWD010000213.1_i000_003609	130	460	330	1	0.632184
GCA_020502165.1-Fun_JAIBWE010000172.1_i000_002596	130	460	330	1	0.632184
GCA_020502185.1-Fun_JAIBWF010000257.1_i000_004479	130	460	330	1	0.632184
GCA_020502525.1-Fun_JAIBWU010000208.1_i000_003339	130	460	330	1	0.632184
GCA_020502595.1-Fun_JAIBWX010000186.1_i000_002933	130	460	330	1	0.632184
GCA_020502705.1-Fun_JAIBXD010000048.1_i000_007065	130	460	330	1	0.632184
GCA_020502995.1-Fun_JAIBXI010000103.1_i000_000312	130	460	330	1	0.632184
GCA_020503015.1-Fun_JAIBXJ010000261.1_i000_004529	130	460	330	1	0.632184
GCA_020503195.1-Fun_JAIBXT010000219.1_i000_003622	130	460	330	1	0.632184
GCA_020503645.1-Fun_JAIBYO010000177.1_i000_002594	130	460	330	1	0.632184
GCA_020503715.1-Fun_JAIBYR010000107.1_i000_000412	130	460	330	1	0.632184
GCA_020503935.1-Fun_JAIBZD010000198.1_i000_003178	130	460	330	1	0.632184
GCA_019202805.1-Pla_CM032907.1_i000_034762	136	457	321	0.972727	0.644578
GCA_019455555.1-Ani_JAGFMF010011769.1_i000_011929	125	459	334	1.01212	0.563238
GCA_013467485.1-Pla_CM025271.1_i000_000420	128	442	314	0.951515	0.707207
GCA_001574975.1-Fun_KQ965742.1_i000_004064	125	458	333	1.00909	0.711538
GCA_011764145.1-Fun_JAANQZ010005811.1_i000_012193	37	342	305	0.924242	0.889213
GCA_016097925.1-Fun_JAAAIQ010002461.1_i000_005278	120	410	290	0.878788	0.707317
GCA_000950595.1-Fun_DF836295.1_i000_010663	136	458	322	0.975758	0.650505
GCA_907166875.3-Ani_CAJRHG030000007.1_i000_012043	127	464	337	1.02121	0.686354
GCA_001974805.1-Pla_AWWV01009782.1_i000_010304	131	461	330	1	0.611111
GCA_008761655.1-Pla_CM018208.1_i000_032267	129	460	331	1.00303	0.621013
GCA_012274485.2-Pla_MU106767.1_i000_039496	129	453	324	0.981818	0.618321
GCA_003711565.2-Ani_CM011071.1_i000_004465	117	445	328	0.993939	0.624762
GCA_004026145.2-Ani_CP034986.1_i000_002389	117	445	328	0.993939	0.624762
GCA_016758945.1-Fun_JAEPRC010000576.1_i000_008609	134	454	320	0.969697	0.650407
GCA_006386115.1-Pro_VFIW01000043.1_i000_010216	241	571	330	1	0.535714
GCA_015844325.1-Fun_VCAU01000136.1_i000_002332	129	461	332	1.00606	0.652259
GCA_011763605.1-Fun_JAANIO010003256.1_i000_007245	135	456	321	0.972727	0.648485
GCA_002880775.3-Ani_CM009282.2_i000_016771	128	455	327	0.990909	0.550505
GCA_018691715.1-Pro_JAFJYM010000034.1_i000_009879	124	458	334	1.01212	0.644788
GCA_000787975.1-Pla_KN445061.1_i000_029055	129	461	332	1.00606	0.622889
GCA_016758985.1-Fun_JAEPRD010000069.1_i000_006893	436	752	316	0.957576	0.403061
GCA_000750995.1-Fun_JPKE01004179.1_i000_010758	139	466	327	0.990909	0.647525
GCA_007990345.1-Pla_CM017668.1_i000_016331	129	460	331	1.00303	0.621013
GCA_007990485.1-Pla_CM017616.1_i000_034699	129	460	331	1.00303	0.621013
GCA_001662575.1-Fun_KV454979.1_i000_001544	140	464	324	0.981818	0.640316
GCA_019097595.1-Ani_CM032611.1_i000_015130	125	450	325	0.984848	0.580357
GCA_021235465.1-Fun_JAJSME010000001.1_i000_000457	120	450	330	1	0.640777
GCA_016097855.1-Fun_JAAAIM010001969.1_i000_004085	122	449	327	0.990909	0.647525
GCA_001651475.1-Pla_CM004361.1_i000_012322	125	457	332	1.00606	0.665331
GCA_019202795.1-Pla_CM032915.1_i000_012395	125	457	332	1.00606	0.665331
GCA_000938895.1-Fun_LN719426.1_i000_001412	129	458	329	0.99697	0.667343
GCA_000313135.1-Pro_KB008172.1_i000_014904	135	471	336	1.01818	0.649903
GCA_008692635.1-Ani_VOAJ01003607.1_i000_008119	56	386	330	1	0.625
GCA_011764025.1-Fun_JAANQT010003743.1_i000_012383	120	446	326	0.987879	0.661258
GCA_011764125.1-Fun_JAANQV010006571.1_i000_011428	120	446	326	0.987879	0.661258
GCA_011801675.1-Fun_JAANQW010002677.1_i000_011023	120	446	326	0.987879	0.661258
GCA_002072255.1-Fun_MDYP01000003.1_i000_001336	139	456	317	0.960606	0.620352
GCA_000187875.1-Ani_GL732533.1_i000_005609	116	448	332	1.00606	0.64466
GCA_009176345.1-Fun_ML732309.1_i000_009516	133	461	328	0.993939	0.618868
GCA_015951145.1-Fun_MU167384.1_i000_011116	124	471	347	1.05152	0.695391
GCA_020536995.1-Ani_CM035922.1_i000_118115	126	460	334	1.01212	0.620818
GCA_000184105.1-Fun_GL573184.1_i000_001329	136	465	329	0.99697	0.629063
GCA_001641265.1-Fun_KV441400.1_i000_006184	136	465	329	0.99697	0.629063
GCA_000478725.1-Pla_KI517408.1_i000_006945	129	459	330	1	0.654762
GCA_006381635.2-Pla_VEPZ02000320.1_i000_009481	126	460	334	1.01212	0.625468
GCA_011763645.1-Fun_JAASGZ010000666.1_i000_006257	119	447	328	0.993939	0.665314
GCA_011763975.1-Fun_JAANJF010000515.1_i000_004375	119	447	328	0.993939	0.665314
GCA_011763995.1-Fun_JAANJE010002751.1_i000_008085	119	447	328	0.993939	0.665314
GCA_011764025.1-Fun_JAANQT010000461.1_i000_004279	119	447	328	0.993939	0.665314
GCA_011764055.1-Fun_JAANQS010000819.1_i000_006330	119	447	328	0.993939	0.665314
GCA_011764125.1-Fun_JAANQV010000814.1_i000_003155	119	447	328	0.993939	0.665314
GCA_011764145.1-Fun_JAANQZ010000429.1_i000_002664	119	447	328	0.993939	0.665314
GCA_011764185.1-Fun_JAANRA010000885.1_i000_006705	119	447	328	0.993939	0.665314
GCA_011764225.1-Fun_JAANRQ010001215.1_i000_003902	119	447	328	0.993939	0.665314
GCA_011800955.1-Fun_JAANRM010000660.1_i000_006479	119	447	328	0.993939	0.665314
GCA_011800985.1-Fun_JAANRL010000617.1_i000_005672	119	447	328	0.993939	0.665314
GCA_011801035.1-Fun_JAANRN010000437.1_i000_004883	119	447	328	0.993939	0.665314
GCA_011801055.1-Fun_JAANRO010000518.1_i000_005344	119	447	328	0.993939	0.665314
GCA_011801305.1-Fun_JAANRS010000866.1_i000_007144	119	447	328	0.993939	0.665314
GCA_011801335.1-Fun_JAANRP010000761.1_i000_005884	119	447	328	0.993939	0.665314
GCA_011801385.1-Fun_JAANRR010000518.1_i000_004646	119	447	328	0.993939	0.665314
GCA_011801495.1-Fun_JAANRV010000875.1_i000_007296	119	447	328	0.993939	0.665314
GCA_011801505.1-Fun_JAANRU010000626.1_i000_005973	119	447	328	0.993939	0.665314
GCA_011801555.1-Fun_JAANRX010000902.1_i000_007323	119	447	328	0.993939	0.665314
GCA_011801575.1-Fun_JAANRW010000917.1_i000_007598	119	447	328	0.993939	0.665314
GCA_011801605.1-Fun_JAANRT010000572.1_i000_005637	119	447	328	0.993939	0.665314
GCA_011801645.1-Fun_JAANRB010000632.1_i000_005863	119	447	328	0.993939	0.665314
GCA_011801675.1-Fun_JAANQW010000873.1_i000_006223	119	447	328	0.993939	0.665314
GCA_011801705.1-Fun_JAANQY010000840.1_i000_006320	119	447	328	0.993939	0.665314
GCA_011801725.1-Fun_JAANQX010000542.1_i000_004834	119	447	328	0.993939	0.665314
GCA_011801785.1-Fun_JAANQR010000685.1_i000_005369	119	447	328	0.993939	0.665314
GCA_011801815.1-Fun_JAANQU010000472.1_i000_004209	119	447	328	0.993939	0.665314
GCA_011950945.1-Fun_JAANRD010000893.1_i000_007526	119	447	328	0.993939	0.665314
GCA_011950985.1-Fun_JAANRF010000112.1_i000_001770	119	447	328	0.993939	0.665314
GCA_011951285.1-Fun_JAANRG010000905.1_i000_008336	119	447	328	0.993939	0.665314
GCA_011951295.1-Fun_JAANRC010000487.1_i000_004432	119	447	328	0.993939	0.665314
GCA_011952045.1-Fun_JAANRH010000765.1_i000_006045	119	447	328	0.993939	0.665314
GCA_011952115.1-Fun_JAANRI010000389.1_i000_003438	119	447	328	0.993939	0.665314
GCA_011952145.1-Fun_JAANRJ010000845.1_i000_007239	119	447	328	0.993939	0.665314
GCA_011952175.1-Fun_JAANRK010000216.1_i000_002994	119	447	328	0.993939	0.665314
GCA_020747065.1-Fun_JAGMVK010000019.1_i000_006056	137	465	328	0.993939	0.640625
GCF_000001405.40-Hum_NC_000020.11_i000_017782	127	455	328	0.993939	0.552189
GCA_015679605.1-Fun_JAAAVE010000060.1_i000_008232	122	450	328	0.993939	0.643137
GCA_910591605.1-Ani_CAJVCH010551648.1_i000_039335	150	505	355	1.07576	0.693359
GCA_011763935.1-Fun_JAANJC010000027.1_i000_000548	124	447	323	0.978788	0.655172
GCA_011763955.1-Fun_JAANJD010000107.1_i000_001587	124	447	323	0.978788	0.655172
GCA_003710015.1-Ani_REGN01009978.1_i000_045083	114	443	329	0.99697	0.72467
GCA_002880755.3-Ani_CM009258.2_i000_016830	125	455	330	1	0.555556
GCA_000750925.1-Fun_JPKC01000027.1_i000_000071	141	467	326	0.987879	0.645545
GCA_009613015.1-Fun_VXCB01000080.1_i000_013161	97	418	321	0.972727	0.680085
GCA_015849305.1-Fun_JAAAHY010001126.1_i000_000619	122	445	323	0.978788	0.667355
GCA_020379485.1-Pla_CM035453.1_i000_028212	139	465	326	0.987879	0.619772
GCA_011763935.1-Fun_JAANJC010001659.1_i000_010076	126	454	328	0.993939	0.666667
GCA_011763955.1-Fun_JAANJD010001450.1_i000_009359	126	454	328	0.993939	0.666667
GCA_019511825.2-Pla_QFCC02000016.1_i000_014131	134	460	326	0.987879	0.62572
GCA_007990325.1-Pla_CM017707.1_i000_037474	129	460	331	1.00303	0.621013
GCA_008761655.1-Pla_CM018221.1_i000_034786	129	460	331	1.00303	0.621013
GCA_000988875.2-Fun_LCTV02000012.1_i000_001952	126	453	327	0.990909	0.642436
GCA_900074895.1-Fun_FJVC01000102.1_i000_006501	137	459	322	0.975758	0.628906
GCA_900074885.1-Fun_FJUW01000022.1_i000_000483	139	459	320	0.969697	0.625
GCA_900074905.1-Fun_FJUX01000034.1_i000_009156	139	459	320	0.969697	0.625
GCA_000002595.3-Pla_CM008973.1_i000_012479	120	457	337	1.02121	0.66998
GCA_000750795.1-Fun_JPJX01003163.1_i000_008518	141	467	326	0.987879	0.645545
GCA_000750815.1-Fun_JPJZ01001191.1_i000_007478	141	467	326	0.987879	0.645545
GCA_001511075.1-Fun_CDMC01000009.1_i000_010622	127	454	327	0.990909	0.641176
GCA_002102555.1-Fun_MCFL01000011.1_i000_001186	116	451	335	1.01515	0.667331
GCA_016808415.1-Fun_JAAWWR010000008.1_i000_007773	130	458	328	0.993939	0.640625
GCA_000151265.1-Pla_GG663739.1_i000_006097	126	457	331	1.00303	0.68107
GCA_007990485.1-Pla_CM017629.1_i000_037418	129	460	331	1.00303	0.621013
GCA_002946415.1-Fun_NJPS01000045.1_i000_004768	144	465	321	0.972727	0.639442
GCA_016098165.1-Fun_JAAAJA010000091.1_i000_009764	120	450	330	1	0.647059
GCA_004786065.1-Fun_ML220118.1_i000_004030	139	462	323	0.978788	0.610586
GCA_002926015.1-Pla_KZ648758.1_i000_026288	129	460	331	1.00303	0.640232
GCA_003952965.2-Pla_CM025852.1_i000_012865	135	462	327	0.990909	0.593466
GCA_003711585.2-Ani_CM011652.2_i000_002496	127	453	326	0.987879	0.578014
GCA_019176425.1-Ani_CM032886.1_i000_013444	135	447	312	0.945455	0.571429
GCA_000230625.1-Fun_JH226131.1_i000_002598	128	457	329	0.99697	0.635135
GCA_002573585.1-Fun_PDNB01000059.1_i000_008242	142	455	313	0.948485	0.610136
GCA_016834595.1-Pla_JAEHOD010000003.1_i000_001729	120	459	339	1.02727	0.675299
GCA_000478725.1-Pla_KI517748.1_i000_022163	123	457	334	1.01212	0.680244
GCA_009014675.2-Fun_BKZM02000001.1_i000_000662	132	457	325	0.984848	0.634766
GCA_009932835.1-Fun_BLJY01000001.1_i000_000742	132	457	325	0.984848	0.634766
GCA_004193795.1-Ani_QDEB01124868.1_i000_014061	114	447	333	1.00909	0.594643
GCA_000751015.1-Pla_LK032523.1_i000_035123	131	460	329	0.99697	0.633911
GCA_003434825.1-Pla_CM010635.1_i000_026874	131	460	329	0.99697	0.633911
GCA_011763935.1-Fun_JAANJC010001274.1_i000_008933	120	446	326	0.987879	0.661258
GCA_011763955.1-Fun_JAANJD010000599.1_i000_005664	120	446	326	0.987879	0.661258
GCA_000003195.3-Pla_CM000760.3_i000_003887	126	460	334	1.01212	0.607273
GCA_015952705.1-Pla_CM027680.1_i000_003951	126	460	334	1.01212	0.607273
GCA_000149615.1-Fun_CH476595.1_i000_009067	130	458	328	0.993939	0.640625
GCA_008271595.1-Pro_SMMQ01002065.1_i000_008802	150	483	333	1.00909	0.22334
GCA_019671135.1-Fun_JAHRHY010000006.1_i000_010586	121	447	326	0.987879	0.645545
GCA_000247585.2-Pro_KI669562.1_i000_002039	127	462	335	1.01515	0.646718
GCA_000365505.1-Pro_ANIZ01001094.1_i000_006558	127	462	335	1.01515	0.646718
GCA_000365525.1-Pro_ANJA01001214.1_i000_006614	127	462	335	1.01515	0.646718
GCA_000365545.1-Pro_ANIX01001325.1_i000_006574	127	462	335	1.01515	0.646718
GCA_000367145.1-Pro_ANIY01001385.1_i000_006601	127	462	335	1.01515	0.646718
GCA_000509465.1-Pro_KI685665.1_i000_006446	127	462	335	1.01515	0.646718
GCA_000509485.1-Pro_KI672232.1_i000_006394	127	462	335	1.01515	0.646718
GCA_000509505.1-Pro_KI678944.1_i000_006250	127	462	335	1.01515	0.646718
GCA_000509525.1-Pro_KI692195.1_i000_006364	127	462	335	1.01515	0.646718
GCA_011763645.1-Fun_JAASGZ010000846.1_i000_007258	130	456	326	0.987879	0.662602
GCA_011763975.1-Fun_JAANJF010000177.1_i000_001957	130	456	326	0.987879	0.662602
GCA_011763995.1-Fun_JAANJE010000468.1_i000_002428	130	456	326	0.987879	0.662602
GCA_011764025.1-Fun_JAANQT010001010.1_i000_007090	130	456	326	0.987879	0.662602
GCA_011764055.1-Fun_JAANQS010000741.1_i000_005927	130	456	326	0.987879	0.662602
GCA_011764125.1-Fun_JAANQV010001189.1_i000_004134	130	456	326	0.987879	0.662602
GCA_011764145.1-Fun_JAANQZ010000249.1_i000_001771	130	456	326	0.987879	0.662602
GCA_011764185.1-Fun_JAANRA010000759.1_i000_006097	130	456	326	0.987879	0.662602
GCA_011764225.1-Fun_JAANRQ010000117.1_i000_000604	130	456	326	0.987879	0.662602
GCA_011764265.1-Fun_JAANRE010001202.1_i000_002684	130	456	326	0.987879	0.662602
GCA_011800955.1-Fun_JAANRM010000864.1_i000_007641	130	456	326	0.987879	0.662602
GCA_011800985.1-Fun_JAANRL010000831.1_i000_006868	130	456	326	0.987879	0.662602
GCA_011801035.1-Fun_JAANRN010000850.1_i000_007412	130	456	326	0.987879	0.662602
GCA_011801055.1-Fun_JAANRO010000824.1_i000_007133	130	456	326	0.987879	0.662602
GCA_011801305.1-Fun_JAANRS010000024.1_i000_000468	130	456	326	0.987879	0.662602
GCA_011801335.1-Fun_JAANRP010001007.1_i000_007026	130	456	326	0.987879	0.662602
GCA_011801385.1-Fun_JAANRR010000029.1_i000_000495	130	456	326	0.987879	0.662602
GCA_011801495.1-Fun_JAANRV010000808.1_i000_006969	130	456	326	0.987879	0.662602
GCA_011801505.1-Fun_JAANRU010000829.1_i000_007098	130	456	326	0.987879	0.662602
GCA_011801555.1-Fun_JAANRX010000836.1_i000_006997	130	456	326	0.987879	0.662602
GCA_011801575.1-Fun_JAANRW010000853.1_i000_007290	130	456	326	0.987879	0.662602
GCA_011801605.1-Fun_JAANRT010000815.1_i000_006975	130	456	326	0.987879	0.662602
GCA_011801645.1-Fun_JAANRB010000277.1_i000_003273	130	456	326	0.987879	0.662602
GCA_011801675.1-Fun_JAANQW010000710.1_i000_005436	130	456	326	0.987879	0.662602
GCA_011801705.1-Fun_JAANQY010000742.1_i000_005815	130	456	326	0.987879	0.662602
GCA_011801725.1-Fun_JAANQX010000755.1_i000_006048	130	456	326	0.987879	0.662602
GCA_011801785.1-Fun_JAANQR010000348.1_i000_003354	130	456	326	0.987879	0.662602
GCA_011801815.1-Fun_JAANQU010001027.1_i000_007069	130	456	326	0.987879	0.662602
GCA_011950945.1-Fun_JAANRD010000840.1_i000_007272	130	456	326	0.987879	0.662602
GCA_011950985.1-Fun_JAANRF010000006.1_i000_000140	130	456	326	0.987879	0.662602
GCA_011951285.1-Fun_JAANRG010000013.1_i000_000370	130	456	326	0.987879	0.662602
GCA_011951295.1-Fun_JAANRC010000745.1_i000_005914	130	456	326	0.987879	0.662602
GCA_011952045.1-Fun_JAANRH010001025.1_i000_007234	130	456	326	0.987879	0.662602
GCA_011952115.1-Fun_JAANRI010000006.1_i000_000093	130	456	326	0.987879	0.662602
GCA_011952145.1-Fun_JAANRJ010000832.1_i000_007177	130	456	326	0.987879	0.662602
GCA_011952175.1-Fun_JAANRK010000008.1_i000_000201	130	456	326	0.987879	0.662602
GCA_004786185.1-Ani_CM015734.1_i000_022061	124	468	344	1.04242	0.631193
GCA_900000015.1-Pro_CCYD01003101.1_i000_015279	126	459	333	1.00909	0.646602
GCA_003260655.2-Pla_QGKV02000832.1_i000_043000	134	455	321	0.972727	0.635644
GCA_001651415.1-Fun_KV442035.1_i000_006487	121	446	325	0.984848	0.643564
GCA_000188695.1-Pro_GL832967.1_i000_005713	138	457	319	0.966667	0.61583
GCA_017366145.1-Fun_JAFJYG010000407.1_i000_009581	138	466	328	0.993939	0.639376
GCA_020726505.1-Fun_JAHLEZ010000002.1_i000_008576	138	466	328	0.993939	0.639376
GCA_021432625.1-Fun_MU270376.1_i000_010044	138	466	328	0.993939	0.639376
GCA_000403535.1-Pla_CM001881.1_i000_009002	133	459	326	0.987879	0.598165
GCA_016984175.1-Ani_JAAWVO010062580.1_i000_011659	134	447	313	0.948485	0.592803
GCA_002946425.1-Fun_NJPT01000052.1_i000_006068	155	476	321	0.972727	0.625731
GCA_000409485.1-Fun_KE145372.1_i000_012174	138	464	326	0.987879	0.628131
GCA_004119915.2-Ani_CM014082.1_i000_004968	129	454	325	0.984848	0.569177
GCA_020887355.1-Pla_AP024993.1_i000_004725	133	462	329	0.99697	0.590664
GCA_011764225.1-Fun_JAANRQ010007175.1_i000_012080	86	414	328	0.993939	0.714597
GCA_001692915.1-Fun_KV749239.1_i000_005037	139	462	323	0.978788	0.59375
GCA_015679425.1-Fun_JAAAUV010001999.1_i000_004317	126	447	321	0.972727	0.635644
GCA_015852415.1-Fun_JAAAIH010001358.1_i000_001845	126	447	321	0.972727	0.635644
GCA_020744185.1-Fun_JAGSXK010000005.1_i000_011480	126	447	321	0.972727	0.635644
GCA_011763955.1-Fun_JAANJD010001830.1_i000_010369	134	456	322	0.975758	0.654472
GCA_013397245.1-Ani_VZTB01012745.1_i000_009242	56	382	326	0.987879	0.695096
GCA_010411085.1-Ani_CM021214.1_i000_014591	74	136	62	0.187879	0.0488574
GCA_010411085.1-Ani_CM021214.1_i000_014591	801	1130	329	0.99697	0.259259
GCA_000320785.2-Fun_KB722646.1_i000_002304	124	455	331	1.00303	0.64902
GCA_003234015.1-Fun_LK052940.1_i000_005383	124	455	331	1.00303	0.64902
GCA_003845795.1-Ani_CM011686.1_i000_012489	134	446	312	0.945455	0.585366
GCA_000750895.1-Fun_JPKB01000793.1_i000_005196	141	463	322	0.975758	0.635108
GCA_001662655.1-Fun_KV460241.1_i000_007275	141	463	322	0.975758	0.635108
GCA_008369825.1-Ani_CM017905.1_i000_012959	121	446	325	0.984848	0.590909
GCA_001712645.2-Pro_MBAD02000670.1_i000_008813	125	462	337	1.02121	0.660784
GCA_001712705.2-Pro_MBDO02000001.1_i000_000031	125	462	337	1.02121	0.660784
GCA_015680655.1-Fun_JAABKD010000029.1_i000_005205	510	834	324	0.981818	0.358804
GCA_019924265.1-Fun_JAHFXL010000027.1_i000_003252	846	1174	328	0.993939	0.265372
GCA_001483015.1-Pro_LNFO01005730.1_i000_015074	129	462	333	1.00909	0.642857
GCA_002072375.1-Fun_MLKD01000003.1_i000_002525	135	457	322	0.975758	0.624031
GCA_001663975.1-Ani_CM004482.1_i000_038427	118	442	324	0.981818	0.606742
GCA_001561935.1-Fun_LHQR01000065.1_i000_005058	130	457	327	0.990909	0.639922
GCA_002006685.1-Fun_LYON01000028.1_i000_000402	129	455	326	0.987879	0.628131
GCA_020617195.1-Fun_JAFDOU010000559.1_i000_003786	129	455	326	0.987879	0.628131
GCA_020617715.1-Fun_JAFDOV010000522.1_i000_003137	129	455	326	0.987879	0.628131
GCA_020617725.1-Fun_JAFDOT010001149.1_i000_010238	129	455	326	0.987879	0.628131
GCA_020617735.1-Fun_JAFCIX010000060.1_i000_001340	129	455	326	0.987879	0.628131
GCA_021556675.1-Fun_JAKFGI010000015.1_i000_003469	129	455	326	0.987879	0.628131
GCA_011763915.1-Fun_JAANJB010000065.1_i000_001066	130	454	324	0.981818	0.654545
GCA_014898415.1-Fun_RCTD01000003.1_i000_001474	139	463	324	0.981818	0.627907
GCA_002104905.1-Fun_MCFE01000284.1_i000_006353	124	445	321	0.972727	0.644578
GCA_004022145.1-Fun_RCNU01000002.1_i000_003869	131	460	329	0.99697	0.632692
GCA_003184545.1-Fun_MSFL01000001.1_i000_000551	129	450	321	0.972727	0.630648
GCA_001662585.1-Fun_KV454586.1_i000_003269	144	466	322	0.975758	0.635108
GCA_011801725.1-Fun_JAANQX010002674.1_i000_011388	100	428	328	0.993939	0.693446
GCA_003711585.2-Ani_CM011673.2_i000_022812	132	447	315	0.954545	0.589888
GCA_011800145.1-Ani_JAAMPH010000036.1_i000_004409	128	455	327	0.990909	0.547739
GCA_016771965.1-Pla_CM028690.1_i000_018732	128	451	323	0.978788	0.646
GCA_000149305.1-Fun_CH476732.1_i000_015331	134	454	320	0.969697	0.646465
GCA_011763585.1-Fun_JAANIP010001020.1_i000_006107	134	454	320	0.969697	0.646465
GCA_011763695.1-Fun_JAANIQ010000006.1_i000_000106	134	454	320	0.969697	0.646465
GCA_011763715.1-Fun_JAANIR010000174.1_i000_001933	134	454	320	0.969697	0.646465
GCA_011763735.1-Fun_JAANIS010002168.1_i000_007434	134	454	320	0.969697	0.646465
GCA_011763755.1-Fun_JAANIW010000079.1_i000_001371	134	454	320	0.969697	0.646465
GCA_011763775.1-Fun_JAANIT010000046.1_i000_000728	134	454	320	0.969697	0.646465
GCA_011763795.1-Fun_JAANIV010000021.1_i000_000436	134	454	320	0.969697	0.646465
GCA_011763815.1-Fun_JAANIU010000031.1_i000_000523	134	454	320	0.969697	0.646465
GCA_011763835.1-Fun_JAANIX010000026.1_i000_000545	134	454	320	0.969697	0.646465
GCA_011763875.1-Fun_JAANIZ010000006.1_i000_000128	134	454	320	0.969697	0.646465
GCA_011763895.1-Fun_JAANIY010000025.1_i000_000412	134	454	320	0.969697	0.646465
GCA_011801335.1-Fun_JAANRP010002770.1_i000_011537	107	433	326	0.987879	0.679167
GCA_000750935.1-Fun_JPKD01003233.1_i000_009803	137	465	328	0.993939	0.646943
GCA_020746875.1-Fun_JAGTJL010000001.1_i000_000298	143	467	324	0.981818	0.629126
GCA_011801505.1-Fun_JAANRU010000772.1_i000_006796	104	432	328	0.993939	0.687631
GCA_000149305.1-Fun_CH476735.1_i000_011138	125	454	329	0.99697	0.668699
GCA_011763585.1-Fun_JAANIP010001311.1_i000_007139	125	454	329	0.99697	0.668699
GCA_011763695.1-Fun_JAANIQ010001149.1_i000_007019	125	454	329	0.99697	0.668699
GCA_011763715.1-Fun_JAANIR010000601.1_i000_004742	125	454	329	0.99697	0.668699
GCA_011763735.1-Fun_JAANIS010000718.1_i000_003544	125	454	329	0.99697	0.668699
GCA_011763755.1-Fun_JAANIW010001235.1_i000_008814	125	454	329	0.99697	0.668699
GCA_011763775.1-Fun_JAANIT010001211.1_i000_007802	125	454	329	0.99697	0.668699
GCA_011763795.1-Fun_JAANIV010001257.1_i000_008826	125	454	329	0.99697	0.668699
GCA_011763815.1-Fun_JAANIU010001205.1_i000_007524	125	454	329	0.99697	0.668699
GCA_011763835.1-Fun_JAANIX010001280.1_i000_009019	125	454	329	0.99697	0.668699
GCA_011763855.1-Fun_JAANJA010001222.1_i000_008604	125	454	329	0.99697	0.668699
GCA_011763875.1-Fun_JAANIZ010001175.1_i000_007395	125	454	329	0.99697	0.668699
GCA_011763895.1-Fun_JAANIY010000617.1_i000_005104	125	454	329	0.99697	0.668699
GCA_000513255.1-Fun_HG792017.1_i000_007812	135	456	321	0.972727	0.62818
GCA_015533775.1-Fun_JABCSE010000004.1_i000_002611	135	456	321	0.972727	0.62818
GCA_009733045.1-Pro_QXGC01000076.1_i000_002632	127	457	330	1	0.64833
GCA_016758895.1-Fun_JAEPRA010000001.1_i000_000425	124	450	326	0.987879	0.624521
GCA_021556665.1-Fun_JAKFGG010000066.1_i000_008964	146	472	326	0.987879	0.608209
GCA_001683725.1-Fun_LUGH01000009.1_i000_010722	116	455	339	1.02727	0.698969
GCA_000150705.2-Fun_KN294015.1_i000_007208	130	460	330	1	0.633397
GCA_020004485.1-Ani_JAATJU010022319.1_i000_010799	223	551	328	0.993939	0.478134
GCA_000365145.2-Fun_KB822711.1_i000_000227	129	463	334	1.01212	0.634981
GCA_004153795.2-Pla_SDRB02012732.1_i000_027214	133	459	326	0.987879	0.453408
GCA_015529515.1-Fun_JAAAUJ010000046.1_i000_006594	122	447	325	0.984848	0.632296
GCA_011763975.1-Fun_JAANJF010000902.1_i000_006329	120	446	326	0.987879	0.661258
GCA_011763995.1-Fun_JAANJE010005837.1_i000_011581	120	446	326	0.987879	0.661258
GCA_011764055.1-Fun_JAANQS010001260.1_i000_008123	120	446	326	0.987879	0.661258
GCA_011764185.1-Fun_JAANRA010002800.1_i000_011800	120	446	326	0.987879	0.661258
GCA_011764265.1-Fun_JAANRE010007012.1_i000_009596	120	446	326	0.987879	0.661258
GCA_011800955.1-Fun_JAANRM010001937.1_i000_011126	120	446	326	0.987879	0.661258
GCA_011800985.1-Fun_JAANRL010002493.1_i000_011555	120	446	326	0.987879	0.661258
GCA_011801035.1-Fun_JAANRN010000152.1_i000_002265	120	446	326	0.987879	0.661258
GCA_011801055.1-Fun_JAANRO010000401.1_i000_004541	120	446	326	0.987879	0.661258
GCA_011801305.1-Fun_JAANRS010002412.1_i000_011460	120	446	326	0.987879	0.661258
GCA_011801385.1-Fun_JAANRR010002659.1_i000_011332	120	446	326	0.987879	0.661258
GCA_011801495.1-Fun_JAANRV010002426.1_i000_011551	120	446	326	0.987879	0.661258
GCA_011801555.1-Fun_JAANRX010002483.1_i000_011664	120	446	326	0.987879	0.661258
GCA_011801575.1-Fun_JAANRW010002406.1_i000_011629	120	446	326	0.987879	0.661258
GCA_011801605.1-Fun_JAANRT010002452.1_i000_011601	120	446	326	0.987879	0.661258
GCA_011801645.1-Fun_JAANRB010000413.1_i000_004405	120	446	326	0.987879	0.661258
GCA_011801705.1-Fun_JAANQY010000902.1_i000_006602	120	446	326	0.987879	0.661258
GCA_011801785.1-Fun_JAANQR010002286.1_i000_010409	120	446	326	0.987879	0.661258
GCA_011801815.1-Fun_JAANQU010002709.1_i000_011288	120	446	326	0.987879	0.661258
GCA_011950945.1-Fun_JAANRD010002417.1_i000_011669	120	446	326	0.987879	0.661258
GCA_011951285.1-Fun_JAANRG010002158.1_i000_011820	120	446	326	0.987879	0.661258
GCA_011951295.1-Fun_JAANRC010002661.1_i000_011377	120	446	326	0.987879	0.661258
GCA_011952045.1-Fun_JAANRH010000903.1_i000_006688	120	446	326	0.987879	0.661258
GCA_011952115.1-Fun_JAANRI010002915.1_i000_011159	120	446	326	0.987879	0.661258
GCA_011952145.1-Fun_JAANRJ010003265.1_i000_012520	120	446	326	0.987879	0.661258
GCA_011952175.1-Fun_JAANRK010001958.1_i000_011115	120	446	326	0.987879	0.661258
GCA_016834605.1-Pla_JAEHOC010000008.1_i000_004667	121	459	338	1.02424	0.673307
GCA_015680625.1-Fun_JAAAXW010000054.1_i000_009465	130	446	316	0.957576	0.625743
GCA_000149865.1-Fun_DS022300.1_i000_007570	136	457	321	0.972727	0.623301
GCA_015852395.1-Fun_JAAAII010003649.1_i000_011984	126	447	321	0.972727	0.635644
GCA_000203795.1-Fun_GL882879.1_i000_000712	137	458	321	0.972727	0.622093
GCA_003789085.1-Ani_QCYY01001401.1_i000_002979	17	115	98	0.29697	0.173759
GCA_003789085.1-Ani_QCYY01001401.1_i000_002979	150	481	331	1.00303	0.586879
GCA_000525045.1-Fun_KI966426.1_i000_003471	127	457	330	1	0.597826
GCA_015499985.1-Fun_JAAAUF010000334.1_i000_006046	123	448	325	0.984848	0.643564
GCA_001696595.2-Fun_MBFL02000072.1_i000_011333	131	461	330	1	0.626186
GCA_011392555.1-Fun_QMFL01000026.1_i000_000366	138	458	320	0.969697	0.621359
GCA_005059875.1-Fun_MXAQ01000006.1_i000_005374	124	454	330	1	0.640777
GCA_001566745.1-Fun_KQ964435.1_i000_001558	117	444	327	0.990909	0.637427
GCA_011763915.1-Fun_JAANJB010001185.1_i000_008235	125	455	330	1	0.666667
GCA_003614725.1-Fun_ML005319.1_i000_003207	122	436	314	0.951515	0.718535
GCA_001636715.1-Fun_AZGZ01000017.1_i000_001708	128	464	336	1.01818	0.651163
GCA_904845875.1-Pla_CAJGYO010000001.1_i000_001788	126	460	334	1.01212	0.606171
GCA_013396435.1-Ani_WBMU01008842.1_i000_013476	64	380	316	0.957576	0.670913
GCA_008636005.1-Pla_BKCP01005517.1_i000_014343	117	439	322	0.975758	0.588665
GCA_014466195.1-Ani_CM025365.1_i000_006107	125	458	333	1.00909	0.662028
GCA_001662645.1-Fun_KV459729.1_i000_009951	135	465	330	1	0.647059
GCA_011950985.1-Fun_JAANRF010000144.1_i000_002158	121	447	326	0.987879	0.545151
GCA_020466585.1-Ani_JAFETG010000010.1_i000_003395	609	939	330	1	0.322581
GCA_001272555.1-Ani_KQ434777.1_i000_000500	101	432	331	1.00303	0.695378
GCA_015849305.1-Fun_JAAAHY010000349.1_i000_006210	123	449	326	0.987879	0.63301
GCA_020466635.1-Ani_JAFETF010000011.1_i000_004827	620	950	330	1	0.318841
GCA_000750805.1-Fun_JPJY01001474.1_i000_007740	141	463	322	0.975758	0.638889
GCA_014108415.1-Ani_JACASF010000006.1_i000_017675	125	457	332	1.00606	0.556114
GCA_003434825.1-Pla_CM010630.1_i000_011395	136	448	312	0.945455	0.617822
GCA_003731715.1-Ani_RJVU01051519.1_i000_013888	132	446	314	0.951515	0.315261
GCA_001411555.2-Pla_CM023849.1_i000_019922	143	460	317	0.960606	0.577413
GCA_000697945.4-Ani_ML763003.1_i000_004580	134	465	331	1.00303	0.658052
GCA_014466185.1-Ani_CM025390.1_i000_006106	144	478	334	1.01212	0.639847
GCA_002105135.1-Fun_MCGN01000003.1_i000_005837	119	444	325	0.984848	0.7287
GCA_000149815.1-Fun_DS017020.1_i000_002455	127	454	327	0.990909	0.455432
GCA_001718145.1-Ani_LJIJ01000077.1_i000_003361	116	448	332	1.00606	0.622889
GCA_016584205.1-Fun_PUHQ01000087.1_i000_006623	118	445	327	0.990909	0.64497
GCA_011763645.1-Fun_JAASGZ010000006.1_i000_000157	126	454	328	0.993939	0.666667
GCA_011763975.1-Fun_JAANJF010001808.1_i000_009365	126	454	328	0.993939	0.666667
GCA_011763995.1-Fun_JAANJE010001276.1_i000_005008	126	454	328	0.993939	0.666667
GCA_011764025.1-Fun_JAANQT010001249.1_i000_007992	126	454	328	0.993939	0.666667
GCA_011764055.1-Fun_JAANQS010000185.1_i000_002214	126	454	328	0.993939	0.666667
GCA_011764125.1-Fun_JAANQV010002432.1_i000_006713	126	454	328	0.993939	0.666667
GCA_011764145.1-Fun_JAANQZ010001001.1_i000_004902	126	454	328	0.993939	0.666667
GCA_011764185.1-Fun_JAANRA010001254.1_i000_008186	126	454	328	0.993939	0.666667
GCA_011764225.1-Fun_JAANRQ010003381.1_i000_007799	126	454	328	0.993939	0.666667
GCA_011764265.1-Fun_JAANRE010005179.1_i000_007858	126	454	328	0.993939	0.666667
GCA_011800955.1-Fun_JAANRM010000481.1_i000_005308	126	454	328	0.993939	0.666667
GCA_011800985.1-Fun_JAANRL010001271.1_i000_008785	126	454	328	0.993939	0.666667
GCA_011801035.1-Fun_JAANRN010001275.1_i000_009215	126	454	328	0.993939	0.666667
GCA_011801055.1-Fun_JAANRO010001262.1_i000_008991	126	454	328	0.993939	0.666667
GCA_011801305.1-Fun_JAANRS010001574.1_i000_009747	126	454	328	0.993939	0.666667
GCA_011801335.1-Fun_JAANRP010001250.1_i000_007995	126	454	328	0.993939	0.666667
GCA_011801385.1-Fun_JAANRR010001612.1_i000_009220	126	454	328	0.993939	0.666667
GCA_011801495.1-Fun_JAANRV010000270.1_i000_003298	126	454	328	0.993939	0.666667
GCA_011801505.1-Fun_JAANRU010000128.1_i000_001934	126	454	328	0.993939	0.666667
GCA_011801555.1-Fun_JAANRX010000410.1_i000_004414	126	454	328	0.993939	0.666667
GCA_011801575.1-Fun_JAANRW010000731.1_i000_006647	126	454	328	0.993939	0.666667
GCA_011801605.1-Fun_JAANRT010001579.1_i000_009849	126	454	328	0.993939	0.666667
GCA_011801645.1-Fun_JAANRB010000162.1_i000_002150	126	454	328	0.993939	0.666667
GCA_011801675.1-Fun_JAANQW010001720.1_i000_009122	126	454	328	0.993939	0.666667
GCA_011801705.1-Fun_JAANQY010001266.1_i000_008092	126	454	328	0.993939	0.666667
GCA_011801725.1-Fun_JAANQX010001716.1_i000_009546	126	454	328	0.993939	0.666667
GCA_011801785.1-Fun_JAANQR010001194.1_i000_007554	126	454	328	0.993939	0.666667
GCA_011801815.1-Fun_JAANQU010001258.1_i000_007974	126	454	328	0.993939	0.666667
GCA_011950945.1-Fun_JAANRD010000234.1_i000_003063	126	454	328	0.993939	0.666667
GCA_011950985.1-Fun_JAANRF010000356.1_i000_004179	126	454	328	0.993939	0.666667
GCA_011951285.1-Fun_JAANRG010000923.1_i000_008414	126	454	328	0.993939	0.666667
GCA_011951295.1-Fun_JAANRC010000090.1_i000_001219	126	454	328	0.993939	0.666667
GCA_011952045.1-Fun_JAANRH010000246.1_i000_002707	126	454	328	0.993939	0.666667
GCA_011952115.1-Fun_JAANRI010001478.1_i000_008160	126	454	328	0.993939	0.666667
GCA_011952145.1-Fun_JAANRJ010000730.1_i000_006634	126	454	328	0.993939	0.666667
GCA_011952175.1-Fun_JAANRK010000117.1_i000_001892	126	454	328	0.993939	0.666667
GCA_019925795.1-Pla_CM034299.1_i000_002438	128	461	333	1.00909	0.608775
GCA_009733125.1-Pro_QXFY01000090.1_i000_003069	160	493	333	1.00909	0.614391
GCA_002705745.1-Fun_KZ303487.1_i000_000651	117	449	332	1.00606	0.636015
GCA_003073865.1-Fun_KZ804111.1_i000_001994	144	463	319	0.966667	0.621832
GCA_014466175.1-Ani_CM025340.1_i000_007336	125	458	333	1.00909	0.662028
GCA_000750875.1-Fun_JPKA01005524.1_i000_010423	159	481	322	0.975758	0.616858
GCA_019721115.1-Ani_CM033896.1_i000_006682	134	446	312	0.945455	0.557143
GCA_009729455.1-Pro_QWGH01000002.1_i000_010785	157	493	336	1.01818	0.619926
GCA_009732925.1-Pro_QXFW01000083.1_i000_002709	157	493	336	1.01818	0.619926
GCA_009732985.1-Pro_QXGB01000100.1_i000_003415	157	493	336	1.01818	0.619926
GCA_009733005.1-Pro_QXFX01000087.1_i000_002961	157	493	336	1.01818	0.619926
GCA_009733025.1-Pro_QXGA01000082.1_i000_002771	157	493	336	1.01818	0.619926
GCA_009733065.1-Pro_QXFZ01000097.1_i000_003338	157	493	336	1.01818	0.619926
GCA_009733085.1-Pro_QXGD01000114.1_i000_003869	157	493	336	1.01818	0.619926
GCA_009733105.1-Pro_QXGE01000089.1_i000_002962	157	493	336	1.01818	0.619926
GCA_000497085.1-Fun_BAUL01000177.1_i000_003430	129	454	325	0.984848	0.626204
GCA_904845875.1-Pla_CAJGYO010000002.1_i000_007187	126	461	335	1.01515	0.607985
GCA_008795845.1-Ani_SGJD01002597.1_i000_012621	165	495	330	1	0.625
GCA_012274485.2-Pla_MU106336.1_i000_033685	126	458	332	1.00606	0.65098
GCA_000149305.1-Fun_CH476749.1_i000_001107	124	447	323	0.978788	0.655172
GCA_011763585.1-Fun_JAANIP010002875.1_i000_010676	124	447	323	0.978788	0.655172
GCA_011763695.1-Fun_JAANIQ010001314.1_i000_007590	124	447	323	0.978788	0.655172
GCA_011763715.1-Fun_JAANIR010000340.1_i000_003168	124	447	323	0.978788	0.655172
GCA_011763735.1-Fun_JAANIS010000869.1_i000_004059	124	447	323	0.978788	0.655172
GCA_011763755.1-Fun_JAANIW010001311.1_i000_009091	124	447	323	0.978788	0.655172
GCA_011763775.1-Fun_JAANIT010000181.1_i000_002182	124	447	323	0.978788	0.655172
GCA_011763795.1-Fun_JAANIV010001363.1_i000_009173	124	447	323	0.978788	0.655172
GCA_011763815.1-Fun_JAANIU010001334.1_i000_007936	124	447	323	0.978788	0.655172
GCA_011763835.1-Fun_JAANIX010001366.1_i000_009320	124	447	323	0.978788	0.655172
GCA_011763855.1-Fun_JAANJA010000066.1_i000_001148	124	447	323	0.978788	0.655172
GCA_011763875.1-Fun_JAANIZ010001285.1_i000_007780	124	447	323	0.978788	0.655172
GCA_011763895.1-Fun_JAANIY010000354.1_i000_003492	124	447	323	0.978788	0.655172
GCA_011763915.1-Fun_JAANJB010000347.1_i000_003786	124	447	323	0.978788	0.655172
GCA_019279435.1-Pla_JAAALK010000079.1_i000_040354	125	460	335	1.01515	0.613553
GCA_006912115.1-Fun_VCMJ01000222.1_i000_000655	135	460	325	0.984848	0.621415
GCA_000004195.4-Ani_CM004451.2_i000_023094	117	444	327	0.990909	0.613508
GCA_010094145.1-Fun_ML979003.1_i000_010862	138	464	326	0.987879	0.630561
GCA_001619985.1-Fun_KV407460.1_i000_005522	136	464	328	0.993939	0.638132
GCA_000750665.1-Fun_JPJS01001154.1_i000_004273	141	467	326	0.987879	0.645545
GCA_000750675.1-Fun_JPJR01000545.1_i000_003305	141	467	326	0.987879	0.645545
GCA_020800215.1-Pro_JAICDV010000006.1_i000_007447	125	461	336	1.01818	0.657534
GCA_020800235.1-Pro_JAICDX010000001.1_i000_000567	125	461	336	1.01818	0.657534
GCA_000836275.1-Fun_KN847524.1_i000_007448	129	459	330	1	0.633397
GCA_007224835.1-Ani_SRMA01026906.1_i000_017976	132	443	311	0.942424	0.520938
GCA_012295175.1-Pro_WSZM01000106.1_i000_005303	125	458	333	1.00909	0.649123
GCA_012552325.1-Pro_JAACNO010001745.1_i000_012838	125	458	333	1.00909	0.649123
GCA_902728155.2-Pla_CACVBM020001495.1_i000_038961	138	442	304	0.921212	0.614141
GCA_000325575.1-Ani_KB031072.1_i000_015328	148	475	327	0.990909	0.531707
GCA_927797965.1-Ani_OV696702.1_i000_023296	114	447	333	1.00909	0.624765
GCA_002104905.1-Fun_MCFE01000020.1_i000_004262	117	448	331	1.00303	0.660679
GCA_012977835.1-Fun_SDJM01000001.1_i000_000163	129	460	331	1.00303	0.600726
GCA_000005005.6-Pla_CM000785.4_i000_035391	126	462	336	1.01818	0.59051
GCA_002104905.1-Fun_MCFE01000429.1_i000_009529	118	446	328	0.993939	0.643137
GCA_001890805.1-Fun_KV878894.1_i000_004280	131	456	325	0.984848	0.633528
GCA_003547095.1-Fun_PQFF01000551.1_i000_024898	123	458	335	1.01515	0.588752
GCA_000204055.1-Fun_GL883100.1_i000_004565	126	455	329	0.99697	0.61039
GCA_014462685.1-Ani_JAACXV010014356.1_i000_018485	125	455	330	1	0.638298
GCA_910591825.1-Fun_CAJVPQ010002259.1_i000_008031	129	463	334	1.01212	0.633776
GCA_019155685.1-Pro_JAGDFL010000001.1_i000_000075	126	458	332	1.00606	0.648438
GCA_003203535.1-Pla_BDRX01000061.1_i000_007900	128	478	350	1.06061	0.714286
GCA_001270105.1-Ani_LHQP01030838.1_i000_038277	134	451	317	0.960606	0.565062
GCA_015852495.1-Fun_JAAAIK010001872.1_i000_003291	90	420	330	1	0.690377
GCA_001879085.1-Pla_MJEQ01000490.1_i000_017980	125	459	334	1.01212	0.609489
GCA_002104935.1-Fun_MCGT01000004.1_i000_007311	124	452	328	0.993939	0.670757
GCA_019448385.1-Pro_JAGTXO010000001.1_i000_001928	111	436	325	0.984848	0.674274
GCA_004011775.1-Fun_NAJM01000012.1_i000_001053	135	461	326	0.987879	0.62572
GCA_902728155.2-Pla_CACVBM020001055.1_i000_014595	128	457	329	0.99697	0.654076
GCA_017639395.1-Pla_CM029886.1_i000_032224	132	459	327	0.990909	0.630058
GCA_016508695.1-Fun_VNKQ01000013.1_i000_001873	141	467	326	0.987879	0.636719
GCA_010015815.1-Fun_ML977505.1_i000_005221	135	463	328	0.993939	0.630769
GCA_003704535.1-Pro_QLLG01000156.1_i000_000639	129	466	337	1.02121	0.648077
GCA_003843895.1-Pro_QKXF01000083.1_i000_000849	129	466	337	1.02121	0.648077
GCA_003521335.2-Ani_QWLN02016365.1_i000_015111	276	605	329	0.99697	0.441019
GCA_016758965.1-Fun_JAEPRB010000009.1_i000_001184	126	455	329	0.99697	0.658
GCA_907169785.1-Ani_CAJRST010015557.1_i000_012609	127	444	317	0.960606	0.595865
GCA_020080175.1-Fun_JAGHQL010000145.1_i000_001486	133	464	331	1.00303	0.597473
GCA_003184645.1-Fun_KZ825942.1_i000_008662	132	452	320	0.969697	0.638723
GCA_008124465.1-Pla_CM017887.1_i000_021000	34	364	330	1	0.714286
GCA_016865095.1-Pro_RCMR01000137.1_i000_006687	126	460	334	1.01212	0.649805
GCA_016880985.1-Pro_QOKR01000139.1_i000_003662	126	460	334	1.01212	0.649805
GCA_003611195.1-Fun_MCBQ01002865.1_i000_001110	139	464	325	0.984848	0.616698
GCA_905331495.1-Ani_CAJNYV010004736.1_i000_025942	3	327	324	0.981818	0.928367
GCA_905332285.1-Ani_CAJOBS010000561.1_i000_010661	3	327	324	0.981818	0.928367
GCA_020080835.1-Ani_CM034667.1_i000_014578	126	460	334	1.01212	0.677485
GCA_016771965.1-Pla_CM028690.1_i000_021171	124	454	330	1	0.658683
GCA_010724915.1-Fun_BLKL01000007.1_i000_001608	128	455	327	0.990909	0.633721
GCA_007821475.1-Fun_QGMF01000412.1_i000_005971	133	495	362	1.09697	0.721116
GCA_001712635.2-Pro_MBAC02010849.1_i000_024699	118	450	332	1.00606	0.654832
GCA_000150475.2-Fun_KN305546.1_i000_007639	130	457	327	0.990909	0.626437
GCA_019049445.1-Ani_JAHFVI010000047.1_i000_011663	127	491	364	1.10303	0.736842
GCA_021491655.1-Pro_CP090800.1_i000_001343	129	464	335	1.01515	0.645472
GCA_000750735.1-Fun_JPJU01002306.1_i000_006367	142	463	321	0.972727	0.633136
GCA_015679415.1-Fun_JAAAUT010000086.1_i000_010076	524	851	327	0.990909	0.357768
GCA_001712635.2-Pro_MBAC02007786.1_i000_017789	117	452	335	1.01515	0.66075
GCA_003611215.1-Fun_MCBR01007331.1_i000_002436	143	464	321	0.972727	0.609108
GCA_001896365.1-Fun_MIKG01000002.1_i000_004415	133	458	325	0.984848	0.64741
GCA_013339905.1-Ani_CM023519.1_i000_020699	124	445	321	0.972727	0.602251
GCA_000836435.1-Fun_KN848086.1_i000_009667	128	461	333	1.00909	0.641618
GCA_001646985.1-Fun_LVCI01000106.1_i000_000533	128	461	333	1.00909	0.641618
GCA_009193465.1-Fun_ML742033.1_i000_001345	128	433	305	0.924242	0.702765
GCA_905337335.1-Fun_CAJPDQ010000012.1_i000_004141	131	490	359	1.08788	0.706693
GCA_002911725.1-Pro_NCKW01020427.1_i000_024003	125	461	336	1.01818	0.687117
GCA_016880175.1-Pro_RCMS01000518.1_i000_014013	168	502	334	1.01212	0.600719
GCA_001605985.2-Pla_KZ503388.1_i000_023281	128	461	333	1.00909	0.608775
GCA_020169575.1-Pla_CM035000.1_i000_003182	123	459	336	1.01818	0.608696
GCA_000333075.3-Pro_AOFI03000023.1_i000_004331	125	460	335	1.01515	0.656863
GCA_000785725.3-Pro_JPWU03000003.1_i000_004691	125	460	335	1.01515	0.656863
GCA_000785735.3-Pro_JPWV03000001.1_i000_000029	125	460	335	1.01515	0.656863
GCA_001707905.2-Pro_MAYM02001079.1_i000_000557	125	460	335	1.01515	0.656863
GCA_001712715.2-Pro_MBDN02000003.1_i000_004774	125	460	335	1.01515	0.656863
GCA_904420315.1-Pla_LR881466.1_i000_003869	1218	1540	322	0.975758	0.193626
GCA_003427355.1-Ani_BFAA01013637.1_i000_018666	107	430	323	0.978788	0.619962
GCA_019202805.1-Pla_CM032902.1_i000_011915	126	457	331	1.00303	0.663327
GCA_016097885.1-Fun_JAAAIO010000667.1_i000_008606	119	451	332	1.00606	0.638462
GCA_902651935.1-Pla_CACRSJ010000106.1_i000_012613	124	451	327	0.990909	0.655311
GCA_018340605.1-Fun_BHVY01000004.1_i000_006082	129	455	326	0.987879	0.631783
GCA_902705455.1-Pla_CACSHJ010000089.1_i000_012445	124	457	333	1.00909	0.667335
GCA_002104995.1-Fun_MCFD01000010.1_i000_001795	118	447	329	0.99697	0.646365
GCA_011763855.1-Fun_JAANJA010000260.1_i000_003227	134	454	320	0.969697	0.646465
GCA_015502505.1-Fun_JAAAUQ010002390.1_i000_005136	121	447	326	0.987879	0.645545
GCA_002762385.1-Pla_NKXS01001011.1_i000_006172	121	439	318	0.963636	0.541738
MEBA001.0722.00001.C001_01251	79	407	328	0.993939	0.792271
GCA_013677235.1-Pla_CM025193.1_i000_000427	59	389	330	1	0.712743
GCA_013677245.1-Pla_CM025206.1_i000_000410	59	389	330	1	0.712743
GCA_000214015.2-Pla_CAID01000008.2_i000_003890	126	461	335	1.01515	0.708245
GCA_002158475.1-Pla_KZ155780.1_i000_002597	126	461	335	1.01515	0.708245
GCA_003611235.1-Fun_MCBS01024996.1_i000_006237	142	465	323	0.978788	0.612903
GCA_011763935.1-Fun_JAANJC010000123.1_i000_001860	346	673	327	0.990909	0.461864
GCA_911649665.1-Fun_CAJVRL010000038.1_i000_002292	137	466	329	0.99697	0.648915
GCA_000001985.1-Fun_DS995904.1_i000_002183	145	461	316	0.957576	0.623274
GCA_009556855.1-Fun_CP045654.1_i000_003311	145	461	316	0.957576	0.623274
GCA_009650675.1-Fun_CM018878.1_i000_008204	145	461	316	0.957576	0.623274
GCA_000142945.1-Pro_DS028124.1_i000_012897	125	459	334	1.01212	0.649805
GCA_002113885.2-Ani_NEDP02005386.1_i000_015374	125	458	333	1.00909	0.635496
GCA_000968595.1-Fun_LASV01000099.1_i000_002431	130	460	330	1	0.381062
GCA_001713645.1-Fun_LZYO01000050.1_i000_005896	131	462	331	1.00303	0.6341
GCA_001713695.1-Fun_LYUC01000062.1_i000_006531	131	462	331	1.00303	0.6341
GCA_905219645.1-Fun_CAJMWZ010001686.1_i000_001763	106	407	301	0.912121	0.526224
GCA_905219645.1-Fun_CAJMWZ010001686.1_i000_001763	401	466	65	0.19697	0.113636
GCA_009733165.1-Ani_CM019148.1_i000_002092	124	442	318	0.963636	0.596623
GCA_000002335.3-Ani_CM000284.3_i000_012856	124	462	338	1.02424	0.691207
GCA_003185045.1-Pla_CM009914.1_i000_034283	126	460	334	1.01212	0.592199
GCA_016097935.1-Fun_JAAAIP010000184.1_i000_002655	119	450	331	1.00303	0.638996
GCA_011763645.1-Fun_JAASGZ010000814.1_i000_007101	121	448	327	0.990909	0.515773
GCA_003788595.2-Fun_ML120431.1_i000_011317	135	463	328	0.993939	0.616541
GCA_000523455.1-Fun_KI963929.1_i000_001758	135	464	329	0.99697	0.635135
GCA_000516915.1-Ani_AZIM01001659.1_i000_008057	121	440	319	0.966667	0.598499
GCA_905250095.1-Ani_CAJNOR010004535.1_i000_040148	139	461	322	0.975758	0.675052
GCA_003287315.1-Pro_MJFZ01000578.1_i000_018138	125	462	337	1.02121	0.65692
GCA_016864665.1-Pro_RCMF01000529.1_i000_014674	125	462	337	1.02121	0.65692
GCA_016864755.1-Pro_RCMH01000523.1_i000_015920	125	462	337	1.02121	0.65692
GCA_020379485.1-Pla_CM035458.1_i000_053706	149	470	321	0.972727	0.593346
GCA_016864795.1-Pro_RCMN01000542.1_i000_014963	126	462	336	1.01818	0.653696
GCA_016864835.1-Pro_RCMM01000533.1_i000_015633	126	462	336	1.01818	0.653696
GCA_016865085.1-Pro_RCMU01000453.1_i000_018333	126	462	336	1.01818	0.653696
GCA_013368085.1-Ani_JABVZW010002413.1_i000_010881	125	466	341	1.03333	0.701646
GCA_003427335.1-Ani_BEZZ01003839.1_i000_021223	130	457	327	0.990909	0.590253
GCA_000750755.1-Fun_JPJW01002213.1_i000_006707	138	466	328	0.993939	0.645669
GCA_000835395.1-Fun_KN846951.1_i000_002564	130	462	332	1.00606	0.64466
GCA_905250025.1-Ani_CAJNOJ010000017.1_i000_005931	142	457	315	0.954545	0.660377
GCA_905331015.1-Ani_CAJNXB010002433.1_i000_014971	112	443	331	1.00303	0.711828
GCA_905331295.1-Ani_CAJNYD010002417.1_i000_019058	112	443	331	1.00303	0.711828
GCA_905331475.1-Ani_CAJNYU010002677.1_i000_020808	112	443	331	1.00303	0.711828
GCA_905331485.1-Ani_CAJNYT010005054.1_i000_028894	112	443	331	1.00303	0.711828
GCA_905332235.1-Ani_CAJOBO010000135.1_i000_003653	112	443	331	1.00303	0.711828
GCA_905332265.1-Ani_CAJOBQ010000556.1_i000_011496	112	443	331	1.00303	0.711828
GCA_001272555.1-Ani_KQ434946.1_i000_008623	120	444	324	0.981818	0.546374
GCA_000150735.2-Fun_KN275962.1_i000_004948	131	463	332	1.00606	0.636015
GCA_001263375.1-Fun_LAVV01006537.1_i000_005274	130	458	328	0.993939	0.640625
GCA_020747045.1-Fun_JAGTJN010000012.1_i000_002483	135	463	328	0.993939	0.630769
GCA_002754855.1-Ani_MRZV01000470.1_i000_020344	110	454	344	1.04242	0.588034
GCA_012411365.1-Ani_CM022769.1_i000_016827	125	456	331	1.00303	0.663327
GCA_018873745.1-Pro_JAENGY010000410.1_i000_011561	175	509	334	1.01212	0.59325
GCA_014176215.1-Ani_JACASE010000012.1_i000_003808	127	454	327	0.990909	0.547739
GCA_013841205.1-Ani_JACDQY010000208.1_i000_004989	129	458	329	0.99697	0.665992
GCA_002928715.1-Pla_KZ668752.1_i000_033525	59	421	362	1.09697	0.752599
GCA_016745375.1-Ani_WIOS01000030.1_i000_014443	127	452	325	0.984848	0.59415
GCA_016618385.1-Ani_JABFOP010000764.1_i000_014149	139	475	336	1.01818	0.59364
GCA_008636005.1-Pla_BKCP01004113.1_i000_005168	117	439	322	0.975758	0.581227
GCA_020169585.1-Pla_CM034976.1_i000_003407	123	460	337	1.02121	0.609403
GCA_021901695.1-Fun_CM038884.1_i000_014349	123	455	332	1.00606	0.652259
GCA_002290385.1-Ani_KZ288253.1_i000_004062	130	461	331	1.00303	0.665996
GCA_902206195.3-Pla_CABITT030000005.1_i000_014859	127	437	310	0.939394	0.707763
GCA_001483705.1-Ani_KQ760547.1_i000_003013	113	445	332	1.00606	0.574394
GCA_015179045.1-Fun_WHUZ01000049.1_i000_010227	134	451	317	0.960606	0.595865
MESP085.0722.00001.C001_01523	79	407	328	0.993939	0.792271
GCA_000090985.2-Pla_CP001327.1_i000_004626	261	615	354	1.07273	0.573744
GCA_016097865.1-Fun_JAAAIN010003076.1_i000_011259	124	453	329	0.99697	0.651485
GCA_016864715.1-Pro_RCMK01000514.1_i000_015422	167	504	337	1.02121	0.606115
GCA_016864775.1-Pro_RCMO01000565.1_i000_016081	167	504	337	1.02121	0.606115
GCA_016906365.1-Pro_RCMQ01000532.1_i000_014821	167	504	337	1.02121	0.606115
GCA_012274485.2-Pla_MU106686.1_i000_038574	133	459	326	0.987879	0.630561
GCA_902829315.1-Ani_CADEPM010000011.1_i000_012230	110	442	332	1.00606	0.700422
GCA_000006295.1-Ani_DS235004.1_i000_010372	136	478	342	1.03636	0.70082
GCA_001191645.1-Fun_AJIL01000182.1_i000_014178	123	454	331	1.00303	0.650295
GCA_021901655.1-Fun_CM038902.1_i000_014109	123	454	331	1.00303	0.650295
GCA_003186165.1-Ani_CP026248.1_i000_006261	226	543	317	0.960606	0.491473
GCA_018873755.1-Pro_JAENGZ010000435.1_i000_012523	174	511	337	1.02121	0.598579
GCA_015849285.1-Fun_JAAAHZ010000417.1_i000_006392	519	845	326	0.987879	0.357849
GCA_016758905.1-Fun_JAEPQZ010000001.1_i000_000707	121	449	328	0.993939	0.633205
GCA_018292915.1-Ani_JACVVK010000005.1_i000_001123	120	443	323	0.978788	0.612903
GCA_001907595.1-Fun_LFMY01000005.1_i000_006987	135	459	324	0.981818	0.63035
GCA_000151315.2-Pro_KE346370.1_i000_006583	134	468	334	1.01212	0.665339
GCA_002105135.1-Fun_MCGN01000002.1_i000_004960	126	455	329	0.99697	0.620755
GCA_016864635.1-Pro_RCME01000512.1_i000_013582	167	502	335	1.01515	0.603604
GCA_016864655.1-Pro_NHQK01000074.1_i000_025375	167	502	335	1.01515	0.603604
GCA_016864695.1-Pro_RCMG01000531.1_i000_014862	167	502	335	1.01515	0.603604
GCA_016864735.1-Pro_RCMI01000520.1_i000_014031	167	502	335	1.01515	0.603604
GCA_016864815.1-Pro_RCML01000544.1_i000_014674	167	502	335	1.01515	0.603604
GCA_016864855.1-Pro_RCMP01000532.1_i000_014494	167	502	335	1.01515	0.603604
GCA_016865055.1-Pro_RCMV01000521.1_i000_013177	167	502	335	1.01515	0.603604
GCA_016865075.1-Pro_RCMT01000566.1_i000_021033	167	502	335	1.01515	0.603604
GCA_017309695.1-Pro_RCMJ01000557.1_i000_018980	167	502	335	1.01515	0.603604
GCA_011763605.1-Fun_JAANIO010006126.1_i000_010219	42	366	324	0.981818	0.782609
GCA_000600275.1-Fun_KK088414.1_i000_002037	131	460	329	0.99697	0.641326
GCA_003325415.1-Fun_PJQM01000758.1_i000_003140	118	449	331	1.00303	0.663327
GCA_016098035.1-Fun_JAAAIV010000048.1_i000_006910	531	858	327	0.990909	0.353132
GCA_004917335.1-Fun_QZAR01000152.1_i000_002329	131	463	332	1.00606	0.631179
GCA_000585565.1-Fun_AMGY01000001.1_i000_000770	130	460	330	1	0.637066
GCA_009835175.1-Pro_VJMJ01000322.1_i000_018511	129	459	330	1	0.681818
GCA_021527685.1-Pro_JAJGMV010000283.1_i000_006486	129	459	330	1	0.681818
GCA_021527745.1-Pro_JAJNML010000595.1_i000_005764	129	459	330	1	0.681818
GCA_000209225.1-Ani_DS469654.1_i000_011793	126	457	331	1.00303	0.615242
GCA_000835555.1-Fun_KN847480.1_i000_008125	129	462	333	1.00909	0.64786
GCA_006346445.1-Ani_VEVO01000011.1_i000_012956	127	455	328	0.993939	0.588869
GCA_004798865.1-Ani_SJPD01000030.1_i000_007557	131	446	315	0.954545	0.587687
GCA_021527665.1-Pro_JAJNMJ010000417.1_i000_004355	130	461	331	1.00303	0.683884
GCA_021527805.1-Pro_JAJNMK010001306.1_i000_010957	130	461	331	1.00303	0.683884
GCA_000787975.1-Pla_JRRC01191467.1_i000_011721	123	440	317	0.960606	0.559083
GCA_002204255.1-Fun_MZNU01000050.1_i000_007503	137	464	327	0.990909	0.637427
GCA_006013705.1-Pla_RXGB01000871.1_i000_004592	122	459	337	1.02121	0.609403
GCA_012184355.1-Fun_LDUC01000503.1_i000_000176	131	460	329	0.99697	0.594937
GCA_019447015.1-Ani_CM033477.1_i000_017417	117	443	326	0.987879	0.615094
GCA_013368755.1-Fun_CP055899.1_i000_003578	131	452	321	0.972727	0.62818
GCA_017365405.1-Fun_JAFJYH010000066.1_i000_005444	142	465	323	0.978788	0.630859
GCA_001566745.1-Fun_KQ964435.1_i000_001564	121	454	333	1.00909	0.686598
GCA_905219575.1-Fun_CAJMWT010003305.1_i000_005647	126	453	327	0.990909	0.59132
GCA_002922495.1-Fun_PJQD01000023.1_i000_002469	129	456	327	0.990909	0.628846
GCA_000827325.1-Fun_KN832876.1_i000_007610	137	465	328	0.993939	0.653386
GCA_004917115.1-Fun_QZAI01000155.1_i000_000842	133	461	328	0.993939	0.623574
GCA_000721785.1-Fun_KL584994.1_i000_009146	131	463	332	1.00606	0.631179
GCA_004917135.1-Fun_QZAJ01000332.1_i000_004992	131	463	332	1.00606	0.631179
GCA_004917155.1-Fun_QZAG01000783.1_i000_009371	131	463	332	1.00606	0.631179
GCA_004917165.1-Fun_QZAK01000395.1_i000_007154	131	463	332	1.00606	0.631179
GCA_004917185.1-Fun_QZAL01000130.1_i000_001526	131	463	332	1.00606	0.631179
GCA_004917205.1-Fun_QZAN01000144.1_i000_002244	131	463	332	1.00606	0.631179
GCA_004917225.1-Fun_QZAH01000622.1_i000_008105	131	463	332	1.00606	0.631179
GCA_004917275.1-Fun_QZAO01000368.1_i000_005769	131	463	332	1.00606	0.631179
GCA_004917305.1-Fun_QZAP01000690.1_i000_008606	131	463	332	1.00606	0.631179
GCA_004917375.1-Fun_QZAT01000131.1_i000_001769	131	463	332	1.00606	0.631179
GCA_004917415.1-Fun_QZAX01000950.1_i000_010379	131	463	332	1.00606	0.631179
GCA_004917425.1-Fun_QZAZ01000345.1_i000_005668	131	463	332	1.00606	0.631179
GCA_004917435.1-Fun_QZBA01000411.1_i000_007592	131	463	332	1.00606	0.631179
GCA_004917595.1-Fun_QZAQ01000450.1_i000_007338	131	463	332	1.00606	0.631179
GCA_004917605.1-Fun_QZAU01000669.1_i000_008442	131	463	332	1.00606	0.631179
GCA_004917615.1-Fun_QZAY01000302.1_i000_005613	131	463	332	1.00606	0.631179
GCA_004917665.1-Fun_QZBH01000181.1_i000_002419	131	463	332	1.00606	0.631179
GCA_004917795.1-Fun_QZBL01000670.1_i000_008415	131	463	332	1.00606	0.631179
GCA_004918105.1-Fun_QZBS01000526.1_i000_007709	131	463	332	1.00606	0.631179
GCA_004918115.1-Fun_QZBT01000146.1_i000_002174	131	463	332	1.00606	0.631179
GCA_004918145.1-Fun_QZBV01000081.1_i000_009826	131	463	332	1.00606	0.631179
GCA_004918165.1-Fun_QZBW01000530.1_i000_008078	131	463	332	1.00606	0.631179
GCA_004918195.1-Fun_QZCA01000467.1_i000_007773	131	463	332	1.00606	0.631179
GCA_004918535.1-Fun_QZBU01000221.1_i000_001250	131	463	332	1.00606	0.631179
GCA_004918575.1-Fun_QZBY01001024.1_i000_000264	131	463	332	1.00606	0.631179
GCA_015251385.1-Fun_JADGIM010000023.1_i000_004328	131	463	332	1.00606	0.631179
GCA_000311805.2-Ani_KB017191.1_i000_012628	900	1231	331	1.00303	0.241606
GCA_004918275.1-Fun_QZBR01000077.1_i000_009378	133	464	331	1.00303	0.629278
GCA_004917255.1-Fun_QZAM01000406.1_i000_007238	137	465	328	0.993939	0.618868
GCA_004917445.1-Fun_QZBB01000161.1_i000_002754	135	467	332	1.00606	0.626415
GCA_004917525.1-Fun_QZBG01000646.1_i000_008509	135	467	332	1.00606	0.626415
GCA_004917755.1-Fun_QZBO01000432.1_i000_007512	135	467	332	1.00606	0.626415
GCA_002271895.2-Pla_MCIT02000034.1_i000_034471	125	460	335	1.01515	0.606884
GCA_000512255.2-Pla_AYRZ02000046.1_i000_031807	128	460	332	1.00606	0.602541
GCA_011745845.1-Pla_VYZY01004617.1_i000_019832	128	460	332	1.00606	0.602541
GCA_011745865.1-Pla_VYZZ01002252.1_i000_011268	128	460	332	1.00606	0.602541
GCA_000750745.1-Fun_JPJV01001606.1_i000_004127	141	469	328	0.993939	0.649505
GCA_002928715.1-Pla_KZ662916.1_i000_003012	122	440	318	0.963636	0.591078
GCA_022343325.1-Fun_JACTNT010000010.1_i000_001817	133	462	329	0.99697	0.635135
GCA_004917555.1-Fun_QZBJ01000167.1_i000_002882	137	468	331	1.00303	0.624528
GCA_004917815.1-Fun_QZBQ01000389.1_i000_007128	137	468	331	1.00303	0.624528
GCA_011763915.1-Fun_JAANJB010000017.1_i000_000337	120	446	326	0.987879	0.31286
GCA_019788955.1-Ani_JAFBMS010000009.1_i000_026101	118	433	315	0.954545	0.601145
GCA_000338995.1-Fun_KB445638.1_i000_002074	136	463	327	0.990909	0.631274
GCA_013416765.1-Fun_WNKQ01000021.1_i000_009756	136	463	327	0.990909	0.631274
GCA_004917385.1-Fun_QZAV01000440.1_i000_007326	144	476	332	1.00606	0.615955
GCA_004917625.1-Fun_QZBC01000516.1_i000_007930	140	472	332	1.00606	0.620561
GCA_020744215.1-Fun_JAGMVJ010000001.1_i000_000954	137	463	326	0.987879	0.62572
GCA_004917105.1-Fun_QZAF01000595.1_i000_007858	144	476	332	1.00606	0.615955
GCA_004918245.1-Fun_QZBX01000131.1_i000_001977	144	476	332	1.00606	0.615955
GCA_014281875.1-Ani_CM024790.1_i000_001000	103	435	332	1.00606	0.605839
GCA_005784505.1-Ani_VCAZ01000019.1_i000_000590	825	1154	329	0.99697	0.261526
GCA_900000135.1-Fun_CCYT01000016.1_i000_006514	122	447	325	0.984848	0.657895
GCA_907166875.3-Ani_CAJRHG030000002.1_i000_003209	114	448	334	1.01212	0.612844
GCA_000523435.1-Fun_KI964537.1_i000_000064	134	464	330	1	0.637066
GCA_004917685.1-Fun_QZBI01000449.1_i000_007259	132	464	332	1.00606	0.632381
GCA_016745375.1-Ani_WIOS01000033.1_i000_014950	120	446	326	0.987879	0.595978
GCA_004918215.1-Fun_QZBP01000922.1_i000_010021	146	477	331	1.00303	0.6141
GCA_002920205.1-Fun_PKSM01000205.1_i000_010492	169	499	330	1	0.595668
GCA_900073065.1-Fun_FJOG01000026.1_i000_003705	136	461	325	0.984848	0.632296
GCA_001890105.1-Fun_KV878336.1_i000_000979	130	459	329	0.99697	0.633911
GCA_004917355.1-Fun_QZAS01000023.1_i000_004175	134	465	331	1.00303	0.625709
GCA_013400215.1-Ani_VXBR01004868.1_i000_005286	60	386	326	0.987879	0.698073
GCA_902728155.2-Pla_CACVBM020000222.1_i000_003492	126	458	332	1.00606	0.66004
GCA_902206195.3-Pla_CABITT030000004.1_i000_010543	124	457	333	1.00909	0.704017
GCA_004917705.1-Fun_QZBK01000373.1_i000_006010	131	463	332	1.00606	0.631179
GCA_903819635.1-Fun_CAIJEN010000001.1_i000_001338	118	451	333	1.00909	0.651663
GCA_001078535.1-Pro_CAIX01000074.1_i000_005364	127	466	339	1.02727	0.668639
GCA_016097325.1-Fun_JADPPX010000001.1_i000_001718	129	458	329	0.99697	0.629063
GCA_013340265.1-Ani_BLKM01000294.1_i000_001734	137	471	334	1.01212	0.665339
GCA_013397755.1-Ani_VZTF01008428.1_i000_012194	8	339	331	1.00303	0.786223
GCA_918697745.1-Ani_CAKKLH010000103.1_i000_005170	1259	1590	331	1.00303	0.171325
GCA_000442015.1-Fun_KE561071.1_i000_003939	548	880	332	1.00606	0.366851
GCA_010015635.1-Fun_ML976002.1_i000_001338	133	464	331	1.00303	0.640232
GCA_000441935.1-Fun_KE525461.1_i000_001427	128	459	331	1.00303	0.612963
GCA_000829775.1-Fun_DF933838.1_i000_002224	127	451	324	0.981818	0.651911
GCA_020744225.1-Fun_JAGMWG010000001.1_i000_000950	146	463	317	0.960606	0.604962
GCA_018320845.1-Ani_CM031335.1_i000_024155	133	444	311	0.942424	0.571691
GCA_011009095.1-Ani_VTPC01000652.1_i000_001261	133	442	309	0.936364	0.622984
GCA_003325415.1-Fun_PJQM01002008.1_i000_006275	83	407	324	0.981818	0.712088
GCA_021223825.1-Ani_JAJJHQ010008452.1_i000_007538	125	456	331	1.00303	0.664659
GCA_002072345.1-Fun_MDYN01000009.1_i000_003891	135	453	318	0.963636	0.621094
GCA_021365285.1-Fun_JAJTJA010000010.1_i000_001832	130	456	326	0.987879	0.634241
GCA_000149685.1-Fun_CH981532.1_i000_000392	139	452	313	0.948485	0.621032
GCA_017639395.1-Pla_CM029881.1_i000_014820	136	448	312	0.945455	0.617822
GCA_905261645.1-Ani_CAJNOV010001887.1_i000_006271	112	443	331	1.00303	0.711828
GCA_905273325.1-Ani_CAJNOW010014759.1_i000_026867	112	443	331	1.00303	0.711828
GCA_905319835.1-Ani_CAJNRE010000056.1_i000_000845	112	443	331	1.00303	0.711828
GCA_905321285.1-Ani_CAJNRF010003477.1_i000_010099	112	443	331	1.00303	0.711828
GCA_905321535.1-Ani_CAJNRG010007994.1_i000_018425	112	443	331	1.00303	0.711828
GCA_905332145.1-Ani_CAJOBF010000897.1_i000_009716	112	443	331	1.00303	0.711828
GCA_905332155.1-Ani_CAJOBG010000583.1_i000_005751	112	443	331	1.00303	0.711828
GCA_004026145.2-Ani_CP034992.1_i000_004803	1	280	279	0.845455	0.818182
GCA_002083745.1-Fun_KV921998.1_i000_008567	123	447	324	0.981818	0.65587
GCA_002708625.1-Fun_KZ303844.1_i000_002491	123	447	324	0.981818	0.65587
GCA_001662605.1-Fun_KV458931.1_i000_009713	135	490	355	1.07576	0.700197
GCA_004917485.1-Fun_QZBD01000602.1_i000_008032	140	472	332	1.00606	0.620561
GCA_001908125.1-Fun_MNBE01000071.1_i000_011380	131	459	328	0.993939	0.663968
GCA_000825725.1-Fun_CDGI01000307.1_i000_010298	122	447	325	0.984848	0.657895
GCA_002083735.1-Fun_KV921409.1_i000_007714	122	447	325	0.984848	0.657895
GCA_011762625.1-Fun_JAANIL010000361.1_i000_005156	122	447	325	0.984848	0.657895
GCA_011762635.1-Fun_JAANIK010000363.1_i000_005154	122	447	325	0.984848	0.657895
GCA_011763475.1-Fun_JAANIM010000089.1_i000_009178	122	447	325	0.984848	0.657895
GCA_011763565.1-Fun_JAANIN010000224.1_i000_004966	122	447	325	0.984848	0.657895
GCA_011764045.1-Fun_JAANQQ010000060.1_i000_001784	122	447	325	0.984848	0.657895
GCA_001263275.1-Ani_KQ414578.1_i000_000218	101	448	347	1.05152	0.751082
GCA_008704415.1-Fun_VXIS01000078.1_i000_011682	137	461	324	0.981818	0.604478
GCA_910592285.1-Fun_CAJVQC010006529.1_i000_004634	172	505	333	1.00909	0.617811
GCA_905250025.1-Ani_CAJNOJ010000244.1_i000_032022	111	444	333	1.00909	0.716129
GCA_905250095.1-Ani_CAJNOR010000465.1_i000_009124	111	444	333	1.00909	0.716129
GCA_002158475.1-Pla_KZ155786.1_i000_004018	126	464	338	1.02424	0.710084
GCA_009650685.1-Fun_CM018863.1_i000_001307	135	468	333	1.00909	0.586268
GCA_002865625.1-Fun_KZ613525.1_i000_014629	138	465	327	0.990909	0.638672
GCA_000185945.1-Fun_CP000290.1_i000_003278	135	468	333	1.00909	0.583187
GCA_000835745.1-Fun_KN848716.1_i000_004477	135	468	333	1.00909	0.583187
GCA_000836335.1-Fun_KN847985.1_i000_004474	135	468	333	1.00909	0.583187
GCA_000836355.1-Fun_KN847941.1_i000_005787	135	468	333	1.00909	0.583187
GCA_000855695.1-Fun_KN848903.1_i000_005245	135	468	333	1.00909	0.583187
GCA_000875815.1-Fun_KN849065.1_i000_004416	135	468	333	1.00909	0.583187
GCA_000935105.1-Fun_KN905631.1_i000_005286	135	468	333	1.00909	0.583187
GCA_003185045.1-Pla_NCVQ01000835.1_i000_037912	125	451	326	0.987879	0.655936
GCA_910591965.1-Fun_CAJVPY010005893.1_i000_010255	118	447	329	0.99697	0.660643
GCA_000004255.1-Pla_GL348715.1_i000_009694	136	456	320	0.969697	0.641283
GCA_000835755.1-Fun_KN848867.1_i000_004538	135	467	332	1.00606	0.581436
GCA_014904845.1-Fun_MU119272.1_i000_010374	140	461	321	0.972727	0.623301
GCA_014282415.2-Ani_JABDTM020022036.1_i000_006671	613	945	332	1.00606	0.339816
GCA_004917145.1-Fun_QZAE01000077.1_i000_009216	196	529	333	1.00909	0.563452
GCA_004917495.1-Fun_QZBE01000226.1_i000_004516	196	529	333	1.00909	0.563452
GCA_004917505.1-Fun_QZBF01000300.1_i000_004637	196	529	333	1.00909	0.563452
GCA_004917725.1-Fun_QZBM01000181.1_i000_002352	196	529	333	1.00909	0.563452
GCA_004917745.1-Fun_QZBN01000531.1_i000_007443	196	529	333	1.00909	0.563452
GCA_022264835.1-Fun_JAIFHY010000039.1_i000_010513	125	455	330	1	0.616822
GCA_003070745.1-Fun_NESQ01000232.1_i000_004805	138	461	323	0.978788	0.591575
GCA_014466175.1-Ani_CM025344.1_i000_010094	131	446	315	0.954545	0.584416
GCA_000211455.3-Ani_ADMH02002125.1_i000_000980	125	456	331	1.00303	0.658052
GCA_007990605.1-Fun_BJWK01000002.1_i000_001152	166	494	328	0.993939	0.599634
GCA_002104935.1-Fun_MCGT01000055.1_i000_009297	120	451	331	1.00303	0.664659
GCA_002865645.1-Fun_KZ613740.1_i000_000471	141	464	323	0.978788	0.62963
GCA_000338975.1-Fun_KB445569.1_i000_000473	133	463	330	1	0.639535
GCA_000354255.1-Fun_KB733459.1_i000_007519	133	463	330	1	0.639535
GCA_019454015.1-Fun_JAHUAA010000007.1_i000_009682	133	463	330	1	0.639535
GCA_000751015.1-Pla_LK033562.1_i000_048885	134	455	321	0.972727	0.635644
GCA_003260695.2-Pla_QGKY02000089.1_i000_002887	134	455	321	0.972727	0.635644
GCA_016771965.1-Pla_CM028695.1_i000_041507	134	455	321	0.972727	0.635644
GCA_021527785.1-Pro_JAJATU010002635.1_i000_005094	125	460	335	1.01515	0.690722
GCA_021527785.1-Pro_JAJATU010003571.1_i000_007942	125	460	335	1.01515	0.690722
GCA_016835505.1-Ani_CM029060.1_i000_006426	134	441	307	0.930303	0.481947
GCA_000214015.2-Pla_CAID01000003.2_i000_001275	126	464	338	1.02424	0.710084
GCA_002105065.1-Fun_MCFC01000007.1_i000_006698	134	463	329	0.99697	0.599271
GCA_000743615.1-Ani_KN124706.1_i000_018070	1087	1416	329	0.99697	0.211304
GCA_900412535.3-Pla_LS974619.2_i000_014195	122	452	330	1	0.653465
GCA_905250095.1-Ani_CAJNOR010000052.1_i000_001650	111	444	333	1.00909	0.716129
GCA_905331505.1-Ani_CAJNYZ010001887.1_i000_031839	2	304	302	0.915152	0.929231
GCA_000733195.1-Pla_CM002872.1_i000_007047	128	460	332	1.00606	0.653543
GCA_000298775.1-Fun_JH921443.1_i000_006757	140	457	317	0.960606	0.616732
GCA_020379485.1-Pla_CM035448.1_i000_011265	127	457	330	1	0.647059
GCA_005549215.1-Pla_SSTE01002358.1_i000_004634	131	453	322	0.975758	0.692473
GCA_000750115.1-Fun_JPOX01000026.1_i000_006410	138	459	321	0.972727	0.411538
GCA_003675905.2-Ani_NCKV01000721.1_i000_002140	129	462	333	1.00909	0.309192
GCA_000313545.1-Fun_CAFZ01000288.1_i000_003894	128	458	330	1	0.627376
GCA_911693285.1-Fun_CAJVRM010000049.1_i000_001960	139	465	326	0.987879	0.644269
GCA_020169555.1-Pla_CM035012.1_i000_003532	123	459	336	1.01818	0.607595
GCA_000151525.2-Fun_ADAS02000145.1_i000_010546	124	456	332	1.00606	0.662675
GCA_019049445.1-Ani_JAHFVI010000010.1_i000_004276	117	445	328	0.993939	0.556876
GCA_005549225.1-Pla_SSTD01007912.1_i000_013373	126	448	322	0.975758	0.7
GCA_014362265.1-Pla_BJWL01000015.1_i000_022635	122	442	320	0.969697	0.604915
GCA_009809945.1-Fun_WTPW01002398.1_i000_023451	122	455	333	1.00909	0.650391
GCA_003709365.1-Pla_QOKY01000159.1_i000_002059	180	530	350	1.06061	0.642202
GCA_000835765.1-Fun_KN848835.1_i000_002762	135	468	333	1.00909	0.583187
GCA_000836315.1-Fun_KN848135.1_i000_002095	135	468	333	1.00909	0.583187
GCA_000836375.1-Fun_KN847911.1_i000_005631	135	468	333	1.00909	0.583187
GCA_000836455.1-Fun_KN848955.1_i000_002441	135	468	333	1.00909	0.583187
GCA_000875795.1-Fun_KN848507.1_i000_002308	135	468	333	1.00909	0.583187
GCA_000875855.1-Fun_KN848926.1_i000_002914	135	468	333	1.00909	0.583187
GCA_002954075.1-Fun_CP025764.1_i000_003649	135	468	333	1.00909	0.583187
GCA_000835815.1-Fun_KN848529.1_i000_003124	135	467	332	1.00606	0.581436
GCA_021399465.1-Fun_JAJTUS010000010.1_i000_000723	143	463	320	0.969697	0.623782
GCA_021399475.1-Fun_JAJTUR010000008.1_i000_015794	143	463	320	0.969697	0.623782
GCA_002072245.1-Fun_MDYL01000005.1_i000_002206	138	459	321	0.972727	0.617308
GCA_000227095.3-Fun_BACD03000004.1_i000_006343	143	460	317	0.960606	0.632735
GCA_001661265.1-Fun_KV454254.1_i000_000578	143	460	317	0.960606	0.632735
GCA_009732905.1-Pro_QXFV01000099.1_i000_002787	125	459	334	1.01212	0.654902
GCA_002271885.2-Pla_MLFT02000246.1_i000_031246	123	460	337	1.02121	0.611615
GCA_018258275.1-Pla_CM031107.1_i000_011180	123	459	336	1.01818	0.607595
GCA_003550325.1-Fun_QKWP01002296.1_i000_027110	122	455	333	1.00909	0.650391
GCA_001048715.1-Fun_CDHK01000002.1_i000_002238	136	466	330	1	0.645793
GCA_002016555.1-Fun_LJBN01000241.1_i000_010218	136	466	330	1	0.645793
GCA_905219615.1-Fun_CAJMWW010000065.1_i000_001029	126	454	328	0.993939	0.58363
GCA_002237265.2-Fun_NKHU02000324.1_i000_005619	129	462	333	1.00909	0.640385
GCA_003614145.1-Fun_KZ987751.1_i000_000338	130	451	321	0.972727	0.639442
GCA_020080795.1-Fun_JAGHQM010001125.1_i000_000499	133	463	330	1	0.584071
GCA_000798715.1-Fun_JNVN01001741.1_i000_003577	135	446	311	0.942424	0.694196
GCA_002317995.1-Fun_MVNX01000116.1_i000_009314	144	462	318	0.963636	0.618677
GCA_002738505.1-Pla_KZ305028.1_i000_008574	126	461	335	1.01515	0.595027
GCA_000281105.1-Fun_JH767603.1_i000_008171	130	463	333	1.00909	0.615527
GCA_000293215.1-Fun_JH977602.1_i000_006406	135	472	337	1.02121	0.599644
GCA_000299215.2-Fun_JH925089.1_i000_001868	135	472	337	1.02121	0.599644
GCA_014049915.1-Ani_JABVXQ010000010.1_i000_002291	127	455	328	0.993939	0.550336
GCA_001417965.1-Ani_LJWW01000074.1_i000_023135	130	457	327	0.990909	0.584973
GCA_910592005.1-Fun_CAJVPP010003079.1_i000_009935	127	463	336	1.01818	0.667992
GCA_014904855.1-Fun_MU118106.1_i000_009401	135	459	324	0.981818	0.623077
MESP036.0722.00001.C001_00821	78	393	315	0.954545	0.799492
GCA_021224005.1-Ani_JAJJHY010008598.1_i000_008514	125	456	331	1.00303	0.67004
GCA_003073295.1-Fun_KZ803330.1_i000_007625	135	460	325	0.984848	0.612053
GCA_016097715.1-Fun_JAAZWU010000004.1_i000_006588	130	457	327	0.990909	0.637427
GCA_016097735.1-Fun_JAAZWV010000007.1_i000_008519	130	457	327	0.990909	0.637427
GCA_013339905.1-Ani_CM023498.1_i000_002847	158	484	326	0.987879	0.542429
GCA_016097715.1-Fun_JAAZWU010000330.1_i000_005762	119	448	329	0.99697	0.661972
GCA_016097735.1-Fun_JAAZWV010000320.1_i000_004684	119	448	329	0.99697	0.661972
GCA_016097755.1-Fun_JAAZWW010000348.1_i000_005796	119	448	329	0.99697	0.661972
GCA_009982855.1-Fun_JAADKA010000002.1_i000_003695	133	463	330	1	0.640777
GCA_000835505.1-Fun_KN847317.1_i000_001168	129	458	329	0.99697	0.637597
GCA_013305925.1-Fun_QVTG01000075.1_i000_002806	141	461	320	0.969697	0.629921
GCA_003182015.1-Fun_PYWC01000062.1_i000_007090	146	469	323	0.978788	0.594843
GCA_015143295.1-Pla_CM026558.1_i000_012241	115	441	326	0.987879	0.668033
GCA_910592245.1-Fun_CAJVQB010016525.1_i000_019632	121	455	334	1.01212	0.65748
GCA_000092065.1-Pla_CP000583.1_i000_001237	126	461	335	1.01515	0.706751
GCA_019455425.1-Pla_CM033494.1_i000_026881	122	440	318	0.963636	0.582418
GCA_009732945.1-Pro_QXFU01000229.1_i000_005394	158	492	334	1.01212	0.615101
GCA_009733145.1-Pro_QXFT01000217.1_i000_005298	158	492	334	1.01212	0.615101
GCA_002276475.2-Fun_NCSK02000079.1_i000_007829	138	464	326	0.987879	0.624521
GCA_013305595.1-Fun_QQZN01000065.1_i000_004256	134	457	323	0.978788	0.637081
GCA_013365075.1-Fun_QQZL01000353.1_i000_003226	134	457	323	0.978788	0.637081
GCA_007646595.3-Ani_VBQZ03000024.1_i000_006199	1026	1353	327	0.990909	0.218876
GCA_001005745.2-Ani_JARO02001421.1_i000_004829	123	433	310	0.939394	0.676856
GCA_000709125.1-Fun_AMGV01000003.1_i000_003643	145	464	319	0.966667	0.612284
GCA_013368075.1-Ani_JABVZV010002352.1_i000_017437	125	460	335	1.01515	0.695021
GCA_021613535.1-Ani_CP075494.1_i000_024696	139	459	320	0.969697	0.686695
GCA_921294245.1-Ani_OV121135.1_i000_005082	127	451	324	0.981818	0.632812
GCA_019924995.1-Fun_JAHFYO010002209.1_i000_007619	74	402	328	0.993939	0.703863
GCA_004918505.1-Fun_QZCB01000266.1_i000_004021	131	463	332	1.00606	0.631179
GCA_014466185.1-Ani_CM025394.1_i000_008916	121	445	324	0.981818	0.543624
GCA_001500285.1-Fun_KQ947419.1_i000_009630	139	462	323	0.978788	0.627184
GCA_903819465.1-Fun_CAIJDR010000007.1_i000_004987	111	440	329	0.99697	0.668699
GCA_903819485.1-Fun_CAIJDU010000008.1_i000_006634	111	440	329	0.99697	0.668699
MESP048.0722.00001.C001_00396	81	410	329	0.99697	0.794686
GCA_020169535.1-Pla_CM034988.1_i000_003334	123	459	336	1.01818	0.607595
GCA_004359215.2-Pro_CM033803.1_i000_000951	144	480	336	1.01818	0.629213
GCA_018342105.1-Ani_JAFIRS010000050.1_i000_001810	803	1134	331	1.00303	0.277452
GCA_903819115.1-Fun_CAIJCR010000005.1_i000_004373	118	447	329	0.99697	0.659319
GCA_903819455.1-Fun_CAIJDQ010000017.1_i000_007611	118	447	329	0.99697	0.659319
GCA_000524645.1-Fun_JATN01000319.1_i000_004974	126	454	328	0.993939	0.59745
GCA_000146915.2-Fun_CH445345.1_i000_004275	134	464	330	1	0.637066
GCA_016801405.1-Fun_CP069034.1_i000_011420	134	464	330	1	0.637066
GCA_020557385.1-Fun_JAIRDT010000020.1_i000_010189	134	464	330	1	0.637066
GCA_020567955.1-Fun_JAIRGA010000020.1_i000_009943	134	464	330	1	0.637066
GCA_020568045.1-Fun_JAIRGB010000017.1_i000_007832	134	464	330	1	0.637066
GCA_020568055.1-Fun_JAIRGC010000039.1_i000_012287	134	464	330	1	0.637066
GCA_020568095.1-Fun_JAIRGD010000022.1_i000_011775	134	464	330	1	0.637066
GCA_020568205.1-Fun_JAIRGE010000019.1_i000_010353	134	464	330	1	0.637066
GCA_020568325.1-Fun_JAIRDU010000017.1_i000_009583	134	464	330	1	0.637066
GCA_020568415.1-Fun_JAIRDV010000017.1_i000_008248	134	464	330	1	0.637066
GCA_020568465.1-Fun_JAIRDW010000020.1_i000_011921	134	464	330	1	0.637066
GCA_020568635.1-Fun_JAIRDX010000021.1_i000_011517	134	464	330	1	0.637066
GCA_020568705.1-Fun_JAIRGF010000083.1_i000_017141	134	464	330	1	0.637066
GCA_020568765.1-Fun_JAIRDY010000020.1_i000_011453	134	464	330	1	0.637066
GCA_020568775.1-Fun_JAIRGG010000020.1_i000_008685	134	464	330	1	0.637066
GCA_020568935.1-Fun_JAIRGH010000036.1_i000_014683	134	464	330	1	0.637066
GCA_020568945.1-Fun_JAIRDZ010000017.1_i000_009058	134	464	330	1	0.637066
GCA_020569145.1-Fun_JAIREA010000001.1_i000_000919	134	464	330	1	0.637066
GCA_020569235.1-Fun_JAIREB010000011.1_i000_007438	134	464	330	1	0.637066
GCA_020569285.1-Fun_JAIREC010000041.1_i000_015384	134	464	330	1	0.637066
GCA_020569485.1-Fun_JAIRGI010000021.1_i000_011464	134	464	330	1	0.637066
GCA_020569495.1-Fun_JAIRED010000003.1_i000_002408	134	464	330	1	0.637066
GCA_020569685.1-Fun_JAIRGK010000058.1_i000_017259	134	464	330	1	0.637066
GCA_020569895.1-Fun_JAIRGL010000022.1_i000_011341	134	464	330	1	0.637066
GCA_020569895.1-Fun_JAIRGL010000022.1_i000_011350	134	464	330	1	0.637066
GCA_020569945.1-Fun_JAIREF010000042.1_i000_015055	134	464	330	1	0.637066
GCA_020570015.1-Fun_JAIREG010000036.1_i000_013947	134	464	330	1	0.637066
GCA_020570045.1-Fun_JAIREI010000042.1_i000_016165	134	464	330	1	0.637066
GCA_020570345.1-Fun_JAIRGM010000006.1_i000_003928	134	464	330	1	0.637066
GCA_020570355.1-Fun_JAIREH010000021.1_i000_009116	134	464	330	1	0.637066
GCA_020570395.1-Fun_JAIRGN010000059.1_i000_017117	134	464	330	1	0.637066
GCA_020570405.1-Fun_JAIREJ010000032.1_i000_014561	134	464	330	1	0.637066
GCA_020570415.1-Fun_JAIRGO010000032.1_i000_015418	134	464	330	1	0.637066
GCA_020570525.1-Fun_JAIREK010000045.1_i000_015523	134	464	330	1	0.637066
GCA_020570635.1-Fun_JAIRGP010000016.1_i000_008313	134	464	330	1	0.637066
GCA_020570685.1-Fun_JAIRGQ010000042.1_i000_016272	134	464	330	1	0.637066
GCA_020570735.1-Fun_JAIRGR010000044.1_i000_015757	134	464	330	1	0.637066
GCA_020570935.1-Fun_JAIREL010000020.1_i000_011837	134	464	330	1	0.637066
GCA_020570965.1-Fun_JAIRGS010000024.1_i000_011312	134	464	330	1	0.637066
GCA_020570975.1-Fun_JAIRGT010000019.1_i000_010584	134	464	330	1	0.637066
GCA_020571265.1-Fun_JAIREM010000042.1_i000_015485	134	464	330	1	0.637066
GCA_020571295.1-Fun_JAIRGU010000037.1_i000_015106	134	464	330	1	0.637066
GCA_020571325.1-Fun_JAIREN010000036.1_i000_013482	134	464	330	1	0.637066
GCA_020571545.1-Fun_JAIREO010000020.1_i000_009850	134	464	330	1	0.637066
GCA_020571575.1-Fun_JAIRGV010000050.1_i000_014434	134	464	330	1	0.637066
GCA_020571605.1-Fun_JAIRGW010000048.1_i000_013465	134	464	330	1	0.637066
GCA_020571815.1-Fun_JAIRGX010000021.1_i000_009108	134	464	330	1	0.637066
GCA_020571885.1-Fun_JAIRGY010000041.1_i000_014718	134	464	330	1	0.637066
GCA_020571895.1-Fun_JAIREP010000040.1_i000_015783	134	464	330	1	0.637066
GCA_020571965.1-Fun_JAIRGZ010000043.1_i000_015185	134	464	330	1	0.637066
GCA_020572075.1-Fun_JAIRHA010000063.1_i000_016484	134	464	330	1	0.637066
GCA_020572205.1-Fun_JAIREQ010000041.1_i000_015338	134	464	330	1	0.637066
GCA_020572305.1-Fun_JAIRHC010000017.1_i000_007951	134	464	330	1	0.637066
GCA_020572315.1-Fun_JAIRHB010000023.1_i000_012678	134	464	330	1	0.637066
GCA_020572345.1-Fun_JAIRHD010000044.1_i000_016471	134	464	330	1	0.637066
GCA_020572395.1-Fun_JAIRHG010000018.1_i000_008652	134	464	330	1	0.637066
GCA_020572635.1-Fun_JAIRHE010000022.1_i000_011506	134	464	330	1	0.637066
GCA_020572645.1-Fun_JAIRHF010000023.1_i000_009677	134	464	330	1	0.637066
GCA_020572675.1-Fun_JAIRHH010000095.1_i000_016141	134	464	330	1	0.637066
GCA_020572945.1-Fun_JAIRHJ010000023.1_i000_010872	134	464	330	1	0.637066
GCA_020572955.1-Fun_JAIRHI010000016.1_i000_008557	134	464	330	1	0.637066
GCA_020572985.1-Fun_JAIRER010000013.1_i000_006589	134	464	330	1	0.637066
GCA_020572995.1-Fun_JAIRES010000044.1_i000_014975	134	464	330	1	0.637066
GCA_020573275.1-Fun_JAIRHK010000020.1_i000_009376	134	464	330	1	0.637066
GCA_020573285.1-Fun_JAIRHL010000038.1_i000_015226	134	464	330	1	0.637066
GCA_020573315.1-Fun_JAIRHM010000070.1_i000_017041	134	464	330	1	0.637066
GCA_020573325.1-Fun_JAIRET010000048.1_i000_017032	134	464	330	1	0.637066
GCA_020573495.1-Fun_JAIRHN010000044.1_i000_014048	134	464	330	1	0.637066
GCA_020573595.1-Fun_JAIRHO010000023.1_i000_010571	134	464	330	1	0.637066
GCA_020573605.1-Fun_JAIRHP010000014.1_i000_006356	134	464	330	1	0.637066
GCA_020573625.1-Fun_JAIRHQ010000017.1_i000_008629	134	464	330	1	0.637066
GCA_020573725.1-Fun_JAIREU010000070.1_i000_017239	134	464	330	1	0.637066
GCA_020573765.1-Fun_JAIREV010000067.1_i000_017015	134	464	330	1	0.637066
GCA_020573915.1-Fun_JAIRHR010000018.1_i000_008521	134	464	330	1	0.637066
GCA_020574055.1-Fun_JAIRHS010000043.1_i000_014879	134	464	330	1	0.637066
GCA_020574085.1-Fun_JAIRHT010000017.1_i000_010680	134	464	330	1	0.637066
GCA_020574115.1-Fun_JAIRHU010000020.1_i000_009139	134	464	330	1	0.637066
GCA_020574145.1-Fun_JAIREW010000020.1_i000_013111	134	464	330	1	0.637066
GCA_020574155.1-Fun_JAIREX010000017.1_i000_010128	134	464	330	1	0.637066
GCA_020574265.1-Fun_JAIREY010000009.1_i000_005883	134	464	330	1	0.637066
GCA_020574295.1-Fun_JAIRHV010000023.1_i000_011628	134	464	330	1	0.637066
GCA_020574345.1-Fun_JAIREZ010000014.1_i000_009075	134	464	330	1	0.637066
GCA_020574365.1-Fun_JAIRHW010000017.1_i000_008880	134	464	330	1	0.637066
GCA_020574375.1-Fun_JAIRFA010000015.1_i000_009247	134	464	330	1	0.637066
GCA_020574385.1-Fun_JAIRFB010000018.1_i000_008864	134	464	330	1	0.637066
GCA_020574405.1-Fun_JAIRHY010000035.1_i000_014022	134	464	330	1	0.637066
GCA_020574595.1-Fun_JAIRHX010000041.1_i000_015474	134	464	330	1	0.637066
GCA_020574615.1-Fun_JAIRHZ010000017.1_i000_005884	134	464	330	1	0.637066
GCA_020574715.1-Fun_JAIRFC010000019.1_i000_010187	134	464	330	1	0.637066
GCA_020574725.1-Fun_JAIRFD010000022.1_i000_011952	134	464	330	1	0.637066
GCA_020574755.1-Fun_JAIRIA010000036.1_i000_013399	134	464	330	1	0.637066
GCA_020574825.1-Fun_JAIRIB010000036.1_i000_015466	134	464	330	1	0.637066
GCA_020574875.1-Fun_JAIRIC010000014.1_i000_008194	134	464	330	1	0.637066
GCA_020575035.1-Fun_JAIRFE010000017.1_i000_009685	134	464	330	1	0.637066
GCA_020575105.1-Fun_JAIRID010000018.1_i000_009752	134	464	330	1	0.637066
GCA_020575195.1-Fun_JAIRIE010000019.1_i000_008352	134	464	330	1	0.637066
GCA_020575285.1-Fun_JAIRIF010000018.1_i000_007475	134	464	330	1	0.637066
GCA_020575355.1-Fun_JAIRIH010000039.1_i000_015259	134	464	330	1	0.637066
GCA_020575375.1-Fun_JAIRIG010000013.1_i000_007215	134	464	330	1	0.637066
GCA_020575405.1-Fun_JAIRII010000021.1_i000_011082	134	464	330	1	0.637066
GCA_020575445.1-Fun_JAIRIJ010000036.1_i000_012846	134	464	330	1	0.637066
GCA_020575485.1-Fun_JAIRIK010000025.1_i000_011084	134	464	330	1	0.637066
GCA_020575615.1-Fun_JAIRIL010000026.1_i000_010123	134	464	330	1	0.637066
GCA_020575645.1-Fun_JAIRIM010000035.1_i000_013606	134	464	330	1	0.637066
GCA_020575775.1-Fun_JAIRIN010000036.1_i000_013383	134	464	330	1	0.637066
GCA_020575955.1-Fun_JAIRIO010000016.1_i000_006209	134	464	330	1	0.637066
GCA_020575975.1-Fun_JAIRFF010000016.1_i000_007456	134	464	330	1	0.637066
GCA_020575995.1-Fun_JAIRIP010000018.1_i000_009493	134	464	330	1	0.637066
GCA_020576185.1-Fun_JAIRIQ010000013.1_i000_007429	134	464	330	1	0.637066
GCA_020576195.1-Fun_JAIRFG010000062.1_i000_016727	134	464	330	1	0.637066
GCA_020576365.1-Fun_JAIRFI010000072.1_i000_016661	134	464	330	1	0.637066
GCA_020577795.1-Fun_JAIRFH010000066.1_i000_016785	134	464	330	1	0.637066
GCA_020577805.1-Fun_JAIRFJ010000068.1_i000_016670	134	464	330	1	0.637066
GCA_020577855.1-Fun_JAIRFK010000022.1_i000_009501	134	464	330	1	0.637066
GCA_020577905.1-Fun_JAIRFL010000045.1_i000_014506	134	464	330	1	0.637066
GCA_020577915.1-Fun_JAIRFM010000071.1_i000_016499	134	464	330	1	0.637066
GCA_020578075.1-Fun_JAIRFO010000073.1_i000_016830	134	464	330	1	0.637066
GCA_020578085.1-Fun_JAIRFN010000066.1_i000_016517	134	464	330	1	0.637066
GCA_020578095.1-Fun_JAIRFP010000073.1_i000_016462	134	464	330	1	0.637066
GCA_020578105.1-Fun_JAIRFQ010000070.1_i000_016728	134	464	330	1	0.637066
GCA_020578115.1-Fun_JAIRFR010000036.1_i000_012518	134	464	330	1	0.637066
GCA_020578205.1-Fun_JAIRFS010000062.1_i000_016735	134	464	330	1	0.637066
GCA_020578265.1-Fun_JAIRIR010000022.1_i000_010076	134	464	330	1	0.637066
GCA_020578295.1-Fun_JAIRIT010000037.1_i000_015399	134	464	330	1	0.637066
GCA_020578315.1-Fun_JAIRIS010000046.1_i000_015188	134	464	330	1	0.637066
GCA_020578375.1-Fun_JAIRFT010000022.1_i000_012192	134	464	330	1	0.637066
GCA_020578445.1-Fun_JAIRIU010000021.1_i000_009233	134	464	330	1	0.637066
GCA_020578515.1-Fun_JAIRIV010000013.1_i000_006959	134	464	330	1	0.637066
GCA_020578585.1-Fun_JAIRIW010000017.1_i000_009310	134	464	330	1	0.637066
GCA_020578615.1-Fun_JAIRIX010000062.1_i000_017116	134	464	330	1	0.637066
GCA_020579815.1-Fun_JAIRIZ010000019.1_i000_011885	134	464	330	1	0.637066
GCA_020579825.1-Fun_JAIRIY010000020.1_i000_008271	134	464	330	1	0.637066
GCA_020579835.1-Fun_JAIRJA010000032.1_i000_012777	134	464	330	1	0.637066
GCA_020579845.1-Fun_JAIRJB010000019.1_i000_009547	134	464	330	1	0.637066
GCA_020579855.1-Fun_JAIRFU010000018.1_i000_008841	134	464	330	1	0.637066
GCA_020580075.1-Fun_JAIRJC010000015.1_i000_008018	134	464	330	1	0.637066
GCA_020580085.1-Fun_JAIRJD010000037.1_i000_014128	134	464	330	1	0.637066
GCA_020580115.1-Fun_JAIRFV010000061.1_i000_017085	134	464	330	1	0.637066
GCA_020580145.1-Fun_JAIRJE010000016.1_i000_007912	134	464	330	1	0.637066
GCA_020580155.1-Fun_JAIRJF010000015.1_i000_009272	134	464	330	1	0.637066
GCA_020580305.1-Fun_JAIRJG010000064.1_i000_016963	134	464	330	1	0.637066
GCA_020580415.1-Fun_JAIRFW010000016.1_i000_008429	134	464	330	1	0.637066
GCA_020580425.1-Fun_JAIRJH010000031.1_i000_012608	134	464	330	1	0.637066
GCA_020580485.1-Fun_JAIRJI010000003.1_i000_002172	134	464	330	1	0.637066
GCA_020580655.1-Fun_JAIRFX010000041.1_i000_015065	134	464	330	1	0.637066
GCA_020580665.1-Fun_JAIRFY010000018.1_i000_010404	134	464	330	1	0.637066
GCA_020580695.1-Fun_JAIRJK010000019.1_i000_009059	134	464	330	1	0.637066
GCA_020580725.1-Fun_JAIRJJ010000040.1_i000_015333	134	464	330	1	0.637066
GCA_020580775.1-Fun_JAIRJL010000038.1_i000_010674	134	464	330	1	0.637066
GCA_020580905.1-Fun_JAIRFZ010000021.1_i000_010269	134	464	330	1	0.637066
GCA_020581045.1-Fun_JAIRJM010000042.1_i000_014947	134	464	330	1	0.637066
GCA_020581155.1-Fun_JAIRJN010000016.1_i000_006705	134	464	330	1	0.637066
GCA_020581165.1-Fun_JAIRJO010000018.1_i000_008535	134	464	330	1	0.637066
GCA_020581275.1-Fun_JAIRJP010000035.1_i000_011952	134	464	330	1	0.637066
GCA_021604985.1-Pla_BQKI01000015.1_i000_023540	125	460	335	1.01515	0.611314
GCA_000327365.1-Pla_CM001746.1_i000_018889	123	440	317	0.960606	0.559083
GCA_002926015.1-Pla_KZ650136.1_i000_034054	123	440	317	0.960606	0.559083
GCA_005393395.2-Pla_CM016624.1_i000_025517	123	440	317	0.960606	0.559083
GCA_007990325.1-Pla_CM017698.1_i000_060851	123	440	317	0.960606	0.559083
GCA_007990325.1-Pla_CM017711.1_i000_064885	123	440	317	0.960606	0.559083
GCA_007990345.1-Pla_CM017672.1_i000_029559	123	440	317	0.960606	0.559083
GCA_007990345.1-Pla_CM017685.1_i000_067883	123	440	317	0.960606	0.559083
GCA_007990455.1-Pla_CM017659.1_i000_061678	123	440	317	0.960606	0.559083
GCA_007990485.1-Pla_CM017620.1_i000_060739	123	440	317	0.960606	0.559083
GCA_007990485.1-Pla_CM017633.1_i000_064843	123	440	317	0.960606	0.559083
GCA_008761655.1-Pla_CM018212.1_i000_056380	123	440	317	0.960606	0.559083
GCA_008761655.1-Pla_CM018225.1_i000_060160	123	440	317	0.960606	0.559083
GCA_020496765.1-Pla_CM035626.1_i000_023287	123	440	317	0.960606	0.559083
GCA_000721765.1-Fun_KL584722.1_i000_008909	131	463	332	1.00606	0.632381
GCA_019924955.1-Fun_JAHFYN010000012.1_i000_001331	131	463	332	1.00606	0.632381
GCA_019925215.1-Fun_JAHFYS010002931.1_i000_008133	87	417	330	1	0.6875
GCA_905219595.1-Fun_CAJMWU010006927.1_i000_009522	126	454	328	0.993939	0.592058
GCA_905219605.1-Fun_CAJMWV010004918.1_i000_006608	126	454	328	0.993939	0.592058
GCA_000715385.1-Fun_AZST01000846.1_i000_008775	126	454	328	0.993939	0.59745
GCA_022160335.1-Fun_MU274903.1_i000_002557	139	456	317	0.960606	0.564057
GCA_013358455.1-Pla_JABWDY010022764.1_i000_017010	130	459	329	0.99697	0.5875
GCA_010015745.1-Fun_ML978287.1_i000_012123	134	463	329	0.99697	0.637597
GCA_001773325.1-Fun_LXJU01000008.1_i000_005411	129	460	331	1.00303	0.642718
GCA_006937295.1-Pla_CM017321.1_i000_002871	120	441	321	0.972727	0.551546
GCA_019924295.1-Fun_JAHFXI010002103.1_i000_007359	87	417	330	1	0.6875
GCA_011799765.1-Pla_JAANDH010000459.1_i000_015158	124	456	332	1.00606	0.587611
GCA_000230815.1-Ani_CM001285.1_i000_008011	132	424	292	0.884848	0.491582
GCA_004917825.1-Fun_QZBZ01000451.1_i000_007707	134	465	331	1.00303	0.625709
GCA_000836115.1-Fun_KN847498.1_i000_009408	131	463	332	1.00606	0.642166
GCA_016097755.1-Fun_JAAZWW010000010.1_i000_000110	193	522	329	0.99697	0.570191
GCA_001692895.1-Fun_KV748179.1_i000_001961	137	462	325	0.984848	0.59633
GCA_010194725.1-Pro_WXXK01000183.1_i000_001275	96	430	334	1.01212	0.348279
GCA_002284615.2-Pla_MU069624.1_i000_005900	124	463	339	1.02727	0.646947
GCA_000182565.2-Fun_KQ257457.1_i000_005400	120	444	324	0.981818	0.611321
GCA_017589495.1-Ani_CM030068.1_i000_025254	133	445	312	0.945455	0.579926
GCA_000230375.1-Fun_FP929133.1_i000_008458	131	464	333	1.00909	0.642857
GCA_010094095.1-Fun_ML979132.1_i000_000419	143	465	322	0.975758	0.621622
GCA_001305275.1-Fun_LHCL01000028.1_i000_004834	137	461	324	0.981818	0.639053
GCA_021962125.1-Ani_JAGDYQ010000107.1_i000_001737	149	480	331	1.00303	0.598553
GCA_000003125.1-Fun_EQ962654.1_i000_003426	143	463	320	0.969697	0.633663
GCA_021604985.1-Pla_BQKI01000082.1_i000_047139	125	460	335	1.01515	0.63447
GCA_014839865.1-Fun_JABAYA010000158.1_i000_002104	128	454	326	0.987879	0.630561
GCA_007990345.1-Pla_CM017681.1_i000_053816	129	460	331	1.00303	0.621013
GCA_010093925.1-Fun_ML994749.1_i000_020892	131	463	332	1.00606	0.61825
GCA_001642475.1-Fun_LVKK01000043.1_i000_007643	130	461	331	1.00303	0.643969
GCA_001651985.1-Fun_LVYI01000004.1_i000_007084	129	461	332	1.00606	0.656126
GCA_020310725.1-Fun_LGJB01000030.1_i000_011325	130	461	331	1.00303	0.643969
GCA_019924015.1-Fun_JAHFWZ010000016.1_i000_002409	132	462	330	1	0.628571
GCA_019924175.1-Fun_JAHFXG010000028.1_i000_004307	132	462	330	1	0.628571
GCA_019924555.1-Fun_JAHFXU010005025.1_i000_018156	132	462	330	1	0.628571
GCA_019924715.1-Fun_JAHFYG010000043.1_i000_006450	132	462	330	1	0.628571
GCA_019924725.1-Fun_JAHFYF010000040.1_i000_006147	132	462	330	1	0.628571
GCA_019924775.1-Fun_JAHFYC010000551.1_i000_003082	132	462	330	1	0.628571
GCA_019924815.1-Fun_JAHFYJ010000037.1_i000_005850	132	462	330	1	0.628571
GCA_019924825.1-Fun_JAHFYH010000036.1_i000_005565	132	462	330	1	0.628571
GCA_019924835.1-Fun_JAHFYI010000038.1_i000_006151	132	462	330	1	0.628571
GCA_019925085.1-Fun_JAHFYT010000049.1_i000_006728	132	462	330	1	0.628571
GCA_910591835.1-Fun_CAJVPV010001232.1_i000_002769	118	451	333	1.00909	0.503021
GCA_001972305.1-Pla_BDDD01000337.1_i000_007737	119	441	322	0.975758	0.562937
GCA_001691755.2-Fun_JNHY02000298.1_i000_003844	205	520	315	0.954545	0.496063
GCA_019426215.1-Pla_CM033393.1_i000_007438	112	427	315	0.954545	0.561497
GCA_009445465.1-Pla_NMUH01000193.1_i000_006411	119	439	320	0.969697	0.547945
GCA_011058895.1-Fun_SWKV01000002.1_i000_003304	133	462	329	0.99697	0.636364
GCA_022343315.1-Fun_JACTNS010000046.1_i000_010273	160	493	333	1.00909	0.608775
GCA_000938895.1-Fun_LN731665.1_i000_007867	120	448	328	0.993939	0.663968
GCA_014905375.1-Pla_BMAC01000981.1_i000_026257	117	438	321	0.972727	0.57424
GCA_001718145.1-Ani_LJIJ01000007.1_i000_000352	127	457	330	1	0.668016
GCA_019924115.1-Fun_JAHFXA010000249.1_i000_001956	132	463	331	1.00303	0.630476
GCA_019924135.1-Fun_JAHFXB010001946.1_i000_009163	132	463	331	1.00303	0.630476
GCA_019924155.1-Fun_JAHFXD010003486.1_i000_012202	132	463	331	1.00303	0.630476
GCA_019924195.1-Fun_JAHFXF010001879.1_i000_006415	132	463	331	1.00303	0.630476
GCA_019924215.1-Fun_JAHFXC010003486.1_i000_012019	132	463	331	1.00303	0.630476
GCA_019924275.1-Fun_JAHFXJ010003523.1_i000_012338	132	463	331	1.00303	0.630476
GCA_019924315.1-Fun_JAHFXH010003024.1_i000_011067	132	463	331	1.00303	0.630476
GCA_019924355.1-Fun_JAHFXO010000019.1_i000_001027	132	463	331	1.00303	0.630476
GCA_019924375.1-Fun_JAHFXM010000639.1_i000_004083	132	463	331	1.00303	0.630476
GCA_019924395.1-Fun_JAHFXN010003809.1_i000_012848	132	463	331	1.00303	0.630476
GCA_019924415.1-Fun_JAHFXV010000010.1_i000_009573	132	463	331	1.00303	0.630476
GCA_019924425.1-Fun_JAHFXT010000020.1_i000_002796	132	463	331	1.00303	0.630476
GCA_019924435.1-Fun_JAHFXP010002751.1_i000_010588	132	463	331	1.00303	0.630476
GCA_019924465.1-Fun_JAHFXQ010000002.1_i000_000387	132	463	331	1.00303	0.630476
GCA_019924485.1-Fun_JAHFXR010000002.1_i000_000372	132	463	331	1.00303	0.630476
GCA_019924535.1-Fun_JAHFXS010000002.1_i000_000379	132	463	331	1.00303	0.630476
GCA_019924575.1-Fun_JAHFXX010002772.1_i000_010662	132	463	331	1.00303	0.630476
GCA_019924615.1-Fun_JAHFXW010002773.1_i000_010781	132	463	331	1.00303	0.630476
GCA_019924655.1-Fun_JAHFXZ010003395.1_i000_012108	132	463	331	1.00303	0.630476
GCA_019924675.1-Fun_JAHFXY010002718.1_i000_010473	132	463	331	1.00303	0.630476
GCA_019924695.1-Fun_JAHFYA010001069.1_i000_005756	132	463	331	1.00303	0.630476
GCA_019924735.1-Fun_JAHFYD010002782.1_i000_010802	132	463	331	1.00303	0.630476
GCA_019924755.1-Fun_JAHFYB010003579.1_i000_012360	132	463	331	1.00303	0.630476
GCA_019924895.1-Fun_JAHFYM010001917.1_i000_006351	132	463	331	1.00303	0.630476
GCA_019924905.1-Fun_JAHFYL010003521.1_i000_012365	132	463	331	1.00303	0.630476
GCA_019925035.1-Fun_JAHFYQ010000014.1_i000_001776	132	463	331	1.00303	0.630476
GCA_019925055.1-Fun_JAHFYR010000027.1_i000_003903	132	463	331	1.00303	0.630476
GCA_019925775.1-Fun_JAHFYE010003242.1_i000_015049	132	463	331	1.00303	0.630476
MEJA003.0722.00001.C001_00745	78	408	330	1	0.797101
GCA_017911155.1-Fun_JAEFCI010007658.1_i000_004872	124	458	334	1.01212	0.596429
GCA_014466195.1-Ani_CM025369.1_i000_010045	119	447	328	0.993939	0.608534
GCA_006535965.1-Fun_QEAR01000035.1_i000_004631	120	445	325	0.984848	0.61553
GCA_000002945.2-Fun_CU329670.1_i000_000343	123	450	327	0.990909	0.643701
GCA_000149845.2-Fun_KE651166.1_i000_001134	120	451	331	1.00303	0.664659
GCA_019924025.1-Fun_JAHFWX010004734.1_i000_017516	132	462	330	1	0.628571
GCA_020796205.1-Pla_CM036898.1_i000_017365	102	429	327	0.990909	0.584973
GCA_019828595.1-Pro_JAHQRK010000029.1_i000_010511	125	462	337	1.02121	0.694845
GCA_015852425.1-Fun_JAAAIG010000039.1_i000_006789	124	451	327	0.990909	0.64881
GCA_905232135.1-Fun_CAJNJQ010000257.1_i000_000670	126	453	327	0.990909	0.597806
GCA_001661315.1-Fun_KV454410.1_i000_003234	131	458	327	0.990909	0.659274
GCA_905332035.1-Ani_CAJOAY010006271.1_i000_037464	128	456	328	0.993939	0.714597
GCA_000002985.3-Ani_BX284601.5_i000_000447	110	443	333	1.00909	0.683778
GCA_002849105.1-Fun_MSFO01000002.1_i000_005231	133	461	328	0.993939	0.631985
GCA_000721775.1-Fun_KL584834.1_i000_005629	132	463	331	1.00303	0.630476
GCA_019925005.1-Fun_JAHFYP010000011.1_i000_001622	132	463	331	1.00303	0.630476
GCA_000721755.1-Fun_KL584780.1_i000_009707	132	464	332	1.00606	0.632381
GCA_000259055.1-Ani_CM000364.1_i000_011278	125	456	331	1.00303	0.667339
GCA_000754195.3-Ani_CM002913.1_i000_010530	125	456	331	1.00303	0.667339
GCA_013365045.1-Fun_QQZM01000044.1_i000_003225	134	460	326	0.987879	0.642998
GCA_001661325.1-Fun_KV454301.1_i000_006681	130	440	310	0.939394	0.702948
GCA_002382835.1-Fun_NPFJ01000066.1_i000_009528	141	461	320	0.969697	0.4
GCA_002382855.1-Fun_NPFK01000057.1_i000_008772	141	461	320	0.969697	0.4
GCA_000350225.2-Pro_HG001727.1_i000_005300	133	462	329	0.99697	0.655378
GCA_000733195.1-Pla_CM002871.1_i000_005311	111	433	322	0.975758	0.658487
GCA_905250065.1-Ani_CAJNON010000184.1_i000_018805	135	457	322	0.975758	0.693966
GCA_010015785.1-Fun_ML978740.1_i000_007833	139	464	325	0.984848	0.625
GCA_000005115.1-Ani_CH902617.1_i000_013312	125	456	331	1.00303	0.668687
GCA_011009095.1-Ani_VTPC01000605.1_i000_001085	127	457	330	1	0.634615
GCA_014904905.1-Fun_MU122107.1_i000_003112	144	461	317	0.960606	0.587037
GCA_010405375.1-Fun_MU004298.1_i000_002381	136	466	330	1	0.637066
GCA_020497125.1-Ani_CM035642.1_i000_014462	127	443	316	0.957576	0.60076
GCA_000835475.1-Fun_KN847009.1_i000_012423	130	461	331	1.00303	0.635317
GCA_021223865.1-Ani_JAJJHT010014123.1_i000_007475	125	456	331	1.00303	0.668687
GCA_011763585.1-Fun_JAANIP010000005.1_i000_000074	121	445	324	0.981818	0.138817
GCA_011763735.1-Fun_JAANIS010000004.1_i000_000039	121	445	324	0.981818	0.138817
GCA_011763755.1-Fun_JAANIW010000010.1_i000_000259	121	445	324	0.981818	0.138817
GCA_011763775.1-Fun_JAANIT010000021.1_i000_000377	121	445	324	0.981818	0.138817
GCA_011763795.1-Fun_JAANIV010000038.1_i000_000752	121	445	324	0.981818	0.138817
GCA_011763815.1-Fun_JAANIU010000016.1_i000_000310	121	445	324	0.981818	0.138817
GCA_011763855.1-Fun_JAANJA010000040.1_i000_000782	121	445	324	0.981818	0.138817
GCA_011763875.1-Fun_JAANIZ010000017.1_i000_000331	121	445	324	0.981818	0.138817
GCA_011763895.1-Fun_JAANIY010000018.1_i000_000303	121	445	324	0.981818	0.138817
GCA_022376525.1-Fun_WTXL01000042.1_i000_008071	127	448	321	0.972727	0.552496
GCA_001879085.1-Pla_CM007400.1_i000_010661	125	459	334	1.01212	0.602888
GCA_000469055.2-Fun_AVOT02006647.1_i000_021809	123	457	334	1.01212	0.581882
GCA_000209185.1-Ani_DS232376.1_i000_005164	115	446	331	1.00303	0.588968
GCA_003698115.1-Fun_RAQS01000201.1_i000_005058	128	458	330	1	0.613383
GCA_002081595.1-Pro_JNBR01000094.1_i000_002569	123	459	336	1.01818	0.691358
GCA_000143925.2-Ani_GL379959.1_i000_020776	112	444	332	1.00606	0.68595
GCA_018687715.1-Pla_CM031820.1_i000_024969	135	461	326	0.987879	0.592727
GCA_018689175.1-Pla_CM031852.1_i000_023588	135	461	326	0.987879	0.592727
GCA_011763695.1-Fun_JAANIQ010000015.1_i000_000246	120	445	325	0.984848	0.139246
GCA_011763715.1-Fun_JAANIR010000012.1_i000_000223	120	445	325	0.984848	0.139246
GCA_011763835.1-Fun_JAANIX010000044.1_i000_000861	120	445	325	0.984848	0.139246
GCA_007844105.2-Pla_CM017585.2_i000_019859	135	458	323	0.978788	0.579892
GCA_017655625.1-Fun_JAEOAQ010000002.1_i000_002709	127	453	326	0.987879	0.648111
GCA_004193775.2-Pla_CM014361.1_i000_011287	126	467	341	1.03333	0.613309
GCA_000315875.1-Fun_HE681722.1_i000_003240	158	481	323	0.978788	0.607143
GCA_000005135.1-Ani_CH954182.1_i000_001686	125	456	331	1.00303	0.665996
GCA_020569505.1-Fun_JAIREE010000031.1_i000_013676	135	463	328	0.993939	0.633205
GCA_020569515.1-Fun_JAIRGJ010000017.1_i000_009668	135	463	328	0.993939	0.633205
GCA_001720245.1-Fun_AWGL01000002.1_i000_002991	145	467	322	0.975758	0.561955
GCA_011392495.1-Fun_QMIJ01000008.1_i000_011108	144	462	318	0.963636	0.3975
PYCA001.0722.00001.C001_01180	96	396	300	0.909091	0.721154
GCA_001644525.1-Fun_KV441723.1_i000_012854	135	464	329	0.99697	0.631478
GCA_000298355.1-Ani_JH880965.1_i000_005416	128	458	330	1	0.551839
GCA_010093945.1-Fun_ML993996.1_i000_005137	140	464	324	0.981818	0.61597
GCA_007990455.1-Pla_CM017646.1_i000_057800	123	440	317	0.960606	0.559083
MEFE002.0722.00001.C001_00105	79	410	331	1.00303	0.79759
GCA_002918395.1-Fun_PEDP01000363.1_i000_002188	115	444	329	0.99697	0.660643
GCA_000005215.1-Ani_CH480815.1_i000_015283	125	456	331	1.00303	0.667339
GCA_014362265.1-Pla_BJWL01000008.1_i000_011811	125	442	317	0.960606	0.560071
GCA_018290095.1-Ani_CM031380.1_i000_007406	136	456	320	0.969697	0.578662
GCA_021223765.1-Ani_JAJJHM010012723.1_i000_009275	125	456	331	1.00303	0.668687
GCA_000264995.1-Fun_JH687541.1_i000_003773	130	450	320	0.969697	0.553633
GCA_021223845.1-Ani_JAJJHU010011684.1_i000_010237	125	456	331	1.00303	0.668687
GCA_003260675.2-Pla_QGKX02001521.1_i000_030933	1	287	286	0.866667	0.814815
GCA_016098045.1-Fun_JAAAIW010000080.1_i000_010497	124	448	324	0.981818	0.578571
GCA_021613535.1-Ani_CP075496.1_i000_018925	118	451	333	1.00909	0.707006
GCA_004119895.1-Ani_SCEB01214839.1_i000_016368	133	447	314	0.951515	0.598095
GCA_905250055.1-Ani_CAJNOF010000495.1_i000_028612	112	443	331	1.00303	0.711828
GCA_905250075.1-Ani_CAJNOP010000888.1_i000_052110	112	443	331	1.00303	0.711828
GCA_905250075.1-Ani_CAJNOP010000890.1_i000_052134	112	443	331	1.00303	0.711828
GCA_905331535.1-Ani_CAJNZB010001076.1_i000_033780	112	443	331	1.00303	0.711828
GCA_019776745.2-Pla_CM034156.1_i000_036259	155	468	313	0.948485	0.492138
GCA_902810595.1-Ani_LR778274.1_i000_024713	128	445	317	0.960606	0.593633
GCA_013397915.1-Ani_VZRO01002709.1_i000_004289	114	437	323	0.978788	0.640873
GCA_009732865.1-Fun_ML769340.1_i000_012770	138	464	326	0.987879	0.634241
GCA_905250075.1-Ani_CAJNOP010000694.1_i000_049497	130	458	328	0.993939	0.705376
GCA_905331505.1-Ani_CAJNYZ010000448.1_i000_023989	130	458	328	0.993939	0.705376
GCA_905331515.1-Ani_CAJNZC010000757.1_i000_027795	130	458	328	0.993939	0.705376
GCA_905332295.1-Ani_CAJOBT010007500.1_i000_027220	130	458	328	0.993939	0.705376
GCA_003024255.1-Pla_CM009661.1_i000_009143	129	445	316	0.957576	0.556338
GCA_006535975.1-Fun_QEAP01000016.1_i000_001065	122	448	326	0.987879	0.620952
GCA_905330535.1-Ani_CAJNVN010000388.1_i000_024454	112	443	331	1.00303	0.711828
GCA_905330805.1-Ani_CAJNWK010000598.1_i000_025767	112	443	331	1.00303	0.711828
GCA_905332165.1-Ani_CAJOBK010002658.1_i000_018752	112	443	331	1.00303	0.711828
GCA_905332185.1-Ani_CAJOBM010000979.1_i000_007241	112	443	331	1.00303	0.711828
GCA_905332225.1-Ani_CAJOBN010009894.1_i000_027835	112	443	331	1.00303	0.711828
GCA_905250095.1-Ani_CAJNOR010000129.1_i000_003399	136	459	323	0.978788	0.693133
GCA_905329745.1-Ani_CAJNSZ010000940.1_i000_031027	112	443	331	1.00303	0.711828
GCA_905330235.1-Ani_CAJNUA010001009.1_i000_029619	112	443	331	1.00303	0.711828
GCA_905332175.1-Ani_CAJOBL010001847.1_i000_010822	112	443	331	1.00303	0.711828
GCA_003991915.1-Ani_RQTK01000327.1_i000_010621	186	521	335	1.01515	0.523438
GCA_000004555.3-Ani_FR847112.2_i000_000630	95	428	333	1.00909	0.713062
GCA_000005975.1-Ani_CM000160.2_i000_013040	125	456	331	1.00303	0.665996
GCA_000151065.3-Fun_HF943548.1_i000_004765	145	465	320	0.969697	0.636183
GCA_900237765.1-Fun_UNSH01000056.1_i000_004399	145	465	320	0.969697	0.636183
GCA_905250055.1-Ani_CAJNOF010000347.1_i000_026524	133	458	325	0.984848	0.698925
GCA_905250075.1-Ani_CAJNOP010000695.1_i000_049515	133	458	325	0.984848	0.698925
GCA_905331525.1-Ani_CAJNZF010000415.1_i000_023053	133	458	325	0.984848	0.698925
GCA_905332315.1-Ani_CAJOBV010002178.1_i000_017925	133	458	325	0.984848	0.698925
GCA_019633455.1-Fun_WSUA01001034.1_i000_000317	126	468	342	1.03636	0.646503
GCA_013368085.1-Ani_JABVZW010002917.1_i000_018293	113	446	333	1.00909	0.597846
GCA_003024255.1-Pla_CM009668.1_i000_016753	122	442	320	0.969697	0.56239
GCA_019632295.1-Fun_WSTZ01000002.1_i000_003870	127	459	332	1.00606	0.613678
GCA_001700775.1-Fun_LGRB01000009.1_i000_003179	142	462	320	0.969697	0.618956
GCA_013358835.1-Ani_JABSTQ010010080.1_i000_016022	115	436	321	0.972727	0.622093
GCA_001020605.1-Fun_KQ085967.1_i000_007824	128	447	319	0.966667	0.594041
GCA_905332335.1-Ani_CAJOBX010051891.1_i000_040344	103	431	328	0.993939	0.613084
GCA_000696155.1-Ani_KK852458.1_i000_000981	114	447	333	1.00909	0.574138
GCA_000004075.3-Pla_CM002923.2_i000_003905	121	444	323	0.978788	0.59375
GCA_013365065.1-Fun_QQZO01000033.1_i000_002935	134	461	327	0.990909	0.64497
GCA_013365125.1-Fun_QQZK01000134.1_i000_000890	134	461	327	0.990909	0.64497
GCA_000005155.1-Ani_CH916374.1_i000_003737	125	456	331	1.00303	0.664659
GCA_000003745.2-Pla_FN597038.1_i000_016818	117	443	326	0.987879	0.687764
GCA_002081575.1-Pro_JNBS01001845.1_i000_007282	126	458	332	1.00606	0.681725
GCA_014839865.1-Fun_JABAYA010000065.1_i000_007917	118	448	330	1	0.657371
GCA_002742825.1-Ani_CM008509.1_i000_000952	112	445	333	1.00909	0.688017
GCA_021491975.1-Ani_CP090891.1_i000_000559	112	445	333	1.00909	0.688017
GCA_022453885.1-Ani_CP092620.1_i000_000541	112	445	333	1.00909	0.688017
GCA_002104985.1-Fun_MCGO01000033.1_i000_008849	6	328	322	0.975758	0.821429
GCA_020887355.1-Pla_AP024989.1_i000_001567	134	449	315	0.954545	0.568592
GCA_000835455.1-Fun_KN846971.1_i000_003867	128	462	334	1.01212	0.649805
GCA_001541205.1-Fun_KQ954465.1_i000_000379	123	454	331	1.00303	0.641473
GCA_016808215.1-Pla_CM029007.1_i000_024614	136	460	324	0.981818	0.589091
GCA_000832345.2-Fun_LN679106.1_i000_006192	126	454	328	0.993939	0.592058
GCA_000365165.2-Fun_KB822698.1_i000_002170	141	461	320	0.969697	0.617761
GCA_014282415.2-Ani_JABDTM020025902.1_i000_010166	706	1040	334	1.01212	0.293497
GCA_002938375.1-Fun_NHYD01003948.1_i000_000988	121	456	335	1.01515	0.63327
GCA_902825445.1-Ani_CADEBC010000532.1_i000_011397	116	443	327	0.990909	0.605556
GCA_902825455.1-Ani_CADEBD010000288.1_i000_005260	116	443	327	0.990909	0.605556
GCA_001277935.1-Ani_CP012526.1_i000_009657	125	456	331	1.00303	0.662
GCA_003788615.2-Fun_ML121559.1_i000_008487	129	455	326	0.987879	0.617424
GCA_021223935.1-Ani_JAJJHV010008987.1_i000_011770	125	456	331	1.00303	0.665996
GCA_004193795.1-Ani_QDEB01003290.1_i000_000393	968	1300	332	1.00606	0.248689
GCA_000005195.1-Ani_CH479179.1_i000_015611	125	456	331	1.00303	0.662
GCA_000836295.1-Fun_KN847547.1_i000_005781	126	465	339	1.02727	0.666012
GCA_001278385.1-Fun_LGAV01000001.1_i000_000705	133	456	323	0.978788	0.623552
GCA_000281045.1-Pro_JH767175.1_i000_011757	124	461	337	1.02121	0.694845
GCA_907164705.1-Ani_CAJQZP010001269.1_i000_020338	114	443	329	0.99697	0.602564
GCA_002317995.1-Fun_MVNX01000056.1_i000_005993	139	462	323	0.978788	0.628405
GCA_001913855.2-Fun_MLYV02000095.1_i000_001301	136	456	320	0.969697	0.565371
GCA_000151425.1-Fun_GG700648.1_i000_008043	132	458	326	0.987879	0.62572
GCA_000616765.1-Fun_KK204030.1_i000_008329	132	458	326	0.987879	0.62572
GCA_000616805.1-Fun_KK207410.1_i000_008289	132	458	326	0.987879	0.62572
GCA_000616825.1-Fun_KK207940.1_i000_008312	132	458	326	0.987879	0.62572
GCA_000616845.1-Fun_KK208477.1_i000_008264	132	458	326	0.987879	0.62572
GCA_000616865.1-Fun_KK208942.1_i000_008315	132	458	326	0.987879	0.62572
GCA_000616905.1-Fun_KK209464.1_i000_008313	132	458	326	0.987879	0.62572
GCA_000616945.1-Fun_KK209982.1_i000_008379	132	458	326	0.987879	0.62572
GCA_000616965.1-Fun_KK210315.1_i000_008185	132	458	326	0.987879	0.62572
GCA_000616985.1-Fun_KK210834.1_i000_008464	132	458	326	0.987879	0.62572
GCA_000622995.1-Fun_AOLB01000342.1_i000_008307	132	458	326	0.987879	0.62572
GCA_000812105.1-Fun_JPGR01000037.1_i000_004593	132	458	326	0.987879	0.62572
GCA_001651445.1-Fun_LHPM01000018.1_i000_002454	132	458	326	0.987879	0.62572
GCA_015679515.1-Fun_JAAAVA010002398.1_i000_011065	117	447	330	1	0.597826
GCA_010093625.1-Fun_MU006737.1_i000_010600	140	464	324	0.981818	0.625483
GCA_022376515.1-Fun_WTXI01000033.1_i000_008484	123	452	329	0.99697	0.565292
GCA_001651435.1-Fun_LHPN01000001.1_i000_000825	129	461	332	1.00606	0.633588
GCA_018859375.1-Ani_JAHGAV010000014.1_i000_002317	125	438	313	0.948485	0.599617
GCA_000241205.2-Fun_BABT02000028.1_i000_005914	124	457	333	1.00909	0.60989
GCA_000708205.1-Fun_KL411544.1_i000_002406	124	457	333	1.00909	0.60989
GCA_010093695.1-Fun_MU006303.1_i000_005860	142	466	324	0.981818	0.625483
GCA_013339725.1-Ani_CM023459.1_i000_004559	47	377	330	1	0.785714
GCA_000341285.1-Pro_KB454518.1_i000_003948	113	441	328	0.993939	0.636893
GCA_012432095.1-Ani_CM022815.1_i000_006728	131	444	313	0.948485	0.559928
GCA_003709865.1-Fun_QRBJ01000032.1_i000_002451	137	461	324	0.981818	0.510236
GCA_000281125.4-Ani_AKHW03003682.1_i000_011999	128	450	322	0.975758	0.625243
GCA_001373355.1-Fun_CENE01000003.1_i000_001089	160	483	323	0.978788	0.591575
GCA_013389865.1-Ani_WAAB01006418.1_i000_003214	123	444	321	0.972727	0.687366
GCA_905332035.1-Ani_CAJOAY010012102.1_i000_043381	54	387	333	1.00909	0.856041
GCA_000006295.1-Ani_DS235832.1_i000_002489	115	447	332	1.00606	0.58042
GCA_000418435.1-Fun_KE375131.1_i000_004724	148	466	318	0.963636	0.632207
GCA_900519115.1-Fun_LR026990.1_i000_004689	148	466	318	0.963636	0.632207
GCA_905067625.1-Fun_LR898474.1_i000_004394	148	466	318	0.963636	0.632207
GCA_000709325.1-Ani_KL447622.1_i000_006135	114	437	323	0.978788	0.611742
GCA_905332015.1-Ani_CAJOAZ010001356.1_i000_018382	125	457	332	1.00606	0.715517
GCA_905250035.1-Ani_CAJNOE010000247.1_i000_022149	134	457	323	0.978788	0.696121
GCA_905332045.1-Ani_CAJOBB010005135.1_i000_035414	134	457	323	0.978788	0.696121
GCA_000151545.2-Pro_KK583298.1_i000_014807	126	458	332	1.00606	0.683128
GCA_002217175.1-Ani_LNIX01000003.1_i000_008040	115	447	332	1.00606	0.654832
GCA_000002865.1-Pro_CH991588.1_i000_000400	117	447	330	1	0.670732
GCA_905332095.1-Ani_CAJOBD010004826.1_i000_026780	1	299	298	0.90303	0.93125
GCA_021365335.1-Fun_JAJTIZ010000016.1_i000_003835	135	464	329	0.99697	0.635135
GCA_002865655.1-Fun_KZ613943.1_i000_006728	145	475	330	1	0.633397
GCA_020747015.1-Fun_JAGTJM010000096.1_i000_014245	136	466	330	1	0.632184
GCA_905250875.1-Ani_CAJNOO010002441.1_i000_027956	130	457	327	0.990909	0.691332
GCA_905332085.1-Ani_CAJOAX010001945.1_i000_015973	130	457	327	0.990909	0.691332
GCA_905252715.1-Ani_CAJNOU010000172.1_i000_005572	130	457	327	0.990909	0.691332
GCA_905332105.1-Ani_CAJOBE010002614.1_i000_016891	130	457	327	0.990909	0.691332
GCA_004000445.1-Ani_RSAL01000206.1_i000_011005	116	444	328	0.993939	0.623574
GCA_900096595.1-Fun_FMSP01000008.1_i000_006085	175	498	323	0.978788	0.54932
GCA_004119895.1-Ani_SCEB01214950.1_i000_017112	218	530	312	0.945455	0.516556
GCA_008638375.1-Pla_CM018039.1_i000_029418	124	442	318	0.963636	0.549223
GCA_905261645.1-Ani_CAJNOV010004679.1_i000_011117	112	443	331	1.00303	0.7103
GCA_905273325.1-Ani_CAJNOW010015586.1_i000_028511	112	443	331	1.00303	0.7103
GCA_905321285.1-Ani_CAJNRF010009828.1_i000_022840	112	443	331	1.00303	0.7103
GCA_905321535.1-Ani_CAJNRG010007540.1_i000_017668	112	443	331	1.00303	0.7103
GCA_905332115.1-Ani_CAJOBH010000078.1_i000_000672	112	443	331	1.00303	0.7103
GCA_905332125.1-Ani_CAJOBJ010000157.1_i000_001049	112	443	331	1.00303	0.7103
GCA_905332145.1-Ani_CAJOBF010001015.1_i000_010552	112	443	331	1.00303	0.7103
GCA_905332155.1-Ani_CAJOBG010000648.1_i000_006242	112	443	331	1.00303	0.7103
GCA_001402995.1-Fun_CCBN010000017.1_i000_005592	134	462	328	0.993939	0.654691
GCA_014596635.1-Fun_QQZJ01000091.1_i000_005044	134	462	328	0.993939	0.654691
GCA_002928715.1-Pla_KZ665826.1_i000_022905	122	441	319	0.966667	0.599624
GCA_000151545.2-Pro_KK583265.1_i000_013168	127	461	334	1.01212	0.691511
GCA_002117355.1-Fun_KZ110600.1_i000_007878	131	452	321	0.972727	0.564148
GCA_002102565.1-Fun_NBSH01000004.1_i000_005075	134	484	350	1.06061	0.600343
GCA_019455425.1-Pla_CM033496.1_i000_031147	123	441	318	0.963636	0.564831
GCA_000835435.1-Fun_KN846959.1_i000_005848	134	461	327	0.990909	0.632495
GCA_905251635.1-Ani_CAJNOT010000243.1_i000_007789	133	459	326	0.987879	0.689218
GCA_905332095.1-Ani_CAJOBD010005525.1_i000_028111	133	459	326	0.987879	0.689218
GCA_015832375.1-Fun_JADOXO010000006.1_i000_008933	129	449	320	0.969697	0.56239
GCA_015179035.1-Fun_WHUY01000017.1_i000_002379	128	460	332	1.00606	0.621723
GCA_013400615.1-Ani_VZTO01001223.1_i000_000583	119	442	323	0.978788	0.696121
GCA_000827205.1-Fun_KN832554.1_i000_001520	123	452	329	0.99697	0.573171
GCA_000359705.1-Fun_KB908504.1_i000_002590	130	465	335	1.01515	0.667331
GCA_013399305.1-Ani_VXAI01000146.1_i000_002307	65	389	324	0.981818	0.790244
GCA_004802725.1-Fun_SGPM01000022.1_i000_003354	130	459	329	0.99697	0.608133
GCA_905250035.1-Ani_CAJNOE010000063.1_i000_009111	107	443	336	1.01818	0.722581
GCA_905332045.1-Ani_CAJOBB010000291.1_i000_007232	107	443	336	1.01818	0.722581
GCA_001644535.1-Fun_KV441638.1_i000_003141	137	462	325	0.984848	0.627413
GCA_014905175.1-Ani_CM026522.1_i000_003189	128	444	316	0.957576	0.710112
GCA_000182765.2-Fun_HE605206.1_i000_001722	130	453	323	0.978788	0.644711
GCA_014049445.1-Fun_JABWAB010000001.1_i000_000079	130	453	323	0.978788	0.644711
GCA_014049455.1-Fun_JABWAA010000001.1_i000_000079	130	453	323	0.978788	0.644711
GCA_014049495.1-Fun_JABWAC010000001.1_i000_000079	130	453	323	0.978788	0.644711
GCA_014049585.1-Fun_JABVZZ010000001.1_i000_001332	130	453	323	0.978788	0.644711
GCA_903989565.1-Fun_CAJEJE010000001.1_i000_000078	130	453	323	0.978788	0.644711
GCA_001632425.1-Fun_KV425585.1_i000_007531	123	450	327	0.990909	0.615819
GCA_013400215.1-Ani_VXBR01000875.1_i000_000904	117	436	319	0.966667	0.640562
GCA_019623705.1-Fun_WSTJ01004850.1_i000_020053	49	376	327	0.990909	0.688421
GCA_006348945.1-Ani_SRLO01000995.1_i000_046694	117	448	331	1.00303	0.61985
GCA_016758985.1-Fun_JAEPRD010000032.1_i000_004442	119	449	330	1	0.668016
GCA_905250005.1-Ani_CAJNOH010006068.1_i000_035257	130	457	327	0.990909	0.691332
GCA_011692745.1-Fun_JAACJD010000001.1_i000_000461	130	457	327	0.990909	0.630058
GCA_002928715.1-Pla_KZ664543.1_i000_015754	120	441	321	0.972727	0.634387
GCA_000512585.2-Fun_KI894023.1_i000_006530	140	466	326	0.987879	0.618596
GCA_905250105.1-Ani_CAJNOC010001201.1_i000_008588	128	460	332	1.00606	0.653543
GCA_002891405.2-Ani_NEVH01015872.1_i000_010372	51	380	329	0.99697	0.691176
GCA_003942145.1-Ani_QXTE01000015.1_i000_002778	125	447	322	0.975758	0.612167
GCA_013677275.1-Pla_CM025257.1_i000_025503	82	402	320	0.969697	0.645161
GCA_020891255.1-Fun_BQFW01000004.1_i000_003479	119	450	331	1.00303	0.659363
GCA_001691835.3-Fun_JNHZ02000265.1_i000_005005	128	454	326	0.987879	0.592727
GCA_905250015.1-Ani_CAJNOM010000213.1_i000_027727	107	443	336	1.01818	0.722581
GCA_021223725.1-Ani_JAJJHN010003777.1_i000_006465	124	456	332	1.00606	0.670707
GCA_013397595.1-Ani_WBNJ01000103.1_i000_014054	118	440	322	0.975758	0.695464
GCA_013677235.1-Pla_CM025205.1_i000_026351	82	401	319	0.966667	0.643145
GCA_013677245.1-Pla_CM025218.1_i000_025407	82	401	319	0.966667	0.643145
GCA_013677255.1-Pla_CM025231.1_i000_024927	82	401	319	0.966667	0.643145
GCA_013677265.1-Pla_CM025244.1_i000_021502	82	401	319	0.966667	0.643145
GCA_000151175.1-Fun_DS995720.1_i000_007623	129	458	329	0.99697	0.631478
GCA_000151455.1-Fun_GG698515.1_i000_002123	129	458	329	0.99697	0.631478
GCA_003550325.1-Fun_QKWP01000456.1_i000_011299	118	429	311	0.942424	0.721578
GCA_905250065.1-Ani_CAJNON010000103.1_i000_013036	107	443	336	1.01818	0.722581
GCA_905332015.1-Ani_CAJOAZ010000117.1_i000_003346	107	443	336	1.01818	0.722581
GCA_905332035.1-Ani_CAJOAY010002127.1_i000_025408	107	443	336	1.01818	0.722581
GCA_021962125.1-Ani_JAGDYQ010000002.1_i000_008185	126	461	335	1.01515	0.62037
GCA_002284835.2-Ani_KV963907.1_i000_012642	143	482	339	1.02727	0.698969
GCA_905250015.1-Ani_CAJNOM010000335.1_i000_034856	128	458	330	1	0.711207
GCA_905250115.1-Ani_CAJNOI010000054.1_i000_013428	128	458	330	1	0.711207
GCA_000699245.1-Ani_KL239055.1_i000_005981	119	438	319	0.966667	0.617021
GCA_002914845.1-Pla_JXTC01000288.1_i000_025915	117	439	322	0.975758	0.563923
GCA_008065275.1-Fun_QKWK01000007.1_i000_002738	136	471	335	1.01515	0.593972
GCA_003709825.1-Fun_QQXN01000037.1_i000_003750	132	462	330	1	0.632184
GCA_000697705.1-Fun_KL198017.1_i000_001087	125	454	329	0.99697	0.572174
GCA_001630375.1-Fun_JYNV01000183.1_i000_004164	136	463	327	0.990909	0.630058
GCA_004011695.1-Fun_RYYQ01000017.1_i000_008679	136	463	327	0.990909	0.630058
GCA_015178965.1-Fun_WHVB01000003.1_i000_006573	127	481	354	1.07273	0.610345
GCA_014362265.1-Pla_BJWL01000010.1_i000_014627	117	442	325	0.984848	0.59415
GCA_019616345.1-Fun_WSTH01000339.1_i000_003257	115	443	328	0.993939	0.606285
GCA_905249995.1-Ani_CAJNOK010003109.1_i000_008989	112	436	324	0.981818	0.738041
GCA_905250885.1-Ani_CAJNOQ010000432.1_i000_003480	112	436	324	0.981818	0.738041
GCA_905332065.1-Ani_CAJOBC010000432.1_i000_003480	112	436	324	0.981818	0.738041
GCA_905332075.1-Ani_CAJOBA010003109.1_i000_008983	112	436	324	0.981818	0.738041
GCA_000835515.1-Fun_KN847340.1_i000_008925	131	457	326	0.987879	0.630561
GCA_006535975.1-Fun_QEAP01000306.1_i000_006757	118	449	331	1.00303	0.630476
GCA_007224835.1-Ani_SRMA01025407.1_i000_006559	130	490	360	1.09091	0.632689
GCA_905250015.1-Ani_CAJNOM010000092.1_i000_016452	114	443	329	0.99697	0.707527
GCA_905250115.1-Ani_CAJNOI010000087.1_i000_017655	114	443	329	0.99697	0.707527
GCA_002762385.1-Pla_NKXS01000851.1_i000_005262	134	460	326	0.987879	0.624521
GCA_013467495.1-Pla_CM025153.1_i000_018988	82	401	319	0.966667	0.644444
GCA_019112545.1-Fun_MU250536.1_i000_007602	80	411	331	1.00303	0.679671
GCA_004011705.1-Fun_RZGK01000002.1_i000_000508	134	462	328	0.993939	0.633205
GCA_003610855.1-Fun_MCFK01001957.1_i000_000834	136	467	331	1.00303	0.632887
GCA_019623705.1-Fun_WSTJ01004851.1_i000_020055	128	455	327	0.990909	0.590253
GCA_000149985.1-Fun_DS231620.1_i000_005423	138	462	324	0.981818	0.625483
GCA_003171515.3-Fun_CM025804.1_i000_014511	138	462	324	0.981818	0.625483
GCA_003171545.1-Fun_NQWZ01000008.1_i000_000586	138	462	324	0.981818	0.625483
GCA_003231325.2-Fun_CM034232.1_i000_013650	138	462	324	0.981818	0.625483
GCA_003231345.1-Fun_MVBI01000012.1_i000_001044	138	462	324	0.981818	0.625483
GCA_003231355.1-Fun_MVBG01000021.1_i000_001718	138	462	324	0.981818	0.625483
GCA_003231365.1-Fun_MVBH01000017.1_i000_001249	138	462	324	0.981818	0.625483
GCA_003231415.2-Fun_CM025823.1_i000_012499	138	462	324	0.981818	0.625483
GCA_003231425.1-Fun_NRDI01000003.1_i000_000212	138	462	324	0.981818	0.625483
GCA_008692205.1-Fun_SAXQ01000010.1_i000_012297	138	462	324	0.981818	0.625483
GCA_003675995.1-Ani_NCKU01001137.1_i000_004985	113	448	335	1.01515	0.706751
GCA_003019875.1-Fun_KZ679017.1_i000_008468	139	466	327	0.990909	0.641176
GCA_000616785.1-Fun_KK204365.1_i000_002058	129	458	329	0.99697	0.631478
GCA_000622975.1-Fun_AOKY01000377.1_i000_005855	129	458	329	0.99697	0.631478
GCA_012182645.1-Fun_JAATJQ010000038.1_i000_004798	129	458	329	0.99697	0.631478
GCA_012182655.1-Fun_JAAQVJ010000039.1_i000_004845	129	458	329	0.99697	0.631478
GCA_019359935.1-Fun_JAADCK010000043.1_i000_005296	129	458	329	0.99697	0.631478
GCA_001654015.2-Ani_LSRL02000004.1_i000_001272	125	457	332	1.00606	0.665331
GCA_003444635.2-Fun_QOKS01000054.1_i000_010937	137	460	323	0.978788	0.615238
GCA_003790465.1-Fun_ML119113.1_i000_002324	137	460	323	0.978788	0.615238
GCA_013340265.1-Ani_BLKM01000294.1_i000_001725	76	407	331	1.00303	0.545305
GCA_021223805.1-Ani_JAJJHR010002627.1_i000_006113	125	456	331	1.00303	0.667339
GCA_000784615.1-Fun_JPEW01000069.1_i000_006211	128	452	324	0.981818	0.624277
GCA_000690575.1-Pla_AYPS01000861.1_i000_002079	124	461	337	1.02121	0.517665
GCA_905250005.1-Ani_CAJNOH010000096.1_i000_007662	112	443	331	1.00303	0.711828
GCA_905250125.1-Ani_CAJNOL010000201.1_i000_010474	112	443	331	1.00303	0.711828
GCA_905251635.1-Ani_CAJNOT010000736.1_i000_015870	112	443	331	1.00303	0.711828
GCA_905332095.1-Ani_CAJOBD010000801.1_i000_010798	112	443	331	1.00303	0.711828
GCA_019924995.1-Fun_JAHFYO010002206.1_i000_007617	73	401	328	0.993939	0.705376
GCA_013036055.1-Fun_JAAABM010000001.1_i000_002603	139	464	325	0.984848	0.631068
GCA_005393395.2-Pla_CM016626.1_i000_033565	123	441	318	0.963636	0.562832
GCA_002895985.1-Fun_NKHZ01000011.1_i000_005041	131	462	331	1.00303	0.595324
GCA_019616345.1-Fun_WSTH01001507.1_i000_009077	138	465	327	0.990909	0.597806
GCA_019648995.1-Ani_BLXT01007282.1_i000_064166	115	445	330	1	0.627376
GCA_001683725.1-Fun_LUGH01000160.1_i000_002368	122	449	327	0.990909	0.660606
GCA_001632375.1-Fun_KV425893.1_i000_003008	123	458	335	1.01515	0.658153
GCA_016758935.1-Fun_JAEPRE010000346.1_i000_006071	118	442	324	0.981818	0.663934
GCA_903813345.1-Ani_CAIIXF010000014.1_i000_023240	117	447	330	1	0.601093
GCA_001444175.2-Ani_KQ562420.1_i000_008627	127	457	330	1	0.656064
GCA_001444175.2-Ani_KQ571347.1_i000_016389	127	457	330	1	0.656064
GCA_002201585.1-Pla_MTKT01017405.1_i000_029127	130	440	310	0.939394	0.550622
GCA_013399295.1-Ani_VXAH01000182.1_i000_001177	120	437	317	0.960606	0.632735
GCA_015178975.1-Fun_WHVD01000063.1_i000_012546	127	456	329	0.99697	0.630268
GCA_004153795.2-Pla_SDRB02012158.1_i000_025379	117	442	325	0.984848	0.586643
GCA_004155955.1-Fun_PDWY01000004.1_i000_007941	139	465	326	0.987879	0.63301
GCA_001975905.1-Fun_MSZU01000075.1_i000_000864	93	419	326	0.987879	0.684874
GCA_013676235.1-Pla_CM025502.1_i000_016136	138	464	326	0.987879	0.565972
GCA_007990455.1-Pla_CM017661.1_i000_073609	123	441	318	0.963636	0.562832
GCA_014905375.1-Pla_BMAC01000476.1_i000_018616	116	446	330	1	0.629771
GCA_004355085.1-Fun_ML170156.1_i000_000195	130	454	324	0.981818	0.558621
GCA_001027345.1-Fun_KQ087230.1_i000_005889	134	466	332	1.00606	0.582456
GCA_008065305.1-Fun_QKWL01000001.1_i000_000446	134	466	332	1.00606	0.582456
GCA_004154765.1-Fun_PDXG01000001.1_i000_000227	138	464	326	0.987879	0.63301
GCA_020736535.1-Fun_JAHBNJ010000003.1_i000_006136	143	465	322	0.975758	0.624031
GCA_001572055.1-Fun_LPVP01000010.1_i000_006279	138	464	326	0.987879	0.63301
GCA_001642055.1-Fun_KV441471.1_i000_002351	138	464	326	0.987879	0.63301
GCA_003574525.1-Fun_QPFE01000108.1_i000_006652	138	464	326	0.987879	0.63301
GCA_004154735.1-Fun_PDXE01000002.1_i000_003690	138	464	326	0.987879	0.63301
GCA_004154745.1-Fun_PDXA01000038.1_i000_007657	138	464	326	0.987879	0.63301
GCA_004154755.1-Fun_PDXD01000001.1_i000_001434	138	464	326	0.987879	0.63301
GCA_004154815.1-Fun_PEJP01000032.1_i000_006438	138	464	326	0.987879	0.63301
GCA_004154835.1-Fun_PDUP01000001.1_i000_000560	138	464	326	0.987879	0.63301
GCA_004154845.1-Fun_PDXH01000001.1_i000_001442	138	464	326	0.987879	0.63301
GCA_004156015.1-Fun_PDXB01000003.1_i000_006745	138	464	326	0.987879	0.63301
GCA_004156025.2-Fun_PDWZ02000009.1_i000_012813	138	464	326	0.987879	0.63301
GCA_004156035.1-Fun_PDXC01000008.1_i000_012078	138	464	326	0.987879	0.63301
GCA_004168565.1-Fun_PDXF01000014.1_i000_002846	138	464	326	0.987879	0.63301
PYNE001.0722.00001.C001_01773	97	399	302	0.915152	0.719048
GCA_003813205.1-Fun_ML122258.1_i000_004752	121	456	335	1.01515	0.621521
GCA_000695605.1-Pla_KK785393.1_i000_022384	8	333	325	0.984848	0.736961
GCA_015501075.1-Fun_JADNYJ010000097.1_i000_016285	126	459	333	1.00909	0.641618
GCA_004115005.2-Pla_CM032146.1_i000_017692	154	474	320	0.969697	0.526316
GCA_000327365.1-Pla_CM001752.1_i000_037167	123	441	318	0.963636	0.56383
GCA_007990325.1-Pla_CM017713.1_i000_077123	123	441	318	0.963636	0.56383
GCA_008761655.1-Pla_CM018227.1_i000_071686	123	441	318	0.963636	0.56383
GCA_018691285.1-Pla_CM031892.1_i000_019023	156	476	320	0.969697	0.52459
GCA_007990345.1-Pla_CM017687.1_i000_074155	123	441	318	0.963636	0.562832
GCA_007990485.1-Pla_CM017635.1_i000_077232	123	441	318	0.963636	0.562832
GCA_013400055.1-Ani_VXBJ01007228.1_i000_013158	123	446	323	0.978788	0.690171
GCA_015832365.1-Ani_JACWZX010000172.1_i000_002516	112	443	331	1.00303	0.616387
GCA_019297735.1-Ani_CM033239.1_i000_007835	112	443	331	1.00303	0.616387
GCA_900245975.1-Ani_OUUW01000013.1_i000_011882	125	457	332	1.00606	0.664
GCA_020137385.1-Fun_JACLAE010000014.1_i000_003111	137	464	327	0.990909	0.624046
GCA_903986555.1-Ani_CAJDYZ010012019.1_i000_009062	127	457	330	1	0.670732
GCA_905332315.1-Ani_CAJOBV010003787.1_i000_023433	2	296	294	0.890909	0.927445
GCA_021223745.1-Ani_JAJJHO010001233.1_i000_001929	125	456	331	1.00303	0.667339
GCA_014851425.1-Pla_CM026266.1_i000_022809	115	439	324	0.981818	0.583784
GCA_000344685.1-Fun_KB469303.1_i000_006758	123	450	327	0.990909	0.608939
GCA_015178995.1-Fun_WHVE01000001.1_i000_000137	141	438	297	0.9	0.675
GCA_013305805.1-Fun_QVQA01000014.1_i000_000789	137	461	324	0.981818	0.636542
GCA_006535985.1-Fun_QEAO01000040.1_i000_005004	122	452	330	1	0.572917
GCA_018446385.1-Pla_CM031513.1_i000_020822	129	456	327	0.990909	0.569686
GCA_000355885.1-Ani_KB742873.1_i000_005960	110	433	323	0.978788	0.70989
GCA_002914805.1-Pla_JXTB01000031.1_i000_005492	117	439	322	0.975758	0.564912
GCA_013399475.1-Ani_VXAL01001997.1_i000_001320	112	434	322	0.975758	0.70614
GCA_005393395.2-Pla_CM016621.1_i000_014543	114	428	314	0.951515	0.565766
GCA_907166805.1-Fun_CAJRGZ010000015.1_i000_002465	134	462	328	0.993939	0.638132
GCA_000149445.2-Fun_CM000309.1_i000_005660	128	446	318	0.963636	0.616279
GCA_000182965.3-Fun_CP017630.1_i000_005946	128	446	318	0.963636	0.616279
GCA_000773725.1-Fun_AJIX01000058.1_i000_005536	128	446	318	0.963636	0.616279
GCA_000773735.1-Fun_AJIW01000068.1_i000_005850	128	446	318	0.963636	0.616279
GCA_000773745.1-Fun_AJIU01000044.1_i000_005151	128	446	318	0.963636	0.616279
GCA_000773805.1-Fun_AJIY01000044.1_i000_005318	128	446	318	0.963636	0.616279
GCA_000773825.1-Fun_AJJA01000048.1_i000_006112	128	446	318	0.963636	0.616279
GCA_000773845.1-Fun_AJIQ01000049.1_i000_004763	128	446	318	0.963636	0.616279
GCA_000774085.1-Fun_AJIT01000043.1_i000_005586	128	446	318	0.963636	0.616279
GCA_000775445.1-Fun_AJIV01000060.1_i000_005344	128	446	318	0.963636	0.616279
GCA_000775465.1-Fun_AJIZ01000050.1_i000_005522	128	446	318	0.963636	0.616279
GCA_000775505.1-Fun_AJJB01000055.1_i000_005210	128	446	318	0.963636	0.616279
GCA_000775525.1-Fun_AJJC01000050.1_i000_005207	128	446	318	0.963636	0.616279
GCA_000784495.1-Fun_AJJE01000045.1_i000_004612	128	446	318	0.963636	0.616279
GCA_000784505.1-Fun_AJJD01000038.1_i000_003241	128	446	318	0.963636	0.616279
GCA_000784515.1-Fun_JSXQ01000050.1_i000_004885	128	446	318	0.963636	0.616279
GCA_000784525.1-Fun_JSXP01000044.1_i000_005206	128	446	318	0.963636	0.616279
GCA_000784595.1-Fun_JPEV01000048.1_i000_005321	128	446	318	0.963636	0.616279
GCA_000784635.1-Fun_AJJF01000038.1_i000_005011	128	446	318	0.963636	0.616279
GCA_000784655.1-Fun_JTBX01000077.1_i000_006025	128	446	318	0.963636	0.616279
GCA_000784695.1-Fun_AJJG01000078.1_i000_000103	128	446	318	0.963636	0.616279
GCA_014049485.1-Fun_JABWAD010000052.1_i000_003858	128	446	318	0.963636	0.616279
GCA_019702505.1-Fun_JAANER010000003.1_i000_005989	136	464	328	0.993939	0.636893
GCA_013399835.1-Ani_VXAX01003481.1_i000_005642	115	435	320	0.969697	0.603774
GCA_905319835.1-Ani_CAJNRE010019907.1_i000_036103	112	446	334	1.01212	0.684426
GCA_000827415.1-Fun_KN824311.1_i000_008788	33	374	341	1.03333	0.738095
GCA_000262585.1-Ani_JH668484.1_i000_007849	8	322	314	0.951515	0.704036
GCA_000569095.1-Pro_CM002466.1_i000_005472	112	443	331	1.00303	0.621013
VUDI001.0722.00001.C001_00309	96	418	322	0.975758	0.764846
GCA_003813185.1-Fun_ML122048.1_i000_005209	121	456	335	1.01515	0.593972
GCA_000784575.1-Fun_JSXR01000053.1_i000_005420	131	446	315	0.954545	0.610465
GCA_000691765.2-Fun_KK667243.1_i000_006101	128	454	326	0.987879	0.639216
GCA_000441915.1-Pla_KE527363.1_i000_001907	127	463	336	1.01818	0.677419
GCA_021442195.1-Pla_CM038195.1_i000_002877	171	480	309	0.936364	0.504078
GCA_000773755.1-Fun_AJIS01000057.1_i000_006114	130	446	316	0.957576	0.608863
GCA_004369175.1-Fun_QPFP01000027.1_i000_009963	145	470	325	0.984848	0.544389
GCA_015956445.1-Fun_WIUZ02000019.1_i000_005176	137	456	319	0.966667	0.56162
GCA_010093635.1-Fun_MU006783.1_i000_005851	140	467	327	0.990909	0.632495
GCA_000327385.1-Ani_KB201785.1_i000_011070	111	447	336	1.01818	0.713376
GCA_905331015.1-Ani_CAJNXB010003085.1_i000_017784	112	443	331	1.00303	0.7103
GCA_905331295.1-Ani_CAJNYD010002575.1_i000_020245	112	443	331	1.00303	0.7103
GCA_905331475.1-Ani_CAJNYU010004239.1_i000_029921	112	443	331	1.00303	0.7103
GCA_905331485.1-Ani_CAJNYT010000910.1_i000_008364	112	443	331	1.00303	0.7103
GCA_905331495.1-Ani_CAJNYV010005958.1_i000_031812	112	443	331	1.00303	0.7103
GCA_905332235.1-Ani_CAJOBO010001753.1_i000_020475	112	443	331	1.00303	0.7103
GCA_905332245.1-Ani_CAJOBP010000309.1_i000_003975	112	443	331	1.00303	0.7103
GCA_905332265.1-Ani_CAJOBQ010001397.1_i000_019723	112	443	331	1.00303	0.7103
GCA_905332275.1-Ani_CAJOBR010001201.1_i000_010654	112	443	331	1.00303	0.7103
GCA_905332285.1-Ani_CAJOBS010001306.1_i000_017957	112	443	331	1.00303	0.7103
GCA_001638985.2-Fun_KV440980.1_i000_007764	132	450	318	0.963636	0.64503
GCA_910591965.1-Fun_CAJVPY010000221.1_i000_000901	121	455	334	1.01212	0.607273
GCA_905250005.1-Ani_CAJNOH010000251.1_i000_012952	112	443	331	1.00303	0.711828
GCA_905250125.1-Ani_CAJNOL010000362.1_i000_015485	112	443	331	1.00303	0.711828
GCA_905250125.1-Ani_CAJNOL010000363.1_i000_015510	112	443	331	1.00303	0.711828
GCA_905250875.1-Ani_CAJNOO010000464.1_i000_011579	112	443	331	1.00303	0.711828
GCA_905251635.1-Ani_CAJNOT010000716.1_i000_015613	112	443	331	1.00303	0.711828
GCA_905252715.1-Ani_CAJNOU010000411.1_i000_010144	112	443	331	1.00303	0.711828
GCA_905332085.1-Ani_CAJOAX010000442.1_i000_006360	112	443	331	1.00303	0.711828
GCA_905332105.1-Ani_CAJOBE010002353.1_i000_015900	112	443	331	1.00303	0.711828
GCA_019059645.1-Ani_JAFELL010002276.1_i000_015500	142	489	347	1.05152	0.574503
GCA_002222465.1-Fun_AMKV01000018.1_i000_001851	135	467	332	1.00606	0.58042
GCA_001006355.1-Fun_LAQI01000215.1_i000_003837	134	463	329	0.99697	0.631478
GCA_002113885.2-Ani_NEDP02076728.1_i000_021473	119	443	324	0.981818	0.627907
GCA_013397455.1-Ani_VYZB01000197.1_i000_003653	123	445	322	0.975758	0.688034
GCA_000151125.2-Fun_ABSU01000018.1_i000_002724	152	476	324	0.981818	0.601113
GCA_000149245.3-Fun_CP003825.1_i000_003480	135	467	332	1.00606	0.582456
GCA_002215765.1-Fun_AMLA01000196.1_i000_001579	135	467	332	1.00606	0.582456
GCA_002215775.1-Fun_AMLG01000072.1_i000_005347	135	467	332	1.00606	0.582456
GCA_002215825.1-Fun_AMLK01000050.1_i000_003548	135	467	332	1.00606	0.582456
GCA_002215885.1-Fun_AMKM01000017.1_i000_002100	135	467	332	1.00606	0.582456
GCA_002216725.1-Fun_CP022326.1_i000_003480	135	467	332	1.00606	0.582456
GCA_002220445.1-Fun_AMLJ01000135.1_i000_001003	135	467	332	1.00606	0.582456
GCA_002221985.1-Fun_APKI01000157.1_i000_001057	135	467	332	1.00606	0.582456
GCA_002222015.1-Fun_APKO01000211.1_i000_001897	135	467	332	1.00606	0.582456
GCA_002222025.1-Fun_APKS01000245.1_i000_001944	135	467	332	1.00606	0.582456
GCA_002222095.1-Fun_APKP01000238.1_i000_002126	135	467	332	1.00606	0.582456
GCA_002222115.1-Fun_APKR01000236.1_i000_001779	135	467	332	1.00606	0.582456
GCA_002222135.1-Fun_APKK01000201.1_i000_001638	135	467	332	1.00606	0.582456
GCA_002222145.1-Fun_APKQ01000192.1_i000_001418	135	467	332	1.00606	0.582456
GCA_002222165.1-Fun_APKT01000191.1_i000_001515	135	467	332	1.00606	0.582456
GCA_002222215.1-Fun_APKH01000154.1_i000_000994	135	467	332	1.00606	0.582456
GCA_002222225.1-Fun_AMLE01000330.1_i000_002802	135	467	332	1.00606	0.582456
GCA_002222245.1-Fun_APKJ01000170.1_i000_001280	135	467	332	1.00606	0.582456
GCA_002222255.1-Fun_AMLH01000225.1_i000_002671	135	467	332	1.00606	0.582456
GCA_002222295.1-Fun_AMLB01000223.1_i000_002544	135	467	332	1.00606	0.582456
GCA_002222315.1-Fun_AMKY01000040.1_i000_002866	135	467	332	1.00606	0.582456
GCA_002222325.1-Fun_AMKT01000049.1_i000_003996	135	467	332	1.00606	0.582456
GCA_002222335.1-Fun_AMKU01000016.1_i000_002278	135	467	332	1.00606	0.582456
GCA_002222375.1-Fun_AMLI01000018.1_i000_001524	135	467	332	1.00606	0.582456
GCA_002222395.1-Fun_AMLD01000203.1_i000_002109	135	467	332	1.00606	0.582456
GCA_002222405.1-Fun_AMLC01000068.1_i000_004934	135	467	332	1.00606	0.582456
GCA_002222455.1-Fun_AMKZ01000193.1_i000_001763	135	467	332	1.00606	0.582456
GCA_002224005.1-Fun_AMLF01000025.1_i000_002159	135	467	332	1.00606	0.582456
GCA_905250015.1-Ani_CAJNOM010000291.1_i000_032503	125	457	332	1.00606	0.715517
GCA_002307695.1-Fun_KZ293649.1_i000_006725	123	454	331	1.00303	0.626894
GCA_021223915.1-Ani_JAJJHS010005105.1_i000_005138	125	457	332	1.00606	0.669355
GCA_013401355.1-Ani_VYZU01070814.1_i000_008391	65	385	320	0.969697	0.683761
GCA_005298045.1-Fun_SWBT01000134.1_i000_000563	130	455	325	0.984848	0.564236
GCA_002215755.1-Fun_NKHW01000054.1_i000_005152	135	467	332	1.00606	0.578397
GCA_002215835.1-Fun_AMKP01000017.1_i000_001802	135	467	332	1.00606	0.578397
GCA_002222475.1-Fun_AMKO01000023.1_i000_002481	135	467	332	1.00606	0.578397
GCA_002234625.1-Fun_AMKQ01000024.1_i000_003217	135	467	332	1.00606	0.578397
GCA_018290095.1-Ani_CM031381.1_i000_012823	116	446	330	1	0.627376
GCA_000151145.1-Fun_DS995703.1_i000_005347	131	458	327	0.990909	0.630058
GCA_000512605.2-Fun_KI894013.1_i000_005423	131	461	330	1	0.552764
GCA_000026945.1-Fun_FM992695.1_i000_000850	130	460	330	1	0.639535
GCA_000612305.1-Pla_KK198760.1_i000_025943	117	442	325	0.984848	0.561313
GCA_021527035.1-Fun_JAKELG010000034.1_i000_006457	123	442	319	0.966667	0.571685
GCA_013399015.1-Ani_VWZX01010881.1_i000_013630	110	433	323	0.978788	0.708333
GCA_001299255.1-Fun_LFJN01000004.1_i000_008097	131	459	328	0.993939	0.621212
GCA_002217545.1-Fun_APKM01000257.1_i000_002074	135	467	332	1.00606	0.578397
GCA_002220035.1-Fun_AMKW01000268.1_i000_002271	135	467	332	1.00606	0.578397
GCA_002220045.1-Fun_NKHY01000053.1_i000_005237	135	467	332	1.00606	0.578397
GCA_020746845.1-Fun_JAGPNJ010000009.1_i000_012500	126	454	328	0.993939	0.604052
GCA_002891405.2-Ani_NEVH01013964.1_i000_009329	128	459	331	1.00303	0.676892
GCA_001638985.2-Fun_KV441024.1_i000_014215	128	449	321	0.972727	0.647177
GCA_002215855.1-Fun_AMKX01000237.1_i000_001697	135	467	332	1.00606	0.574394
GCA_000775455.1-Fun_AJIR01000057.1_i000_005172	128	446	318	0.963636	0.616279
GCA_019511825.2-Pla_QFCC02000011.1_i000_005607	119	443	324	0.981818	0.582734
GCA_905332095.1-Ani_CAJOBD010001210.1_i000_013830	135	458	323	0.978788	0.671518
GCA_009728645.1-Fun_WJSL01000012.1_i000_008832	140	461	321	0.972727	0.619691
GCA_009728655.1-Fun_WJSN01000011.1_i000_009219	140	461	321	0.972727	0.619691
GCA_900231935.2-Fun_OCTF02000010.1_i000_009218	140	461	321	0.972727	0.619691
GCA_001969505.1-Fun_LSSK01000792.1_i000_001729	123	462	339	1.02727	0.656977
GCA_007990455.1-Pla_CM017643.1_i000_040181	121	441	320	0.969697	0.582878
GCA_905250075.1-Ani_CAJNOP010000020.1_i000_015396	132	457	325	0.984848	0.677083
GCA_905331505.1-Ani_CAJNYZ010000022.1_i000_008433	132	457	325	0.984848	0.677083
GCA_905331525.1-Ani_CAJNZF010000004.1_i000_002854	132	457	325	0.984848	0.677083
GCA_905332305.1-Ani_CAJOBU010000594.1_i000_006158	132	457	325	0.984848	0.677083
GCA_905332315.1-Ani_CAJOBV010000949.1_i000_011214	132	457	325	0.984848	0.677083
GCA_905332325.1-Ani_CAJOBW010002062.1_i000_010666	132	457	325	0.984848	0.677083
GCA_010093885.1-Fun_ML995478.1_i000_002491	135	463	328	0.993939	0.607407
GCA_001953115.1-Fun_LSSL01000584.1_i000_001611	133	460	327	0.990909	0.590253
GCA_905251635.1-Ani_CAJNOT010001410.1_i000_022431	136	457	321	0.972727	0.665975
GCA_003335185.2-Ani_QKKF02012754.1_i000_006020	124	460	336	1.01818	0.670659
GCA_004369175.1-Fun_QPFP01000001.1_i000_000701	122	454	332	1.00606	0.627599
GCA_000512605.2-Fun_KI894010.1_i000_003554	137	485	348	1.05455	0.615929
GCA_905250055.1-Ani_CAJNOF010000020.1_i000_012169	132	457	325	0.984848	0.677083
GCA_905250075.1-Ani_CAJNOP010000004.1_i000_005398	132	457	325	0.984848	0.677083
GCA_905331515.1-Ani_CAJNZC010000023.1_i000_008845	132	457	325	0.984848	0.677083
GCA_905331535.1-Ani_CAJNZB010000004.1_i000_003084	132	457	325	0.984848	0.677083
GCA_905332295.1-Ani_CAJOBT010001595.1_i000_012033	132	457	325	0.984848	0.677083
GCA_002218305.1-Ani_MCFN01000125.1_i000_004901	124	449	325	0.984848	0.577265
GCA_019924255.1-Fun_JAHFXK010001693.1_i000_005385	132	463	331	1.00303	0.630476
GCA_019924895.1-Fun_JAHFYM010001918.1_i000_006354	132	463	331	1.00303	0.630476
GCA_007990325.1-Pla_CM017700.1_i000_074273	123	441	318	0.963636	0.567857
GCA_007990345.1-Pla_CM017669.1_i000_020726	121	441	320	0.969697	0.582878
GCA_008761655.1-Pla_CM018209.1_i000_039106	121	441	320	0.969697	0.581818
GCA_000507465.3-Fun_KI669472.1_i000_000550	143	468	325	0.984848	0.571178
GCA_000507485.3-Fun_KI669550.1_i000_003440	143	468	325	0.984848	0.571178
GCA_000507885.2-Fun_KI669463.1_i000_004617	143	468	325	0.984848	0.571178
GCA_000787975.1-Pla_JRRC01118436.1_i000_008017	123	441	318	0.963636	0.565836
GCA_000787975.1-Pla_JRRC01118436.1_i000_008018	123	441	318	0.963636	0.565836
GCA_007990345.1-Pla_CM017674.1_i000_035417	123	441	318	0.963636	0.565836
GCA_008761655.1-Pla_CM018214.1_i000_068988	123	441	318	0.963636	0.565836
GCA_007990325.1-Pla_CM017695.1_i000_042195	121	441	320	0.969697	0.580762
GCA_021524915.1-Fun_JAKELL010000055.1_i000_009705	127	447	320	0.969697	0.602637
GCA_013396975.1-Ani_VWZO01020120.1_i000_012477	115	432	317	0.960606	0.575318
GCA_007990455.1-Pla_CM017648.1_i000_070831	123	441	318	0.963636	0.564831
GCA_013339695.1-Ani_CM023522.1_i000_008182	115	442	327	0.990909	0.608939
GCA_013399225.1-Ani_VXAC01002952.1_i000_004841	112	434	322	0.975758	0.596296
GCA_001049375.1-Pro_CDSF01000077.1_i000_002707	119	446	327	0.990909	0.64497
GCA_905250005.1-Ani_CAJNOH010000310.1_i000_014263	135	458	323	0.978788	0.670124
GCA_905250125.1-Ani_CAJNOL010002328.1_i000_039630	135	458	323	0.978788	0.670124
GCA_905250875.1-Ani_CAJNOO010001727.1_i000_023995	135	458	323	0.978788	0.670124
GCA_905252715.1-Ani_CAJNOU010001667.1_i000_022899	135	458	323	0.978788	0.670124
GCA_905332085.1-Ani_CAJOAX010000878.1_i000_010001	135	458	323	0.978788	0.670124
GCA_905332105.1-Ani_CAJOBE010007312.1_i000_027735	135	458	323	0.978788	0.670124
GCA_000344705.1-Fun_AOGT01000772.1_i000_001903	83	408	325	0.984848	0.704989
GCA_000512565.2-Fun_KI894033.1_i000_005852	136	486	350	1.06061	0.606586
GCA_001632425.1-Fun_KV425564.1_i000_004116	123	452	329	0.99697	0.581272
GCA_905368565.1-Ani_CAJPIZ010002285.1_i000_004718	137	448	311	0.942424	0.579143
GCA_009728635.1-Fun_WJSK01000011.1_i000_009442	146	463	317	0.960606	0.608445
GCA_009728665.1-Fun_WJSO01000011.1_i000_009568	146	463	317	0.960606	0.608445
GCA_009728675.1-Fun_WJSM01000010.1_i000_008816	146	463	317	0.960606	0.608445
GCA_900232045.3-Fun_HG992986.1_i000_009983	146	463	317	0.960606	0.608445
GCA_013397635.1-Ani_VYZG01000371.1_i000_004130	108	430	322	0.975758	0.710817
GCA_000300595.1-Fun_JH930469.1_i000_002589	136	453	317	0.960606	0.566071
GCA_021525005.1-Fun_JAKEYE010000174.1_i000_004915	127	447	320	0.969697	0.571429
GCA_905332135.1-Ani_CAJOBI010001881.1_i000_006792	112	422	310	0.939394	0.732861
THTE004.0722.00001.C001_01596	96	399	303	0.918182	0.72488
GCA_020736505.1-Fun_JAHBNI010000004.1_i000_008288	135	464	329	0.99697	0.638835
GCA_022201065.1-Pla_CM039176.1_i000_021453	115	440	325	0.984848	0.561313
GCA_016772295.1-Fun_JAAGWA010000007.1_i000_009044	123	457	334	1.01212	0.603978
GCA_013396895.1-Ani_VWZM01020157.1_i000_013880	118	433	315	0.954545	0.583333
GCA_003325435.1-Fun_PJQL01004865.1_i000_015515	23	301	278	0.842424	0.923588
GCA_022201045.1-Pla_CM039167.1_i000_021240	115	440	325	0.984848	0.558419
GCA_002215745.1-Fun_NKHX01000049.1_i000_004700	173	505	332	1.00606	0.542484
GCA_013401215.1-Ani_VZUJ01154355.1_i000_013304	118	440	322	0.975758	0.695464
GCA_007859695.1-Pla_CP031047.1_i000_007159	127	463	336	1.01818	0.685714
GCA_000151505.1-Fun_ACYE01000167.1_i000_004793	204	531	327	0.990909	0.54958
GCA_900100905.1-Fun_FMWP01000012.1_i000_007935	147	473	326	0.987879	0.578014
GCA_900102585.1-Fun_FMWQ01000021.1_i000_005497	147	473	326	0.987879	0.578014
GCA_007990455.1-Pla_CM017656.1_i000_043230	123	441	318	0.963636	0.562832
GCA_000327365.1-Pla_CM001743.1_i000_009946	123	441	318	0.963636	0.560847
GCA_018688675.1-Pla_CM031836.1_i000_024701	135	462	327	0.990909	0.595628
GCA_000182895.1-Fun_AACS02000008.1_i000_009038	123	456	333	1.00909	0.598921
GCA_000697705.1-Fun_KL198034.1_i000_006982	123	455	332	1.00606	0.698947
GCA_001691785.2-Fun_JNHV02000103.1_i000_003044	133	455	322	0.975758	0.583333
GCA_013398195.1-Ani_VZSB01002942.1_i000_005131	108	431	323	0.978788	0.713024
GCA_007990485.1-Pla_CM017622.1_i000_074346	123	441	318	0.963636	0.564831
GCA_000708025.2-Ani_KL872975.1_i000_011614	117	436	319	0.966667	0.62549
GCA_013400755.1-Ani_VZTQ01005779.1_i000_005212	65	388	323	0.978788	0.787805
GCA_000835495.1-Fun_KN847041.1_i000_004587	134	459	325	0.984848	0.626204
GCA_013396775.1-Ani_VZRE01014216.1_i000_011919	111	437	326	0.987879	0.654618
GCA_008638375.1-Pla_CM018033.1_i000_019791	117	442	325	0.984848	0.566202
GCA_013398455.1-Ani_VZSM01001468.1_i000_003336	120	442	322	0.975758	0.692473
GCA_013399115.1-Ani_VXAA01007015.1_i000_013070	114	433	319	0.966667	0.61583
GCA_014362265.1-Pla_BJWL01000007.1_i000_010436	160	488	328	0.993939	0.605166
GCA_019455425.1-Pla_CM033491.1_i000_019155	121	438	317	0.960606	0.558099
GCA_000709365.1-Ani_KL470206.1_i000_009831	118	437	319	0.966667	0.619417
GCA_001191545.1-Fun_LGLR01000248.1_i000_008635	135	465	330	1	0.263368
GCA_003268335.1-Fun_QGDH01000045.1_i000_005849	135	465	330	1	0.263368
GCA_013397865.1-Ani_VZTI01004304.1_i000_009855	112	434	322	0.975758	0.645291
GCA_013396485.1-Ani_VWYY01000097.1_i000_003231	112	434	322	0.975758	0.645291
GCA_004565275.1-Pro_SDOX01000008.1_i000_007976	112	443	331	1.00303	0.621013
GCA_013398015.1-Ani_VZRR01014002.1_i000_013320	111	433	322	0.975758	0.646586
GCA_009835185.1-Pro_VJMH01000063.1_i000_000960	126	459	333	1.00909	0.682377
GCA_900708865.1-Pro_CAADRA010000063.1_i000_000917	126	459	333	1.00909	0.682377
GCA_013399195.1-Ani_VXAD01008599.1_i000_008548	112	434	322	0.975758	0.645291
GCA_000585515.1-Fun_AMGW01000004.1_i000_005376	133	456	323	0.978788	0.624758
GCA_013397725.1-Ani_VZTD01001642.1_i000_003307	112	434	322	0.975758	0.645291
GCA_000493195.1-Pla_KI536726.1_i000_011035	115	442	327	0.990909	0.592391
GCA_013398155.1-Ani_VZRU01017002.1_i000_010483	126	437	311	0.942424	0.575926
GCA_000471905.1-Pla_KI394767.1_i000_019543	124	441	317	0.960606	0.536379
GCA_010093685.1-Fun_MU006224.1_i000_006665	137	463	326	0.987879	0.62572
GCA_019648995.1-Ani_BLXT01000981.1_i000_008959	122	458	336	1.01818	0.576329
GCA_013397015.1-Ani_VWZQ01011413.1_i000_011280	112	438	326	0.987879	0.653307
GCA_004802665.1-Fun_SGPJ01000076.1_i000_007535	138	454	316	0.957576	0.333685
GCA_021223895.1-Ani_JAJJHX010008117.1_i000_007862	125	457	332	1.00606	0.669355
GCA_013400515.1-Ani_VZTN01036903.1_i000_012825	112	434	322	0.975758	0.645291
GCA_905250035.1-Ani_CAJNOE010000082.1_i000_011011	127	461	334	1.01212	0.70021
GCA_905332045.1-Ani_CAJOBB010000016.1_i000_000671	127	461	334	1.01212	0.70021
GCA_001186125.1-Pro_KQ241691.1_i000_002172	142	475	333	1.00909	0.630682
GCA_013400235.1-Ani_VXBT01001174.1_i000_001257	112	433	321	0.972727	0.643287
GCA_002156985.1-Ani_KZ149934.1_i000_010169	112	446	334	1.01212	0.620818
GCA_905250015.1-Ani_CAJNOM010000084.1_i000_015392	132	460	328	0.993939	0.687631
GCA_905250115.1-Ani_CAJNOI010000035.1_i000_010268	132	460	328	0.993939	0.687631
GCA_017311265.1-Fun_JABTEF010000019.1_i000_001223	113	446	333	1.00909	0.650391
GCA_017788925.1-Fun_JACEFK010000001.1_i000_001674	113	446	333	1.00909	0.650391
GCA_013401055.1-Ani_VZUE01000119.1_i000_007455	122	444	322	0.975758	0.689507
GCA_905250015.1-Ani_CAJNOM010000115.1_i000_018989	132	460	328	0.993939	0.687631
GCA_905250045.1-Ani_CAJNOG010000070.1_i000_009744	132	460	328	0.993939	0.687631
GCA_905250065.1-Ani_CAJNON010000108.1_i000_013366	132	460	328	0.993939	0.687631
GCA_905332015.1-Ani_CAJOAZ010000812.1_i000_013380	132	460	328	0.993939	0.687631
GCA_905332035.1-Ani_CAJOAY010001781.1_i000_023388	132	460	328	0.993939	0.687631
GCA_013396875.1-Ani_VZRF01008663.1_i000_007012	112	434	322	0.975758	0.645291
GCA_013401065.1-Ani_VZUD01000126.1_i000_009128	123	445	322	0.975758	0.688034
GCA_015143295.1-Pla_CM026568.1_i000_024584	126	489	363	1.1	0.603993
GCA_000005245.1-Ani_CH940650.1_i000_010142	125	457	332	1.00606	0.666667
GCA_010093705.1-Fun_MU006096.1_i000_005004	133	465	332	1.00606	0.654832
GCA_013400475.1-Ani_WAAF01005705.1_i000_003807	118	440	322	0.975758	0.695464
GCA_001883845.1-Fun_MNUE01000014.1_i000_001848	139	462	323	0.978788	0.616412
GCA_905219655.1-Fun_CAJMXA010003564.1_i000_006009	126	456	330	1	0.586146
GCA_007844105.2-Pla_CM017584.2_i000_019112	117	441	324	0.981818	0.573451
GCA_013368075.1-Ani_JABVZV010002219.1_i000_016110	114	442	328	0.993939	0.596364
GCA_013397975.1-Ani_VZRQ01006359.1_i000_007876	112	434	322	0.975758	0.645291
GCA_013397535.1-Ani_VYZE01000443.1_i000_007022	118	441	323	0.978788	0.697624
GCA_001592805.2-Fun_CP051142.1_i000_005999	137	463	326	0.987879	0.581105
GCA_013399495.1-Ani_VXAM01000056.1_i000_002141	123	445	322	0.975758	0.688034
GCA_010015605.1-Fun_ML975244.1_i000_000232	146	461	315	0.954545	0.61165
GCA_013397275.1-Ani_VYXH01001426.1_i000_001482	69	389	320	0.969697	0.732265
GCA_001179505.1-Pro_CDMY01000733.1_i000_019217	116	445	329	0.99697	0.619586
GCA_013397815.1-Ani_VZTH01003588.1_i000_002556	124	446	322	0.975758	0.630137
GCA_002906115.4-Pla_PKMF03021375.1_i000_075274	135	463	328	0.993939	0.600733
GCA_019448385.1-Pro_JAGTXO010000041.1_i000_013767	129	462	333	1.00909	0.710021
GCA_905249995.1-Ani_CAJNOK010000026.1_i000_000234	111	443	332	1.00606	0.718615
GCA_905250885.1-Ani_CAJNOQ010000434.1_i000_003494	111	443	332	1.00606	0.718615
GCA_905332065.1-Ani_CAJOBC010000434.1_i000_003494	111	443	332	1.00606	0.718615
GCA_905332075.1-Ani_CAJOBA010000026.1_i000_000234	111	443	332	1.00606	0.718615
GCA_013397055.1-Ani_VWZT01009954.1_i000_007484	125	446	321	0.972727	0.626953
GCA_900120095.1-Fun_FQNC01000018.1_i000_003714	151	474	323	0.978788	0.568662
GCA_013399875.1-Ani_VXAZ01001305.1_i000_001904	112	434	322	0.975758	0.596296
GCA_905249995.1-Ani_CAJNOK010000224.1_i000_001255	128	473	345	1.04545	0.699797
GCA_905332075.1-Ani_CAJOBA010000224.1_i000_001256	128	473	345	1.04545	0.699797
GCA_005959815.1-Ani_QOCX01000122.1_i000_003944	124	457	333	1.00909	0.663347
GCA_002760635.1-Fun_AYKW01000069.1_i000_015188	123	459	336	1.01818	0.59469
GCA_000149385.1-Fun_CM000044.1_i000_003055	135	468	333	1.00909	0.570205
GCA_002906115.4-Pla_PKMF03022155.1_i000_077960	124	442	318	0.963636	0.527363
GCA_000005175.1-Ani_CH933806.1_i000_012621	125	457	332	1.00606	0.665331
GCA_019364595.1-Fun_JAHRGV010000022.1_i000_002872	123	455	332	1.00606	0.58042
GCA_000091045.1-Fun_AE017345.1_i000_003118	135	467	332	1.00606	0.568493
GCA_000599465.2-Ani_AWGT02000109.1_i000_008187	124	475	351	1.06364	0.709091
GCA_013389985.1-Ani_WEIT01029211.1_i000_008686	111	433	322	0.975758	0.597403
GCA_013400815.1-Ani_WBNK01000497.1_i000_006273	117	439	322	0.975758	0.692473
GCA_000708835.1-Pla_DF237240.1_i000_007155	130	441	311	0.942424	0.559353
GCA_013398615.1-Ani_VZSR01000028.1_i000_005834	120	442	322	0.975758	0.692473
GCA_000512565.2-Fun_KI894037.1_i000_008090	131	460	329	0.99697	0.549249
GCA_001949185.1-Ani_BDGG01000001.1_i000_002652	128	457	329	0.99697	0.660643
GCA_013396635.1-Ani_WBMW01002373.1_i000_005278	118	434	316	0.957576	0.585185
GCA_013397695.1-Ani_VYZI01000089.1_i000_013241	117	440	323	0.978788	0.694624
GCA_003268315.1-Fun_QGDG01000036.1_i000_004578	135	463	328	0.993939	0.229853
GCA_904845305.1-Ani_CAJGYM010000001.1_i000_000832	110	444	334	1.01212	0.677485
GCA_021527775.1-Fun_JAKEYF010000017.1_i000_004705	152	468	316	0.957576	0.539249
GCA_013398055.1-Ani_VZRS01001745.1_i000_001612	112	434	322	0.975758	0.595194
GCA_022160315.1-Fun_MU275175.1_i000_003205	135	453	318	0.963636	0.550173
GCA_002705745.1-Fun_KZ303502.1_i000_003711	121	454	333	1.00909	0.678208
GCA_002897195.1-Pla_BDQV01000151.1_i000_017638	119	442	323	0.978788	0.587273
GCA_013399715.1-Ani_VXAV01006481.1_i000_006977	129	443	314	0.951515	0.594697
GCA_014905635.1-Pla_JABVCE010000002.1_i000_003262	84	405	321	0.972727	0.702407
GCA_900000015.1-Pro_CCYD01000286.1_i000_002498	115	449	334	1.01212	0.68866
GCA_003024255.1-Pla_CM009660.1_i000_007448	118	440	322	0.975758	0.566901
GCA_022201065.1-Pla_CM039174.1_i000_014556	119	441	322	0.975758	0.572954
GCA_013467465.1-Pla_CM025166.1_i000_023866	82	402	320	0.969697	0.645161
GCA_012923435.1-Pla_JAATIP010000107.1_i000_006252	147	472	325	0.984848	0.549915
GCA_012923435.1-Pla_JAATIP010000370.1_i000_015244	147	472	325	0.984848	0.549915
GCA_013030025.1-Pla_JAATIQ010000184.1_i000_008220	147	472	325	0.984848	0.549915
GCA_013030025.1-Pla_JAATIQ010000392.1_i000_018591	147	472	325	0.984848	0.549915
GCA_002906115.4-Pla_PKMF03010682.1_i000_038651	150	468	318	0.963636	0.507987
GCA_013400495.1-Ani_WAAE01018784.1_i000_009210	110	432	322	0.975758	0.693966
GCA_009809945.1-Fun_WTPW01000111.1_i000_003175	119	448	329	0.99697	0.397823
GCA_009982845.1-Fun_JAADKB010000004.1_i000_005948	137	461	324	0.981818	0.605607
GCA_013396525.1-Ani_VWYX01000528.1_i000_006342	112	434	322	0.975758	0.596296
GCA_013399175.1-Ani_VXAB01012447.1_i000_011718	133	445	312	0.945455	0.571429
GCA_000344685.1-Fun_KB469297.1_i000_002456	125	450	325	0.984848	0.574205
GCA_022496205.1-Fun_WTXD01000052.1_i000_009683	131	451	320	0.969697	0.56338
GCA_019649035.1-Ani_BMAT01013298.1_i000_066289	159	490	331	1.00303	0.579685
GCA_002287475.2-Fun_CM008257.1_i000_007524	122	450	328	0.993939	0.589928
GCA_010093995.1-Fun_ML992514.1_i000_008421	130	462	332	1.00606	0.598198
GCA_013399055.1-Ani_WBNM01005192.1_i000_001418	117	440	323	0.978788	0.697624
GCA_017309325.2-Fun_JAESVG020000002.1_i000_002138	132	463	331	1.00303	0.597473
GCA_011058865.1-Fun_SWKW01000188.1_i000_003969	135	463	328	0.993939	0.638132
GCA_000512585.2-Fun_KI894018.1_i000_000114	121	449	328	0.993939	0.564544
GCA_000005925.1-Ani_CH964272.1_i000_012053	125	458	333	1.00909	0.663347
GCA_013397555.1-Ani_VZRH01003520.1_i000_005598	121	437	316	0.957576	0.585185
GCA_013399275.1-Ani_VXAG01000108.1_i000_002723	65	388	323	0.978788	0.787805
GCA_000690535.1-Ani_KK524918.1_i000_009892	117	431	314	0.951515	0.610895
GCA_905250035.1-Ani_CAJNOE010000659.1_i000_033954	112	443	331	1.00303	0.711828
GCA_905332045.1-Ani_CAJOBB010000133.1_i000_003992	112	443	331	1.00303	0.711828
GCA_013399355.1-Ani_VXAJ01000022.1_i000_004711	117	440	323	0.978788	0.699134
GCA_020169575.1-Pla_CM035004.1_i000_016971	119	443	324	0.981818	0.598891
GCA_905250885.1-Ani_CAJNOQ010000118.1_i000_001289	128	473	345	1.04545	0.699797
GCA_905332065.1-Ani_CAJOBC010000118.1_i000_001289	128	473	345	1.04545	0.699797
GCA_905250065.1-Ani_CAJNON010000184.1_i000_018806	166	457	291	0.881818	0.636761
GCA_002307675.1-Fun_KZ293418.1_i000_004317	123	454	331	1.00303	0.642718
GCA_005382405.1-Fun_PTQR01000039.1_i000_004528	131	463	332	1.00606	0.592857
GCA_000507465.3-Fun_KV700054.1_i000_007802	132	459	327	0.990909	0.550505
GCA_000507485.3-Fun_KI669547.1_i000_001050	132	459	327	0.990909	0.550505
GCA_000507885.2-Fun_KV700091.1_i000_006205	132	459	327	0.990909	0.550505
GCA_002104985.1-Fun_MCGO01000039.1_i000_009903	140	471	331	1.00303	0.672764
GCA_013398125.1-Ani_VZRW01001184.1_i000_001240	131	445	314	0.951515	0.615686
GCA_013399365.1-Ani_VWYH01001147.1_i000_001548	108	431	323	0.978788	0.713024
GCA_003194525.1-Pro_NBIV01000102.1_i000_006130	124	460	336	1.01818	0.635161
GCA_001750085.1-Pro_KV784353.1_i000_000251	123	460	337	1.02121	0.649326
GCA_905250095.1-Ani_CAJNOR010008878.1_i000_052920	66	397	331	1.00303	0.789976
GCA_004359215.2-Pro_SHOA02000202.1_i000_008694	119	451	332	1.00606	0.665331
GCA_013399535.1-Ani_VZZW01000126.1_i000_002129	119	442	323	0.978788	0.696121
GCA_000691975.1-Ani_KK718916.1_i000_007415	112	434	322	0.975758	0.625243
GCA_011764045.1-Fun_JAANQQ010002644.1_i000_010897	4	308	304	0.921212	0.856338
GCA_001692735.1-Fun_KV745422.1_i000_011741	134	462	328	0.993939	0.588869
GCA_002897195.1-Pla_BDQV01000255.1_i000_020647	157	484	327	0.990909	0.506192
GCA_000832265.1-Fun_KN840461.1_i000_003070	128	449	321	0.972727	0.572193
GCA_013400295.1-Ani_WAAC01009728.1_i000_005612	122	445	323	0.978788	0.691649
GCA_013401255.1-Ani_WBNH01002161.1_i000_002443	113	436	323	0.978788	0.70524
GCA_905250125.1-Ani_CAJNOL010000197.1_i000_010327	112	443	331	1.00303	0.711828
GCA_905250875.1-Ani_CAJNOO010000425.1_i000_010999	112	443	331	1.00303	0.711828
GCA_905332085.1-Ani_CAJOAX010000178.1_i000_003325	112	443	331	1.00303	0.711828
GCA_004355085.1-Fun_ML170159.1_i000_002742	126	455	329	0.99697	0.616105
GCA_013397655.1-Ani_VYZF01000782.1_i000_007006	123	446	323	0.978788	0.690171
GCA_013397755.1-Ani_VZTF01008143.1_i000_011558	122	438	316	0.957576	0.630739
GCA_003013795.1-Fun_NHZQ01000087.1_i000_007879	133	462	329	0.99697	0.5875
GCA_003942205.1-Fun_RSCE01000014.1_i000_002857	136	473	337	1.02121	0.603943
GCA_001243155.1-Fun_LM651693.1_i000_002589	127	457	330	1	0.705128
GCA_008802855.1-Ani_VVIM01000008.1_i000_011861	127	460	333	1.00909	0.686598
GCA_008802855.1-Ani_VVIM01001705.1_i000_015475	127	460	333	1.00909	0.686598
GCA_013398935.1-Ani_VWPQ01005058.1_i000_006462	130	446	316	0.957576	0.568345
GCA_013397565.1-Ani_VZRJ01008927.1_i000_008523	120	431	311	0.942424	0.624498
GCA_013399335.1-Ani_VZZT01000831.1_i000_006387	65	388	323	0.978788	0.787805
GCA_905331015.1-Ani_CAJNXB010004810.1_i000_027031	130	459	329	0.99697	0.692632
GCA_905331295.1-Ani_CAJNYD010001325.1_i000_010978	130	459	329	0.99697	0.692632
GCA_905331475.1-Ani_CAJNYU010000745.1_i000_007874	130	459	329	0.99697	0.692632
GCA_905331495.1-Ani_CAJNYV010003028.1_i000_017002	130	459	329	0.99697	0.692632
GCA_905332235.1-Ani_CAJOBO010000494.1_i000_009409	130	459	329	0.99697	0.692632
GCA_905332245.1-Ani_CAJOBP010000630.1_i000_006646	130	459	329	0.99697	0.692632
GCA_905332265.1-Ani_CAJOBQ010000976.1_i000_016166	130	459	329	0.99697	0.692632
GCA_905332285.1-Ani_CAJOBS010000393.1_i000_008310	130	459	329	0.99697	0.692632
GCA_900157425.1-Fun_FUEG01000008.1_i000_006380	123	454	331	1.00303	0.623352
GCA_902713445.1-Pla_LR743780.1_i000_006038	115	438	323	0.978788	0.565674
GCA_000488995.1-Fun_AWSO01001070.1_i000_013086	132	458	326	0.987879	0.612782
GCA_013400575.1-Ani_WBNO01010165.1_i000_003977	120	437	317	0.960606	0.632735
GCA_013401015.1-Ani_VZUC01000003.1_i000_000467	122	445	323	0.978788	0.691649
GCA_013400175.1-Ani_VXBQ01016502.1_i000_012301	111	433	322	0.975758	0.70614
GCA_013397155.1-Ani_VWZV01004689.1_i000_003501	118	442	324	0.981818	0.594495
GCA_013390065.1-Ani_WEIW01000504.1_i000_005048	131	447	316	0.957576	0.625743
GCA_008636195.1-Fun_VXIT01000012.1_i000_002359	132	463	331	1.00303	0.64902
GCA_900169345.1-Fun_FWEW01001418.1_i000_003500	132	463	331	1.00303	0.64902
GCA_002174775.1-Pla_MVGT01000924.1_i000_021720	124	443	319	0.966667	0.570662
GCA_000344655.2-Fun_KE504131.1_i000_002984	131	451	320	0.969697	0.561404
GCA_018107945.1-Pla_JACEIK010009659.1_i000_047374	117	441	324	0.981818	0.581688
GCA_013400935.1-Ani_VZTY01002268.1_i000_000780	125	447	322	0.975758	0.651822
GCA_000150975.2-Fun_DS989822.1_i000_007460	130	461	331	1.00303	0.632887
GCA_011503125.2-Fun_WWBZ02000022.1_i000_006471	137	462	325	0.984848	0.622605
GCA_013399155.1-Ani_VWYG01012092.1_i000_006524	123	434	311	0.942424	0.570642
GCA_001600855.1-Fun_BCLC01000014.1_i000_007234	141	470	329	0.99697	0.556684
GCA_013398225.1-Ani_VZSC01010945.1_i000_007746	82	405	323	0.978788	0.75644
GCA_013400155.1-Ani_VXBM01000049.1_i000_001567	112	434	322	0.975758	0.606403
GCA_004307905.1-Fun_ML145118.1_i000_007232	129	462	333	1.00909	0.583187
GCA_013396595.1-Ani_VWZB01000535.1_i000_007827	124	438	314	0.951515	0.570909
GCA_013398625.1-Ani_VZSS01000012.1_i000_012336	120	443	323	0.978788	0.694624
GCA_013398095.1-Ani_VZRY01004162.1_i000_008760	122	439	317	0.960606	0.581651
GCA_905332305.1-Ani_CAJOBU010004361.1_i000_020505	1	284	283	0.857576	0.927869
GCA_020726555.1-Fun_JAHBNH010000004.1_i000_007613	133	462	329	0.99697	0.636364
THUZ001.0722.00001.C001_01898	96	403	307	0.930303	0.73445
GCA_018873745.1-Pro_JAENGY010000178.1_i000_004754	115	451	336	1.01818	0.685714
GCA_004379255.2-Pla_CM031472.1_i000_002090	114	440	326	0.987879	0.674948
GCA_013397775.1-Ani_VZTE01001920.1_i000_004033	120	435	315	0.954545	0.631263
GCA_001020605.1-Fun_KQ085884.1_i000_000848	123	453	330	1	0.541872
GCA_015680905.1-Pla_CM027381.1_i000_021266	132	442	310	0.939394	0.541012
GCA_013400635.1-Ani_VYZP01014234.1_i000_002172	132	447	315	0.954545	0.616438
GCA_013398475.1-Ani_VZSO01000025.1_i000_001260	118	441	323	0.978788	0.697624
GCA_013400585.1-Ani_WEZZ01019288.1_i000_005952	121	442	321	0.972727	0.711752
GCA_013400915.1-Ani_VZTX01005503.1_i000_002114	125	441	316	0.957576	0.625743
GCA_013400955.1-Ani_VZTZ01024241.1_i000_006237	110	433	323	0.978788	0.708333
GCA_002029285.1-Ani_LSYS01005888.1_i000_011377	131	447	316	0.957576	0.583026
GCA_000313135.1-Pro_KB007917.1_i000_005317	121	442	321	0.972727	0.611429
GCA_010015805.1-Fun_ML978125.1_i000_005724	129	463	334	1.01212	0.641075
GCA_018446385.1-Pla_CM031512.1_i000_017039	129	458	329	0.99697	0.597096
GCA_000166175.1-Fun_GL541645.1_i000_000526	132	453	321	0.972727	0.592251
GCA_013396655.1-Ani_WBMV01009146.1_i000_013307	110	432	322	0.975758	0.704595
GCA_000827185.1-Fun_KN839835.1_i000_000723	125	452	327	0.990909	0.579787
GCA_013397465.1-Ani_VYZD01000310.1_i000_006804	110	432	322	0.975758	0.704595
GCA_013397495.1-Ani_VYZC01000081.1_i000_012522	118	440	322	0.975758	0.69697
GCA_905250125.1-Ani_CAJNOL010000629.1_i000_021335	395	723	328	0.993939	0.444444
GCA_013400435.1-Ani_VWYP01015839.1_i000_005947	114	436	322	0.975758	0.594096
GCA_021223945.1-Ani_JAJJHW010000014.1_i000_000802	124	455	331	1.00303	0.679671
GCA_013398175.1-Ani_VZRZ01002289.1_i000_003429	110	433	323	0.978788	0.70989
GCA_019623675.1-Fun_WSTN01000463.1_i000_008618	48	390	342	1.03636	0.732334
GCA_013398535.1-Ani_VZSP01002383.1_i000_011314	111	434	323	0.978788	0.708333
GCA_013401155.1-Ani_VZUF01142662.1_i000_007317	111	434	323	0.978788	0.708333
GCA_000264905.1-Fun_JH687395.1_i000_011378	124	450	326	0.987879	0.619772
GCA_013400655.1-Ani_VYZQ01001037.1_i000_000134	111	433	322	0.975758	0.70614
GCA_013397895.1-Ani_VZRL01001273.1_i000_002596	111	434	323	0.978788	0.708333
GCA_019511825.2-Pla_QFCC02000018.1_i000_018629	122	445	323	0.978788	0.579892
GCA_000258705.1-Pla_AGSI01000004.1_i000_002713	131	444	313	0.948485	0.564982
GCA_013398855.1-Ani_VZTA01017459.1_i000_007822	111	433	322	0.975758	0.70614
GCA_013400445.1-Ani_VXBY01001122.1_i000_006296	114	436	322	0.975758	0.642715
GCA_013398075.1-Ani_VZRX01015541.1_i000_008477	125	440	315	0.954545	0.625
GCA_004307925.1-Fun_ML143409.1_i000_006067	126	459	333	1.00909	0.57913
GCA_013339685.1-Ani_CM023482.1_i000_006742	120	446	326	0.987879	0.607076
GCA_000507365.1-Ani_KI658066.1_i000_003415	150	480	330	1	0.59034
GCA_905261645.1-Ani_CAJNOV010005360.1_i000_012361	125	460	335	1.01515	0.705263
GCA_905273325.1-Ani_CAJNOW010013454.1_i000_024652	125	460	335	1.01515	0.705263
GCA_905319835.1-Ani_CAJNRE010007263.1_i000_015419	125	460	335	1.01515	0.705263
GCA_905321285.1-Ani_CAJNRF010009699.1_i000_022506	125	460	335	1.01515	0.705263
GCA_905321535.1-Ani_CAJNRG010005339.1_i000_013512	125	460	335	1.01515	0.705263
GCA_016865095.1-Pro_RCMR01000037.1_i000_002493	117	452	335	1.01515	0.683673
GCA_016880175.1-Pro_RCMS01000034.1_i000_002099	117	452	335	1.01515	0.683673
GCA_016880985.1-Pro_QOKR01000164.1_i000_005515	117	452	335	1.01515	0.683673
GCA_905250065.1-Ani_CAJNON010000573.1_i000_032000	112	443	331	1.00303	0.711828
GCA_905332035.1-Ani_CAJOAY010000485.1_i000_010767	112	443	331	1.00303	0.711828
GCA_000697665.1-Fun_KL197709.1_i000_001133	136	455	319	0.966667	0.553819
GCA_019973155.1-Fun_BPQB01000001.1_i000_000823	139	453	314	0.951515	0.569873
GCA_004307915.1-Fun_ML143900.1_i000_005438	134	459	325	0.984848	0.571178
GCA_000699085.1-Ani_KL218130.1_i000_007294	110	432	322	0.975758	0.707692
GCA_013396855.1-Ani_VWZJ01010746.1_i000_010187	110	434	324	0.981818	0.710526
GCA_905332245.1-Ani_CAJOBP010006313.1_i000_025573	125	457	332	1.00606	0.688797
GCA_905332285.1-Ani_CAJOBS010000483.1_i000_009635	125	457	332	1.00606	0.688797
GCA_018446385.1-Pla_CM031527.1_i000_070654	117	441	324	0.981818	0.565445
GCA_905331015.1-Ani_CAJNXB010004198.1_i000_024326	126	458	332	1.00606	0.687371
GCA_905331295.1-Ani_CAJNYD010001586.1_i000_013020	126	458	332	1.00606	0.687371
GCA_905331475.1-Ani_CAJNYU010000512.1_i000_006145	126	458	332	1.00606	0.687371
GCA_905331485.1-Ani_CAJNYT010003893.1_i000_023165	126	458	332	1.00606	0.687371
GCA_905331495.1-Ani_CAJNYV010005372.1_i000_029028	126	458	332	1.00606	0.687371
GCA_905332235.1-Ani_CAJOBO010000607.1_i000_010837	126	458	332	1.00606	0.687371
GCA_905332265.1-Ani_CAJOBQ010000660.1_i000_012787	126	458	332	1.00606	0.687371
GCA_905332275.1-Ani_CAJOBR010000466.1_i000_005583	126	458	332	1.00606	0.687371
GCA_013398715.1-Ani_VZSU01000133.1_i000_001105	116	439	323	0.978788	0.700651
GCA_013398875.1-Ani_VYZK01000041.1_i000_002086	116	439	323	0.978788	0.700651
GCA_000757645.3-Ani_AZBU02000003.1_i000_014628	12	344	332	1.00606	0.873684
GCA_013401095.1-Ani_WBNP01003455.1_i000_007454	116	439	323	0.978788	0.700651
GCA_013396355.1-Ani_VWPS01000135.1_i000_001741	116	438	322	0.975758	0.698482
GCA_013396575.1-Ani_VWYZ01000013.1_i000_001387	117	440	323	0.978788	0.699134
GCA_003675995.1-Ani_NCKU01005291.1_i000_013036	141	460	319	0.966667	0.591837
GCA_013399855.1-Ani_VXAY01000699.1_i000_001211	117	432	315	0.954545	0.587687
GCA_013400035.1-Ani_VXBH01007413.1_i000_010294	120	439	319	0.966667	0.655031
GCA_013398245.1-Ani_VZSD01011889.1_i000_008823	124	434	310	0.939394	0.569853
GCA_013399945.1-Ani_VXBC01009940.1_i000_010081	120	436	316	0.957576	0.586271
GCA_013396555.1-Ani_VZRD01000025.1_i000_005038	122	444	322	0.975758	0.689507
GCA_013400395.1-Ani_WBNN01018653.1_i000_006040	120	437	317	0.960606	0.584871
GCA_000709895.1-Ani_KL493517.1_i000_007336	119	437	318	0.963636	0.615087
GCA_013390005.1-Ani_WEIV01006667.1_i000_002509	118	441	323	0.978788	0.697624
GCA_006352295.1-Fun_SOZI01000030.1_i000_004379	127	455	328	0.993939	0.600733
GCA_013398775.1-Ani_VZSX01000144.1_i000_002486	121	441	320	0.969697	0.686695
GCA_005239225.1-Pla_RCHU01000222.1_i000_012560	117	439	322	0.975758	0.572954
GCA_018804465.1-Pla_CM031976.1_i000_041303	117	439	322	0.975758	0.572954
GCA_013396455.1-Ani_VWYV01000175.1_i000_003880	129	439	310	0.939394	0.569853
GCA_018127085.1-Fun_CM030720.1_i000_000021	135	457	322	0.975758	0.604128
GCA_008932095.1-Pla_CM018516.1_i000_027358	114	442	328	0.993939	0.596364
GCA_019787685.1-Fun_JAHNUO010000002.1_i000_001239	123	454	331	1.00303	0.578671
GCA_013397095.1-Ani_VWZU01013077.1_i000_008455	117	442	325	0.984848	0.606343
GCA_013398405.1-Ani_VZSJ01003637.1_i000_008360	121	444	323	0.978788	0.693133
GCA_013398745.1-Ani_VZSY01000070.1_i000_003029	122	445	323	0.978788	0.691649
GCA_019512045.2-Pla_QIYW02000007.1_i000_017135	120	441	321	0.972727	0.577338
GCA_013397135.1-Ani_VYXB01002302.1_i000_002906	129	445	316	0.957576	0.622047
GCA_000710305.1-Ani_KL534676.1_i000_010922	114	433	319	0.966667	0.624266
GCA_004379255.2-Pla_CM031473.1_i000_005398	114	441	327	0.990909	0.592391
GCA_013339765.1-Ani_CM023450.1_i000_007852	112	443	331	1.00303	0.6141
GCA_013397825.1-Ani_VZRK01000015.1_i000_001112	123	445	322	0.975758	0.688034
GCA_013398495.1-Ani_WBNB01000197.1_i000_010678	115	439	324	0.981818	0.70282
GCA_000512255.2-Pla_CM008457.1_i000_007871	12	332	320	0.969697	0.742459
GCA_002287475.2-Fun_CM008253.1_i000_003162	117	452	335	1.01515	0.602518
GCA_013398815.1-Ani_VZSZ01008375.1_i000_009521	136	450	314	0.951515	0.628
GCA_013398115.1-Ani_VZRV01007336.1_i000_008839	123	445	322	0.975758	0.688034
GCA_021613535.1-Ani_CP075495.1_i000_009024	133	460	327	0.990909	0.682672
GCA_905368565.1-Ani_CAJPIZ010004518.1_i000_007465	85	375	290	0.878788	0.773333
GCA_021223965.1-Ani_JAJJHZ010000276.1_i000_000605	144	472	328	0.993939	0.648221
GCA_013400735.1-Ani_VYZT01023780.1_i000_004996	119	436	317	0.960606	0.634
GCA_013390045.1-Ani_WEKY01010189.1_i000_002311	132	449	317	0.960606	0.620352
GCA_010799875.2-Ani_VXIV02001497.1_i000_014440	960	1270	310	0.939394	0.22912
GCA_000690775.1-Ani_JJRO01060273.1_i000_006766	114	432	318	0.963636	0.621094
GCA_013389825.1-Ani_VWPW01019556.1_i000_008057	123	443	320	0.969697	0.686695
GCA_013389845.1-Ani_VWPX01006284.1_i000_004050	123	443	320	0.969697	0.686695
GCA_022376555.1-Fun_WTXH01000045.1_i000_007274	127	449	322	0.975758	0.554217
GCA_004303085.2-Pla_SDAM02000098.1_i000_007693	123	440	317	0.960606	0.570144
GCA_013398835.1-Ani_VYZJ01000167.1_i000_003796	116	440	324	0.981818	0.701299
GCA_002240705.1-Fun_NPHW01004850.1_i000_004792	131	461	330	1	0.397112
GCA_004918915.1-Fun_SPRN01000087.1_i000_004095	124	459	335	1.01515	0.612431
GCA_004918325.1-Fun_SPNW01000006.1_i000_002874	127	454	327	0.990909	0.595628
GCA_013397715.1-Ani_WBNL01000009.1_i000_000648	121	443	322	0.975758	0.690987
GCA_001632365.1-Fun_KV427605.1_i000_000678	132	455	323	0.978788	0.560764
GCA_002105025.1-Fun_MCFA01000082.1_i000_014593	134	463	329	0.99697	0.612663
GCA_013400975.1-Ani_WBMZ01003116.1_i000_002598	123	446	323	0.978788	0.690171
GCA_013397235.1-Ani_VYXG01005935.1_i000_006930	124	446	322	0.975758	0.631373
GCA_013396815.1-Ani_WBMX01000086.1_i000_000479	83	409	326	0.987879	0.695096
GCA_019623665.1-Fun_WSTM01000257.1_i000_005307	63	400	337	1.02121	0.707983
GCA_019627745.1-Fun_WSTR01000437.1_i000_008843	63	400	337	1.02121	0.707983
GCA_012295175.1-Pro_WSZM01000706.1_i000_017315	115	449	334	1.01212	0.673387
GCA_012552325.1-Pro_JAACNO010000465.1_i000_003351	115	449	334	1.01212	0.673387
GCA_012552325.1-Pro_JAACNO010000465.1_i000_003358	115	449	334	1.01212	0.673387
GCA_013400775.1-Ani_VZTR01002113.1_i000_000863	123	445	322	0.975758	0.688034
GCA_004917965.1-Fun_SPRO01000084.1_i000_004088	124	456	332	1.00606	0.606947
GCA_004918665.1-Fun_SPRB01000088.1_i000_004095	124	456	332	1.00606	0.606947
GCA_004918795.1-Fun_SPRH01000090.1_i000_004104	124	456	332	1.00606	0.606947
GCA_004919005.1-Fun_SPRX01000090.1_i000_004133	124	456	332	1.00606	0.606947
GCA_004918075.1-Fun_SPRL01000079.1_i000_004021	124	456	332	1.00606	0.606947
GCA_004918605.1-Fun_SPRK01000089.1_i000_004126	124	456	332	1.00606	0.606947
GCA_004918725.1-Fun_SPRT01000102.1_i000_000473	124	456	332	1.00606	0.606947
GCA_004918905.1-Fun_SPRC01000082.1_i000_004061	124	456	332	1.00606	0.606947
GCA_003287315.1-Pro_MJFZ01000345.1_i000_012577	115	451	336	1.01818	0.685714
GCA_016864635.1-Pro_RCME01000153.1_i000_006526	115	451	336	1.01818	0.685714
GCA_016864655.1-Pro_NHQK01000085.1_i000_027508	115	451	336	1.01818	0.685714
GCA_016864665.1-Pro_RCMF01000765.1_i000_017457	115	451	336	1.01818	0.685714
GCA_016864695.1-Pro_RCMG01000133.1_i000_006437	115	451	336	1.01818	0.685714
GCA_016864715.1-Pro_RCMK01000165.1_i000_007865	115	451	336	1.01818	0.685714
GCA_016864735.1-Pro_RCMI01000118.1_i000_005602	115	451	336	1.01818	0.685714
GCA_016864755.1-Pro_RCMH01000159.1_i000_007879	115	451	336	1.01818	0.685714
GCA_016864775.1-Pro_RCMO01000543.1_i000_015801	115	451	336	1.01818	0.685714
GCA_016864795.1-Pro_RCMN01000079.1_i000_004191	115	451	336	1.01818	0.685714
GCA_016864815.1-Pro_RCML01000391.1_i000_012275	115	451	336	1.01818	0.685714
GCA_016864835.1-Pro_RCMM01000755.1_i000_018466	115	451	336	1.01818	0.685714
GCA_016864855.1-Pro_RCMP01000759.1_i000_017132	115	451	336	1.01818	0.685714
GCA_016865055.1-Pro_RCMV01000774.1_i000_015985	115	451	336	1.01818	0.685714
GCA_016865075.1-Pro_RCMT01000773.1_i000_024836	115	451	336	1.01818	0.685714
GCA_016865085.1-Pro_RCMU01000087.1_i000_026162	115	451	336	1.01818	0.685714
GCA_016906365.1-Pro_RCMQ01000138.1_i000_006424	115	451	336	1.01818	0.685714
GCA_017309695.1-Pro_RCMJ01000047.1_i000_004212	115	451	336	1.01818	0.685714
GCA_018873755.1-Pro_JAENGZ010000209.1_i000_006503	115	451	336	1.01818	0.685714
GCA_013396365.1-Ani_VWPP01000163.1_i000_002933	124	437	313	0.948485	0.574312
GCA_002116315.1-Fun_KZ107851.1_i000_008817	138	464	326	0.987879	0.629344
GCA_019721275.1-Fun_JAASLF010000028.1_i000_004579	138	464	326	0.987879	0.629344
GCA_013398885.1-Ani_VYZL01000186.1_i000_000381	133	448	315	0.954545	0.614035
GCA_004917975.1-Fun_SPRM01000083.1_i000_004071	126	456	330	1	0.606618
GCA_004918005.1-Fun_SPRU01000089.1_i000_004116	126	456	330	1	0.606618
GCA_004918515.1-Fun_SPRA01000087.1_i000_004115	126	456	330	1	0.606618
GCA_004918635.1-Fun_SPRD01000084.1_i000_004095	126	456	330	1	0.606618
GCA_004918645.1-Fun_SPRE01000085.1_i000_004128	126	456	330	1	0.606618
GCA_004918805.1-Fun_SPRR01000083.1_i000_004082	126	456	330	1	0.606618
GCA_004918985.1-Fun_SPRS01000083.1_i000_004075	126	456	330	1	0.606618
GCA_010093585.1-Fun_MU001788.1_i000_002974	133	461	328	0.993939	0.628352
GCA_000263375.1-Fun_JH668230.1_i000_002489	126	456	330	1	0.606618
GCA_004918525.1-Fun_SPRF01000088.1_i000_004130	126	456	330	1	0.606618
GCA_004918995.1-Fun_SPRY01000090.1_i000_004128	126	456	330	1	0.606618
GCA_013398735.1-Ani_VZSV01000046.1_i000_009131	123	443	320	0.969697	0.683761
GCA_010015565.1-Fun_ML975945.1_i000_002488	137	461	324	0.981818	0.582734
GCA_910592325.1-Fun_CAJVPM010010450.1_i000_005924	122	450	328	0.993939	0.595281
GCA_905250015.1-Ani_CAJNOM010000577.1_i000_043807	112	443	331	1.00303	0.711828
GCA_905250115.1-Ani_CAJNOI010000008.1_i000_003616	112	443	331	1.00303	0.711828
GCA_902602495.3-Pro_CACKRE030000537.1_i000_004519	129	468	339	1.02727	0.700413
GCA_000006335.3-Fun_GG692397.1_i000_003005	128	450	322	0.975758	0.624031
GCA_017315405.1-Fun_JAFIQD010000003.1_i000_003589	128	450	322	0.975758	0.624031
GCA_013400715.1-Ani_VZTP01012041.1_i000_003575	118	442	324	0.981818	0.594495
GCA_013396465.1-Ani_VWYW01000004.1_i000_000374	130	448	318	0.963636	0.625984
GCA_020809275.1-Ani_SDOV01000004.1_i000_004446	139	466	327	0.990909	0.652695
GCA_000328475.2-Fun_CM003161.1_i000_006614	128	458	330	1	0.630975
GCA_013398555.1-Ani_VZSQ01000063.1_i000_005407	118	440	322	0.975758	0.695464
GCA_013401115.1-Ani_VZUG01013387.1_i000_004533	123	445	322	0.975758	0.688034
GCA_010093895.1-Fun_ML996083.1_i000_003675	137	460	323	0.978788	0.558824
GCA_013397795.1-Ani_VZTJ01001571.1_i000_003647	120	435	315	0.954545	0.583333
GCA_000763605.2-Pla_JRKL02004283.1_i000_021541	124	442	318	0.963636	0.527363
GCA_004918155.1-Fun_SPRG01000085.1_i000_004127	124	454	330	1	0.596745
GCA_013399595.1-Ani_VXAP01000601.1_i000_010083	123	445	322	0.975758	0.688034
GCA_001720205.1-Fun_AWGJ01000006.1_i000_006389	135	469	334	1.01212	0.592199
GCA_000517465.1-Fun_AWNI01000004.1_i000_000751	123	460	337	1.02121	0.624074
GCA_005498985.1-Fun_CM016681.1_i000_006077	128	459	331	1.00303	0.6341
GCA_013399555.1-Ani_VZZV01000649.1_i000_011162	123	445	322	0.975758	0.688034
GCA_013390085.1-Ani_WEIX01012545.1_i000_010173	121	444	323	0.978788	0.693133
GCA_013399815.1-Ani_VZZX01007702.1_i000_008600	118	440	322	0.975758	0.695464
GCA_000692015.2-Ani_KL672766.1_i000_011440	106	430	324	0.981818	0.636542
GCA_010078415.1-Ani_VUKZ01002993.1_i000_002650	27	349	322	0.975758	0.867925
GCA_013397355.1-Ani_VXBE01010303.1_i000_010821	121	434	313	0.948485	0.57963
GCA_001720235.1-Fun_MEKH01000006.1_i000_006160	135	470	335	1.01515	0.587719
GCA_000142945.1-Pro_DS028132.1_i000_009509	138	472	334	1.01212	0.643545
GCA_004917925.1-Fun_SPRI01000081.1_i000_004061	125	453	328	0.993939	0.596364
GCA_004917935.1-Fun_SPRJ01000088.1_i000_004135	125	453	328	0.993939	0.596364
GCA_004918025.1-Fun_SPRV01000019.1_i000_001228	125	453	328	0.993939	0.596364
GCA_004918485.1-Fun_SPRQ01000079.1_i000_003957	125	453	328	0.993939	0.596364
GCA_004918835.1-Fun_SPRW01000084.1_i000_004072	125	453	328	0.993939	0.596364
GCA_004115005.2-Pla_CM032139.1_i000_008562	118	442	324	0.981818	0.588022
GCA_001720155.1-Fun_AWGH01000017.1_i000_002315	135	470	335	1.01515	0.597148
GCA_008355005.1-Fun_NIDF01000106.1_i000_000514	135	470	335	1.01515	0.597148
GCA_013398995.1-Ani_VWYE01016862.1_i000_007691	108	430	322	0.975758	0.710817
GCA_013389905.1-Ani_WEKW01020018.1_i000_007746	120	435	315	0.954545	0.62253
GCA_000695815.1-Ani_KK828678.1_i000_002558	111	434	323	0.978788	0.628405
GCA_001691775.3-Fun_JNHW02000036.1_i000_004949	136	456	320	0.969697	0.547945
GCA_910591925.1-Fun_CAJVPW010006173.1_i000_005784	121	459	338	1.02424	0.660156
GCA_008932095.1-Pla_CM018516.1_i000_027615	114	442	328	0.993939	0.595281
GCA_000690835.1-Ani_KK595040.1_i000_004672	116	435	319	0.966667	0.619417
GCA_000310025.1-Pro_FN649748.1_i000_009442	129	461	332	1.00606	0.68595
GCA_019845555.1-Pla_CM034080.1_i000_010863	126	440	314	0.951515	0.543253
GCA_002215705.1-Fun_AMKS01000024.1_i000_002980	135	467	332	1.00606	0.578397
GCA_002222155.1-Fun_APKL01000265.1_i000_001835	135	467	332	1.00606	0.578397
GCA_002222385.1-Fun_AMKN01000067.1_i000_004994	135	467	332	1.00606	0.578397
GCA_020800215.1-Pro_JAICDV010000001.1_i000_000473	115	449	334	1.01212	0.678862
GCA_020800235.1-Pro_JAICDX010000005.1_i000_006626	115	449	334	1.01212	0.678862
GCA_000320605.2-Fun_KB445792.1_i000_001920	125	444	319	0.966667	0.712054
GCA_000692075.1-Ani_KK735554.1_i000_009945	113	436	323	0.978788	0.702174
GCA_013397935.1-Ani_VZRN01005202.1_i000_010834	115	432	317	0.960606	0.635271
GCA_013399755.1-Ani_VZTK01011587.1_i000_004976	65	388	323	0.978788	0.787805
GCA_001632445.1-Fun_KV424513.1_i000_006378	129	451	322	0.975758	0.560976
GCA_003144125.1-Fun_KZ819191.1_i000_003003	127	458	331	1.00303	0.61985
GCA_001600855.1-Fun_BCLC01000009.1_i000_005022	131	463	332	1.00606	0.61825
GCA_013400095.1-Ani_VXBK01005364.1_i000_005871	123	446	323	0.978788	0.690171
GCA_000687265.1-Ani_KK407664.1_i000_001536	119	425	306	0.927273	0.594175
GCA_000385595.1-Fun_KB916521.1_i000_007267	126	460	334	1.01212	0.643545
GCA_905250015.1-Ani_CAJNOM010000498.1_i000_041463	112	443	331	1.00303	0.711828
GCA_002897355.1-Pro_BEYU01000135.1_i000_009131	116	447	331	1.00303	0.617537
GCA_013400195.1-Ani_VXBL01003409.1_i000_004964	117	435	318	0.963636	0.585635
GCA_000695765.1-Ani_KK822169.1_i000_012061	121	435	314	0.951515	0.60735
GCA_004369135.1-Fun_ML179189.1_i000_012844	124	457	333	1.00909	0.608775
GCA_900002365.1-Fun_LK056670.1_i000_002926	128	459	331	1.00303	0.635317
GCA_013398035.1-Ani_VZRT01000577.1_i000_004848	118	435	317	0.960606	0.635271
GCA_905332145.1-Ani_CAJOBF010001546.1_i000_013954	111	448	337	1.02121	0.727862
GCA_905332155.1-Ani_CAJOBG010001189.1_i000_009686	111	448	337	1.02121	0.727862
GCA_001243155.1-Fun_LM651686.1_i000_002435	123	460	337	1.02121	0.582038
GCA_900002365.1-Fun_LK056657.1_i000_005427	123	460	337	1.02121	0.582038
GCA_004332605.1-Fun_RWJN01000020.1_i000_003175	132	454	322	0.975758	0.561955
GCA_006013705.1-Pla_RXGB01000505.1_i000_002890	119	447	328	0.993939	0.638132
GCA_006381635.2-Pla_VEPZ02001081.1_i000_041068	122	440	318	0.963636	0.566845
GCA_900162835.1-Fun_LT795075.1_i000_000258	127	459	332	1.00606	0.64466
GCA_016906555.1-Fun_CP059646.1_i000_005523	126	454	328	0.993939	0.608534
GCA_016906575.1-Fun_CP059614.1_i000_005595	126	454	328	0.993939	0.608534
GCA_018446385.1-Pla_CM031526.1_i000_067747	191	513	322	0.975758	0.497682
GCA_013400375.1-Ani_VXBW01004283.1_i000_006785	120	443	323	0.978788	0.694624
GCA_000687205.1-Ani_KK378771.1_i000_003526	114	412	298	0.90303	0.719807
GCA_000143415.2-Pla_GL377578.1_i000_009987	116	443	327	0.990909	0.568696
GCA_013398295.1-Ani_VZSF01000770.1_i000_000996	123	446	323	0.978788	0.690171
GCA_013397515.1-Ani_VZRI01001158.1_i000_001007	120	434	314	0.951515	0.629259
GCA_000292625.1-Fun_JH795860.1_i000_003712	126	459	333	1.00909	0.611009
GCA_013399655.1-Ani_VXAS01014328.1_i000_008352	115	435	320	0.969697	0.592593
GCA_002092935.1-Fun_KZ084150.1_i000_011318	121	450	329	0.99697	0.605893
GCA_003851025.1-Fun_BFAD01000002.1_i000_002066	136	450	314	0.951515	0.541379
GCA_010015675.1-Fun_ML976991.1_i000_007358	130	460	330	1	0.638298
GCA_010093785.1-Fun_MU003849.1_i000_009157	134	466	332	1.00606	0.603636
GCA_013398435.1-Ani_VZSL01000115.1_i000_000733	120	444	324	0.981818	0.695279
GCA_000585585.1-Fun_AMWN01000002.1_i000_002115	130	460	330	1	0.638298
GCA_013399035.1-Ani_VWYF01019636.1_i000_006744	121	436	315	0.954545	0.628743
GCA_005059885.1-Fun_NAJL01000006.1_i000_006826	133	466	333	1.00909	0.595707
GCA_013399695.1-Ani_VXAU01003312.1_i000_007156	113	431	318	0.963636	0.596623
GCA_016906575.1-Fun_CP059630.1_i000_020406	126	454	328	0.993939	0.607407
GCA_017499595.2-Fun_CM039001.1_i000_005147	127	455	328	0.993939	0.574431
GCA_000696525.1-Pla_KK915213.1_i000_023813	123	440	317	0.960606	0.549393
GCA_011057915.1-Ani_RZID01001378.1_i000_001260	111	430	319	0.966667	0.626719
GCA_006536005.1-Fun_QEAQ01000001.1_i000_000205	119	447	328	0.993939	0.621212
GCA_013397845.1-Ani_VZTG01008348.1_i000_010846	118	434	316	0.957576	0.633267
GCA_003843895.1-Pro_QKXF01000123.1_i000_002591	114	451	337	1.02121	0.68357
GCA_021491655.1-Pro_CP090810.1_i000_009333	114	451	337	1.02121	0.68357
GCA_015883425.1-Ani_JADDUC010000099.1_i000_014231	6	271	265	0.80303	0.732044
GCA_015883425.1-Ani_JADDUC010000099.1_i000_014231	322	362	40	0.121212	0.110497
GCA_905329745.1-Ani_CAJNSZ010000021.1_i000_009205	132	459	327	0.990909	0.67562
GCA_905332165.1-Ani_CAJOBK010002172.1_i000_016652	132	459	327	0.990909	0.67562
GCA_013396735.1-Ani_VWZG01010250.1_i000_010232	112	435	323	0.978788	0.591575
GCA_013400675.1-Ani_VYZR01058383.1_i000_002700	116	438	322	0.975758	0.710817
GCA_013397215.1-Ani_VYXE01005553.1_i000_003062	121	440	319	0.966667	0.588561
GCA_000698965.1-Ani_KL206820.1_i000_011782	113	432	319	0.966667	0.620623
GCA_013397175.1-Ani_VYXC01003289.1_i000_003092	112	434	322	0.975758	0.596296
GCA_000687285.1-Ani_KK451937.1_i000_006009	117	437	320	0.969697	0.623782
GCA_013399435.1-Ani_VXAK01027257.1_i000_013063	123	436	313	0.948485	0.585047
GCA_013399915.1-Ani_VXBB01009691.1_i000_005337	118	433	315	0.954545	0.63253
GCA_900005825.1-Ani_CVRI01000040.1_i000_008298	116	445	329	0.99697	0.605893
GCA_000705375.2-Ani_KL893085.1_i000_008099	111	433	322	0.975758	0.624031
GCA_000143455.1-Pla_GL378324.1_i000_000860	128	445	317	0.960606	0.602662
GCA_013399415.1-Ani_VWYJ01026547.1_i000_009898	119	435	316	0.957576	0.630739
GCA_013401135.1-Ani_VZUI01059719.1_i000_010589	122	445	323	0.978788	0.690171
GCA_015501535.1-Fun_JADNRW010000019.1_i000_007806	132	452	320	0.969697	0.566372
GCA_013399515.1-Ani_VXAN01000010.1_i000_011636	121	444	323	0.978788	0.693133
GCA_021613535.1-Ani_CP075493.1_i000_002057	112	443	331	1.00303	0.711828
GCA_000687185.1-Ani_KK502039.1_i000_011037	112	437	325	0.984848	0.631068
GCA_013396715.1-Ani_VWZC01014015.1_i000_012082	126	446	320	0.969697	0.627451
GCA_013399095.1-Ani_VWZZ01005823.1_i000_009261	123	432	309	0.936364	0.576493
GCA_017499595.2-Fun_CM039003.1_i000_007221	121	456	335	1.01515	0.628518
GCA_014461135.1-Fun_JACAZF010000009.1_i000_010176	124	451	327	0.990909	0.632495
GCA_004679265.1-Fun_SEKV01000283.1_i000_004657	131	451	320	0.969697	0.564374
GCA_022264815.1-Fun_JADCUA010000001.1_i000_000228	131	451	320	0.969697	0.564374
GCA_013401195.1-Ani_VZSW01000041.1_i000_001776	121	437	316	0.957576	0.630739
GCA_000337935.2-Ani_AKCR02000142.1_i000_011758	131	448	317	0.960606	0.414921
GCA_015501055.1-Fun_JADNYV010000002.1_i000_006721	128	464	336	1.01818	0.635161
GCA_013399795.1-Ani_VWYL01008696.1_i000_003716	118	434	316	0.957576	0.634538
GCA_022376525.1-Fun_WTXL01000115.1_i000_001476	97	427	330	1	0.75
GCA_013398675.1-Ani_WBNF01000164.1_i000_012217	118	440	322	0.975758	0.695464
GCA_013397435.1-Ani_VZRG01002786.1_i000_010264	115	435	320	0.969697	0.602637
GCA_003942215.1-Fun_RSCD01000001.1_i000_000265	131	463	332	1.00606	0.571429
GCA_000151685.2-Pla_EQ973777.1_i000_027986	124	441	317	0.960606	0.551304
GCA_013401035.1-Ani_VZUA01072535.1_i000_004466	119	441	322	0.975758	0.693966
GCA_003704535.1-Pro_QLLG01000197.1_i000_002014	111	451	340	1.0303	0.689655
GCA_020796215.1-Pla_CM036787.1_i000_013976	115	441	326	0.987879	0.582143
GCA_020496765.1-Pla_CM035632.1_i000_045252	123	441	318	0.963636	0.56383
GCA_000143415.2-Pla_GL377631.1_i000_025179	116	444	328	0.993939	0.569444
GCA_013398375.1-Ani_VZSI01000014.1_i000_000435	124	446	322	0.975758	0.686567
GCA_013398635.1-Ani_WBNE01000045.1_i000_001111	115	439	324	0.981818	0.70282
GCA_013400315.1-Ani_VXBU01006960.1_i000_005112	111	434	323	0.978788	0.708333
GCA_013399895.1-Ani_VXBA01002855.1_i000_006418	115	435	320	0.969697	0.597015
GCA_002197715.1-Ani_MUZQ01000099.1_i000_015237	128	445	317	0.960606	0.601518
GCA_013398795.1-Ani_WBNG01000075.1_i000_002877	123	446	323	0.978788	0.690171
GCA_013398275.1-Ani_VZSE01006401.1_i000_005440	122	445	323	0.978788	0.691649
GCA_013399635.1-Ani_VXAQ01000094.1_i000_002688	118	440	322	0.975758	0.695464
GCA_900323505.1-Fun_OOIN01000038.1_i000_011781	128	458	330	1	0.633397
GCA_013396505.1-Ani_VZRC01000215.1_i000_004696	130	442	312	0.945455	0.615385
GCA_001687445.1-Fun_KV722333.1_i000_000718	133	453	320	0.969697	0.566372
GCA_015501585.1-Fun_JADNRY010000006.1_i000_018269	137	447	310	0.939394	0.547703
GCA_013397325.1-Ani_VZTC01002365.1_i000_002953	120	437	317	0.960606	0.584871
GCA_013399075.1-Ani_VWZY01010702.1_i000_009536	119	434	315	0.954545	0.583333
GCA_008632915.2-Pla_AP019302.1_i000_017760	17	341	324	0.981818	0.72809
GCA_004837865.1-Pla_CM017198.1_i000_029552	117	439	322	0.975758	0.550427
GCA_001563735.1-Fun_KQ963224.1_i000_011160	129	458	329	0.99697	0.613806
GCA_018688675.1-Pla_MU228986.1_i000_032954	135	461	326	0.987879	0.592727
GCA_013397395.1-Ani_VXBN01015726.1_i000_012462	115	437	322	0.975758	0.607547
GCA_000690875.1-Ani_KK625057.1_i000_005205	113	411	298	0.90303	0.72155
GCA_016584305.1-Ani_JACEEZ010021476.1_i000_016482	120	455	335	1.01515	0.563025
GCA_013400075.1-Ani_VWYN01017802.1_i000_008181	118	433	315	0.954545	0.583333
GCA_013400855.1-Ani_VZTT01036377.1_i000_004123	118	440	322	0.975758	0.695464
GCA_905332165.1-Ani_CAJOBK010015936.1_i000_042920	1	299	298	0.90303	0.93125
GCA_905332175.1-Ani_CAJOBL010024350.1_i000_044722	1	299	298	0.90303	0.93125
GCA_905332185.1-Ani_CAJOBM010026551.1_i000_041256	1	299	298	0.90303	0.93125
GCA_019627725.1-Fun_WSTQ01000155.1_i000_002416	128	460	332	1.00606	0.6171
GCA_019627735.1-Fun_WSTP01000305.1_i000_006466	128	460	332	1.00606	0.6171
GCA_019633565.1-Fun_WSUH01000151.1_i000_002040	128	460	332	1.00606	0.6171
GCA_013398685.1-Ani_VZST01000376.1_i000_003541	115	439	324	0.981818	0.70282
GCA_000230245.1-Fun_FQ311444.1_i000_006482	128	459	331	1.00303	0.628083
GCA_013399935.1-Ani_VWYM01004336.1_i000_002197	120	443	323	0.978788	0.694624
GCA_020796205.1-Pla_CM036891.1_i000_004540	176	500	324	0.981818	0.491654
GCA_003711565.2-Ani_CM011072.1_i000_005141	128	478	350	1.06061	0.59322
GCA_000328475.2-Fun_CM003145.1_i000_002989	126	459	333	1.00909	0.572165
GCA_001187945.1-Ani_JRES01000310.1_i000_004217	125	457	332	1.00606	0.661355
GCA_008009225.1-Pla_CM017762.1_i000_003100	114	432	318	0.963636	0.724374
GCA_000691405.1-Ani_KK649042.1_i000_003552	123	439	316	0.957576	0.611219
GCA_004369045.1-Fun_ML213504.1_i000_002276	125	449	324	0.981818	0.567426
GCA_000149845.2-Fun_KE651166.1_i000_000248	142	463	321	0.972727	0.648485
GCA_013400615.1-Ani_VZTO01018817.1_i000_008911	55	186	131	0.39697	0.255859
GCA_013400615.1-Ani_VZTO01018817.1_i000_008911	203	414	211	0.639394	0.412109
GCA_002077065.1-Fun_NAJO01000043.1_i000_012964	137	467	330	1	0.587189
GCA_905330235.1-Ani_CAJNUA010000021.1_i000_009083	132	457	325	0.984848	0.670103
GCA_905330535.1-Ani_CAJNVN010000021.1_i000_009063	132	457	325	0.984848	0.670103
GCA_905332175.1-Ani_CAJOBL010010329.1_i000_030774	132	457	325	0.984848	0.670103
GCA_015039355.1-Fun_MU134386.1_i000_008834	130	452	322	0.975758	0.560976
GCA_018258275.1-Pla_CM031114.1_i000_048431	117	441	324	0.981818	0.591241
GCA_010078445.1-Ani_VULE01001562.1_i000_001833	120	443	323	0.978788	0.694624
GCA_010078485.1-Ani_VULA01000650.1_i000_000796	120	443	323	0.978788	0.694624
GCA_010080425.1-Ani_VULF01010304.1_i000_009747	120	443	323	0.978788	0.694624
GCA_010082375.1-Ani_VULI01016291.1_i000_012395	120	443	323	0.978788	0.694624
GCA_010084205.1-Ani_VULJ01006091.1_i000_006940	120	443	323	0.978788	0.694624
GCA_010085315.1-Ani_VULG01044751.1_i000_011054	120	443	323	0.978788	0.694624
GCA_010085335.1-Ani_VULH01002953.1_i000_000563	120	443	323	0.978788	0.694624
GCA_010085355.1-Ani_VULL01001210.1_i000_005075	120	443	323	0.978788	0.694624
GCA_010085365.1-Ani_VULK01000684.1_i000_007581	120	443	323	0.978788	0.694624
GCA_010090195.1-Ani_VUKY01007200.1_i000_005789	120	443	323	0.978788	0.694624
GCA_900005825.1-Ani_CVRI01000055.1_i000_014187	133	458	325	0.984848	0.6238
GCA_905331505.1-Ani_CAJNYZ010004361.1_i000_035505	1	301	300	0.909091	0.923077
GCA_905331525.1-Ani_CAJNZF010002559.1_i000_032782	1	301	300	0.909091	0.923077
GCA_905332305.1-Ani_CAJOBU010019135.1_i000_037167	1	301	300	0.909091	0.923077
GCA_905332315.1-Ani_CAJOBV010007267.1_i000_030405	1	301	300	0.909091	0.923077
GCA_002245835.2-Pla_LHPG02000008.1_i000_009005	120	445	325	0.984848	0.633528
GCA_010080355.1-Ani_VULC01000331.1_i000_000328	111	434	323	0.978788	0.708333
GCA_010080465.1-Ani_VULD01005650.1_i000_006193	111	434	323	0.978788	0.708333
GCA_000697665.1-Fun_KL197711.1_i000_003188	123	455	332	1.00606	0.613678
GCA_013400135.1-Ani_VXBO01004505.1_i000_004008	122	434	312	0.945455	0.640657
GCA_013399215.1-Ani_VXAF01000241.1_i000_003568	121	436	315	0.954545	0.579044
GCA_905330665.1-Ani_HG994582.1_i000_002696	103	438	335	1.01515	0.685072
GCA_013398315.1-Ani_VZSG01000403.1_i000_007212	108	428	320	0.969697	0.706402
GCA_013398335.1-Ani_VZSH01000054.1_i000_010520	108	428	320	0.969697	0.706402
GCA_015501605.1-Fun_JADNRZ010000001.1_i000_000375	134	448	314	0.951515	0.562724
GCA_003325415.1-Fun_PJQM01000418.1_i000_002019	84	410	326	0.987879	0.726058
GCA_000286035.1-Fun_CAGI01000177.1_i000_002229	124	460	336	1.01818	0.578313
GCA_900519145.1-Fun_ULHA01000028.1_i000_004900	124	460	336	1.01818	0.578313
GCA_003952965.2-Pla_CM025856.1_i000_024568	118	439	321	0.972727	0.551546
GCA_905261645.1-Ani_CAJNOV010003805.1_i000_009639	131	458	327	0.990909	0.677019
GCA_905273325.1-Ani_CAJNOW010006254.1_i000_013478	131	458	327	0.990909	0.677019
GCA_905319835.1-Ani_CAJNRE010016806.1_i000_030834	131	458	327	0.990909	0.677019
GCA_905321285.1-Ani_CAJNRF010011753.1_i000_027001	131	458	327	0.990909	0.677019
GCA_905321535.1-Ani_CAJNRG010019354.1_i000_037152	131	458	327	0.990909	0.677019
GCA_905332145.1-Ani_CAJOBF010000497.1_i000_006318	131	458	327	0.990909	0.677019
GCA_905332155.1-Ani_CAJOBG010000976.1_i000_008386	131	458	327	0.990909	0.677019
GCA_010078495.1-Ani_VULB01004343.1_i000_003445	120	443	323	0.978788	0.694624
GCA_013398915.1-Ani_VYZM01014436.1_i000_007858	131	443	312	0.945455	0.629032
GCA_013401295.1-Ani_VWPO01000377.1_i000_002822	131	443	312	0.945455	0.629032
GCA_007859695.1-Pla_CP031045.1_i000_006496	127	438	311	0.942424	0.660297
GCA_013400275.1-Ani_VWYO01009700.1_i000_004619	122	437	315	0.954545	0.590994
GCA_013396615.1-Ani_VWZA01000569.1_i000_005175	132	448	316	0.957576	0.620825
GCA_013390025.1-Ani_WEKX01023072.1_i000_010634	112	434	322	0.975758	0.601869
GCA_000764455.1-Fun_JQFK01000005.1_i000_002900	126	450	324	0.981818	0.65587
GCA_003054445.1-Fun_CP028773.1_i000_000189	126	450	324	0.981818	0.65587
GCA_003693665.1-Fun_QQSL01000017.1_i000_001332	128	461	333	1.00909	0.644101
GCA_002794465.1-Fun_MTSL01000126.1_i000_002687	116	434	318	0.963636	0.585635
GCA_016628075.1-Fun_JABBWC010000097.1_i000_016448	128	453	325	0.984848	0.600739
GCA_910591945.1-Fun_CAJVPL010001979.1_i000_008788	113	439	326	0.987879	0.739229
GCA_000691845.1-Ani_JJRJ01015721.1_i000_001747	119	436	317	0.960606	0.613153
GCA_002844005.1-Ani_KZ505656.1_i000_001406	121	443	322	0.975758	0.501558
GCA_905332225.1-Ani_CAJOBN010010149.1_i000_028190	3	332	329	0.99697	0.916435
GCA_001970865.1-Fun_LSSM01002034.1_i000_004842	123	456	333	1.00909	0.637931
GCA_000747805.1-Ani_KN125898.1_i000_001475	121	433	312	0.945455	0.607004
GCA_000315625.1-Pro_JH992978.1_i000_005061	121	449	328	0.993939	0.654691
GCA_000507425.3-Fun_KV700187.1_i000_003130	133	462	329	0.99697	0.548333
GCA_016748015.1-Fun_JAAOMT010000436.1_i000_015068	117	452	335	1.01515	0.520186
GCA_905115235.1-Ani_LR899013.1_i000_012865	124	457	333	1.00909	0.598921
GCA_021730765.1-Ani_JAIZAO010000154.1_i000_020762	118	446	328	0.993939	0.645669
GCA_000690715.1-Ani_JJRP01073305.1_i000_008203	121	433	312	0.945455	0.604651
GCA_013389925.1-Ani_WEIU01017831.1_i000_009392	118	433	315	0.954545	0.63253
GCA_000286035.1-Fun_CAGI01000137.1_i000_006239	128	460	332	1.00606	0.643411
GCA_900519145.1-Fun_ULHA01000031.1_i000_005610	128	460	332	1.00606	0.643411
GCA_014080715.1-Pla_JACERP010000051.1_i000_012862	133	445	312	0.945455	0.604651
GCA_013397375.1-Ani_VXBI01010041.1_i000_009645	114	433	319	0.966667	0.595149
GCA_013400835.1-Ani_VZTU01029592.1_i000_011047	119	434	315	0.954545	0.592105
GCA_000934385.1-Fun_KN880481.1_i000_004857	124	460	336	1.01818	0.636364
GCA_013400015.1-Ani_VXBG01005527.1_i000_004396	116	432	316	0.957576	0.596226
GCA_011745845.1-Pla_VYZY01001524.1_i000_007646	118	442	324	0.981818	0.585895
GCA_013115145.1-Pro_JAAPAO010000636.1_i000_008925	114	452	338	1.02424	0.686992
GCA_020169535.1-Pla_CM034992.1_i000_018237	131	437	306	0.927273	0.568773
GCA_020169555.1-Pla_CM035016.1_i000_017149	131	437	306	0.927273	0.568773
GCA_000695195.1-Ani_KK754249.1_i000_006999	118	436	318	0.963636	0.615087
GCA_003086725.1-Fun_MBFT01000974.1_i000_006479	132	461	329	0.99697	0.624288
GCA_003097675.1-Fun_MBFU01000400.1_i000_004128	132	461	329	0.99697	0.624288
GCA_021029105.1-Fun_JAEVFJ010000004.1_i000_007440	128	450	322	0.975758	0.570922
GCA_003991915.1-Ani_RQTK01000017.1_i000_001058	115	447	332	1.00606	0.632381
GCA_001027345.1-Fun_KQ087177.1_i000_000126	127	455	328	0.993939	0.605166
GCA_008065305.1-Fun_QKWL01000001.1_i000_001383	127	455	328	0.993939	0.605166
GCA_000400465.1-Fun_KE007233.1_i000_002795	125	458	333	1.00909	0.607664
GCA_004917845.1-Fun_SPOB01000026.1_i000_001760	125	458	333	1.00909	0.607664
GCA_004917865.1-Fun_SPOD01000010.1_i000_004022	125	458	333	1.00909	0.607664
GCA_004917895.1-Fun_SPOH01000007.1_i000_003357	125	458	333	1.00909	0.607664
GCA_004918015.1-Fun_SPOC01000007.1_i000_003336	125	458	333	1.00909	0.607664
GCA_004918065.1-Fun_SPOQ01000009.1_i000_003818	125	458	333	1.00909	0.607664
GCA_004918235.1-Fun_SPOE01000008.1_i000_003648	125	458	333	1.00909	0.607664
GCA_004918305.1-Fun_SPOM01000010.1_i000_004015	125	458	333	1.00909	0.607664
GCA_004918315.1-Fun_SPNX01000009.1_i000_003851	125	458	333	1.00909	0.607664
GCA_004918335.1-Fun_SPNZ01000012.1_i000_000327	125	458	333	1.00909	0.607664
GCA_004918345.1-Fun_SPOA01000026.1_i000_001743	125	458	333	1.00909	0.607664
GCA_004918405.1-Fun_SPOO01000010.1_i000_004021	125	458	333	1.00909	0.607664
GCA_004918415.1-Fun_SPOL01000008.1_i000_003590	125	458	333	1.00909	0.607664
GCA_004918445.1-Fun_SPOG01000006.1_i000_003049	125	458	333	1.00909	0.607664
GCA_004918455.1-Fun_SPOF01000008.1_i000_003605	125	458	333	1.00909	0.607664
GCA_004918625.1-Fun_SPOK01000008.1_i000_003612	125	458	333	1.00909	0.607664
GCA_004918655.1-Fun_SPOP01000010.1_i000_004012	125	458	333	1.00909	0.607664
GCA_004918735.1-Fun_SPON01000010.1_i000_004011	125	458	333	1.00909	0.607664
GCA_004918745.1-Fun_SPOJ01000008.1_i000_003557	125	458	333	1.00909	0.607664
GCA_004918755.1-Fun_SPOI01000316.1_i000_002430	125	458	333	1.00909	0.607664
GCA_004918885.1-Fun_SPNY01000010.1_i000_004023	125	458	333	1.00909	0.607664
GCA_004918895.1-Fun_SPOR01000007.1_i000_003417	125	458	333	1.00909	0.607664
GCA_000703405.1-Ani_KL383298.1_i000_006064	119	436	317	0.960606	0.613153
GCA_006013705.1-Pla_RXGB01003189.1_i000_013120	123	445	322	0.975758	0.582278
GCA_001659605.2-Pla_CM004394.2_i000_015360	123	439	316	0.957576	0.545769
GCA_013397995.1-Ani_VZRP01022776.1_i000_013683	120	440	320	0.969697	0.634921
GCA_905219545.1-Fun_CAJMWQ010001450.1_i000_006473	126	450	324	0.981818	0.586957
GCA_001630335.1-Fun_KV417608.1_i000_019619	133	453	320	0.969697	0.553633
GCA_006547085.1-Pla_VIEB01000380.1_i000_021513	114	441	327	0.990909	0.594545
GCA_003692655.1-Ani_QRBI01000096.1_i000_026464	131	446	315	0.954545	0.601145
GCA_013397075.1-Ani_VWZS01010376.1_i000_013503	115	435	320	0.969697	0.597015
GCA_017311285.1-Fun_JABTEG010000009.1_i000_001260	140	457	317	0.960606	0.60728
GCA_002906115.4-Pla_PKMF03009427.1_i000_033608	134	464	330	1	0.604396
GCA_905330805.1-Ani_CAJNWK010000025.1_i000_009606	10	340	330	1	0.896739
GCA_011763605.1-Fun_JAANIO010003775.1_i000_007876	125	451	326	0.987879	0.665306
GCA_013400415.1-Ani_VXBX01006118.1_i000_008250	119	432	313	0.948485	0.588346
GCA_001661265.1-Fun_KV454258.1_i000_001980	124	452	328	0.993939	0.609665
GCA_013398975.1-Ani_VWYD01000180.1_i000_000106	120	436	316	0.957576	0.590654
GCA_000090985.2-Pla_CP001574.1_i000_000649	117	463	346	1.04848	0.734607
GCA_000611955.2-Ani_KK120312.1_i000_021813	128	446	318	0.963636	0.675159
GCA_905332325.1-Ani_CAJOBW010009718.1_i000_025987	1	298	297	0.9	0.92236
GCA_004379715.1-Fun_ML213591.1_i000_001221	136	454	318	0.963636	0.562832
GCA_008802855.1-Ani_VVIM01000006.1_i000_008593	108	446	338	1.02424	0.583765
GCA_019845555.1-Pla_CM034078.1_i000_002105	140	455	315	0.954545	0.545927
GCA_000493195.1-Pla_KI536799.1_i000_013728	119	442	323	0.978788	0.586207
GCA_022201045.1-Pla_CM039165.1_i000_014212	119	442	323	0.978788	0.586207
GCA_003327735.1-Fun_QLNQ01000028.1_i000_006976	130	445	315	0.954545	0.602294
GCA_000691785.1-Ani_KK680127.1_i000_006830	118	437	319	0.966667	0.618217
GCA_000504015.1-Pla_KI632154.1_i000_021909	143	465	322	0.975758	0.565905
GCA_000346465.2-Pla_CM007656.1_i000_021071	115	441	326	0.987879	0.604824
GCA_020424065.1-Pla_CM035465.1_i000_000456	115	440	325	0.984848	0.602968
GCA_902201215.1-Pla_LR694011.1_i000_020438	115	440	325	0.984848	0.602968
GCA_903112645.1-Pla_CAEKDK010000006.1_i000_023826	115	440	325	0.984848	0.602968
GCA_903114435.1-Pla_CAEKKB010000006.1_i000_024063	115	440	325	0.984848	0.602968
GCA_000497045.1-Fun_KI545891.1_i000_005316	127	458	331	1.00303	0.574653
GCA_013396435.1-Ani_WBMU01001619.1_i000_005933	132	448	316	0.957576	0.572464
GCA_000708225.1-Ani_KL410237.1_i000_004244	115	434	319	0.966667	0.621832
GCA_003710015.1-Ani_REGN01002165.1_i000_015435	124	460	336	1.01818	0.657534
GCA_002286715.1-Fun_NSJX01000001.1_i000_000158	129	451	322	0.975758	0.570922
GCA_013396755.1-Ani_VWZF01004364.1_i000_007975	114	436	322	0.975758	0.698482
GCA_002554575.1-Fun_KZ302241.1_i000_008830	134	457	323	0.978788	0.559792
GCA_013396375.1-Ani_VWPR01000049.1_i000_001441	129	446	317	0.960606	0.578467
GCA_000507405.3-Fun_KI669492.1_i000_000176	137	468	331	1.00303	0.587922
GCA_000585535.1-Fun_AMGX01000044.1_i000_013138	128	501	373	1.1303	0.72147
GCA_003813185.1-Fun_ML122055.1_i000_008449	128	452	324	0.981818	0.575488
GCA_003813205.1-Fun_ML122260.1_i000_005575	128	452	324	0.981818	0.575488
GCA_006937295.1-Pla_VIBQ01000012.1_i000_022253	132	459	327	0.990909	0.627639
GCA_018804465.1-Pla_CM031977.1_i000_043167	117	439	322	0.975758	0.572954
GCA_013398395.1-Ani_VZSK01002545.1_i000_000606	116	439	323	0.978788	0.700651
GCA_015584075.1-Fun_MU150248.1_i000_004692	121	456	335	1.01515	0.632075
GCA_013398955.1-Ani_VWPU01000869.1_i000_000564	122	404	282	0.854545	0.69802
GCA_001970855.1-Fun_LSSN01000030.1_i000_000247	124	460	336	1.01818	0.626866
GCA_001970855.1-Fun_LSSN01003273.1_i000_008011	124	460	336	1.01818	0.626866
GCA_000002775.3-Pla_CM009294.1_i000_012892	118	439	321	0.972727	0.571174
GCA_001625215.1-Pla_CM004279.1_i000_007321	118	437	319	0.966667	0.567616
GCA_000497045.1-Fun_KI545868.1_i000_003825	128	458	330	1	0.609982
SUAC001.0722.00001.C001_01023	90	408	318	0.963636	0.768116
GCA_013186435.1-Ani_PYHW01010052.1_i000_008727	127	445	318	0.963636	0.603416
GCA_000328365.1-Ani_KB309380.1_i000_024384	128	459	331	1.00303	0.656746
GCA_000507425.3-Fun_KV700276.1_i000_007081	137	468	331	1.00303	0.578671
GCA_003614695.1-Fun_ML004430.1_i000_000443	129	446	317	0.960606	0.606119
GCA_018691285.1-Pla_CM031885.1_i000_009062	354	675	321	0.972727	0.409439
GCA_000271645.1-Fun_JH711535.1_i000_005211	136	468	332	1.00606	0.562712
GCA_007252995.1-Ani_SWJQ01000118.1_i000_005472	131	446	315	0.954545	0.597723
GCA_003676055.1-Ani_QUSF01000024.1_i000_007658	132	445	313	0.948485	0.496825
GCA_013401335.1-Ani_VYZX01010825.1_i000_004220	120	443	323	0.978788	0.694624
GCA_008704605.1-Fun_SWFS01000211.1_i000_001170	127	452	325	0.984848	0.646123
GCA_905331515.1-Ani_CAJNZC010003154.1_i000_034709	3	327	324	0.981818	0.923077
GCA_900080155.1-Fun_LT558122.1_i000_003529	125	458	333	1.00909	0.577123
GCA_900519155.1-Fun_ULHB01000115.1_i000_004658	125	458	333	1.00909	0.577123
GCA_905338405.1-Ani_CAJPEX010000049.1_i000_000570	906	1256	350	1.06061	0.265756
GCA_001298355.1-Ani_KQ460644.1_i000_007927	115	444	329	0.99697	0.604779
GCA_001298345.1-Ani_KQ459584.1_i000_007633	114	445	331	1.00303	0.608456
GCA_000700745.1-Ani_KL342538.1_i000_003284	119	434	315	0.954545	0.614035
GCA_022376435.1-Fun_JABYQE010000010.1_i000_000454	128	451	323	0.978788	0.554031
GCA_014904975.1-Fun_MU127926.1_i000_014042	126	477	351	1.06364	0.632432
GCA_001974825.1-Pla_AWUE01015212.1_i000_011807	123	439	316	0.957576	0.670913
GCA_003547095.1-Fun_PQFF01000327.1_i000_016680	116	447	331	1.00303	0.464888
GCA_905332295.1-Ani_CAJOBT010008075.1_i000_028068	20	350	330	1	0.882353
GCA_000787975.1-Pla_JRRC01180008.1_i000_011168	121	441	320	0.969697	0.583942
GCA_000312925.2-Fun_HE965173.1_i000_003810	117	439	322	0.975758	0.612167
GCA_002105105.1-Fun_MCFI01000019.1_i000_002694	112	443	331	1.00303	0.628083
GCA_013396835.1-Ani_VWZI01014185.1_i000_007764	117	430	313	0.948485	0.628514
GCA_905146915.1-Pla_CAJHUC010001107.1_i000_005121	119	446	327	0.990909	0.6
GCA_013401445.1-Pla_CM023879.1_i000_013885	126	440	314	0.951515	0.549912
GCA_021029105.1-Fun_JAEVFJ010000010.1_i000_000882	129	462	333	1.00909	0.641618
GCA_003942205.1-Fun_RSCE01000004.1_i000_006559	130	458	328	0.993939	0.588869
GCA_004115385.1-Pla_CM014054.1_i000_013414	122	467	345	1.04545	0.57309
GCA_013511315.1-Pla_CM025264.1_i000_012094	1	283	282	0.854545	0.689487
GCA_000334475.1-Fun_DF196771.1_i000_000786	124	460	336	1.01818	0.57732
GCA_000747765.1-Fun_DF830072.1_i000_004246	124	460	336	1.01818	0.57732
GCA_900322835.1-Fun_OOIQ01000005.1_i000_002640	124	460	336	1.01818	0.57732
GCA_000227095.3-Fun_BACD03000034.1_i000_002326	185	513	328	0.993939	0.547579
GCA_900242705.1-Fun_OEYX01000118.1_i000_008242	124	460	336	1.01818	0.57931
GCA_000365505.1-Pro_ANIZ01002825.1_i000_016054	110	449	339	1.02727	0.683468
GCA_000365525.1-Pro_ANJA01002983.1_i000_016021	110	449	339	1.02727	0.683468
GCA_000365545.1-Pro_ANIX01003216.1_i000_015895	110	449	339	1.02727	0.683468
GCA_000367145.1-Pro_ANIY01003379.1_i000_015900	110	449	339	1.02727	0.683468
GCA_000509465.1-Pro_KI688248.1_i000_015623	110	449	339	1.02727	0.683468
GCA_000509525.1-Pro_KI694960.1_i000_015468	110	449	339	1.02727	0.683468
GCA_004918925.1-Fun_SPRP01000083.1_i000_004066	124	456	332	1.00606	0.606947
GCA_000002425.2-Pla_CM009317.1_i000_003314	131	428	297	0.9	0.532258
GCA_017655625.1-Fun_JAEOAQ010000002.1_i000_001534	130	446	316	0.957576	0.611219
GCA_020169535.1-Pla_CM034996.1_i000_030004	117	441	324	0.981818	0.591241
GCA_020169555.1-Pla_CM035020.1_i000_029298	117	441	324	0.981818	0.591241
GCA_020169585.1-Pla_CM034984.1_i000_029421	117	441	324	0.981818	0.591241
GCA_005298045.1-Fun_SWBT01000113.1_i000_006779	135	460	325	0.984848	0.616698
GCA_003573695.1-Pla_CM010722.1_i000_029441	123	442	319	0.966667	0.581056
GCA_001632435.1-Fun_KV424025.1_i000_009055	127	459	332	1.00606	0.691667
GCA_000403515.1-Fun_DF238782.1_i000_001646	126	458	332	1.00606	0.569468
GCA_003014415.1-Fun_PYGM01000001.1_i000_000030	129	447	318	0.963636	0.609195
GCA_008275145.1-Fun_CP043442.1_i000_001750	129	447	318	0.963636	0.609195
GCA_016809505.1-Fun_CP050673.1_i000_000135	129	447	318	0.963636	0.609195
GCA_013397315.1-Ani_WBMY01011951.1_i000_008939	116	439	323	0.978788	0.700651
GCA_011745865.1-Pla_VYZZ01001516.1_i000_008008	119	441	322	0.975758	0.517685
GCA_020744275.1-Fun_JAGTJR010000014.1_i000_003374	134	464	330	1	0.633397
GCA_003013715.2-Fun_CP043531.1_i000_000134	129	447	318	0.963636	0.605714
GCA_007168705.1-Fun_BGOX01000002.1_i000_002928	129	447	318	0.963636	0.605714
GCA_000327385.1-Ani_KB201977.1_i000_012730	122	452	330	1	0.638298
GCA_022160305.1-Fun_MU277225.1_i000_009772	123	457	334	1.01212	0.599641
GCA_903189775.1-Fun_CAEVNN010000066.1_i000_003377	125	455	330	1	0.56314
GCA_900242695.1-Fun_OHJM01000009.1_i000_001762	124	460	336	1.01818	0.580311
GCA_022496195.1-Fun_WTXC01000017.1_i000_003316	125	453	328	0.993939	0.572426
GCA_014461125.1-Fun_JACAZG010000015.1_i000_011166	130	460	330	1	0.613383
GCA_000403535.1-Pla_CM001883.1_i000_016919	117	439	322	0.975758	0.569912
GCA_002775015.1-Fun_PGLS01000004.1_i000_000200	129	447	318	0.963636	0.602273
GCA_013400115.1-Ani_VXBP01006372.1_i000_008603	123	436	313	0.948485	0.62475
GCA_905332115.1-Ani_CAJOBH010003513.1_i000_011243	20	361	341	1.03333	0.919137
GCA_022376545.1-Fun_WTXJ01000072.1_i000_010559	131	444	313	0.948485	0.542461
GCA_001189475.1-Fun_LGST01000039.1_i000_004051	129	447	318	0.963636	0.59887
GCA_002759435.2-Fun_PEKT02000004.1_i000_004475	129	447	318	0.963636	0.59887
GCA_019332045.1-Fun_CP076749.1_i000_001525	129	447	318	0.963636	0.59887
GCA_003336725.1-Ani_JOJR01000706.1_i000_018752	3	303	300	0.909091	0.983607
GCA_905332185.1-Ani_CAJOBM010009063.1_i000_028879	125	457	332	1.00606	0.68595
GCA_000302655.1-Fun_AHHD01000259.1_i000_005759	134	464	330	1	0.633397
GCA_000509485.1-Pro_KI675008.1_i000_015526	116	449	333	1.00909	0.671371
GCA_000509505.1-Pro_KI681695.1_i000_015330	116	449	333	1.00909	0.671371
GCA_000180735.1-Ani_CAAE01014642.1_i000_014429	126	477	351	1.06364	0.625668
GCA_015178965.1-Fun_WHVB01000005.1_i000_008672	123	451	328	0.993939	0.613084
GCA_013399135.1-Ani_VXBZ01006975.1_i000_007097	116	437	321	0.972727	0.597765
GCA_000313525.1-Fun_HE796918.1_i000_001691	130	449	319	0.966667	0.563604
GCA_000265015.1-Fun_JH687742.1_i000_005263	130	458	328	0.993939	0.634429
GCA_000403515.1-Fun_DF238790.1_i000_002663	128	457	329	0.99697	0.633911
GCA_003546565.1-Pro_QUSZ01001903.1_i000_000162	180	516	336	1.01818	0.629213
GCA_013400335.1-Ani_VZZY01025707.1_i000_013564	116	436	320	0.969697	0.593692
GCA_004369045.1-Fun_ML213509.1_i000_005298	122	451	329	0.99697	0.641326
GCA_900080155.1-Fun_LT558138.1_i000_000273	128	459	331	1.00303	0.642718
GCA_900519155.1-Fun_ULHB01000032.1_i000_002200	128	459	331	1.00303	0.642718
GCA_010077915.1-Ani_VUKU01022231.1_i000_011896	116	436	320	0.969697	0.69869
GCA_001712645.2-Pro_MBAD02002532.1_i000_006241	123	461	338	1.02424	0.664047
GCA_001712705.2-Pro_MBDO02000095.1_i000_009890	123	461	338	1.02424	0.664047
GCA_004802705.1-Fun_SGPL01000348.1_i000_005329	123	450	327	0.990909	0.451657
GCA_000697685.1-Fun_KL198007.1_i000_004713	125	451	326	0.987879	0.613936
GCA_000950595.1-Fun_DF836346.1_i000_007744	122	443	321	0.972727	0.643287
GCA_000247585.2-Pro_KI669611.1_i000_017574	116	449	333	1.00909	0.671371
GCA_001482985.1-Pro_LNFP01000206.1_i000_003533	116	449	333	1.00909	0.671371
GCA_001483015.1-Pro_LNFO01005725.1_i000_015060	116	449	333	1.00909	0.671371
GCA_000417875.1-Fun_KE361650.1_i000_006736	140	460	320	0.969697	0.602637
GCA_900322975.1-Fun_OOIP01000020.1_i000_005950	140	460	320	0.969697	0.602637
GCA_021525015.1-Fun_JAKELH010000143.1_i000_003665	127	451	324	0.981818	0.576512
GCA_021525025.1-Fun_JAKELI010000306.1_i000_008222	127	451	324	0.981818	0.576512
GCA_000143565.1-Fun_DS547094.1_i000_014950	123	456	333	1.00909	0.680982
GCA_000699005.1-Ani_KL215353.1_i000_003250	121	434	313	0.948485	0.610136
GCA_009078335.1-Pla_CM018576.1_i000_007230	139	461	322	0.975758	0.548552
GCA_005966545.1-Pro_SPLM01000001.1_i000_002400	113	449	336	1.01818	0.667992
GCA_013399735.1-Ani_VXAW01013171.1_i000_013091	122	441	319	0.966667	0.634195
GCA_003144125.1-Fun_KZ819189.1_i000_002012	125	460	335	1.01515	0.568761
GCA_000181695.1-Fun_AAYY01000006.1_i000_002413	131	459	328	0.993939	0.605166
GCA_002102565.1-Fun_NBSH01000003.1_i000_004395	131	456	325	0.984848	0.555556
GCA_001420675.1-Ani_LMAW01002801.1_i000_012525	124	446	322	0.975758	0.583333
GCA_015484485.1-Fun_MU156538.1_i000_008441	134	451	317	0.960606	0.557118
GCA_010076225.1-Ani_VUKV01002571.1_i000_002707	120	443	323	0.978788	0.694624
GCA_010076325.1-Ani_VUKW01001680.1_i000_002152	120	443	323	0.978788	0.694624
GCA_010077935.1-Ani_VUKX01011740.1_i000_010570	120	443	323	0.978788	0.694624
GCA_000511025.2-Pla_CM002328.2_i000_018814	135	445	310	0.939394	0.541958
GCA_000143105.2-Fun_GL629767.1_i000_003363	134	468	334	1.01212	0.652344
GCA_000002525.1-Fun_CR382130.1_i000_003251	136	460	324	0.981818	0.635294
GCA_001761485.1-Fun_CP017556.1_i000_004109	136	460	324	0.981818	0.635294
GCA_003367845.1-Fun_KZ857304.1_i000_001339	136	460	324	0.981818	0.635294
GCA_003367865.1-Fun_KZ857342.1_i000_004611	136	460	324	0.981818	0.635294
GCA_003367925.1-Fun_KZ857368.1_i000_005151	136	460	324	0.981818	0.635294
GCA_003367945.1-Fun_KZ858087.1_i000_004880	136	460	324	0.981818	0.635294
GCA_003367965.1-Fun_KZ858657.1_i000_003945	136	460	324	0.981818	0.635294
GCA_003698155.1-Fun_PKSB01000007.1_i000_006112	136	460	324	0.981818	0.635294
GCA_009194645.1-Fun_ML736631.1_i000_004640	136	460	324	0.981818	0.635294
GCA_009372015.1-Fun_ML756029.1_i000_004838	136	460	324	0.981818	0.635294
GCA_014490615.1-Fun_CP061015.1_i000_003239	136	460	324	0.981818	0.635294
GCA_900087985.1-Fun_LT576311.1_i000_000265	136	460	324	0.981818	0.635294
GCA_900537225.1-Fun_UTQH01000004.1_i000_002062	136	460	324	0.981818	0.635294
GCA_003709845.1-Fun_QQXO01000142.1_i000_001036	131	463	332	1.00606	0.435696
GCA_019677355.1-Fun_WSLN01000245.1_i000_002776	128	457	329	0.99697	0.588551
GCA_004379255.2-Pla_CM031475.1_i000_011604	84	413	329	0.99697	0.627863
GCA_002105065.1-Fun_MCFC01000001.1_i000_000281	135	423	288	0.872727	0.676056
GCA_019155715.1-Pro_JAGDFM010000180.1_i000_003804	113	451	338	1.02424	0.68008
GCA_001625215.1-Pla_CM004278.1_i000_002660	118	438	320	0.969697	0.565371
GCA_004115385.1-Pla_CM014052.1_i000_008794	114	442	328	0.993939	0.593128
GCA_006547085.1-Pla_VIEB01001941.1_i000_044239	114	442	328	0.993939	0.593128
GCA_905250055.1-Ani_CAJNOF010000307.1_i000_025818	112	443	331	1.00303	0.708779
GCA_905250075.1-Ani_CAJNOP010001934.1_i000_057087	112	443	331	1.00303	0.708779
GCA_905331535.1-Ani_CAJNZB010001969.1_i000_037150	112	443	331	1.00303	0.708779
GCA_000209185.1-Ani_DS231859.1_i000_015706	128	458	330	1	0.654762
GCA_000699145.1-Ani_KL226294.1_i000_010862	116	435	319	0.966667	0.620623
GCA_002742065.1-Fun_CM008500.1_i000_002766	132	463	331	1.00303	0.597473
GCA_019650295.1-Fun_BOLY01000001.1_i000_001631	132	463	331	1.00303	0.597473
GCA_019650235.1-Pla_BNCP01000003.1_i000_001583	122	438	316	0.957576	0.578755
GCA_019650255.1-Pla_BNCQ01000001.1_i000_000416	122	438	316	0.957576	0.578755
GCA_905219595.1-Fun_CAJMWU010002645.1_i000_005072	126	441	315	0.954545	0.709459
GCA_012979565.1-Fun_SJDA01000003.1_i000_005808	128	458	330	1	0.571924
GCA_012980525.1-Fun_SJKE01000003.1_i000_005127	128	458	330	1	0.571924
GCA_012980535.1-Fun_SJKF01000003.1_i000_005620	128	458	330	1	0.571924
GCA_000699105.1-Ani_KL224607.1_i000_001159	116	435	319	0.966667	0.620623
GCA_000320585.2-Fun_KI925458.1_i000_005669	126	453	327	0.990909	0.61236
GCA_001630475.1-Fun_KV419396.1_i000_001471	120	449	329	0.99697	0.605893
GCA_013400795.1-Ani_VZTS01006160.1_i000_002781	120	403	283	0.857576	0.698765
GCA_016834595.1-Pla_JAEHOD010000016.1_i000_006214	134	441	307	0.930303	0.607921
GCA_019633465.1-Fun_WSTY01000611.1_i000_003490	83	418	335	1.01515	0.663366
GCA_000315875.1-Fun_HE681724.1_i000_004964	130	447	317	0.960606	0.67735
GCA_000349305.2-Fun_HE999552.1_i000_000774	140	458	318	0.963636	0.612717
GCA_900149145.1-Fun_LT671821.1_i000_000144	140	458	318	0.963636	0.612717
GCA_921882275.1-Ani_OV170222.1_i000_002633	128	457	329	0.99697	0.715217
GCA_014925845.1-Fun_JACGCL010000002.1_i000_005580	138	453	315	0.954545	0.551664
GCA_000026945.1-Fun_FM992693.1_i000_005086	129	448	319	0.966667	0.618217
GCA_000934395.1-Fun_KN882061.1_i000_008828	135	454	319	0.966667	0.613462
GCA_013399455.1-Ani_VWYI01038321.1_i000_010167	115	434	319	0.966667	0.630435
GCA_008931885.1-Fun_VCHE01000070.1_i000_011052	137	465	328	0.993939	0.640625
GCA_012971845.1-Fun_QCYV01000241.1_i000_008589	137	465	328	0.993939	0.640625
GCA_002938355.1-Fun_NHTK01000341.1_i000_000528	124	453	329	0.99697	0.604779
GCA_019677325.2-Fun_CM033830.1_i000_009114	128	445	317	0.960606	0.557118
GCA_015484515.1-Fun_MU154528.1_i000_002267	117	432	315	0.954545	0.560498
GCA_003549995.1-Fun_QKKE01000010.1_i000_000190	113	428	315	0.954545	0.732558
GCA_009835225.1-Ani_VUJU01006400.1_i000_020330	138	461	323	0.978788	0.690171
GCA_004802705.1-Fun_SGPL01000025.1_i000_003796	135	456	321	0.972727	0.564148
GCA_015179045.1-Fun_WHUZ01000001.1_i000_000663	131	450	319	0.966667	0.528146
GCA_000150505.2-Fun_KE503206.1_i000_001200	131	447	316	0.957576	0.623274
GCA_000827315.1-Fun_KN832989.1_i000_008608	129	455	326	0.987879	0.592727
GCA_000688135.1-Ani_JARK01001341.1_i000_009043	133	461	328	0.993939	0.652087
GCA_003676035.1-Fun_NSGQ01000074.1_i000_004791	131	442	311	0.942424	0.617063
GCA_003086735.1-Fun_MBFR01000155.1_i000_003458	121	451	330	1	0.611111
GCA_016647635.1-Fun_JABBWG010000317.1_i000_008627	127	454	327	0.990909	0.604436
GCA_000223485.1-Fun_GL996505.1_i000_005219	133	448	315	0.954545	0.615234
GCA_000687375.1-Ani_KK497335.1_i000_011978	112	432	320	0.969697	0.623782
GCA_019364655.1-Ani_JAGXCG010013980.1_i000_040855	117	445	328	0.993939	0.567474
GCA_013399255.1-Ani_VXAE01009811.1_i000_006783	118	433	315	0.954545	0.581181
GCA_014466165.1-Fun_JACETU010000003.1_i000_005371	136	450	314	0.951515	0.545139
GCA_003546785.1-Pro_QUTF01017631.1_i000_011736	180	513	333	1.00909	0.623596
GCA_019202705.1-Fun_JAGSYN010000117.1_i000_001798	128	443	315	0.954545	0.625
GCA_020169575.1-Pla_CM035008.1_i000_029212	117	442	325	0.984848	0.591985
GCA_902713445.1-Pla_LR743793.1_i000_020954	344	665	321	0.972727	0.409439
GCA_905071925.1-Ani_CAJHJT010000001.1_i000_003205	128	457	329	0.99697	0.641326
GCA_015178925.1-Fun_WHVC01000023.1_i000_005057	139	448	309	0.936364	0.516722
PYIS001.0722.00001.C001_00435	95	398	303	0.918182	0.721429
GCA_018282005.1-Fun_JABCKV010000044.1_i000_003564	171	502	331	1.00303	0.533011
GCA_019677335.1-Fun_WSLM01000044.1_i000_000932	128	447	319	0.966667	0.559649
GCA_002911725.1-Pro_NCKW01008312.1_i000_013715	112	449	337	1.02121	0.672655
GCA_021399455.1-Fun_JAJTUO010000005.1_i000_014404	123	456	333	1.00909	0.570205
GCA_000340215.1-Fun_KB446564.1_i000_012063	134	463	329	0.99697	0.635135
GCA_000708925.1-Ani_KL423524.1_i000_003630	115	434	319	0.966667	0.619417
GCA_000333075.3-Pro_AOFI03000065.1_i000_009656	129	461	332	1.00606	0.652259
GCA_000785725.3-Pro_JPWU03000056.1_i000_007589	129	461	332	1.00606	0.652259
GCA_000785735.3-Pro_JPWV03000055.1_i000_007478	129	461	332	1.00606	0.652259
GCA_001707905.2-Pro_MAYM02000222.1_i000_005753	129	461	332	1.00606	0.652259
GCA_001712715.2-Pro_MBDN02000081.1_i000_009115	129	461	332	1.00606	0.652259
GCA_905221625.1-Pro_CAJNDU010002900.1_i000_003904	119	452	333	1.00909	0.690871
GCA_905231925.1-Pro_CAJNJV010002383.1_i000_003365	119	452	333	1.00909	0.690871
GCA_015143295.1-Pla_CM026564.1_i000_020334	117	441	324	0.981818	0.604478
GCA_000464535.1-Fun_KE721293.1_i000_006519	127	460	333	1.00909	0.641618
GCA_003546625.1-Pro_QUTC01008356.1_i000_011391	240	573	333	1.00909	0.560606
GCA_003666305.1-Pro_QUTI01025354.1_i000_007826	240	573	333	1.00909	0.560606
GCA_900074925.1-Fun_FJUY01000001.1_i000_008046	138	462	324	0.981818	0.595588
GCA_900323505.1-Fun_OOIN01000040.1_i000_012144	128	458	330	1	0.632184
GCA_016618355.2-Fun_JADGIP010001448.1_i000_008697	126	453	327	0.990909	0.567708
GCA_013397615.1-Ani_WBNI01000145.1_i000_003153	123	445	322	0.975758	0.688034
GCA_000264905.1-Fun_JH687383.1_i000_005173	131	452	321	0.972727	0.568142
GCA_017635955.1-Fun_JAAQQV010000005.1_i000_005358	137	460	323	0.978788	0.639604
GCA_000338955.1-Fun_KB445551.1_i000_001641	141	467	326	0.987879	0.576991
GCA_013399615.1-Ani_VXAR01012043.1_i000_011315	122	438	316	0.957576	0.580882
GCA_003573695.1-Pla_CM010718.1_i000_015565	123	443	320	0.969697	0.582878
GCA_900242705.1-Fun_OEYX01000061.1_i000_004650	128	459	331	1.00303	0.641473
GCA_007990325.1-Pla_CM017708.1_i000_045355	123	441	318	0.963636	0.561837
GCA_000827465.1-Fun_KN823165.1_i000_014137	125	459	334	1.01212	0.701681
GCA_004369085.1-Fun_ML210163.1_i000_003373	122	461	339	1.02727	0.624309
GCA_921882275.1-Ani_OV170226.1_i000_007099	112	445	333	1.00909	0.589381
GCA_015178975.1-Fun_WHVD01000003.1_i000_008066	135	453	318	0.963636	0.554974
GCA_004369125.1-Fun_ML178828.1_i000_007399	137	450	313	0.948485	0.554965
GCA_004329165.1-Pla_CM014731.1_i000_010332	121	443	322	0.975758	0.619231
GCA_020536065.1-Fun_JAEUBE010000487.1_i000_002061	133	453	320	0.969697	0.647773
GCA_002933655.1-Fun_PNEN01000443.1_i000_006225	133	462	329	0.99697	0.591727
GCA_014904935.1-Fun_MU123695.1_i000_000039	128	457	329	0.99697	0.576182
GCA_010411085.1-Ani_CM021199.1_i000_005404	9	338	329	0.99697	0.756322
GCA_015143295.1-Pla_CM026570.1_i000_025983	118	448	330	1	0.564103
GCA_004153795.2-Pla_SDRB02009349.1_i000_015640	131	434	303	0.918182	0.696552
GCA_000230245.1-Fun_FQ311471.1_i000_002758	127	459	332	1.00606	0.604736
GCA_001632355.1-Fun_KV428024.1_i000_003472	121	449	328	0.993939	0.564544
GCA_905329745.1-Ani_CAJNSZ010000961.1_i000_031179	129	456	327	0.990909	0.689873
GCA_905330235.1-Ani_CAJNUA010000648.1_i000_026981	129	456	327	0.990909	0.689873
GCA_905330535.1-Ani_CAJNVN010001576.1_i000_032649	129	456	327	0.990909	0.689873
GCA_905332165.1-Ani_CAJOBK010002700.1_i000_018927	129	456	327	0.990909	0.689873
GCA_905332175.1-Ani_CAJOBL010003294.1_i000_015826	129	456	327	0.990909	0.689873
GCA_905332185.1-Ani_CAJOBM010005502.1_i000_022081	129	456	327	0.990909	0.689873
GCA_905332225.1-Ani_CAJOBN010003807.1_i000_015867	129	456	327	0.990909	0.689873
GCA_013423385.1-Fun_BLZA01000030.1_i000_004968	141	466	325	0.984848	0.544389
GCA_002571385.1-Ani_LSMT01000306.1_i000_014349	114	462	348	1.05455	0.385382
GCA_013397025.1-Ani_VWZR01006030.1_i000_004261	119	435	316	0.957576	0.576642
GCA_019154785.2-Pro_JAGRRH010000007.1_i000_028487	129	461	332	1.00606	0.639692
GCA_017639365.1-Fun_JAAQQX010000005.1_i000_004911	136	460	324	0.981818	0.640316
GCA_017639385.1-Fun_JAAQQW010000004.1_i000_003538	136	460	324	0.981818	0.640316
GCA_013399975.1-Ani_VXBD01009568.1_i000_008139	118	440	322	0.975758	0.695464
GCA_000934395.1-Fun_KN881650.1_i000_002554	122	456	334	1.01212	0.613971
GCA_004802725.1-Fun_SGPM01000003.1_i000_004743	118	447	329	0.99697	0.333671
GCA_001661245.1-Fun_KV454012.1_i000_001229	129	452	323	0.978788	0.647295
GCA_900536885.1-Fun_UWZB01000734.1_i000_015465	129	451	322	0.975758	0.561955
GCA_001970955.1-Pro_MPUH01000449.1_i000_019723	119	443	324	0.981818	0.713656
GCA_000271605.1-Fun_JH717974.1_i000_006992	135	451	316	0.957576	0.562278
GCA_009761285.1-Ani_VYZN01000023.1_i000_007186	136	462	326	0.987879	0.696581
GCA_013368325.1-Fun_JAACJK010000113.1_i000_010752	125	450	325	0.984848	0.566202
GCA_004009835.2-Fun_RIBY02002067.1_i000_007097	133	466	333	1.00909	0.61326
GCA_014904835.1-Fun_MU120898.1_i000_000543	127	453	326	0.987879	0.570928
GCA_000827275.1-Fun_KN833760.1_i000_010644	130	454	324	0.981818	0.557659
GCA_001263195.1-Fun_KQ412861.1_i000_010400	123	455	332	1.00606	0.636015
GCA_007990345.1-Pla_CM017682.1_i000_058514	123	441	318	0.963636	0.561837
GCA_007990485.1-Pla_CM017630.1_i000_045261	123	441	318	0.963636	0.561837
GCA_000835815.1-Fun_KN848528.1_i000_002349	129	458	329	0.99697	0.581272
GCA_019511825.2-Pla_QFCC02000007.1_i000_034900	121	444	323	0.978788	0.586207
GCA_013398575.1-Ani_WBNC01000655.1_i000_005045	116	439	323	0.978788	0.700651
GCA_004126415.1-Fun_SDEE01000006.1_i000_011279	123	452	329	0.99697	0.605893
GCA_002286715.1-Fun_NSJX01000007.1_i000_012319	124	453	329	0.99697	0.614953
GCA_019154785.2-Pro_JAGRRH010000017.1_i000_007899	127	463	336	1.01818	0.647399
GCA_000836375.1-Fun_KN847903.1_i000_003464	128	457	329	0.99697	0.582301
GCA_000836455.1-Fun_KN848984.1_i000_005777	128	457	329	0.99697	0.582301
GCA_000875855.1-Fun_KN848925.1_i000_002582	128	457	329	0.99697	0.582301
GCA_002215365.1-Pro_NBNE01010559.1_i000_027519	115	450	335	1.01515	0.667331
GCA_900242695.1-Fun_OHJM01000005.1_i000_001593	128	459	331	1.00303	0.641473
GCA_010093825.1-Fun_ML995944.1_i000_010549	133	463	330	1	0.594595
GCA_019512045.2-Pla_QIYW02000010.1_i000_002519	119	443	324	0.981818	0.586957
GCA_900162835.1-Fun_LT795059.1_i000_003178	127	459	332	1.00606	0.604736
GCA_015956445.1-Fun_WIUZ02000010.1_i000_001756	122	455	333	1.00909	0.578125
GCA_004303085.2-Pla_SDAM02000099.1_i000_007736	117	441	324	0.981818	0.586957
GCA_002007985.1-Fun_MSRX01000072.1_i000_004353	138	459	321	0.972727	0.625731
GCA_002008015.1-Fun_MSSE01000070.1_i000_004659	138	459	321	0.972727	0.625731
GCA_002008025.1-Fun_MSRY01000030.1_i000_002539	138	459	321	0.972727	0.625731
GCA_002008075.1-Fun_MSSB01000063.1_i000_004466	138	459	321	0.972727	0.625731
GCA_003144295.1-Fun_KZ819634.1_i000_001663	132	450	318	0.963636	0.534454
GCA_020884735.1-Fun_BPWL01000002.1_i000_001882	124	451	327	0.990909	0.558974
GCA_018127085.1-Fun_CM030735.1_i000_003344	120	448	328	0.993939	0.646943
GCA_016628085.1-Fun_JABBWB010000001.1_i000_000059	127	456	329	0.99697	0.604779
GCA_902728275.1-Fun_CACVBS010000037.1_i000_004459	153	489	336	1.01818	0.586387
GCA_013400355.1-Ani_VXBV01003542.1_i000_005876	118	437	319	0.966667	0.588561
GCA_000699545.1-Ani_JMFS01017699.1_i000_001520	128	445	317	0.960606	0.60381
GCA_003367725.1-Fun_KZ857388.1_i000_004444	131	451	320	0.969697	0.568384
GCA_000002425.2-Pla_CM009326.1_i000_014989	140	436	296	0.89697	0.5
GCA_003367725.1-Fun_KZ857387.1_i000_004245	121	456	335	1.01515	0.596085
GCA_019633495.1-Fun_WSUD01000931.1_i000_005352	126	459	333	1.00909	0.620112
GCA_020496765.1-Pla_CM035623.1_i000_012356	123	441	318	0.963636	0.559859
GCA_003144135.1-Fun_KZ819321.1_i000_000570	126	459	333	1.00909	0.591474
GCA_910591765.1-Fun_CAJVPS010002306.1_i000_006537	117	443	326	0.987879	0.732584
GCA_000182765.2-Fun_HE605202.1_i000_005779	129	447	318	0.963636	0.615087
GCA_014049445.1-Fun_JABWAB010000009.1_i000_004855	129	447	318	0.963636	0.615087
GCA_014049455.1-Fun_JABWAA010000009.1_i000_005053	129	447	318	0.963636	0.615087
GCA_014049495.1-Fun_JABWAC010000009.1_i000_005085	129	447	318	0.963636	0.615087
GCA_014049585.1-Fun_JABVZZ010000010.1_i000_005121	129	447	318	0.963636	0.615087
GCA_903989565.1-Fun_CAJEJE010000008.1_i000_005806	129	447	318	0.963636	0.615087
GCA_000150955.2-Pro_CM000609.1_i000_003175	120	460	340	1.0303	0.642722
GCA_000835765.1-Fun_KN848834.1_i000_002120	129	458	329	0.99697	0.581272
GCA_000836315.1-Fun_KN848137.1_i000_002366	129	458	329	0.99697	0.581272
GCA_000875795.1-Fun_KN848511.1_i000_003904	129	458	329	0.99697	0.581272
GCA_001329695.1-Fun_KQ474079.1_i000_003763	123	455	332	1.00606	0.643411
GCA_000350255.1-Fun_CAOJ01000692.1_i000_000525	130	452	322	0.975758	0.605263
GCA_000696875.1-Ani_KK931477.1_i000_001860	114	436	322	0.975758	0.622824
GCA_000344635.1-Fun_KB468113.1_i000_008656	133	447	314	0.951515	0.556738
GCA_000344705.1-Fun_AOGT01002328.1_i000_005360	129	449	320	0.969697	0.615385
GCA_002111425.1-Fun_KZ107831.1_i000_009321	135	432	297	0.9	0.6875
GCA_013401445.1-Pla_CM023873.1_i000_006973	126	440	314	0.951515	0.548951
GCA_004369055.1-Fun_ML211227.1_i000_009154	133	449	316	0.957576	0.560284
GCA_002082055.1-Ani_MTYJ01000054.1_i000_007880	125	458	333	1.00909	0.664671
GCA_015039395.1-Fun_MU132146.1_i000_004025	126	454	328	0.993939	0.586762
GCA_016618375.1-Pro_JADEVP010000065.1_i000_019318	112	449	337	1.02121	0.667327
GCA_000223485.1-Fun_GL996500.1_i000_001301	132	451	319	0.966667	0.639279
GCA_003086735.1-Fun_MBFR01000069.1_i000_001994	125	457	332	1.00606	0.662675
GCA_002197585.2-Pro_MZMZ02001573.1_i000_002493	240	573	333	1.00909	0.560606
GCA_003546765.1-Pro_QUTG01002041.1_i000_002876	240	573	333	1.00909	0.560606
GCA_000149755.2-Pro_JH159156.1_i000_017061	117	449	332	1.00606	0.678937
GCA_000401635.1-Fun_KE123935.1_i000_003724	119	450	331	1.00303	0.660679
GCA_015584085.1-Fun_MU151160.1_i000_006657	136	455	319	0.966667	0.537037
GCA_015342415.1-Fun_JACYCE010000030.1_i000_005042	126	450	324	0.981818	0.585895
GCA_015342435.1-Fun_JACYCD010000023.1_i000_005152	126	450	324	0.981818	0.585895
GCA_002897155.2-Fun_BDIQ02000026.1_i000_009478	116	450	334	1.01212	0.504532
GCA_903189775.1-Fun_CAEVNN010000254.1_i000_010454	116	450	334	1.01212	0.504532
GCA_014898675.1-Fun_JACXVL010000102.1_i000_000438	135	453	318	0.963636	0.554007
GCA_002217885.1-Pro_BDSP01000202.1_i000_011732	145	469	324	0.981818	0.60788
GCA_000775505.1-Fun_AJJB01000035.1_i000_002773	130	448	318	0.963636	0.616279
GCA_002222255.1-Fun_AMLH01000274.1_i000_003452	130	458	328	0.993939	0.577465
GCA_002222375.1-Fun_AMLI01000021.1_i000_002676	130	458	328	0.993939	0.577465
GCA_000004335.1-Ani_GL192652.1_i000_006092	115	436	321	0.972727	0.705495
GCA_008692635.1-Ani_VOAJ01006362.1_i000_015229	115	436	321	0.972727	0.705495
GCA_002844615.1-Fun_MVDW01000024.1_i000_004400	132	464	332	1.00606	0.599278
GCA_000773755.1-Fun_AJIS01000046.1_i000_004328	129	449	320	0.969697	0.621359
GCA_000784635.1-Fun_AJJF01000028.1_i000_003229	129	449	320	0.969697	0.621359
GCA_000209165.1-Fun_CM000437.1_i000_000752	134	457	323	0.978788	0.647295
GCA_016859295.1-Fun_JADGGA010000002.1_i000_000558	134	457	323	0.978788	0.647295
GCA_000504015.1-Pla_KI632154.1_i000_021910	117	441	324	0.981818	0.585895
GCA_013053245.1-Fun_JAACJL010000030.1_i000_003513	123	456	333	1.00909	0.62594
GCA_015341985.1-Fun_JACYCC010000021.1_i000_005172	126	450	324	0.981818	0.585895
GCA_016906535.1-Fun_CP059662.1_i000_004745	126	450	324	0.981818	0.585895
GCA_905219565.1-Fun_CAJMWR010004032.1_i000_007154	126	450	324	0.981818	0.585895
GCA_003546825.1-Pro_QUTH01002137.1_i000_003370	263	596	333	1.00909	0.539708
GCA_018854895.1-Fun_JABAJV010008589.1_i000_009322	122	452	330	1	0.621469
GCA_014898675.1-Fun_JACXVL010000630.1_i000_018210	137	454	317	0.960606	0.551304
GCA_000765035.1-Fun_CCBP010000057.1_i000_001807	121	450	329	0.99697	0.605893
GCA_015484485.1-Fun_MU156468.1_i000_004221	123	456	333	1.00909	0.624765
GCA_015039395.1-Fun_MU132144.1_i000_003015	130	451	321	0.972727	0.565141
GCA_013397955.1-Ani_VZRM01005241.1_i000_008005	123	445	322	0.975758	0.688034
GCA_000344655.2-Fun_KE504124.1_i000_001157	126	451	325	0.984848	0.612053
GCA_019207475.1-Fun_JAHLUX010000004.1_i000_003329	138	452	314	0.951515	0.624254
GCA_019207505.1-Fun_JAHLUZ010000003.1_i000_002761	138	452	314	0.951515	0.624254
GCA_019207515.1-Fun_JAHLVA010000004.1_i000_003124	138	452	314	0.951515	0.624254
GCA_019207585.1-Fun_JAHLVF010000004.1_i000_003072	138	452	314	0.951515	0.624254
GCA_019207635.1-Fun_JAHLVE010000004.1_i000_003308	138	452	314	0.951515	0.624254
GCA_000300555.1-Fun_JH971387.1_i000_002894	136	452	316	0.957576	0.551483
GCA_014872705.1-Fun_CM026496.1_i000_005083	136	452	316	0.957576	0.551483
GCA_000827485.1-Fun_KN818234.1_i000_005004	123	455	332	1.00606	0.59605
GCA_010093985.1-Fun_ML992709.1_i000_011178	134	463	329	0.99697	0.593863
GCA_018691715.1-Pro_JAFJYM010000048.1_i000_012476	114	449	335	1.01515	0.674044
GCA_013397295.1-Ani_VYXF01008334.1_i000_008862	121	433	312	0.945455	0.625251
GCA_010093935.1-Fun_ML993587.1_i000_004564	133	462	329	0.99697	0.594937
GCA_022264855.1-Fun_JABYQU010000014.1_i000_002154	127	452	325	0.984848	0.580357
GCA_016834605.1-Pla_JAEHOC010000020.1_i000_008592	128	445	317	0.960606	0.624016
GCA_000827485.1-Fun_KN818232.1_i000_004607	133	455	322	0.975758	0.567901
GCA_000691765.2-Fun_KK667235.1_i000_004376	128	447	319	0.966667	0.618217
GCA_000773735.1-Fun_AJIW01000038.1_i000_003503	128	447	319	0.966667	0.618217
GCA_000773805.1-Fun_AJIY01000028.1_i000_002740	128	447	319	0.966667	0.618217
GCA_000774085.1-Fun_AJIT01000028.1_i000_002728	128	447	319	0.966667	0.618217
GCA_000775465.1-Fun_AJIZ01000034.1_i000_003730	128	447	319	0.966667	0.618217
GCA_000784495.1-Fun_AJJE01000025.1_i000_002724	128	447	319	0.966667	0.618217
GCA_000784505.1-Fun_AJJD01000020.1_i000_001497	128	447	319	0.966667	0.618217
GCA_000784615.1-Fun_JPEW01000040.1_i000_003793	128	447	319	0.966667	0.618217
GCA_000784655.1-Fun_JTBX01000052.1_i000_004274	128	447	319	0.966667	0.618217
GCA_013397665.1-Ani_VYZH01001741.1_i000_006956	119	436	317	0.960606	0.571171
GCA_018688675.1-Pla_CM031831.1_i000_014242	120	440	320	0.969697	0.555556
GCA_003691605.1-Fun_CP033149.1_i000_000865	133	461	328	0.993939	0.638132
GCA_013339745.1-Ani_CM023471.1_i000_006135	116	446	330	1	0.613383
GCA_000006405.1-Pro_GG673069.1_i000_002791	112	451	339	1.02727	0.684848
GCA_900332095.2-Pla_OOIL02005040.1_i000_035511	125	458	333	1.00909	0.612132
GCA_002007995.1-Fun_MSRZ01000009.1_i000_004984	137	454	317	0.960606	0.617934
GCA_002008065.1-Fun_MSSA01000044.1_i000_003820	137	454	317	0.960606	0.617934
GCA_002008085.1-Fun_MSSD01000016.1_i000_001324	137	454	317	0.960606	0.617934
GCA_002008095.1-Fun_MSSC01000050.1_i000_004232	137	454	317	0.960606	0.617934
GCA_019207295.1-Fun_JAHLUM010000004.1_i000_003365	132	452	320	0.969697	0.629921
GCA_003290485.1-Fun_CP030252.1_i000_001519	134	460	326	0.987879	0.634241
GCA_011058905.1-Fun_SWKU01000007.1_i000_010551	134	463	329	0.99697	0.635135
GCA_002938375.1-Fun_NHYD01003173.1_i000_011876	127	454	327	0.990909	0.568696
GCA_902498895.1-Fun_CABVLU010000001.1_i000_000823	134	470	336	1.01818	0.667992
GCA_014898675.1-Fun_JACXVL010000065.1_i000_018464	123	455	332	1.00606	0.627599
GCA_000836335.1-Fun_KN847999.1_i000_006171	129	458	329	0.99697	0.580247
GCA_000855695.1-Fun_KN848894.1_i000_002603	129	458	329	0.99697	0.580247
GCA_015499995.1-Fun_JADNRV010000297.1_i000_008719	60	393	333	1.00909	0.705508
COCA004.0722.00001.C001_01565	86	396	310	0.939394	0.765432
GCA_003990745.1-Fun_RBNI01001938.1_i000_002556	123	196	73	0.221212	0.143701
GCA_003990745.1-Fun_RBNI01001938.1_i000_002556	250	506	256	0.775758	0.503937
GCA_902439185.1-Ani_CABPRJ010000972.1_i000_007104	141	456	315	0.954545	0.678879
GCA_002077065.1-Fun_NAJO01000005.1_i000_014258	135	465	330	1	0.567986
GCA_000597685.1-Fun_JEMT01029310.1_i000_025299	120	449	329	0.99697	0.483113
GCA_001593125.1-Fun_LLXH01000163.1_i000_004996	120	449	329	0.99697	0.483113
GCA_001593145.1-Fun_LLXI01000157.1_i000_004369	120	449	329	0.99697	0.483113
GCA_001593205.1-Fun_LLXJ01000250.1_i000_005630	120	449	329	0.99697	0.483113
GCA_903189815.1-Fun_CAEVNS010000051.1_i000_018111	120	449	329	0.99697	0.483113
GCA_903231485.1-Fun_CAFBRS010000195.1_i000_008568	120	449	329	0.99697	0.483113
GCA_903470525.1-Fun_CAGKOT010000025.1_i000_011767	120	449	329	0.99697	0.483113
GCA_001578235.1-Fun_LFZN01000033.1_i000_006494	132	463	331	1.00303	0.595324
GCA_000439145.3-Fun_AUPC02000115.1_i000_001811	120	449	329	0.99697	0.485968
GCA_000002595.3-Pla_CM008971.1_i000_010466	130	442	312	0.945455	0.614173
GCA_910592225.1-Fun_CAJVPR010001555.1_i000_012508	127	456	329	0.99697	0.484536
GCA_000520115.1-Pro_KI914009.1_i000_013795	160	496	336	1.01818	0.649903
GCA_013397245.1-Ani_VZTB01008355.1_i000_006063	117	433	316	0.957576	0.589552
GCA_001466705.1-Fun_LATX01001400.1_i000_005433	122	434	312	0.945455	0.574586
GCA_003260385.1-Pla_NQVE01000162.1_i000_009325	125	457	332	1.00606	0.608059
GCA_003203555.1-Fun_BEXD01003112.1_i000_017133	125	448	323	0.978788	0.479941
GCA_015698045.1-Fun_BLAL01000300.1_i000_026967	125	448	323	0.978788	0.479941
GCA_001630345.1-Fun_KV417284.1_i000_005401	127	462	335	1.01515	0.650485
GCA_010094035.1-Fun_ML987209.1_i000_015370	130	463	333	1.00909	0.640385
GCA_004011995.1-Pla_QGNW01000010.1_i000_004948	196	497	301	0.912121	0.499171
GCA_013400995.1-Ani_VZUB01000021.1_i000_000029	122	436	314	0.951515	0.598095
PYAE001.0722.00001.C001_02278	98	398	300	0.909091	0.712589
GCA_001578225.1-Fun_LFZO01000045.1_i000_006575	134	463	329	0.99697	0.592793
GCA_001659605.2-Pla_CM004395.2_i000_017501	122	439	317	0.960606	0.550347
GCA_003112345.1-Pla_PKPP01006046.1_i000_039165	9	317	308	0.933333	0.900585
GCA_021605115.1-Pla_BMAR01000001.1_i000_000516	128	440	312	0.945455	0.616601
GCA_000006335.3-Fun_GG692404.1_i000_005862	128	436	308	0.933333	0.608696
GCA_017315405.1-Fun_JAFIQD010000004.1_i000_003713	128	436	308	0.933333	0.608696
GCA_013115115.1-Pro_JABAHT010000751.1_i000_009321	114	452	338	1.02424	0.678715
GCA_013115135.1-Pro_JABANP010000028.1_i000_006084	114	452	338	1.02424	0.678715
GCA_000488995.1-Fun_AWSO01000361.1_i000_007277	136	452	316	0.957576	0.566308
GCA_000816705.1-Ani_KN716157.1_i000_000820	119	449	330	1	0.666667
GCA_002105055.1-Fun_MCGR01000018.1_i000_002627	128	456	328	0.993939	0.615385
GCA_018924745.1-Fun_CM032185.1_i000_007515	126	453	327	0.990909	0.611215
GCA_019616945.1-Fun_WSTK01000353.1_i000_006869	126	453	327	0.990909	0.595628
GCA_016758785.1-Fun_JABBWO010000003.1_i000_006308	133	457	324	0.981818	0.568421
GCA_016695485.1-Fun_MU172310.1_i000_008926	127	453	326	0.987879	0.575972
GCA_014905175.1-Ani_CM026523.1_i000_006144	93	428	335	1.01515	0.613553
GCA_008704605.1-Fun_SWFS01000028.1_i000_005826	132	450	318	0.963636	0.616279
GCA_014188975.1-Fun_JACGCI010000007.1_i000_021715	123	451	328	0.993939	0.569444
GCA_000695605.1-Pla_KK785075.1_i000_018297	1	288	287	0.869697	0.724747
GCA_014904975.1-Fun_MU127787.1_i000_001541	139	452	313	0.948485	0.559928
GCA_017607575.1-Fun_JABAJY010007836.1_i000_009574	123	455	332	1.00606	0.636015
GCA_002127325.2-Pla_CM007896.2_i000_025906	123	443	320	0.969697	0.585009
GCA_000326865.1-Ani_KB096742.1_i000_011094	117	445	328	0.993939	0.447476
GCA_001970955.1-Pro_MPUH01000347.1_i000_016622	119	443	324	0.981818	0.713656
GCA_000292625.1-Fun_JH795855.1_i000_000528	123	452	329	0.99697	0.549249
GCA_000003195.3-Pla_CM000760.3_i000_003905	131	441	310	0.939394	0.544815
GCA_015952705.1-Pla_CM027680.1_i000_003967	131	441	310	0.939394	0.544815
GCA_014851425.1-Pla_CM026263.1_i000_011034	115	441	326	0.987879	0.591652
GCA_000149685.1-Fun_CH981530.1_i000_000779	129	447	318	0.963636	0.6139
GCA_004679275.1-Fun_SEOQ01000172.1_i000_003261	138	452	314	0.951515	0.428962
GCA_000004155.2-Fun_KE546988.1_i000_001011	126	447	321	0.972727	0.63189
GCA_015731905.1-Pla_CM027663.1_i000_007313	139	461	322	0.975758	0.545763
GCA_008629635.1-Fun_NQVO01000034.1_i000_005646	87	461	374	1.13333	0.630691
GCA_004115385.1-Pla_CM014060.1_i000_028826	692	1015	323	0.978788	0.286856
GCA_022496215.1-Fun_WTXF01000087.1_i000_013082	131	448	317	0.960606	0.546552
GCA_021014935.1-Fun_MU267593.1_i000_000652	136	454	318	0.963636	0.554007
GCA_014065205.1-Fun_JACCEG010000262.1_i000_004808	127	447	320	0.969697	0.701754
GCA_018687715.1-Pla_CM031815.1_i000_014436	120	440	320	0.969697	0.556522
GCA_916048055.1-Pla_CAJZHL010000032.1_i000_007694	122	440	318	0.963636	0.657025
GCA_001572075.1-Fun_JOOL01000710.1_i000_004759	132	458	326	0.987879	0.572935
GCA_001592465.1-Fun_JPDO01000113.1_i000_000713	132	458	326	0.987879	0.572935
GCA_004369055.1-Fun_ML211043.1_i000_004495	121	456	335	1.01515	0.59292
GCA_009733145.1-Pro_QXFT01003113.1_i000_025609	117	448	331	1.00303	0.667339
GCA_900618405.1-Ani_UYSL01007859.1_i000_004331	3	326	323	0.978788	0.936232
GCA_905332375.1-Ani_CAJOBZ010000012.1_i000_005967	127	456	329	0.99697	0.716776
GCA_020536535.1-Pro_JAHLWZ010000972.1_i000_014862	130	455	325	0.984848	0.438596
GCA_019207455.1-Fun_JAHLUW010000004.1_i000_003437	137	453	316	0.957576	0.628231
GCA_019207555.1-Fun_JAHLUY010000005.1_i000_004192	137	453	316	0.957576	0.628231
GCA_019207615.1-Fun_JAHLVC010000003.1_i000_002984	137	453	316	0.957576	0.628231
GCA_000442015.1-Fun_KE560826.1_i000_001611	1	284	283	0.857576	0.825073
GCA_003614725.1-Fun_ML005899.1_i000_004879	1	284	283	0.857576	0.825073
GCA_000005215.1-Ani_CH480818.1_i000_008864	130	448	318	0.963636	0.624754
GCA_001983325.1-Fun_MQVM01000028.1_i000_004271	125	458	333	1.00909	0.67002
GCA_001593155.1-Fun_LLXL01000620.1_i000_010646	119	448	329	0.99697	0.483824
GCA_903189765.1-Fun_CAEVNM010000004.1_i000_004766	119	448	329	0.99697	0.483824
GCA_903470595.1-Fun_CAGKPD010000054.1_i000_016194	119	448	329	0.99697	0.483824
GCA_019925795.1-Pla_CM034311.1_i000_016400	127	441	314	0.951515	0.505636
GCA_019616325.1-Fun_WSTG01003581.1_i000_013477	44	363	319	0.966667	0.630435
GCA_905219545.1-Fun_CAJMWQ010000964.1_i000_003054	131	450	319	0.966667	0.55286
GCA_000271625.1-Fun_JH711577.1_i000_005736	132	456	324	0.981818	0.566434
GCA_905249995.1-Ani_CAJNOK010005501.1_i000_013279	117	449	332	1.00606	0.601449
GCA_905250885.1-Ani_CAJNOQ010006477.1_i000_020474	117	449	332	1.00606	0.601449
GCA_905332065.1-Ani_CAJOBC010006477.1_i000_020471	117	449	332	1.00606	0.601449
GCA_905332075.1-Ani_CAJOBA010005507.1_i000_013282	117	449	332	1.00606	0.601449
GCA_002049455.2-Pro_KV918798.1_i000_002430	142	471	329	0.99697	0.598182
GCA_015852605.2-Pla_CM027574.2_i000_009828	681	1001	320	0.969697	0.284698
GCA_014298035.1-Fun_JABCIY010000157.1_i000_007117	141	462	321	0.972727	0.578378
GCA_002926055.1-Fun_PKFO01000003.1_i000_001616	128	446	318	0.963636	0.605714
GCA_005498985.1-Fun_CM016686.1_i000_002042	125	459	334	1.01212	0.573883
GCA_000151265.1-Pla_GG663736.1_i000_009036	129	440	311	0.942424	0.663113
GCA_003144245.1-Fun_KZ819662.1_i000_000697	125	458	333	1.00909	0.597846
GCA_004117975.1-Fun_SDIL01000011.1_i000_000718	136	468	332	1.00606	0.562712
GCA_009732905.1-Pro_QXFV01003243.1_i000_024789	112	449	337	1.02121	0.675351
GCA_009732945.1-Pro_QXFU01002360.1_i000_022235	112	449	337	1.02121	0.675351
GCA_000827335.1-Fun_KN831978.1_i000_012257	136	456	320	0.969697	0.594796
GCA_900332095.2-Pla_OOIL02000203.1_i000_003455	125	457	332	1.00606	0.608059
GCA_000827355.1-Fun_KN831781.1_i000_008878	123	457	334	1.01212	0.62782
GCA_905332125.1-Ani_CAJOBJ010002897.1_i000_008783	2	327	325	0.984848	0.967262
GCA_014925825.1-Fun_JACGCK010000398.1_i000_010658	141	456	315	0.954545	0.54878
GCA_012184645.1-Fun_WYDC01000010.1_i000_000235	128	447	319	0.966667	0.612284
GCA_012184655.1-Fun_WYDD01000010.1_i000_000176	128	447	319	0.966667	0.612284
GCA_905221615.1-Pro_CAJNDT010003613.1_i000_028167	120	449	329	0.99697	0.506154
GCA_001632345.1-Fun_KV429033.1_i000_000800	134	451	317	0.960606	0.552265
GCA_013400255.1-Ani_VXBS01003965.1_i000_004795	115	434	319	0.966667	0.640562
GCA_000262585.1-Ani_JH668497.1_i000_008138	128	457	329	0.99697	0.713666
GCA_005059855.1-Fun_NAJP01000007.1_i000_015146	134	465	331	1.00303	0.596396
GCA_003112345.1-Pla_PKPP01000085.1_i000_001739	136	443	307	0.930303	0.560219
GCA_019155685.1-Pro_JAGDFL010000110.1_i000_000646	113	449	336	1.01818	0.676056
GCA_018397855.1-Fun_JAGFBS010000016.1_i000_003335	125	454	329	0.99697	0.574171
GCA_000507405.3-Fun_KI669498.1_i000_002679	133	462	329	0.99697	0.548333
GCA_000507365.1-Ani_KI658197.1_i000_003884	125	449	324	0.981818	0.72
GCA_003324165.2-Pro_PYSW02000031.1_i000_010118	115	447	332	1.00606	0.709402
GCA_004681135.1-Fun_SFCI01000053.1_i000_008198	128	453	325	0.984848	0.617871
GCA_019049425.1-Fun_JAHMUF010000022.1_i000_002534	129	449	320	0.969697	0.629921
GCA_009733045.1-Pro_QXGC01001680.1_i000_019626	117	448	331	1.00303	0.655446
GCA_010093715.1-Fun_MU005794.1_i000_013133	132	463	331	1.00303	0.637765
GCA_014904835.1-Fun_MU120944.1_i000_005663	122	453	331	1.00303	0.601818
GCA_000182965.3-Fun_CP017628.1_i000_004282	128	447	319	0.966667	0.618217
GCA_000773725.1-Fun_AJIX01000033.1_i000_003750	128	447	319	0.966667	0.618217
GCA_000773745.1-Fun_AJIU01000026.1_i000_002745	128	447	319	0.966667	0.618217
GCA_000773825.1-Fun_AJJA01000027.1_i000_003307	128	447	319	0.966667	0.618217
GCA_000773845.1-Fun_AJIQ01000031.1_i000_002949	128	447	319	0.966667	0.618217
GCA_000775445.1-Fun_AJIV01000035.1_i000_003303	128	447	319	0.966667	0.618217
GCA_000775455.1-Fun_AJIR01000035.1_i000_003194	128	447	319	0.966667	0.618217
GCA_000775525.1-Fun_AJJC01000035.1_i000_003475	128	447	319	0.966667	0.618217
GCA_000784515.1-Fun_JSXQ01000031.1_i000_002411	128	447	319	0.966667	0.618217
GCA_000784525.1-Fun_JSXP01000026.1_i000_002750	128	447	319	0.966667	0.618217
GCA_000784575.1-Fun_JSXR01000035.1_i000_003665	128	447	319	0.966667	0.618217
GCA_000784595.1-Fun_JPEV01000034.1_i000_003566	128	447	319	0.966667	0.618217
GCA_000784695.1-Fun_AJJG01000050.1_i000_001764	128	447	319	0.966667	0.618217
GCA_014049485.1-Fun_JABWAD010000022.1_i000_002115	128	447	319	0.966667	0.618217
GCA_018857265.1-Fun_JABAJZ010000029.1_i000_000683	52	367	315	0.954545	0.649485
GCA_015499995.1-Fun_JADNRV010000131.1_i000_003043	123	455	332	1.00606	0.620561
GCA_000005245.1-Ani_CH940649.1_i000_007089	126	449	323	0.978788	0.623552
GCA_015499995.1-Fun_JADNRV010000053.1_i000_013587	123	456	333	1.00909	0.620112
GCA_003014415.1-Fun_PYGM01000032.1_i000_002455	132	458	326	0.987879	0.646825
GCA_008275145.1-Fun_CP043442.1_i000_001305	132	458	326	0.987879	0.646825
GCA_000827265.1-Fun_KN834816.1_i000_017306	120	435	315	0.954545	0.564516
GCA_001882365.1-Fun_LVVM01006558.1_i000_013935	126	455	329	0.99697	0.578207
GCA_000005155.1-Ani_CH916372.1_i000_005073	131	448	317	0.960606	0.619141
GCA_001638945.1-Fun_AMYB01000001.1_i000_000554	119	450	331	1.00303	0.659363
GCA_010203745.1-Fun_JAAECE010000004.1_i000_006746	119	450	331	1.00303	0.659363
GCA_013053245.1-Fun_JAACJL010000032.1_i000_002822	129	448	319	0.966667	0.319
GCA_009735665.1-Ani_MQTX01000085.1_i000_003259	118	446	328	0.993939	0.668024
GCA_000832345.2-Fun_LN679103.1_i000_000379	131	451	320	0.969697	0.56239
GCA_000275845.1-Fun_JH719404.1_i000_004652	134	454	320	0.969697	0.564374
GCA_004307905.1-Fun_ML145099.1_i000_004999	134	454	320	0.969697	0.564374
GCA_004307915.1-Fun_ML143826.1_i000_000371	134	454	320	0.969697	0.564374
GCA_004307925.1-Fun_ML143396.1_i000_004007	134	454	320	0.969697	0.564374
GCA_013368445.1-Fun_JAACJO010000001.1_i000_000941	137	453	316	0.957576	0.556338
GCA_020091625.1-Fun_JAGYZC010000004.1_i000_006969	123	460	337	1.02121	0.634652
GCA_004117975.1-Fun_SDIL01000052.1_i000_005807	132	459	327	0.990909	0.547739
GCA_018688675.1-Pla_CM031831.1_i000_014240	122	439	317	0.960606	0.550347
GCA_018689175.1-Pla_CM031847.1_i000_013390	122	439	317	0.960606	0.550347
GCA_009729455.1-Pro_QWGH01000011.1_i000_003576	117	450	333	1.00909	0.667335
GCA_009732925.1-Pro_QXFW01001672.1_i000_019550	117	450	333	1.00909	0.667335
GCA_009732985.1-Pro_QXGB01001738.1_i000_020885	117	450	333	1.00909	0.667335
GCA_009733005.1-Pro_QXFX01001698.1_i000_020179	117	450	333	1.00909	0.667335
GCA_009733025.1-Pro_QXGA01001659.1_i000_019704	117	450	333	1.00909	0.667335
GCA_009733065.1-Pro_QXFZ01001720.1_i000_020914	117	450	333	1.00909	0.667335
GCA_009733085.1-Pro_QXGD01001748.1_i000_022012	117	450	333	1.00909	0.667335
GCA_009733105.1-Pro_QXGE01001667.1_i000_019895	117	450	333	1.00909	0.667335
GCA_009733125.1-Pro_QXFY01001720.1_i000_020302	117	450	333	1.00909	0.667335
GCA_015584075.1-Fun_MU150255.1_i000_005724	124	442	318	0.963636	0.553043
GCA_000935105.1-Fun_KN905632.1_i000_005325	129	458	329	0.99697	0.580247
GCA_018687715.1-Pla_CM031815.1_i000_014434	120	439	319	0.966667	0.553819
GCA_009805615.1-Ani_VIIS01000589.1_i000_006849	111	444	333	1.00909	0.564407
GCA_016808215.1-Pla_CM029002.1_i000_014268	120	439	319	0.966667	0.55286
GCA_000827315.1-Fun_KN833001.1_i000_011473	83	409	326	0.987879	0.673554
GCA_001687445.1-Fun_KV722382.1_i000_005074	124	452	328	0.993939	0.618868
GCA_015178925.1-Fun_WHVC01000046.1_i000_009380	123	451	328	0.993939	0.605166
GCA_014461115.1-Fun_JACAZE010000006.1_i000_004747	124	454	330	1	0.574913
GCA_001266575.1-Ani_JTDY01001244.1_i000_005128	85	412	327	0.990909	0.589189
GCA_000827335.1-Fun_KN831967.1_i000_009860	124	454	330	1	0.629771
GCA_916720795.1-Ani_CAKASE010000058.1_i000_007862	117	444	327	0.990909	0.597806
MEVU001.0722.00001.C001_00353	79	413	334	1.01212	0.795238
GCA_021365275.1-Fun_JAJTIY010000006.1_i000_014123	133	462	329	0.99697	0.648915
GCA_019202705.1-Fun_JAGSYN010000178.1_i000_002705	131	450	319	0.966667	0.609943
GCA_019207525.1-Fun_JAHLVB010000005.1_i000_003912	137	453	316	0.957576	0.628231
GCA_019207605.1-Fun_JAHLVD010000004.1_i000_003810	137	453	316	0.957576	0.628231
GCA_016758755.1-Fun_JABBWM010000035.1_i000_008725	127	454	327	0.990909	0.603321
GCA_022376455.1-Fun_JACBKO010000004.1_i000_007804	122	439	317	0.960606	0.563055
GCA_002104995.1-Fun_MCFD01000002.1_i000_004742	120	461	341	1.03333	0.734914
GCA_000003195.3-Pla_CM000761.3_i000_009895	123	460	337	1.02121	0.59646
GCA_015952705.1-Pla_CM027681.1_i000_010086	123	460	337	1.02121	0.59646
GCA_019623665.1-Fun_WSTM01000435.1_i000_008850	124	459	335	1.01515	0.564924
GCA_000827255.1-Fun_KN835230.1_i000_006933	138	456	318	0.963636	0.591078
GCA_916720795.1-Ani_CAKASE010000062.1_i000_008717	126	455	329	0.99697	0.719912
GCA_002006685.1-Fun_LYON01000394.1_i000_003061	117	446	329	0.99697	0.643836
GCA_020617715.1-Fun_JAFDOV010000985.1_i000_007714	117	446	329	0.99697	0.643836
GCA_020617735.1-Fun_JAFCIX010000332.1_i000_004987	117	446	329	0.99697	0.643836
GCA_021556675.1-Fun_JAKFGI010000038.1_i000_006485	117	446	329	0.99697	0.643836
GCA_019627725.1-Fun_WSTQ01000283.1_i000_006036	127	454	327	0.990909	0.551433
GCA_019627735.1-Fun_WSTP01000103.1_i000_000233	127	454	327	0.990909	0.551433
GCA_019627755.1-Fun_WSTS01000191.1_i000_003469	127	454	327	0.990909	0.551433
GCA_019633565.1-Fun_WSUH01000213.1_i000_003935	127	454	327	0.990909	0.551433
GCA_000300595.1-Fun_JH930476.1_i000_010308	127	450	323	0.978788	0.608286
GCA_011800875.2-Fun_JRHT02000116.1_i000_001944	132	452	320	0.969697	0.594796
GCA_009498055.1-Fun_CP038484.1_i000_000754	129	445	316	0.957576	0.613592
GCA_009498075.1-Fun_CP039550.1_i000_000423	129	445	316	0.957576	0.613592
GCA_009498095.1-Fun_CP039652.1_i000_000429	129	445	316	0.957576	0.613592
GCA_009498115.1-Fun_CP039660.1_i000_000429	129	445	316	0.957576	0.613592
GCA_009498135.1-Fun_CP039618.1_i000_000429	129	445	316	0.957576	0.613592
GCA_000091045.1-Fun_AE017346.1_i000_003332	130	460	330	1	0.580986
GCA_001882365.1-Fun_LVVM01006541.1_i000_013894	122	454	332	1.00606	0.619403
GCA_000835755.1-Fun_KN848862.1_i000_003081	129	458	329	0.99697	0.580247
GCA_000149385.1-Fun_CM000045.1_i000_003725	130	459	329	0.99697	0.582301
GCA_019511825.2-Pla_QFCC02000009.1_i000_038220	117	442	325	0.984848	0.590909
GCA_019968535.1-Ani_JAIFTH010000014.1_i000_002079	114	427	313	0.948485	0.731308
GCA_014904945.1-Fun_MU127426.1_i000_005251	129	454	325	0.984848	0.569177
GCA_014607435.1-Fun_JAACFV010000096.1_i000_012365	127	457	330	1	0.635838
GCA_018296085.1-Fun_JACKQM010000829.1_i000_000943	141	477	336	1.01818	0.612022
GCA_003675555.2-Fun_QOBI02000001.1_i000_000392	129	445	316	0.957576	0.610039
GCA_019633425.1-Fun_WSUB01000017.1_i000_003413	129	463	334	1.01212	0.607273
GCA_019633485.1-Fun_WSUC01000014.1_i000_002233	129	463	334	1.01212	0.607273
GCA_002938385.1-Fun_NHYE01001291.1_i000_004989	135	456	321	0.972727	0.315015
GCA_000003835.1-Fun_CH408076.1_i000_004256	129	445	316	0.957576	0.608863
GCA_021525775.1-Fun_JAKELK010000045.1_i000_012409	120	434	314	0.951515	0.599237
GCA_018282005.1-Fun_JABCKV010000119.1_i000_005429	118	453	335	1.01515	0.638095
GCA_022376465.1-Fun_JACDTU010000011.1_i000_001913	121	450	329	0.99697	0.60367
GCA_021014945.1-Fun_MU266335.1_i000_001346	134	458	324	0.981818	0.5625
GCA_900536885.1-Fun_UWZB01000051.1_i000_003333	126	449	323	0.978788	0.608286
GCA_000835745.1-Fun_KN848565.1_i000_000470	128	457	329	0.99697	0.581272
GCA_000185945.1-Fun_CP000291.1_i000_003921	129	458	329	0.99697	0.580247
GCA_000875815.1-Fun_KN849083.1_i000_006630	129	458	329	0.99697	0.580247
GCA_021442195.1-Pla_CM038194.1_i000_001168	128	443	315	0.954545	0.544983
GCA_019633595.1-Fun_WSUI01000211.1_i000_004443	125	458	333	1.00909	0.607664
GCA_003013735.1-Fun_PYFQ01000001.1_i000_001171	128	447	319	0.966667	0.626719
GCA_000182895.1-Fun_AACS02000005.1_i000_006077	132	454	322	0.975758	0.565905
GCA_016772295.1-Fun_JAAGWA010000005.1_i000_007463	132	454	322	0.975758	0.565905
GCA_003851025.1-Fun_BFAD01000005.1_i000_006116	126	450	324	0.981818	0.598891
GCA_014108235.1-Ani_JABWUV010000008.1_i000_019708	129	443	314	0.951515	0.581481
GCA_021904315.1-Pla_CM038907.1_i000_001088	129	439	310	0.939394	0.536332
GCA_016695475.1-Fun_MU172964.1_i000_009027	127	453	326	0.987879	0.602588
GCA_003521335.2-Ani_QWLN02003564.1_i000_003019	129	446	317	0.960606	0.590317
GCA_010093505.1-Fun_MU001637.1_i000_006499	135	465	330	1	0.59246
GCA_014636115.1-Fun_JAASFG010000001.1_i000_000714	129	445	316	0.957576	0.59962
GCA_000827475.1-Fun_KN819325.1_i000_001796	128	455	327	0.990909	0.571678
GCA_016628075.1-Fun_JABBWC010000027.1_i000_007636	135	454	319	0.966667	0.559649
GCA_016758765.1-Fun_JABBWL010000049.1_i000_014131	127	454	327	0.990909	0.604436
GCA_008330635.1-Pro_VLTL01000002.1_i000_000208	124	460	336	1.01818	0.649903
GCA_008330645.1-Pro_VLTN01000041.1_i000_005793	124	460	336	1.01818	0.649903
GCA_008330665.1-Pro_VLTO01000005.1_i000_001379	124	460	336	1.01818	0.649903
GCA_016758775.1-Fun_JABBWN010000013.1_i000_002665	126	455	329	0.99697	0.576182
GCA_001477535.1-Fun_LFWA01000015.1_i000_001303	121	454	333	1.00909	0.649123
PYFE001.0722.00001.C001_01472	99	399	300	0.909091	0.712589
GCA_008403515.1-Pro_VFQX01000007.1_i000_012417	118	447	329	0.99697	0.702991
GCA_013677255.1-Pla_CM025222.1_i000_006719	1	255	254	0.769697	0.988327
GCA_001189475.1-Fun_LGST01000052.1_i000_005501	132	458	326	0.987879	0.646825
GCA_002759435.2-Fun_PEKT02000007.1_i000_000157	132	458	326	0.987879	0.646825
GCA_002775015.1-Fun_PGLS01000004.1_i000_000654	132	458	326	0.987879	0.646825
GCA_003013715.2-Fun_CP043531.1_i000_000574	132	458	326	0.987879	0.646825
GCA_007168705.1-Fun_BGOX01000002.1_i000_002492	132	458	326	0.987879	0.646825
GCA_019332045.1-Fun_CP076749.1_i000_001141	132	458	326	0.987879	0.646825
GCA_004155055.1-Fun_QJNZ01000079.1_i000_010424	135	462	327	0.990909	0.638672
GCA_018258275.1-Pla_CM031110.1_i000_029394	97	432	335	1.01515	0.636882
GCA_900661375.1-Ani_CAAGRJ010012530.1_i000_008303	128	445	317	0.960606	0.565062
GCA_000230795.1-Ani_CM001264.1_i000_010579	133	445	312	0.945455	0.588679
GCA_000230815.1-Ani_CM001287.1_i000_009629	133	445	312	0.945455	0.588679
GCA_002880775.3-Ani_CM009264.2_i000_002849	133	445	312	0.945455	0.588679
GCA_019627745.1-Fun_WSTR01000439.1_i000_008854	143	470	327	0.990909	0.535188
GCA_903819665.1-Fun_CAIJEO010000002.1_i000_000107	112	444	332	1.00606	0.656126
GCA_904859935.1-Fun_CAJHEQ010000504.1_i000_004585	136	466	330	1	0.558376
GCA_002938355.1-Fun_NHTK01001074.1_i000_002927	136	451	315	0.954545	0.563506
GCA_016647645.1-Fun_JABBWF010000069.1_i000_014150	127	453	326	0.987879	0.601476
GCA_016647685.1-Fun_JABBWJ010000035.1_i000_009381	127	453	326	0.987879	0.601476
GCA_016647785.1-Fun_JABBWK010000023.1_i000_006909	127	453	326	0.987879	0.601476
GCA_015039465.1-Fun_MU130264.1_i000_006114	122	457	335	1.01515	0.628518
GCA_905146905.1-Ani_CAJHUB010000761.1_i000_018823	130	446	316	0.957576	0.583026
GCA_022160315.1-Fun_MU275177.1_i000_003410	124	455	331	1.00303	0.592129
GCA_015657495.1-Fun_MU157917.1_i000_012352	131	451	320	0.969697	0.542373
GCA_000002945.2-Fun_CU329671.1_i000_002687	136	452	316	0.957576	0.635815
GCA_016647685.1-Fun_JABBWJ010000036.1_i000_009428	127	455	328	0.993939	0.608534
GCA_002271895.2-Pla_CM008442.1_i000_030440	116	442	326	0.987879	0.587387
GCA_013676235.1-Pla_CM025499.1_i000_010142	118	442	324	0.981818	0.570423
GCF_000001405.40-Hum_NC_000002.12_i000_003021	129	446	317	0.960606	0.599244
GCA_005059865.1-Fun_NAJQ01000287.1_i000_006645	119	449	330	1	0.59246
GCA_002880755.3-Ani_CM009240.2_i000_002862	130	435	305	0.924242	0.57656
GCA_000412655.1-Ani_KE161251.1_i000_001540	167	478	311	0.942424	0.542757
GCA_000697645.1-Fun_KL142369.1_i000_003630	122	454	332	1.00606	0.620561
GCA_000327345.1-Ani_KB102035.1_i000_002868	130	446	316	0.957576	0.585185
GCA_000827395.1-Fun_KN824839.1_i000_000865	122	454	332	1.00606	0.601449
GCA_020617195.1-Fun_JAFDOU010001043.1_i000_008612	117	446	329	0.99697	0.647638
GCA_020617725.1-Fun_JAFDOT010000615.1_i000_003491	117	446	329	0.99697	0.647638
GCA_000517465.1-Fun_AWNI01000041.1_i000_005710	127	459	332	1.00606	0.639692
GCA_900245975.1-Ani_OUUW01000006.1_i000_006866	121	446	325	0.984848	0.621415
GCA_015501065.1-Fun_JADNYI010000004.1_i000_012243	120	453	333	1.00909	0.62243
GCA_905332375.1-Ani_CAJOBZ010000023.1_i000_008825	117	444	327	0.990909	0.568696
GCA_000005975.1-Ani_CM000157.2_i000_002824	123	448	325	0.984848	0.638507
GCA_013396955.1-Ani_VWZN01000679.1_i000_000323	123	445	322	0.975758	0.688034
GCA_020509005.2-Fun_CP090173.1_i000_013238	132	461	329	0.99697	0.592793
GCA_003097675.1-Fun_MBFU01000486.1_i000_004785	120	450	330	1	0.625
GCA_000143185.1-Fun_GL377304.1_i000_005221	129	457	328	0.993939	0.605166
GCA_902860255.1-Pla_LR794324.1_i000_008811	122	443	321	0.972727	0.588991
GCA_022376465.1-Fun_JACDTU010000008.1_i000_011464	131	449	318	0.963636	0.561837
GCA_020875895.1-Ani_JNEY01000011.1_i000_005477	110	443	333	1.00909	0.668675
GCA_014462655.1-Fun_JACAZI010000032.1_i000_022733	127	451	324	0.981818	0.5625
GCA_000827495.1-Fun_KN817539.1_i000_006296	123	458	335	1.01515	0.630885
GCA_001720195.1-Fun_AWGK01000033.1_i000_004428	132	460	328	0.993939	0.578483
GCA_001720245.1-Fun_AWGL01000001.1_i000_000012	132	460	328	0.993939	0.578483
GCA_019112545.1-Fun_MU250535.1_i000_007362	131	452	321	0.972727	0.590074
GCA_000320565.2-Fun_KB456270.1_i000_008902	130	465	335	1.01515	0.613553
GCA_002234625.1-Fun_AMKQ01000027.1_i000_003902	130	458	328	0.993939	0.578483
GCA_900106115.1-Fun_LT635756.1_i000_000778	141	452	311	0.942424	0.617063
GCA_900106125.1-Fun_LT635764.1_i000_000815	141	452	311	0.942424	0.617063
GCA_000149245.3-Fun_CP003826.1_i000_004164	130	458	328	0.993939	0.577465
GCA_002215705.1-Fun_AMKS01000031.1_i000_004912	130	458	328	0.993939	0.577465
GCA_002215745.1-Fun_NKHX01000143.1_i000_001433	130	458	328	0.993939	0.577465
GCA_002215755.1-Fun_NKHW01000148.1_i000_001486	130	458	328	0.993939	0.577465
GCA_002215765.1-Fun_AMLA01000241.1_i000_002318	130	458	328	0.993939	0.577465
GCA_002215775.1-Fun_AMLG01000081.1_i000_006028	130	458	328	0.993939	0.577465
GCA_002215825.1-Fun_AMLK01000055.1_i000_004229	130	458	328	0.993939	0.577465
GCA_002215835.1-Fun_AMKP01000031.1_i000_004691	130	458	328	0.993939	0.577465
GCA_002215855.1-Fun_AMKX01000293.1_i000_002495	130	458	328	0.993939	0.577465
GCA_002215885.1-Fun_AMKM01000019.1_i000_002851	130	458	328	0.993939	0.577465
GCA_002216725.1-Fun_CP022327.1_i000_004163	130	458	328	0.993939	0.577465
GCA_002217545.1-Fun_APKM01000303.1_i000_002957	130	458	328	0.993939	0.577465
GCA_002220035.1-Fun_AMKW01000322.1_i000_003131	130	458	328	0.993939	0.577465
GCA_002220445.1-Fun_AMLJ01000158.1_i000_001676	130	458	328	0.993939	0.577465
GCA_002221985.1-Fun_APKI01000187.1_i000_001986	130	458	328	0.993939	0.577465
GCA_002222015.1-Fun_APKO01000253.1_i000_002626	130	458	328	0.993939	0.577465
GCA_002222025.1-Fun_APKS01000297.1_i000_002651	130	458	328	0.993939	0.577465
GCA_002222095.1-Fun_APKP01000289.1_i000_002808	130	458	328	0.993939	0.577465
GCA_002222115.1-Fun_APKR01000290.1_i000_002463	130	458	328	0.993939	0.577465
GCA_002222135.1-Fun_APKK01000254.1_i000_002318	130	458	328	0.993939	0.577465
GCA_002222145.1-Fun_APKQ01000236.1_i000_002144	130	458	328	0.993939	0.577465
GCA_002222155.1-Fun_APKL01000312.1_i000_002747	130	458	328	0.993939	0.577465
GCA_002222165.1-Fun_APKT01000232.1_i000_002222	130	458	328	0.993939	0.577465
GCA_002222215.1-Fun_APKH01000189.1_i000_001886	130	458	328	0.993939	0.577465
GCA_002222225.1-Fun_AMLE01000372.1_i000_003671	130	458	328	0.993939	0.577465
GCA_002222245.1-Fun_APKJ01000209.1_i000_001967	130	458	328	0.993939	0.577465
GCA_002222295.1-Fun_AMLB01000264.1_i000_003216	130	458	328	0.993939	0.577465
GCA_002222315.1-Fun_AMKY01000049.1_i000_003545	130	458	328	0.993939	0.577465
GCA_002222325.1-Fun_AMKT01000056.1_i000_004765	130	458	328	0.993939	0.577465
GCA_002222335.1-Fun_AMKU01000019.1_i000_003112	130	458	328	0.993939	0.577465
GCA_002222385.1-Fun_AMKN01000077.1_i000_005713	130	458	328	0.993939	0.577465
GCA_002222395.1-Fun_AMLD01000245.1_i000_002795	130	458	328	0.993939	0.577465
GCA_002222405.1-Fun_AMLC01000083.1_i000_005801	130	458	328	0.993939	0.577465
GCA_002222455.1-Fun_AMKZ01000232.1_i000_002448	130	458	328	0.993939	0.577465
GCA_002222465.1-Fun_AMKV01000018.1_i000_002195	130	458	328	0.993939	0.577465
GCA_002222475.1-Fun_AMKO01000027.1_i000_003155	130	458	328	0.993939	0.577465
GCA_002224005.1-Fun_AMLF01000028.1_i000_002839	130	458	328	0.993939	0.577465
GCA_001632365.1-Fun_KV427612.1_i000_003761	124	449	325	0.984848	0.629845
GCA_003086725.1-Fun_MBFT01000397.1_i000_003831	120	450	330	1	0.617978
GCA_000827185.1-Fun_KN839846.1_i000_006170	126	451	325	0.984848	0.613208
GCA_004837865.1-Pla_CM017195.1_i000_021379	1022	1339	317	0.960606	0.212895
GCA_000147195.1-Ani_GL446332.1_i000_002170	128	445	317	0.960606	0.46963
GCA_001673695.2-Fun_LYUB02000010.1_i000_003396	129	445	316	0.957576	0.610039
GCA_000005925.1-Ani_CH963920.1_i000_006036	121	446	325	0.984848	0.629845
GCA_002307675.1-Fun_KZ293421.1_i000_006310	133	453	320	0.969697	0.565371
GCA_010015615.1-Fun_ML976617.1_i000_008935	131	464	333	1.00909	0.644101
GCA_016413885.1-Pla_CM028168.1_i000_011931	127	441	314	0.951515	0.529511
GCA_004155945.1-Fun_QJNY01000123.1_i000_001186	140	464	324	0.981818	0.63035
GCA_019049425.1-Fun_JAHMUF010000022.1_i000_002593	128	458	330	1	0.66
GCA_000827355.1-Fun_KN831777.1_i000_007376	135	455	320	0.969697	0.558464
GCA_016647645.1-Fun_JABBWF010000027.1_i000_008370	127	455	328	0.993939	0.57645
GCA_016647785.1-Fun_JABBWK010000015.1_i000_003858	127	455	328	0.993939	0.57645
GCA_000259055.1-Ani_CM000361.1_i000_000874	123	447	324	0.981818	0.635294
GCA_000754195.3-Ani_CM002910.1_i000_000890	123	447	324	0.981818	0.635294
GCA_016758775.1-Fun_JABBWN010000015.1_i000_003840	127	453	326	0.987879	0.613936
GCA_016695475.1-Fun_MU172948.1_i000_007385	127	455	328	0.993939	0.57645
GCA_000803125.3-Ani_CM016631.2_i000_003613	120	432	312	0.945455	0.59542
GCA_905219655.1-Fun_CAJMXA010003889.1_i000_008149	131	451	320	0.969697	0.56239
GCA_001876935.1-Pla_CM007385.1_i000_011577	111	428	317	0.960606	0.571171
GCA_001658105.1-Fun_KV448170.1_i000_003125	122	453	331	1.00303	0.61183
GCA_015039355.1-Fun_MU135458.1_i000_020150	124	451	327	0.990909	0.628846
GCA_008629635.1-Fun_NQVO01000022.1_i000_004487	131	465	334	1.01212	0.590106
GCA_001447755.1-Ani_JYDO01000001.1_i000_004144	147	484	337	1.02121	0.586087
GCA_002307695.1-Fun_KZ293645.1_i000_002026	133	453	320	0.969697	0.565371
GCA_000512255.2-Pla_CM008466.1_i000_030161	116	442	326	0.987879	0.587387
GCA_000005135.1-Ani_CH954177.1_i000_012850	131	447	316	0.957576	0.622047
GCA_002220045.1-Fun_NKHY01000073.1_i000_006290	130	458	328	0.993939	0.577465
GCA_016758755.1-Fun_JABBWM010000003.1_i000_007721	127	454	327	0.990909	0.578761
GCA_905332335.1-Ani_CAJOBX010001400.1_i000_002987	11	281	270	0.818182	0.957447
GCA_019650175.1-Pla_BNCO01000003.1_i000_001800	123	443	320	0.969697	0.546075
GCA_013368325.1-Fun_JAACJK010000225.1_i000_009868	126	456	330	1	0.615672
GCA_014066315.1-Fun_JACCJB010000020.1_i000_005163	129	465	336	1.01818	0.651163
GCA_000006405.1-Pro_GG679756.1_i000_022931	118	453	335	1.01515	0.676768
GCA_000747765.1-Fun_DF830086.1_i000_000971	127	458	331	1.00303	0.6341
GCA_900322835.1-Fun_OOIQ01000021.1_i000_006493	127	458	331	1.00303	0.6341
GCA_016758785.1-Fun_JABBWO010000103.1_i000_001082	128	454	326	0.987879	0.599265
GCA_900323505.1-Fun_OOIN01000011.1_i000_005949	125	459	334	1.01212	0.573883
GCA_000832265.1-Fun_KN840509.1_i000_006068	123	448	325	0.984848	0.617871
GCA_000836255.1-Fun_DF938581.1_i000_008065	137	468	331	1.00303	0.550749
GCA_014925825.1-Fun_JACGCK010000141.1_i000_003340	147	464	317	0.960606	0.543739
GCA_013390105.1-Ani_WAAG01066741.1_i000_007686	116	398	282	0.854545	0.708543
GCA_018857285.1-Fun_JABAKA010008047.1_i000_005153	122	452	330	1	0.626186
GCA_900199415.2-Ani_FZQP02000471.1_i000_002367	116	443	327	0.990909	0.604436
GCA_014066305.1-Fun_JACCJC010000002.1_i000_001005	130	467	337	1.02121	0.653101
GCA_015179015.1-Fun_WHUW01000002.1_i000_006542	137	454	317	0.960606	0.599244
GCA_002352805.1-Ani_KZ348470.1_i000_011721	153	482	329	0.99697	0.627863
GCA_016767475.1-Fun_MU179310.1_i000_005984	137	455	318	0.963636	0.5878
GCA_014925795.1-Fun_WIQF01000090.1_i000_017715	128	453	325	0.984848	0.569177
GCA_020736565.1-Fun_JAHBOF010000004.1_i000_017203	132	452	320	0.969697	0.553633
GCA_015501595.1-Fun_JADNRX010000005.1_i000_020243	134	452	318	0.963636	0.574007
GCA_000230445.1-Ani_JH172931.1_i000_018275	88	402	314	0.951515	0.638211
GCA_016647745.1-Fun_JABBWE010000014.1_i000_003297	127	453	326	0.987879	0.601476
GCA_001879085.1-Pla_CM007397.1_i000_008263	123	442	319	0.966667	0.572711
GCA_000005005.6-Pla_CM007647.1_i000_001531	131	441	310	0.939394	0.549645
GCA_009650685.1-Fun_CM018860.1_i000_000430	129	458	329	0.99697	0.580247
GCA_000298355.1-Ani_JH882248.1_i000_012908	114	424	310	0.939394	0.589354
GCA_900323505.1-Fun_OOIN01000012.1_i000_006302	125	459	334	1.01212	0.573883
GCA_003546525.1-Pro_QUSY01000528.1_i000_005946	612	945	333	1.00909	0.344008
GCA_016800925.1-Fun_JABCPU010000062.1_i000_015897	127	455	328	0.993939	0.574431
GCA_009805615.1-Ani_VIIS01001978.1_i000_022381	75	408	333	1.00909	0.601083
GCA_002554575.1-Fun_KZ301990.1_i000_003634	124	454	330	1	0.587189
GCA_016920775.1-Ani_JAFDOW010000699.1_i000_002093	125	455	330	1	0.666667
GCA_014871385.1-Pla_CM026430.1_i000_024241	131	442	311	0.942424	0.531624
GCA_014462675.1-Fun_JACAZH010000009.1_i000_012244	119	454	335	1.01515	0.471831
GCA_020746845.1-Fun_JAGPNJ010000002.1_i000_005265	132	451	319	0.966667	0.558669
GCA_004918325.1-Fun_SPNW01000022.1_i000_001348	121	449	328	0.993939	0.617702
GCA_001632445.1-Fun_KV424817.1_i000_016904	126	453	327	0.990909	0.620493
GCA_018296165.1-Fun_JACKQL010004559.1_i000_003792	141	477	336	1.01818	0.612022
GCA_019722365.1-Pla_JADFUC010000388.1_i000_022221	117	438	321	0.972727	0.58047
GCA_000743615.1-Ani_KN125438.1_i000_020278	130	441	311	0.942424	0.58349
GCA_001078535.1-Pro_CAIX01000285.1_i000_010490	111	446	335	1.01515	0.672691
GCA_016758945.1-Fun_JAEPRC010001140.1_i000_011325	120	448	328	0.993939	0.66129
GCA_016695465.1-Fun_MU177919.1_i000_007237	127	454	327	0.990909	0.604436
GCA_016413895.1-Pla_CM028154.1_i000_012290	186	500	314	0.951515	0.481595
GCA_004918755.1-Fun_SPOI01000053.1_i000_003254	123	449	326	0.987879	0.608209
GCA_015039315.1-Fun_WIDE01000135.1_i000_002554	136	460	324	0.981818	0.557659
GCA_022376455.1-Fun_JACBKO010000042.1_i000_008634	124	459	335	1.01515	0.581597
GCA_014925845.1-Fun_JACGCL010000006.1_i000_010837	129	461	332	1.00606	0.610294
GCA_000827395.1-Fun_KN824833.1_i000_000614	127	457	330	1	0.576923
GCA_016647625.1-Fun_JABBWH010000033.1_i000_010270	127	454	327	0.990909	0.603321
GCA_001632435.1-Fun_KV423997.1_i000_007698	122	452	330	1	0.547264
GCA_904845875.1-Pla_CAJGYO010000001.1_i000_001777	207	517	310	0.939394	0.479876
GCA_004918335.1-Fun_SPNZ01000017.1_i000_001033	123	449	326	0.987879	0.608209
GCA_016647755.1-Fun_JABBWI010000069.1_i000_019051	127	453	326	0.987879	0.602588
GCA_000400465.1-Fun_KE007228.1_i000_001430	123	449	326	0.987879	0.608209
GCA_004917845.1-Fun_SPOB01000015.1_i000_000826	123	449	326	0.987879	0.608209
GCA_004917865.1-Fun_SPOD01000021.1_i000_001453	123	449	326	0.987879	0.608209
GCA_004917895.1-Fun_SPOH01000018.1_i000_001066	123	449	326	0.987879	0.608209
GCA_004918015.1-Fun_SPOC01000016.1_i000_000861	123	449	326	0.987879	0.608209
GCA_004918065.1-Fun_SPOQ01000017.1_i000_000961	123	449	326	0.987879	0.608209
GCA_004918235.1-Fun_SPOE01000019.1_i000_001151	123	449	326	0.987879	0.608209
GCA_004918315.1-Fun_SPNX01000017.1_i000_000907	123	449	326	0.987879	0.608209
GCA_004918345.1-Fun_SPOA01000015.1_i000_000799	123	449	326	0.987879	0.608209
GCA_004918445.1-Fun_SPOG01000015.1_i000_000784	123	449	326	0.987879	0.608209
GCA_004918455.1-Fun_SPOF01000018.1_i000_001097	123	449	326	0.987879	0.608209
GCA_004918895.1-Fun_SPOR01000015.1_i000_000741	123	449	326	0.987879	0.608209
GCA_001584585.1-Pla_LSYV01000039.1_i000_010017	114	433	319	0.966667	0.645749
GCA_000827475.1-Fun_KN819330.1_i000_004353	126	457	331	1.00303	0.605119
GCA_003427395.1-Pla_BFEA01000767.1_i000_030370	714	1033	319	0.966667	0.264511
GCA_020466585.1-Ani_JAFETG010000009.1_i000_013041	112	444	332	1.00606	0.639692
GCA_002127325.2-Pla_CM007903.2_i000_055722	123	443	320	0.969697	0.581818
GCA_009363875.1-Pla_CM018685.1_i000_033063	123	442	319	0.966667	0.611111
GCA_000417875.1-Fun_KE361644.1_i000_005868	129	463	334	1.01212	0.568027
GCA_900322975.1-Fun_OOIP01000010.1_i000_003977	129	463	334	1.01212	0.568027
GCA_011745845.1-Pla_VYZY01004802.1_i000_020380	116	442	326	0.987879	0.53268
GCA_011745865.1-Pla_VYZZ01015044.1_i000_035277	116	442	326	0.987879	0.53268
GCA_002870075.2-Pla_CM022518.1_i000_002023	124	443	319	0.966667	0.588561
GCA_000346045.2-Ani_KB632387.1_i000_011640	112	444	332	1.00606	0.636015
GCA_000355655.1-Ani_KB741231.1_i000_011091	112	444	332	1.00606	0.636015
GCA_020466635.1-Ani_JAFETF010000009.1_i000_013251	112	444	332	1.00606	0.636015
GCA_001630335.1-Fun_KV417571.1_i000_016137	124	457	333	1.00909	0.62949
GCA_016584345.1-Fun_JABCPV010000121.1_i000_001940	126	453	327	0.990909	0.577739
GCA_000325575.1-Ani_KB031068.1_i000_015125	129	449	320	0.969697	0.606061
GCA_014176215.1-Ani_JACASE010000002.1_i000_009696	129	445	316	0.957576	0.593985
GCA_003327735.1-Fun_QLNQ01000018.1_i000_003006	129	457	328	0.993939	0.649505
GCA_001661235.1-Fun_KV454001.1_i000_000069	124	448	324	0.981818	0.721604
GCA_000836355.1-Fun_KN847938.1_i000_005368	129	458	329	0.99697	0.580247
GCA_016628565.1-Fun_JABBWD010000009.1_i000_014653	135	451	316	0.957576	0.544828
GCA_015039435.1-Fun_MU130777.1_i000_004168	133	454	321	0.972727	0.560209
GCA_003546545.1-Pro_QUTB01005128.1_i000_006320	240	588	348	1.05455	0.585859
GCA_003546585.1-Pro_QUTD01010901.1_i000_013188	240	588	348	1.05455	0.585859
GCA_003546605.1-Pro_QUTA01000633.1_i000_000342	240	588	348	1.05455	0.585859
GCA_003546805.1-Pro_QUTE01007990.1_i000_003918	240	588	348	1.05455	0.585859
GCA_001373355.1-Fun_CENE01000015.1_i000_002988	69	393	324	0.981818	0.710526
GCA_008782695.1-Ani_CM018501.1_i000_009549	121	435	314	0.951515	0.603846
GCA_008787405.2-Ani_CM018480.1_i000_008493	121	435	314	0.951515	0.603846
GCA_016808215.1-Pla_CM029002.1_i000_014270	120	439	319	0.966667	0.553819
GCA_018689175.1-Pla_CM031847.1_i000_013392	120	439	319	0.966667	0.553819
GCA_015501065.1-Fun_JADNYI010000050.1_i000_014032	133	455	322	0.975758	0.560976
GCA_002220235.1-Pla_FO082273.1_i000_003200	128	444	316	0.957576	0.655602
GCA_001691835.3-Fun_JNHZ02000025.1_i000_004617	127	457	330	1	0.582011
GCA_003144235.1-Fun_KZ820032.1_i000_004939	133	459	326	0.987879	0.613936
GCA_904845875.1-Pla_CAJGYO010000002.1_i000_007170	131	441	310	0.939394	0.544815
GCA_003336725.1-Ani_JOJR01000009.1_i000_001750	126	462	336	1.01818	0.658824
GCA_905329745.1-Ani_CAJNSZ010005333.1_i000_040728	1	284	283	0.857576	0.927869
GCA_905330235.1-Ani_CAJNUA010001883.1_i000_033046	1	284	283	0.857576	0.927869
GCA_905330535.1-Ani_CAJNVN010006278.1_i000_040132	1	284	283	0.857576	0.927869
GCA_013634535.1-Ani_JACDTQ010004070.1_i000_015042	130	445	315	0.954545	0.586592
GCA_007210705.1-Ani_CM017373.1_i000_000471	79	401	322	0.975758	0.637624
GCA_016809505.1-Fun_CP050673.1_i000_000575	132	458	326	0.987879	0.646825
GCA_000143565.1-Fun_DS547115.1_i000_006928	135	455	320	0.969697	0.615385
GCA_000189635.1-Pro_GG662712.1_i000_009124	115	447	332	1.00606	0.724891
GCA_004369065.1-Fun_ML208268.1_i000_003044	131	452	321	0.972727	0.546848
GCA_002926085.1-Fun_PKFP01000008.1_i000_000122	129	451	322	0.975758	0.632613
GCA_019332025.1-Fun_CP076661.1_i000_000117	129	451	322	0.975758	0.632613
GCA_015179125.1-Fun_WHVA01000176.1_i000_004185	126	453	327	0.990909	0.665988
GCA_014108255.1-Ani_JACAGC010000006.1_i000_016098	129	435	306	0.927273	0.574109
GCA_902729315.2-Pla_LR746275.1_i000_016602	118	440	322	0.975758	0.557093
GCA_018855395.1-Fun_JABAJW010017966.1_i000_012224	193	515	322	0.975758	0.509494
GCA_018855915.1-Fun_JABCKO010023870.1_i000_011163	122	453	331	1.00303	0.630476
GCA_022539455.1-Pla_CM039732.1_i000_020538	125	439	314	0.951515	0.512235
GCA_003073295.1-Fun_KZ803344.1_i000_008594	128	452	324	0.981818	0.542714
GCA_003182015.1-Fun_PYWC01000052.1_i000_006283	128	448	320	0.969697	0.558464
GCA_017524585.1-Ani_CM029820.1_i000_003107	130	446	316	0.957576	0.586271
GCA_002786265.1-Pla_KZ451969.1_i000_010261	114	440	326	0.987879	0.556314
GCA_002335675.1-Pla_BEGY01000001.1_i000_000275	129	445	316	0.957576	0.595104
GCA_002352805.1-Ani_KZ358800.1_i000_018748	112	421	309	0.936364	0.730496
GCA_011800875.2-Fun_JRHT02000123.1_i000_002561	127	454	327	0.990909	0.604436
GCA_016628085.1-Fun_JABBWB010000022.1_i000_005702	127	454	327	0.990909	0.604436
GCA_018107945.1-Pla_JACEIK010000032.1_i000_001520	120	443	323	0.978788	0.585145
GCA_014898675.1-Fun_JACXVL010000009.1_i000_021849	123	457	334	1.01212	0.63138
GCA_014058105.1-Pla_JACGCM010001659.1_i000_015095	113	442	329	0.99697	0.572174
GCA_014108245.1-Ani_JACAGB010000007.1_i000_016737	131	442	311	0.942424	0.582397
GCA_014049915.1-Ani_JABVXQ010000004.1_i000_013115	127	436	309	0.936364	0.570111
GCA_000827255.1-Fun_KN835417.1_i000_011681	128	454	326	0.987879	0.602588
GCA_001531365.1-Pla_CM009732.1_i000_000947	124	443	319	0.966667	0.578947
GCA_000402015.1-Ani_KE124808.1_i000_002266	127	462	335	1.01515	0.655577
GCA_003676015.1-Fun_NSDU01000013.1_i000_001952	125	459	334	1.01212	0.660079
GCA_904063045.1-Ani_CAJFCJ010000006.1_i000_004521	126	457	331	1.00303	0.574653
GCA_020310465.1-Fun_JAHSQE010000018.1_i000_004077	125	453	328	0.993939	0.57645
GCA_020875875.1-Pla_CM037029.1_i000_023921	113	440	327	0.990909	0.559932
GCA_021029095.1-Fun_JAJOHG010000046.1_i000_010261	127	454	327	0.990909	0.593466
GCA_000688135.1-Ani_JARK01000186.1_i000_003061	127	462	335	1.01515	0.658153
GCA_015501595.1-Fun_JADNRX010000005.1_i000_020240	131	460	329	0.99697	0.618421
GCA_014595675.1-Ani_WVUK01000062.1_i000_003726	134	457	323	0.978788	0.627184
GCA_000392275.1-Fun_KB933036.1_i000_003208	134	468	334	1.01212	0.65748
GCA_000722935.2-Pla_KN654438.1_i000_023808	115	443	328	0.993939	0.593128
GCA_004193775.2-Pla_CM014368.1_i000_033310	115	443	328	0.993939	0.593128
GCA_905337355.1-Fun_CAJPDT010000003.1_i000_000737	133	464	331	1.00303	0.641473
GCA_014462655.1-Fun_JACAZI010000021.1_i000_019537	124	460	336	1.01818	0.641221
GCA_000006445.2-Fun_CR382139.2_i000_005475	128	459	331	1.00303	0.655446
GCA_014595675.1-Ani_WVUK01000065.1_i000_006425	144	446	302	0.915152	0.611336
GCA_000004515.5-Pla_CM000845.3_i000_030376	115	441	326	0.987879	0.586331
GCA_012273815.2-Pla_CM022570.2_i000_032641	115	441	326	0.987879	0.586331
GCA_014282035.1-Pla_CM024844.1_i000_021389	115	441	326	0.987879	0.586331
GCA_014282085.1-Pla_CM024904.1_i000_006374	115	441	326	0.987879	0.586331
GCA_014282145.1-Pla_CM024944.1_i000_032842	115	441	326	0.987879	0.586331
GCA_020497155.1-Pla_CM035718.1_i000_033117	115	441	326	0.987879	0.586331
GCA_019208045.1-Fun_JAHLVS010000003.1_i000_003251	135	460	325	0.984848	0.659229
GCA_004802695.1-Fun_SGPK01000017.1_i000_002100	379	697	318	0.963636	0.258747
GCA_010458925.1-Pla_CM021231.1_i000_011752	126	443	317	0.960606	0.61079
GCA_900106125.1-Fun_LT635764.1_i000_000127	128	446	318	0.963636	0.602273
GCA_014462675.1-Fun_JACAZH010000011.1_i000_013342	120	454	334	1.01212	0.58087
GCA_900106115.1-Fun_LT635758.1_i000_003161	128	446	318	0.963636	0.612717
GCA_000002775.3-Pla_CM009302.1_i000_029900	117	440	323	0.978788	0.575758
GCA_016647745.1-Fun_JABBWE010000048.1_i000_010582	127	454	327	0.990909	0.573684
GCA_001447935.2-Fun_LMYN01000002.1_i000_000207	128	456	328	0.993939	0.645669
GCA_000005195.1-Ani_CH479184.1_i000_010230	132	448	316	0.957576	0.611219
GCA_018991925.1-Ani_JAHLQT010031643.1_i000_018181	120	446	326	0.987879	0.701075
GCA_004679265.1-Fun_SEKV01000018.1_i000_002867	122	450	328	0.993939	0.618868
GCA_022264815.1-Fun_JADCUA010000003.1_i000_007325	122	450	328	0.993939	0.618868
GCA_019616945.1-Fun_WSTK01000011.1_i000_000628	132	450	318	0.963636	0.554974
GCA_003370565.1-Pla_QJKJ01002791.1_i000_013536	115	436	321	0.972727	0.578378
GCA_002092935.1-Fun_KZ084109.1_i000_007114	131	449	318	0.963636	0.557895
GCA_020744475.1-Fun_JAGMUX010000015.1_i000_004810	139	461	322	0.975758	0.631373
GCA_001411555.2-Pla_CM023851.1_i000_023623	121	440	319	0.966667	0.55095
GCA_001411555.2-Pla_LIHL02000143.1_i000_036930	121	440	319	0.966667	0.55095
GCA_003675905.2-Ani_NCKV01004329.1_i000_007187	117	445	328	0.993939	0.307404
GCA_001691775.3-Fun_JNHW02000008.1_i000_006675	122	452	330	1	0.606618
GCA_003713155.1-Pla_CP030985.1_i000_013751	115	436	321	0.972727	0.58047
GCA_003713155.1-Pla_CP030995.1_i000_018478	115	436	321	0.972727	0.58047
GCA_004170445.1-Pla_CM014317.1_i000_017496	115	436	321	0.972727	0.58047
GCA_004170445.1-Pla_CM014327.1_i000_022450	115	436	321	0.972727	0.58047
GCA_017635955.1-Fun_JAAQQV010000006.1_i000_006215	132	447	315	0.954545	0.614035
GCA_905338405.1-Ani_CAJPEX010000312.1_i000_002668	344	677	333	1.00909	0.442819
GCA_003112345.1-Pla_PKPP01000210.1_i000_003687	128	446	318	0.963636	0.588889
GCA_010261695.1-Pla_CM020996.1_i000_000207	115	437	322	0.975758	0.576029
GCA_005406025.1-Ani_BGZK01000106.1_i000_013774	149	479	330	1	0.677618
GCA_009771035.1-Pla_CM019999.1_i000_000227	115	437	322	0.975758	0.572954
GCA_010093535.1-Fun_MU003508.1_i000_007964	131	467	336	1.01818	0.632768
GCA_014466165.1-Fun_JACETU010000002.1_i000_003416	127	457	330	1	0.615672
GCA_019677325.2-Fun_CM033826.1_i000_004983	127	457	330	1	0.615672
GCA_022160275.1-Fun_MU276211.1_i000_013926	122	453	331	1.00303	0.609576
GCA_008065275.1-Fun_QKWK01000006.1_i000_002545	129	459	330	1	0.605505
GCA_016628065.1-Fun_JABBWA010000004.1_i000_012601	125	453	328	0.993939	0.574431
GCA_014925785.1-Fun_WIQG01000069.1_i000_042975	124	453	329	0.99697	0.620755
GCA_003704355.1-Fun_QWIL01003406.1_i000_015421	130	444	314	0.951515	0.704036
GCA_021927905.1-Pro_BLLK01000038.1_i000_006554	124	460	336	1.01818	0.661417
GCA_003194525.1-Pro_NBIV01000144.1_i000_007249	115	445	330	1	0.596745
GCA_019207005.1-Fun_JAHLUH010000004.1_i000_003548	135	458	323	0.978788	0.643426
GCA_019207375.1-Fun_JAHLUR010000002.1_i000_003219	135	458	323	0.978788	0.643426
GCA_019207405.1-Fun_JAHLUS010000004.1_i000_003622	135	458	323	0.978788	0.643426
GCA_016906575.1-Fun_CP059626.1_i000_015608	130	449	319	0.966667	0.556719
GCA_015852605.2-Pla_CM027582.2_i000_022719	117	439	322	0.975758	0.575
GCA_903819495.1-Fun_CAIJDT010000010.1_i000_008261	86	415	329	0.99697	0.704497
GCA_001277935.1-Ani_CP012523.1_i000_000731	121	447	326	0.987879	0.635478
GCA_001702695.2-Fun_CM008293.1_i000_011528	138	463	325	0.984848	0.675676
GCA_000697685.1-Fun_KL198006.1_i000_003666	123	459	336	1.01818	0.606498
GCA_004522655.2-Fun_SNSC02000024.1_i000_010819	134	461	327	0.990909	0.642436
GCA_004522665.1-Fun_SNSD01000024.1_i000_010594	134	461	327	0.990909	0.642436
GCA_022376545.1-Fun_WTXJ01000001.1_i000_000417	123	450	327	0.990909	0.6
GCA_014905825.1-Fun_JACGCN010000002.1_i000_005541	133	453	320	0.969697	0.555556
GCA_005223365.2-Pla_SPHZ02000006.1_i000_021400	129	441	312	0.945455	0.608187
GCA_002818225.1-Fun_KZ454987.1_i000_000596	144	461	317	0.960606	0.60728
GCA_003351075.1-Fun_QFBF01000015.1_i000_002673	132	462	330	1	0.652174
GCA_009769405.1-Fun_WNWR01000005.1_i000_000295	132	462	330	1	0.652174
GCA_009769425.1-Fun_WNWS01000010.1_i000_000723	132	462	330	1	0.652174
GCA_009769445.1-Fun_WNWQ01000796.1_i000_008118	132	462	330	1	0.652174
GCA_010015735.1-Fun_ML978074.1_i000_011175	138	465	327	0.990909	0.64881
GCA_016906575.1-Fun_CP059610.1_i000_000738	130	449	319	0.966667	0.556719
GCA_019623675.1-Fun_WSTN01000067.1_i000_009914	68	396	328	0.993939	0.610801
GCA_019455555.1-Ani_JAGFMF010011501.1_i000_004174	192	509	317	0.960606	0.535473
GCA_013368555.1-Fun_JAACJN010000015.1_i000_003588	164	479	315	0.954545	0.563506
GCA_905221605.1-Pro_CAJNDS010000499.1_i000_007225	119	451	332	1.00606	0.670707
GCA_016858145.1-Pla_JAEHOE010000002.1_i000_000962	132	434	302	0.915152	0.576336
GCA_020169585.1-Pla_CM034980.1_i000_017074	119	443	324	0.981818	0.598891
GCA_014904945.1-Fun_MU127431.1_i000_007043	122	452	330	1	0.608856
GCA_916048055.1-Pla_CAJZHL010000028.1_i000_006239	126	460	334	1.01212	0.683027
GCA_000151545.2-Pro_KK583246.1_i000_011739	112	450	338	1.02424	0.686992
GCA_016584345.1-Fun_JABCPV010000396.1_i000_010713	117	443	326	0.987879	0.610487
GCA_905219575.1-Fun_CAJMWT010002493.1_i000_004373	132	450	318	0.963636	0.556918
GCA_015484515.1-Fun_MU154521.1_i000_000471	123	458	335	1.01515	0.626168
GCA_900660405.1-Pro_CAACVS010000039.1_i000_001458	80	417	337	1.02121	0.71097
GCA_016695465.1-Fun_MU178012.1_i000_013810	135	455	320	0.969697	0.56042
GCA_016647755.1-Fun_JABBWI010000056.1_i000_017177	135	453	318	0.963636	0.558875
GCA_000696525.1-Pla_KK914488.1_i000_011807	117	442	325	0.984848	0.575221
GCA_000697645.1-Fun_KL142383.1_i000_011877	134	457	323	0.978788	0.559792
GCA_000235995.2-Ani_KZ248834.1_i000_012793	97	426	329	0.99697	0.7669
GCA_904845875.1-Pla_CAJGYO010000005.1_i000_019200	131	441	310	0.939394	0.547703
GCA_002217885.1-Pro_BDSP01000022.1_i000_011906	139	466	327	0.990909	0.613508
GCA_000816745.1-Ani_KN726880.1_i000_002663	207	544	337	1.02121	0.532385
GCA_018804465.1-Pla_CM031992.1_i000_008328	117	439	322	0.975758	0.571936
GCA_003704575.1-Fun_QWIN01003653.1_i000_010449	2	309	307	0.930303	0.775253
GCA_000524645.1-Fun_JATN01000322.1_i000_012543	132	451	319	0.966667	0.558669
GCA_000715385.1-Fun_AZST01000092.1_i000_003153	132	451	319	0.966667	0.558669
GCA_900059795.1-Pla_HG974434.1_i000_018835	115	420	305	0.924242	0.722749
GCA_016647625.1-Fun_JABBWH010000084.1_i000_015868	137	454	317	0.960606	0.557118
GCA_003704575.1-Fun_QWIN01001507.1_i000_003377	2	308	306	0.927273	0.772727
GCA_014065215.1-Fun_JACCEH010000005.1_i000_008121	133	450	317	0.960606	0.55614
GCA_003061485.1-Pla_CM009757.1_i000_031511	131	441	310	0.939394	0.541958
GCA_020796215.1-Pla_CM036791.1_i000_017996	132	468	336	1.01818	0.6
GCA_003573695.1-Pla_CM010716.1_i000_008553	125	442	317	0.960606	0.592523
GCA_019632295.1-Fun_WSTZ01000011.1_i000_000630	128	454	326	0.987879	0.570928
GCA_019633455.1-Fun_WSUA01000009.1_i000_012365	128	454	326	0.987879	0.570928
GCA_016920775.1-Ani_JAFDOW010001337.1_i000_004708	116	444	328	0.993939	0.578483
GCA_014108415.1-Ani_JACASF010000011.1_i000_003111	120	445	325	0.984848	0.609756
GCA_013676235.1-Pla_CM025497.1_i000_004428	133	469	336	1.01818	0.595745
GCA_005239225.1-Pla_RCHU01000026.1_i000_014024	117	439	322	0.975758	0.571936
GCA_019722365.1-Pla_JADFUC010000514.1_i000_014680	117	438	321	0.972727	0.581522
GCA_007646595.3-Ani_VBQZ03000001.1_i000_000208	129	443	314	0.951515	0.217753
GCA_020004445.1-Ani_JAATJV010425555.1_i000_019888	230	540	310	0.939394	0.474006
GCA_021218885.1-Ani_JAIQCD010002027.1_i000_004591	128	442	314	0.951515	0.593573
GCA_008795845.1-Ani_SGJD01002184.1_i000_011295	132	445	313	0.948485	0.514803
GCA_016647635.1-Fun_JABBWG010000066.1_i000_013882	137	454	317	0.960606	0.558099
GCA_905337345.1-Fun_CAJPDS010000025.1_i000_004393	131	465	334	1.01212	0.646035
GCA_001447665.1-Ani_JYDP01000001.1_i000_000253	123	460	337	1.02121	0.329102
GCA_004379255.2-Pla_CM031474.1_i000_008471	193	515	322	0.975758	0.511924
GCA_000697945.4-Ani_ML763204.1_i000_012253	130	451	321	0.972727	0.565141
GCA_016881025.1-Ani_JAESOR010000362.1_i000_012191	130	442	312	0.945455	0.588679
GCA_000271605.1-Fun_JH717980.1_i000_009597	125	452	327	0.990909	0.587074
GCA_018804465.1-Pla_CM031993.1_i000_009469	136	458	322	0.975758	0.552316
GCA_001187945.1-Ani_JRES01001511.1_i000_003568	131	447	316	0.957576	0.608863
GCA_000223465.1-Fun_GL996510.1_i000_000328	128	458	330	1	0.652174
GCA_003018175.1-Ani_PYGN01001265.1_i000_021671	119	446	327	0.990909	0.566724
GCA_001023035.1-Fun_JRVG01000060.1_i000_010107	144	465	321	0.972727	0.62818
GCA_001023065.1-Fun_JRVH01002322.1_i000_007739	144	465	321	0.972727	0.62818
GCA_003615215.1-Fun_MRDB01000055.1_i000_011644	144	465	321	0.972727	0.62818
GCA_017309875.1-Fun_PKMG01000089.1_i000_009288	144	465	321	0.972727	0.62818
GCA_900029915.1-Fun_FCQG01000012.1_i000_011251	144	465	321	0.972727	0.62818
GCA_900067095.1-Fun_FJOF01000005.1_i000_008270	144	465	321	0.972727	0.62818
GCA_900079805.1-Fun_HF679029.1_i000_010299	144	465	321	0.972727	0.62818
GCA_900096615.1-Fun_FMJV01000016.1_i000_004262	144	465	321	0.972727	0.62818
GCA_900096635.1-Fun_FMJW01000007.1_i000_004946	144	465	321	0.972727	0.62818
GCA_900096505.1-Fun_FMSL01000015.1_i000_002309	144	465	321	0.972727	0.62818
GCA_014533835.1-Ani_WJEC01008756.1_i000_019800	132	445	313	0.948485	0.590566
GCA_901343595.1-Ani_CABDUW010000761.1_i000_016942	132	445	313	0.948485	0.590566
GCA_003573695.1-Pla_CM010717.1_i000_012166	125	442	317	0.960606	0.590317
GCA_001605315.2-Fun_LUEZ02000079.1_i000_013380	126	452	326	0.987879	0.564014
GCA_021018615.1-Fun_JAEVFL010000004.1_i000_005435	134	458	324	0.981818	0.566434
GCA_015484465.1-Fun_MU155198.1_i000_006385	135	455	320	0.969697	0.561404
GCA_002926085.1-Fun_PKFP01000008.1_i000_000546	127	456	329	0.99697	0.646365
GCA_019332025.1-Fun_CP076661.1_i000_000498	127	456	329	0.99697	0.646365
GCA_002738505.1-Pla_KZ305020.1_i000_003254	133	443	310	0.939394	0.537262
GCA_902806795.1-Ani_CADCXV010000602.1_i000_002993	117	445	328	0.993939	0.262821
GCA_000145635.1-Fun_GL385395.1_i000_002515	133	466	333	1.00909	0.640385
GCA_015179125.1-Fun_WHVA01000155.1_i000_003299	135	451	316	0.957576	0.559292
GCA_005223365.2-Pla_SPHZ02000006.1_i000_021364	129	440	311	0.942424	0.665953
GCA_002926055.1-Fun_PKFO01000003.1_i000_002035	128	460	332	1.00606	0.654832
GCA_012184645.1-Fun_WYDC01000035.1_i000_003149	128	460	332	1.00606	0.654832
GCA_012184655.1-Fun_WYDD01000023.1_i000_002432	128	460	332	1.00606	0.654832
GCA_000209535.1-Ani_FN653020.1_i000_004302	113	447	334	1.01212	0.598566
GCA_022160365.1-Fun_MU273527.1_i000_004134	127	450	323	0.978788	0.603738
GCA_001969505.1-Fun_LSSK01000567.1_i000_000486	104	437	333	1.00909	0.642857
GCA_902860255.1-Pla_LR794333.1_i000_005474	125	443	318	0.963636	0.479638
GCA_000219495.2-Pla_CM001221.2_i000_026810	118	442	324	0.981818	0.549153
GCA_003473485.2-Pla_CM010652.1_i000_024994	118	442	324	0.981818	0.549153
GCA_015179015.1-Fun_WHUW01000008.1_i000_017472	124	440	316	0.957576	0.714932
GCA_013368375.1-Fun_JAACJP010000044.1_i000_009554	135	454	319	0.966667	0.559649
GCA_000281045.1-Pro_JH767194.1_i000_013656	112	452	340	1.0303	0.691057
GCA_003788615.2-Fun_ML121569.1_i000_009332	127	452	325	0.984848	0.56719
GCA_000828355.1-Ani_JXLN01015549.1_i000_008983	168	493	325	0.984848	0.590909
GCA_000005115.1-Ani_CH902620.1_i000_005129	131	445	314	0.951515	0.613281
GCA_003704375.1-Fun_QWIK01002973.1_i000_009027	121	453	332	1.00606	0.614815
GCA_900044065.1-Fun_FCQH01000016.1_i000_015530	144	456	312	0.945455	0.610568
GCA_002127715.1-Fun_MUNK01000021.1_i000_002435	135	466	331	1.00303	0.599638
GCA_015501605.1-Fun_JADNRZ010000009.1_i000_016978	134	451	317	0.960606	0.581651
GCA_003704615.1-Fun_QWIQ01000409.1_i000_008721	131	465	334	1.01212	0.605072
GCA_022496185.1-Fun_WTXG01000021.1_i000_004192	133	451	318	0.963636	0.560847
GCA_000340195.1-Fun_KB446544.1_i000_010146	136	462	326	0.987879	0.59058
GCA_002217885.1-Pro_BDSP01000143.1_i000_013774	126	462	336	1.01818	0.664032
GCA_004155915.1-Fun_QJOA01000125.1_i000_001345	142	463	321	0.972727	0.624514
GCA_003444635.2-Fun_QOKS01000001.1_i000_000865	128	449	321	0.972727	0.552496
GCA_003790465.1-Fun_ML119144.1_i000_007622	128	449	321	0.972727	0.552496
GCA_900184105.1-Fun_LT854283.1_i000_010449	132	462	330	1	0.605505
GCA_000827415.1-Fun_KN824316.1_i000_009379	122	452	330	1	0.561224
GCA_900091695.1-Fun_LT853702.1_i000_010514	133	463	330	1	0.605505
GCA_001950575.1-Fun_BDGI01000123.1_i000_002921	126	449	323	0.978788	0.653846
GCA_008690995.1-Pro_VRMN01000011.1_i000_004783	135	475	340	1.0303	0.636704
GCA_014925785.1-Fun_WIQG01000010.1_i000_001478	124	453	329	0.99697	0.573171
GCA_000151685.2-Pla_EQ974483.1_i000_007420	126	442	316	0.957576	0.566308
GCA_000149405.2-Pro_CM000642.1_i000_004333	138	437	299	0.906061	0.682648
GCA_002897355.1-Pro_BEYU01000017.1_i000_002187	128	460	332	1.00606	0.612546
GCA_004153795.2-Pla_SDRB02004289.1_i000_007890	120	442	322	0.975758	0.564912
GCA_000441895.2-Ani_KE524806.1_i000_002231	121	454	333	1.00909	0.639155
GCA_003704645.1-Fun_QWIR01000052.1_i000_006299	132	463	331	1.00303	0.599638
GCA_015039465.1-Fun_MU130533.1_i000_014008	128	456	328	0.993939	0.570435
GCA_001661395.1-Fun_KV454541.1_i000_003334	127	453	326	0.987879	0.640472
GCA_010458925.1-Pla_CM021240.1_i000_038199	133	467	334	1.01212	0.59325
GCA_019096205.1-Ani_CM032520.1_i000_016017	129	455	326	0.987879	0.713348
GCA_905116875.3-Ani_CAJHNJ030000021.1_i000_006555	129	455	326	0.987879	0.713348
GCA_018282025.1-Fun_JABCKI010005741.1_i000_007046	122	455	333	1.00909	0.606557
GCA_000827425.1-Fun_KN822011.1_i000_003002	133	456	323	0.978788	0.568662
GCA_012980525.1-Fun_SJKE01000001.1_i000_000604	125	458	333	1.00909	0.62243
GCA_905250095.1-Ani_CAJNOR010000023.1_i000_000805	122	444	322	0.975758	0.723596
GCA_004000445.1-Ani_RSAL01000118.1_i000_008549	128	457	329	0.99697	0.716776
GCA_012979565.1-Fun_SJDA01000004.1_i000_007460	125	458	333	1.00909	0.62243
GCA_910592005.1-Fun_CAJVPP010004123.1_i000_011141	108	440	332	1.00606	0.502269
GCA_014904855.1-Fun_MU118187.1_i000_010667	123	454	331	1.00303	0.573657
GCA_000219625.1-Fun_CM001206.1_i000_009432	136	464	328	0.993939	0.601835
GCA_900184115.1-Fun_LT854263.1_i000_010543	136	464	328	0.993939	0.601835
GCA_015584085.1-Fun_MU151079.1_i000_003292	121	453	332	1.00606	0.610294
GCA_020137385.1-Fun_JACLAE010000003.1_i000_009515	133	452	319	0.966667	0.55095
GCA_002166775.1-Fun_NHMM01000002.1_i000_001340	128	461	333	1.00909	0.69375
GCA_904063045.1-Ani_CAJFCJ010000014.1_i000_009153	111	422	311	0.942424	0.731765
GCA_018446385.1-Pla_CM031518.1_i000_039540	134	458	324	0.981818	0.544538
GCA_014905825.1-Fun_JACGCN010000004.1_i000_010200	121	458	337	1.02121	0.634652
GCA_009771035.1-Pla_CM020017.1_i000_030241	114	437	323	0.978788	0.572695
GCA_010261695.1-Pla_CM021004.1_i000_014434	114	437	323	0.978788	0.572695
GCA_000005505.4-Pla_CM000880.3_i000_007901	130	441	311	0.942424	0.555357
GCA_001574975.1-Fun_KQ965752.1_i000_006061	135	447	312	0.945455	0.610568
GCA_022160275.1-Fun_MU275844.1_i000_001498	135	454	319	0.966667	0.543441
GCA_010093795.1-Fun_MU006561.1_i000_000223	141	471	330	1	0.633397
GCA_013400495.1-Ani_WAAE01006651.1_i000_003588	56	190	134	0.406061	0.264822
GCA_013400495.1-Ani_WAAE01006651.1_i000_003588	208	413	205	0.621212	0.405138
GCA_019359905.1-Fun_JAENJO010000006.1_i000_002443	130	449	319	0.966667	0.618217
GCA_019201745.1-Fun_JABELV010000047.1_i000_004998	131	474	343	1.03939	0.571667
GCA_021052385.1-Fun_JAIFAB010000021.1_i000_004027	131	474	343	1.03939	0.571667
GCA_019157295.1-Fun_JAELUQ010000007.1_i000_015269	144	457	313	0.948485	0.612524
GCA_020744335.1-Fun_JAHBOG010000012.1_i000_003984	144	457	313	0.948485	0.612524
GCA_005059855.1-Fun_NAJP01000037.1_i000_009666	134	437	303	0.918182	0.691781
GCA_015501055.1-Fun_JADNYV010000002.1_i000_006724	134	445	311	0.942424	0.558348
GCA_000751175.1-Pro_CCKQ01012108.1_i000_012583	124	461	337	1.02121	0.660784
GCA_001594065.1-Ani_KQ978106.1_i000_012192	113	445	332	1.00606	0.511556
GCA_003061485.1-Pla_CM009757.1_i000_031509	131	441	310	0.939394	0.54386
GCA_001876935.1-Pla_CM007387.1_i000_017793	99	416	317	0.960606	0.578467
GCA_010015825.1-Fun_ML977311.1_i000_000993	131	463	332	1.00606	0.637236
VUMO001.0722.00001.C001_01403	95	417	322	0.975758	0.764846
GCA_015039435.1-Fun_MU131030.1_i000_011661	125	456	331	1.00303	0.584806
GCA_000263155.2-Pla_CM003536.1_i000_032497	130	442	312	0.945455	0.549296
GCA_005286985.1-Pla_CM016560.1_i000_036421	130	442	312	0.945455	0.549296
GCA_009835185.1-Pro_VJMH01005219.1_i000_010559	115	449	334	1.01212	0.668
GCA_900708865.1-Pro_CAADRA010005240.1_i000_007906	115	449	334	1.01212	0.668
GCA_003046395.2-Pla_CM009691.2_i000_007582	131	441	310	0.939394	0.544815
GCA_003046395.2-Pla_CM009691.2_i000_007581	131	441	310	0.939394	0.544815
GCA_002211085.2-Pla_CM008054.2_i000_031942	131	441	310	0.939394	0.54386
GCA_002211085.2-Pla_CM008054.2_i000_031949	131	441	310	0.939394	0.54386
GCA_003076615.3-Ani_NJHN03000029.1_i000_012981	141	459	318	0.963636	0.619883
GCA_012980535.1-Fun_SJKF01000002.1_i000_003775	165	497	332	1.00606	0.58042
GCA_904845875.1-Pla_CAJGYO010000006.1_i000_023514	131	441	310	0.939394	0.54386
GCA_022376555.1-Fun_WTXH01000016.1_i000_002754	123	449	326	0.987879	0.605948
GCA_000966595.1-Fun_LAFY01000422.1_i000_004442	170	497	327	0.990909	0.562823
GCA_016628565.1-Fun_JABBWD010000008.1_i000_013818	128	453	325	0.984848	0.598527
GCA_001651215.1-Pro_LXWW01000210.1_i000_003517	115	443	328	0.993939	0.650794
GCA_003046395.2-Pla_CM009690.2_i000_001507	131	441	310	0.939394	0.545775
GCA_900199415.2-Ani_FZQP02002537.1_i000_007590	128	456	328	0.993939	0.716157
GCA_004802695.1-Fun_SGPK01000298.1_i000_003977	69	399	330	1	0.670732
GCA_012932015.1-Fun_JAADJF010000031.1_i000_001398	144	456	312	0.945455	0.610568
GCA_003013735.1-Fun_PYFQ01000001.1_i000_000755	127	458	331	1.00303	0.650295
GCA_009771035.1-Pla_CM020001.1_i000_004241	113	438	325	0.984848	0.580357
GCA_010261695.1-Pla_CM020997.1_i000_002469	113	438	325	0.984848	0.580357
GCA_013396005.1-Fun_JAAOAO010000015.1_i000_000385	146	460	314	0.951515	0.614481
GCA_019207715.1-Fun_JAHLVL010000003.1_i000_003026	135	462	327	0.990909	0.661943
GCA_019207725.1-Fun_JAHLVK010000003.1_i000_003085	135	462	327	0.990909	0.661943
GCA_019207815.1-Fun_JAHLVO010000002.1_i000_002511	135	462	327	0.990909	0.661943
GCA_019207825.1-Fun_JAHLVP010000003.1_i000_002693	135	462	327	0.990909	0.661943
GCA_019207835.1-Fun_JAHLVN010000002.1_i000_002253	135	462	327	0.990909	0.661943
GCA_019207905.1-Fun_JAHLVQ010000001.1_i000_001936	135	462	327	0.990909	0.661943
GCA_019208005.1-Fun_JAHLVR010000003.1_i000_002892	135	462	327	0.990909	0.661943
GCA_020536115.1-Fun_JAEUBD010001266.1_i000_003430	135	462	327	0.990909	0.661943
GCA_001286725.1-Fun_CYGV01001112.1_i000_003676	313	628	315	0.954545	0.418883
GCA_018857265.1-Fun_JABAJZ010000110.1_i000_001508	179	508	329	0.99697	0.560477
GCA_000263155.2-Pla_CM003536.1_i000_032498	130	442	312	0.945455	0.550265
GCA_001605315.2-Fun_LUEZ02000096.1_i000_016437	119	459	340	1.0303	0.640301
GCA_005286985.1-Pla_CM016560.1_i000_036422	130	442	312	0.945455	0.549296
GCA_000816745.1-Ani_KN729761.1_i000_007775	165	493	328	0.993939	0.629559
GCA_022496215.1-Fun_WTXF01000052.1_i000_009857	123	451	328	0.993939	0.601835
GCA_001664045.1-Fun_AECK01000003.1_i000_001904	135	462	327	0.990909	0.661943
GCA_019207735.1-Fun_JAHLVJ010000002.1_i000_002492	135	462	327	0.990909	0.661943
GCA_019207965.1-Fun_JAHLVM010000003.1_i000_002870	135	462	327	0.990909	0.661943
GCA_019207995.1-Fun_JAHLVT010000002.1_i000_002307	135	462	327	0.990909	0.661943
GCA_021399455.1-Fun_JAJTUO010000017.1_i000_005991	103	436	333	1.00909	0.62594
GCA_000344635.1-Fun_KB468053.1_i000_006876	122	456	334	1.01212	0.621974
GCA_001023045.1-Fun_JRVF01000498.1_i000_008328	138	461	323	0.978788	0.632094
GCA_900096645.1-Fun_FMJU01000013.1_i000_002818	138	461	323	0.978788	0.632094
GCA_900096685.1-Fun_FMSM01000015.1_i000_011173	138	461	323	0.978788	0.632094
GCA_000334495.1-Ani_KB320805.1_i000_010355	121	431	310	0.939394	0.596154
GCA_016767475.1-Fun_MU179396.1_i000_014041	127	453	326	0.987879	0.602588
GCA_002217885.1-Pro_BDSP01000061.1_i000_013402	126	462	336	1.01818	0.664032
GCA_013676235.1-Pla_CM025497.1_i000_004050	148	438	290	0.878788	0.660592
GCA_014904895.1-Fun_MU124881.1_i000_001713	136	440	304	0.921212	0.520548
GCA_010356995.1-Fun_ML996696.1_i000_005810	132	465	333	1.00909	0.628302
GCA_001447565.1-Ani_JYDW01000056.1_i000_010926	141	477	336	1.01818	0.607595
GCA_002081595.1-Pro_JNBR01002408.1_i000_008653	119	448	329	0.99697	0.67418
GCA_003550305.1-Fun_QKYT01000132.1_i000_002742	117	445	328	0.993939	0.488823
GCA_003704585.1-Fun_QWIP01000156.1_i000_003185	121	455	334	1.01212	0.616236
GCA_003704345.1-Fun_QWIJ01002017.1_i000_005864	131	465	334	1.01212	0.606171
GCA_001447645.1-Ani_JYDV01000005.1_i000_001246	160	497	337	1.02121	0.581034
GCA_900537275.1-Ani_UYRX01000003.1_i000_003396	130	459	329	0.99697	0.553872
GCA_900576705.1-Ani_UXUI01000314.1_i000_000321	125	460	335	1.01515	0.611314
GCA_900096605.1-Fun_FMJS01000015.1_i000_008173	145	461	316	0.957576	0.618395
GCA_900096625.1-Fun_FMJX01000016.1_i000_012617	145	461	316	0.957576	0.618395
GCA_900096705.1-Fun_FMJT01000015.1_i000_005513	145	461	316	0.957576	0.618395
GCA_005125345.1-Ani_RWIC01000747.1_i000_013461	132	446	314	0.951515	0.601533
GCA_004369235.1-Pro_SDXP01000463.1_i000_000401	582	908	326	0.987879	0.358636
GCA_013368315.1-Fun_JAACJM010000098.1_i000_011853	138	454	316	0.957576	0.557319
GCA_905231925.1-Pro_CAJNJV010007243.1_i000_008346	115	446	331	1.00303	0.641473
GCA_003615085.1-Fun_CM010805.1_i000_011072	144	461	317	0.960606	0.620352
GCA_020796175.1-Fun_JAJGYP010000007.1_i000_017271	144	461	317	0.960606	0.620352
GCA_000259975.2-Fun_JH650830.1_i000_004551	144	461	317	0.960606	0.620352
GCA_002003045.1-Fun_BDGU01000086.1_i000_003595	138	450	312	0.945455	0.552212
GCA_021015755.1-Fun_JABWDW010000015.1_i000_002493	138	450	312	0.945455	0.552212
GCA_003704615.1-Fun_QWIQ01000021.1_i000_004153	131	464	333	1.00909	0.603261
GCA_004917925.1-Fun_SPRI01000012.1_i000_000525	122	447	325	0.984848	0.612053
GCA_004917975.1-Fun_SPRM01000021.1_i000_001464	122	447	325	0.984848	0.612053
GCA_004918485.1-Fun_SPRQ01000013.1_i000_000628	122	447	325	0.984848	0.612053
GCA_004918635.1-Fun_SPRD01000011.1_i000_000359	122	447	325	0.984848	0.612053
GCA_004918645.1-Fun_SPRE01000011.1_i000_000346	122	447	325	0.984848	0.612053
GCA_004918665.1-Fun_SPRB01000009.1_i000_003937	122	447	325	0.984848	0.612053
GCA_004918795.1-Fun_SPRH01000009.1_i000_003940	122	447	325	0.984848	0.612053
GCA_004918805.1-Fun_SPRR01000010.1_i000_004169	122	447	325	0.984848	0.612053
GCA_004918835.1-Fun_SPRW01000011.1_i000_000415	122	447	325	0.984848	0.612053
GCA_004918915.1-Fun_SPRN01000017.1_i000_001080	122	447	325	0.984848	0.612053
GCA_004918925.1-Fun_SPRP01000011.1_i000_000455	122	447	325	0.984848	0.612053
GCA_004918985.1-Fun_SPRS01000010.1_i000_004167	122	447	325	0.984848	0.612053
GCA_001659605.2-Pla_CM004400.2_i000_025907	119	441	322	0.975758	0.563923
GCA_000263375.1-Fun_JH668242.1_i000_004223	122	447	325	0.984848	0.612053
GCA_004917935.1-Fun_SPRJ01000012.1_i000_000522	122	447	325	0.984848	0.612053
GCA_004917965.1-Fun_SPRO01000036.1_i000_002269	122	447	325	0.984848	0.612053
GCA_004918155.1-Fun_SPRG01000012.1_i000_000551	122	447	325	0.984848	0.612053
GCA_004918525.1-Fun_SPRF01000014.1_i000_000745	122	447	325	0.984848	0.612053
GCA_004918605.1-Fun_SPRK01000011.1_i000_000338	122	447	325	0.984848	0.612053
GCA_004918725.1-Fun_SPRT01000007.1_i000_003389	122	447	325	0.984848	0.612053
GCA_004918905.1-Fun_SPRC01000011.1_i000_000362	122	447	325	0.984848	0.612053
GCA_004918995.1-Fun_SPRY01000013.1_i000_000685	122	447	325	0.984848	0.612053
GCA_004919005.1-Fun_SPRX01000010.1_i000_004160	122	447	325	0.984848	0.612053
GCA_000388065.2-Pro_KB932206.1_i000_003617	120	445	325	0.984848	0.727069
GCA_004918005.1-Fun_SPRU01000009.1_i000_003952	122	447	325	0.984848	0.612053
GCA_004918025.1-Fun_SPRV01000012.1_i000_000599	122	447	325	0.984848	0.612053
GCA_004918075.1-Fun_SPRL01000009.1_i000_004060	122	447	325	0.984848	0.612053
GCA_004918515.1-Fun_SPRA01000010.1_i000_004171	122	447	325	0.984848	0.612053
GCA_001447435.1-Ani_JYDK01000001.1_i000_000021	158	494	336	1.01818	0.589474
GCA_016618385.1-Ani_JABFOP010000285.1_i000_007176	111	448	337	1.02121	0.600713
GCA_000151295.1-Fun_GG745341.1_i000_009948	126	443	317	0.960606	0.62279
GCA_000312925.2-Fun_HE965034.1_i000_000199	129	464	335	1.01515	0.676768
GCA_000986645.1-Fun_JZBS01003033.1_i000_003001	131	432	301	0.912121	0.602
GCA_001447745.1-Ani_JYDM01000080.1_i000_013415	158	494	336	1.01818	0.589474
GCA_001447655.1-Ani_JYDQ01000059.1_i000_004486	158	494	336	1.01818	0.589474
GCA_018127125.1-Pla_CM030792.1_i000_014443	117	442	325	0.984848	0.588768
GCA_000151645.1-Fun_FN430064.1_i000_002046	130	466	336	1.01818	0.311111
GCA_000260155.3-Fun_JH651399.1_i000_014226	143	459	316	0.957576	0.611219
GCA_000271705.2-Fun_JH717907.1_i000_014530	144	459	315	0.954545	0.61284
GCA_003615185.1-Fun_MRDA01000028.1_i000_008121	144	459	315	0.954545	0.61284
GCA_001447585.1-Ani_JYDI01000040.1_i000_003302	158	494	336	1.01818	0.589474
GCA_007726485.1-Pla_RWGY01000191.1_i000_034418	122	440	318	0.963636	0.576087
GCA_002127715.1-Fun_MUNK01000107.1_i000_015295	131	464	333	1.00909	0.603261
GCA_003704675.1-Fun_QWIS01000006.1_i000_006362	131	464	333	1.00909	0.603261
GCA_003704685.1-Fun_QWIT01000004.1_i000_007219	131	464	333	1.00909	0.603261
GCA_000005005.6-Pla_CM000785.4_i000_035398	131	441	310	0.939394	0.551601
GCA_003185045.1-Pla_CM009914.1_i000_034293	131	441	310	0.939394	0.551601
GCA_014925795.1-Fun_WIQF01000036.1_i000_010570	131	462	331	1.00303	0.572664
GCA_005406065.1-Fun_BIMT01000023.1_i000_002699	128	445	317	0.960606	0.60381
GCA_001447575.1-Ani_JYDT01000116.1_i000_009174	160	497	337	1.02121	0.581034
GCA_001447675.1-Ani_JYDR01000064.1_i000_006179	160	497	337	1.02121	0.581034
GCA_017311285.1-Fun_JABTEG010000003.1_i000_000894	119	450	331	1.00303	0.64902
GCA_021525025.1-Fun_JAKELI010000098.1_i000_015864	127	452	325	0.984848	0.607477
GCA_000211455.3-Ani_ADMH02002134.1_i000_000714	111	447	336	1.01818	0.607595
GCA_014871845.1-Pla_CM026442.1_i000_023390	131	443	312	0.945455	0.533333
GCA_000743755.1-Pro_JPUL02000275.1_i000_004382	116	446	330	1	0.628571
GCA_000151295.1-Fun_GG745339.1_i000_010889	126	444	318	0.963636	0.624754
GCA_001190045.1-Pla_CM003378.1_i000_020477	117	429	312	0.945455	0.566243
GCA_004320505.1-Pla_AP015039.1_i000_018378	117	429	312	0.945455	0.566243
GCA_016808095.1-Pla_CM028989.1_i000_014414	117	429	312	0.945455	0.566243
GCA_002870075.2-Pla_CM022519.1_i000_006560	129	445	316	0.957576	0.551483
GCA_904859935.1-Fun_CAJHEQ010000053.1_i000_001035	140	462	322	0.975758	0.346609
GCA_004918415.1-Fun_SPOL01000012.1_i000_000456	123	449	326	0.987879	0.608209
GCA_004918625.1-Fun_SPOK01000013.1_i000_000550	123	449	326	0.987879	0.608209
GCA_022160305.1-Fun_MU277187.1_i000_000719	133	452	319	0.966667	0.558669
GCA_001278385.1-Fun_LGAV01000003.1_i000_002040	138	462	324	0.981818	0.606742
GCA_020497155.1-Pla_CM035717.1_i000_031004	125	451	326	0.987879	0.583184
GCA_000004515.5-Pla_CM000844.4_i000_028492	121	443	322	0.975758	0.584392
GCA_000722935.2-Pla_KN646098.1_i000_009242	121	443	322	0.975758	0.584392
GCA_004193775.2-Pla_CM014367.1_i000_029644	121	443	322	0.975758	0.584392
GCA_012273815.2-Pla_CM022569.2_i000_030737	121	443	322	0.975758	0.584392
GCA_014282095.1-Pla_CM024923.1_i000_031343	121	443	322	0.975758	0.584392
GCA_014282145.1-Pla_CM024943.1_i000_030802	121	443	322	0.975758	0.584392
GCA_001661405.1-Fun_KV453938.1_i000_004868	135	458	323	0.978788	0.632094
GCA_016808335.1-Pla_CM029053.1_i000_039043	131	443	312	0.945455	0.549296
GCA_019616915.1-Fun_WSTI01007731.1_i000_007952	4	307	303	0.918182	0.704651
GCA_019206905.1-Fun_JAHLUB010000003.1_i000_003260	135	461	326	0.987879	0.650699
GCA_019206925.1-Fun_JAHLUE010000004.1_i000_003464	135	461	326	0.987879	0.650699
GCA_019206965.1-Fun_JAHLUF010000003.1_i000_003197	135	461	326	0.987879	0.650699
GCA_019206985.1-Fun_JAHLUC010000002.1_i000_002650	135	461	326	0.987879	0.650699
GCA_019207125.1-Fun_JAHLUD010000002.1_i000_002601	135	461	326	0.987879	0.650699
GCA_019207165.1-Fun_JAHLUV010000002.1_i000_002476	135	461	326	0.987879	0.650699
GCA_019207175.1-Fun_JAHLUI010000003.1_i000_003647	135	461	326	0.987879	0.650699
GCA_019207185.1-Fun_JAHLUG010000002.1_i000_002509	135	461	326	0.987879	0.650699
GCA_019207205.1-Fun_JAHLUJ010000003.1_i000_003108	135	461	326	0.987879	0.650699
GCA_019207235.1-Fun_JAHLUK010000005.1_i000_003751	135	461	326	0.987879	0.650699
GCA_019207265.1-Fun_JAHLUN010000002.1_i000_002595	135	461	326	0.987879	0.650699
GCA_019207285.1-Fun_JAHLUL010000001.1_i000_001965	135	461	326	0.987879	0.650699
GCA_019207315.1-Fun_JAHLUO010000003.1_i000_003112	135	461	326	0.987879	0.650699
GCA_019207325.1-Fun_JAHLUP010000005.1_i000_003705	135	461	326	0.987879	0.650699
GCA_019207365.1-Fun_JAHLUQ010000003.1_i000_003392	135	461	326	0.987879	0.650699
GCA_019207415.1-Fun_JAHLUU010000003.1_i000_003097	135	461	326	0.987879	0.650699
GCA_019207435.1-Fun_JAHLUT010000004.1_i000_003348	135	461	326	0.987879	0.650699
GCA_001263195.1-Fun_KQ412567.1_i000_005537	125	454	329	0.99697	0.619586
GCA_900087985.1-Fun_LT576331.1_i000_004749	130	447	317	0.960606	0.611969
GCA_016808335.1-Pla_CM029053.1_i000_039042	131	441	310	0.939394	0.545775
GCA_022496195.1-Fun_WTXC01000024.1_i000_005186	127	450	323	0.978788	0.594843
GCA_015476405.1-Fun_CM027201.1_i000_005682	135	450	315	0.954545	0.557522
GCA_001865875.1-Pla_CM007373.1_i000_020017	115	437	322	0.975758	0.579137
GCA_018857305.1-Fun_JABCKQ010008830.1_i000_004404	123	454	331	1.00303	0.624528
GCA_001299255.1-Fun_LFJN01000006.1_i000_010266	121	457	336	1.01818	0.542811
GCA_018296245.1-Fun_JADFTV010000190.1_i000_006307	145	461	316	0.957576	0.618395
GCA_018296265.1-Fun_JADFTU010000186.1_i000_006269	145	461	316	0.957576	0.618395
GCA_018296285.1-Fun_JADFTT010000312.1_i000_008528	145	461	316	0.957576	0.618395
GCA_018296305.1-Fun_JADFTW010000177.1_i000_005087	145	461	316	0.957576	0.618395
GCA_018296325.1-Fun_JADFTY010000033.1_i000_001935	145	461	316	0.957576	0.618395
GCA_018296345.1-Fun_JADFTX010000265.1_i000_006632	145	461	316	0.957576	0.618395
GCA_000149425.1-Fun_CH408157.1_i000_003236	125	464	339	1.02727	0.666012
GCA_001632345.1-Fun_KV429099.1_i000_009391	121	452	331	1.00303	0.624528
GCA_000827275.1-Fun_KN833921.1_i000_016560	124	454	330	1	0.625
GCA_003024175.1-Pro_MDYQ01000061.1_i000_015489	1264	1591	327	0.990909	0.193491
GCA_000002525.1-Fun_CR382128.1_i000_000720	131	449	318	0.963636	0.617476
GCA_001761485.1-Fun_CP017554.1_i000_000970	131	449	318	0.963636	0.617476
GCA_003367845.1-Fun_KZ859396.1_i000_006190	131	449	318	0.963636	0.617476
GCA_003367865.1-Fun_KZ859073.1_i000_005664	131	449	318	0.963636	0.617476
GCA_003367925.1-Fun_KZ858407.1_i000_005823	131	449	318	0.963636	0.617476
GCA_003367945.1-Fun_KZ858148.1_i000_006190	131	449	318	0.963636	0.617476
GCA_003367965.1-Fun_KZ858828.1_i000_006497	131	449	318	0.963636	0.617476
GCA_003698155.1-Fun_PKSB01000001.1_i000_000043	131	449	318	0.963636	0.617476
GCA_009194645.1-Fun_ML736639.1_i000_005069	131	449	318	0.963636	0.617476
GCA_009372015.1-Fun_ML755995.1_i000_002573	131	449	318	0.963636	0.617476
GCA_014490615.1-Fun_CP061013.1_i000_000725	131	449	318	0.963636	0.617476
GCA_900537225.1-Fun_UTQH01000009.1_i000_006274	131	449	318	0.963636	0.617476
GCA_900099495.1-Fun_LT882686.1_i000_010490	136	464	328	0.993939	0.601835
GCA_001245095.1-Fun_CDQK01000005.1_i000_003837	121	446	325	0.984848	0.653924
GCA_008355005.1-Fun_NIDF01000028.1_i000_003939	130	456	326	0.987879	0.56993
GCA_002081575.1-Pro_JNBS01001045.1_i000_005025	115	446	331	1.00303	0.676892
GCA_000827195.1-Fun_KN838544.1_i000_002446	122	456	334	1.01212	0.623134
GCA_001633215.2-Pla_KV784030.1_i000_026367	128	442	314	0.951515	0.550877
GCA_017506865.1-Pro_JAFCMP010000434.1_i000_013226	122	446	324	0.981818	0.69379
GCA_000219495.2-Pla_CM001220.2_i000_022353	117	441	324	0.981818	0.585895
GCA_003473485.2-Pla_CM010651.1_i000_020758	117	441	324	0.981818	0.585895
GCA_022376445.1-Fun_JACBKP010000003.1_i000_008847	121	450	329	0.99697	0.626667
GCA_017639365.1-Fun_JAAQQX010000003.1_i000_002499	131	449	318	0.963636	0.617476
GCA_017639385.1-Fun_JAAQQW010000007.1_i000_005013	131	449	318	0.963636	0.617476
GCA_002938385.1-Fun_NHYE01001430.1_i000_006741	124	466	342	1.03636	0.622951
GCA_003335185.2-Ani_QKKF02036444.1_i000_016752	112	443	331	1.00303	0.618692
GCA_019677355.1-Fun_WSLN01000095.1_i000_001629	133	450	317	0.960606	0.237098
GCA_019627685.1-Fun_WSTO01003174.1_i000_009425	13	340	327	0.990909	0.691332
GCA_009363875.1-Pla_CM018683.1_i000_029768	125	442	317	0.960606	0.393789
GCA_000149865.1-Fun_DS022311.1_i000_001318	117	446	329	0.99697	0.655378
GCA_020744175.1-Fun_JAGTJP010000068.1_i000_011885	128	459	331	1.00303	0.624528
GCA_001720155.1-Fun_AWGH01000043.1_i000_006006	130	456	326	0.987879	0.56993
GCA_022478985.1-Fun_JAKSZP010017703.1_i000_005018	121	444	323	0.978788	0.604869
GCA_004155925.1-Fun_QJNX01000003.1_i000_005641	140	464	324	0.981818	0.63035
GCA_014058105.1-Pla_JACGCM010000067.1_i000_025366	116	442	326	0.987879	0.565972
GCA_001661335.1-Fun_KV454436.1_i000_004989	128	457	329	0.99697	0.646365
GCA_001720205.1-Fun_AWGJ01000004.1_i000_005354	130	457	327	0.990909	0.570681
GCA_001720235.1-Fun_MEKH01000004.1_i000_005306	130	457	327	0.990909	0.570681
GCA_002245815.2-Pla_LHPF02000042.1_i000_006726	120	447	327	0.990909	0.633721
GCA_000340665.1-Pla_CM003606.1_i000_008502	115	441	326	0.987879	0.585278
GCA_000313545.1-Fun_CAFZ01000111.1_i000_006864	121	454	333	1.00909	0.567291
GCA_910890315.1-Fun_CAJVGD010000005.1_i000_002568	121	454	333	1.00909	0.567291
GCA_003046395.2-Pla_CM009690.2_i000_001506	131	441	310	0.939394	0.498392
GCA_000222805.1-Fun_AFQF01001995.1_i000_006538	144	461	317	0.960606	0.620352
GCA_000260075.2-Fun_JH650974.1_i000_010880	144	461	317	0.960606	0.620352
GCA_000260215.2-Fun_KK033188.1_i000_006283	144	461	317	0.960606	0.620352
GCA_000260235.2-Fun_JH658369.1_i000_005322	144	461	317	0.960606	0.620352
GCA_000260495.2-Fun_JH659333.1_i000_008547	144	461	317	0.960606	0.620352
GCA_000271745.2-Fun_JH717845.1_i000_010561	144	461	317	0.960606	0.620352
GCA_005930515.1-Fun_SRMI01000009.1_i000_015157	144	461	317	0.960606	0.620352
GCA_014154955.1-Fun_CM024368.1_i000_011926	144	461	317	0.960606	0.620352
GCA_018894095.1-Fun_RSAI01000012.1_i000_003851	144	461	317	0.960606	0.620352
GCA_019157275.1-Fun_JAELUR010000005.1_i000_014913	144	461	317	0.960606	0.620352
GCA_020744355.1-Fun_JAHEVI010000007.1_i000_014490	144	461	317	0.960606	0.620352
GCA_900096695.1-Fun_FMJY01000007.1_i000_004541	144	461	317	0.960606	0.620352
GCA_003615115.1-Fun_MRCX01000011.1_i000_001242	143	466	323	0.978788	0.635827
GCA_020744455.1-Fun_JAHEWL010000007.1_i000_015248	143	466	323	0.978788	0.635827
GCA_011763645.1-Fun_JAASGZ010007451.1_i000_019719	1	291	290	0.878788	0.870871
GCA_000827205.1-Fun_KN832564.1_i000_009480	123	455	332	1.00606	0.632381
GCA_000350345.1-Fun_KB730332.1_i000_008896	144	463	319	0.966667	0.624266
GCA_010093595.1-Fun_MU003695.1_i000_003861	132	461	329	0.99697	0.626667
GCA_016618355.2-Fun_JADGIP010000309.1_i000_004854	125	452	327	0.990909	0.607807
GCA_008124465.1-Pla_CM017883.1_i000_017246	6	326	320	0.969697	0.780488
GCA_000149955.2-Fun_CM000597.1_i000_014868	144	459	315	0.954545	0.61284
GCA_000767015.2-Ani_ASGP02000003.1_i000_007093	137	447	310	0.939394	0.521886
GCA_020809275.1-Ani_SDOV01000001.1_i000_001424	137	447	310	0.939394	0.521886
GCA_019915245.1-Fun_CM034120.1_i000_009854	144	465	321	0.972727	0.62818
GCA_000313485.1-Fun_CAIF01000017.1_i000_005812	133	460	327	0.990909	0.632495
GCA_002894225.1-Fun_MTQA01000070.1_i000_013243	144	456	312	0.945455	0.610568
GCA_002287525.1-Ani_LIAE01006789.1_i000_006244	112	440	328	0.993939	0.650794
GCA_018296085.1-Fun_JACKQM010000443.1_i000_000480	126	450	324	0.981818	0.56942
GCA_018296165.1-Fun_JACKQL010014159.1_i000_013083	126	450	324	0.981818	0.56942
GCA_013368295.1-Fun_JAACJJ010000028.1_i000_001232	128	454	326	0.987879	0.350915
GCA_000260175.2-Fun_JH657930.1_i000_006895	143	455	312	0.945455	0.610568
GCA_000260195.2-Fun_JH658282.1_i000_007459	143	455	312	0.945455	0.610568
GCA_000350365.1-Fun_KB726235.1_i000_001540	143	455	312	0.945455	0.610568
GCA_902825445.1-Ani_CADEBC010000598.1_i000_016484	128	456	328	0.993939	0.716157
GCA_902825455.1-Ani_CADEBD010000290.1_i000_005644	128	456	328	0.993939	0.716157
GCA_019456465.1-Fun_JAHXPR010000012.1_i000_005051	131	461	330	1	0.643275
GCA_905219625.1-Fun_CAJMWX010001047.1_i000_004468	133	450	317	0.960606	0.241616
GCA_007726485.1-Pla_RWGY01000830.1_i000_053878	224	539	315	0.954545	0.483129
GCA_016584265.1-Fun_PUHW01000222.1_i000_001896	184	497	313	0.948485	0.628514
GCA_000188695.1-Pro_GL832979.1_i000_008947	118	447	329	0.99697	0.637597
GCA_015657495.1-Fun_MU157860.1_i000_008197	127	456	329	0.99697	0.614953
GCA_003546025.1-Pla_QPKB01000011.1_i000_023296	124	443	319	0.966667	0.5299
GCA_905216605.1-Pla_LR999456.1_i000_016194	121	441	320	0.969697	0.601504
GCA_019202805.1-Pla_CM032910.1_i000_046481	121	441	320	0.969697	0.601504
GCA_004369085.1-Fun_ML210247.1_i000_008769	134	454	320	0.969697	0.564374
GCA_902806795.1-Ani_CADCXV010001472.1_i000_016199	124	439	315	0.954545	0.714286
GCA_004337985.1-Fun_CM014987.1_i000_004988	137	465	328	0.993939	0.639376
GCA_001447725.1-Ani_JYDS01000138.1_i000_005828	160	498	338	1.02424	0.587826
GCA_019447015.1-Ani_JAACNH010000372.1_i000_018695	59	337	278	0.842424	0.824926
GCA_001630345.1-Fun_KV417270.1_i000_001616	125	452	327	0.990909	0.543189
GCA_000004985.1-Pro_GG738901.1_i000_011592	117	447	330	1	0.712743
GCA_003316975.2-Fun_CM010973.1_i000_009398	145	466	321	0.972727	0.62818
GCA_003144245.1-Fun_KZ819663.1_i000_001862	130	464	334	1.01212	0.577855
GCA_013305805.1-Fun_QVQA01000278.1_i000_002302	131	449	318	0.963636	0.6139
GCA_905237085.1-Pro_CAJNNV010014449.1_i000_020823	118	452	334	1.01212	0.704641
GCA_002287525.1-Ani_LIAE01008690.1_i000_014685	112	442	330	1	0.657371
GCA_002156985.1-Ani_KZ149936.1_i000_010238	128	457	329	0.99697	0.715217
GCA_019202795.1-Pla_CM032923.1_i000_046168	121	441	320	0.969697	0.601504
GCA_000711695.1-Fun_JMSN01000014.1_i000_001592	127	462	335	1.01515	0.613553
GCA_021527775.1-Fun_JAKEYF010000083.1_i000_016343	127	452	325	0.984848	0.599631
GCA_001447425.1-Ani_JYDJ01000023.1_i000_001692	145	481	336	1.01818	0.603232
GCA_017607575.1-Fun_JABAJY010000011.1_i000_000631	138	461	323	0.978788	0.554983
GCA_010405425.1-Fun_MU005578.1_i000_006408	135	463	328	0.993939	0.629559
GCA_000478725.1-Pla_KI517408.1_i000_007681	119	441	322	0.975758	0.595194
GCA_000002265.1-Ani_CM000239.2_i000_018568	129	441	312	0.945455	0.58427
GCA_014282035.1-Pla_CM024843.1_i000_019340	265	592	327	0.990909	0.467143
GCA_018446385.1-Pla_CM031510.1_i000_010524	128	438	310	0.939394	0.70615
GCA_000585565.1-Fun_AMGY01000005.1_i000_006635	135	457	322	0.975758	0.507886
GCA_000209535.1-Ani_FN653018.1_i000_003232	116	464	348	1.05455	0.705882
GCA_000005175.1-Ani_CH933807.1_i000_009221	121	446	325	0.984848	0.625
GCA_020744175.1-Fun_JAGTJP010000014.1_i000_002798	129	451	322	0.975758	0.512739
GCA_004379715.1-Fun_ML213628.1_i000_010404	120	453	333	1.00909	0.624765
GCA_014180765.2-Pla_MUAA02000017.1_i000_003989	118	445	327	0.990909	0.610075
GCA_014282345.1-Pla_CM024978.1_i000_030613	277	603	326	0.987879	0.457865
GCA_900624975.1-Ani_UYYA01004326.1_i000_009587	124	461	337	1.02121	0.712474
GCA_001286725.1-Fun_CYGV01001290.1_i000_005966	329	633	304	0.921212	0.414169
GCA_003070745.1-Fun_NESQ01000017.1_i000_002791	130	447	317	0.960606	0.293247
GCA_009735665.1-Ani_MQTX01000096.1_i000_003741	138	495	357	1.08182	0.694553
GCA_000149555.1-Fun_CM000584.1_i000_011376	205	522	317	0.960606	0.555166
GCA_020091625.1-Fun_JAGYZC010000003.1_i000_005599	125	446	321	0.972727	0.545918
GCA_002994745.2-Pla_CM009584.1_i000_015273	117	446	329	0.99697	0.596014
GCA_001477535.1-Fun_LFWA01000004.1_i000_002391	138	457	319	0.966667	0.575812
GCA_000187245.3-Fun_CM002304.1_i000_003345	141	461	320	0.969697	0.647773
GCA_019207595.1-Fun_JAHLVG010000004.1_i000_003382	141	461	320	0.969697	0.647773
GCA_019207695.1-Fun_JAHLVH010000005.1_i000_004567	141	461	320	0.969697	0.647773
GCA_019207935.1-Fun_JAHLVI010000001.1_i000_001940	141	461	320	0.969697	0.647773
GCA_000235995.2-Ani_KZ248735.1_i000_010609	118	445	327	0.990909	0.597806
GCA_003290285.1-Fun_PKMI01000001.1_i000_001169	520	838	318	0.963636	0.358512
GCA_017309865.1-Fun_PKMH01000079.1_i000_003996	520	838	318	0.963636	0.358512
GCA_013397865.1-Ani_VZTI01003155.1_i000_007266	56	398	342	1.03636	0.74026
GCA_001651475.1-Pla_CM004361.1_i000_011516	132	440	308	0.933333	0.577861
GCA_019202795.1-Pla_CM032915.1_i000_011597	132	440	308	0.933333	0.577861
GCA_019202805.1-Pla_CM032902.1_i000_011113	132	440	308	0.933333	0.577861
GCA_902651935.1-Pla_CACRSJ010000106.1_i000_011803	132	440	308	0.933333	0.577861
GCA_902705455.1-Pla_CACSHJ010000089.1_i000_011639	132	440	308	0.933333	0.577861
GCA_904420315.1-Pla_LR881468.1_i000_009675	132	440	308	0.933333	0.577861
GCA_002120335.1-Fun_KZ111286.1_i000_011699	133	460	327	0.990909	0.641176
GCA_905221605.1-Pro_CAJNDS010002811.1_i000_034457	120	453	333	1.00909	0.663347
GCA_015039365.1-Fun_WION01000005.1_i000_011936	134	461	327	0.990909	0.611215
GCA_019973975.1-Ani_BMAO01038273.1_i000_067943	114	439	325	0.984848	0.695931
GCA_013305595.1-Fun_QQZN01000013.1_i000_000782	132	449	317	0.960606	0.608445
GCA_013365075.1-Fun_QQZL01000105.1_i000_000202	132	449	317	0.960606	0.608445
GCA_021525015.1-Fun_JAKELH010000020.1_i000_006870	127	453	326	0.987879	0.591652
GCA_019828595.1-Pro_JAHQRK010000005.1_i000_014246	115	443	328	0.993939	0.650794
GCA_016808335.1-Pla_CM029054.1_i000_077690	131	441	310	0.939394	0.553571
GCA_013396165.1-Fun_JAAQPF010000609.1_i000_011398	554	875	321	0.972727	0.348156
GCA_014871385.1-Pla_CM026427.1_i000_017447	128	442	314	0.951515	0.559715
GCA_014871845.1-Pla_CM026439.1_i000_016892	128	442	314	0.951515	0.559715
GCA_001664035.1-Fun_LXTC01000004.1_i000_003875	128	447	319	0.966667	0.612284
GCA_013365065.1-Fun_QQZO01000018.1_i000_001604	131	452	321	0.972727	0.612595
GCA_905332335.1-Ani_CAJOBX010025557.1_i000_028267	129	445	316	0.957576	0.580882
GCA_000002495.2-Fun_CM001233.1_i000_006991	134	466	332	1.00606	0.645914
GCA_000292585.1-Fun_JH793314.1_i000_004896	134	466	332	1.00606	0.645914
GCA_000292605.1-Fun_JH795505.1_i000_010247	134	466	332	1.00606	0.645914
GCA_004346965.1-Fun_CP034206.1_i000_006719	134	466	332	1.00606	0.645914
GCA_021442365.1-Fun_PHFK01000001.1_i000_001843	134	466	332	1.00606	0.645914
GCA_021845515.1-Fun_VIDS01000006.1_i000_009928	134	466	332	1.00606	0.645914
GCA_021527685.1-Pro_JAJGMV010000091.1_i000_001966	116	440	324	0.981818	0.645418
GCA_002794465.1-Fun_MTSL01000041.1_i000_000576	136	468	332	1.00606	0.619403
GCA_009835175.1-Pro_VJMJ01000056.1_i000_017803	117	441	324	0.981818	0.644135
GCA_021527665.1-Pro_JAJNMJ010005755.1_i000_015032	117	441	324	0.981818	0.644135
GCA_021527785.1-Pro_JAJATU010000122.1_i000_001026	117	441	324	0.981818	0.644135
GCA_021527805.1-Pro_JAJNMK010000526.1_i000_007013	117	441	324	0.981818	0.644135
GCA_010085315.1-Ani_VULG01039168.1_i000_009741	110	445	335	1.01515	0.723542
GCA_014904895.1-Fun_MU125070.1_i000_013948	131	455	324	0.981818	0.60788
GCA_017309895.1-Fun_PKMJ01000010.1_i000_011025	565	885	320	0.969697	0.343348
GCA_000147175.1-Ani_GL442192.1_i000_011234	96	434	338	1.02424	0.733189
GCA_001402995.1-Fun_CCBN010000005.1_i000_002288	131	452	321	0.972727	0.619691
GCA_014596635.1-Fun_QQZJ01000118.1_i000_000519	131	452	321	0.972727	0.619691
GCA_905237085.1-Pro_CAJNNV010031763.1_i000_053073	118	452	334	1.01212	0.706131
GCA_000333975.2-Fun_CAKM01000282.1_i000_000317	136	460	324	0.981818	0.613636
GCA_004918305.1-Fun_SPOM01000019.1_i000_001147	123	449	326	0.987879	0.608209
GCA_004918405.1-Fun_SPOO01000019.1_i000_001146	123	449	326	0.987879	0.608209
GCA_004918655.1-Fun_SPOP01000019.1_i000_001152	123	449	326	0.987879	0.608209
GCA_004918735.1-Fun_SPON01000019.1_i000_001148	123	449	326	0.987879	0.608209
GCA_004918745.1-Fun_SPOJ01000015.1_i000_000733	123	449	326	0.987879	0.608209
GCA_004918885.1-Fun_SPNY01000019.1_i000_001147	123	449	326	0.987879	0.608209
GCA_017552425.1-Pla_CM029803.1_i000_009206	117	440	323	0.978788	0.568662
GCA_904066235.2-Ani_CAJFCV020000001.1_i000_001094	110	445	335	1.01515	0.721983
GCA_904067135.1-Ani_CAJFDI010000001.1_i000_001094	110	445	335	1.01515	0.721983
GCA_016584195.1-Fun_PUHU01000214.1_i000_001887	301	614	313	0.948485	0.508943
GCA_013365045.1-Fun_QQZM01000037.1_i000_002797	132	451	319	0.966667	0.608779
GCA_013365125.1-Fun_QQZK01000121.1_i000_000643	132	451	319	0.966667	0.608779
GCA_001742945.1-Pla_DF973217.1_i000_009677	116	442	326	0.987879	0.586331
GCA_018854895.1-Fun_JABAJV010000084.1_i000_002056	125	453	328	0.993939	0.573427
GCA_000003195.3-Pla_CM000762.3_i000_014436	131	441	310	0.939394	0.545775
GCA_019279435.1-Pla_JAAALK010000286.1_i000_009423	131	442	311	0.942424	0.532534
GCA_002980475.2-Fun_PVQB02000090.1_i000_002596	144	464	320	0.969697	0.628684
GCA_009078335.1-Pla_CM018584.1_i000_019471	117	440	323	0.978788	0.577818
GCA_905115235.1-Ani_LR899009.1_i000_001576	114	447	333	1.00909	0.713062
GCA_001447455.1-Ani_JYDL01000002.1_i000_006799	145	481	336	1.01818	0.405797
GCA_001411555.2-Pla_CM023851.1_i000_023621	120	440	320	0.969697	0.553633
GCA_016808335.1-Pla_CM029054.1_i000_077691	131	443	312	0.945455	0.551237
GCA_000005425.2-Pla_AP008209.2_i000_008774	131	441	310	0.939394	0.545775
GCA_000149285.1-Pla_CM000140.1_i000_010322	131	441	310	0.939394	0.545775
GCA_001433935.1-Pla_AP014959.1_i000_012746	131	441	310	0.939394	0.545775
GCA_004007595.1-Pla_CM012943.1_i000_010154	131	441	310	0.939394	0.545775
GCA_009797565.1-Pla_CM020523.1_i000_010560	131	441	310	0.939394	0.545775
GCA_004337975.1-Fun_RRCJ01000002.1_i000_004346	133	462	329	0.99697	0.640078
GCA_000934385.1-Fun_KN880481.1_i000_004862	131	448	317	0.960606	0.573237
GCA_014764975.1-Fun_JACYFE010005850.1_i000_007716	138	465	327	0.990909	0.641176
GCA_013396255.1-Fun_JAAOAY010000041.1_i000_001666	554	875	321	0.972727	0.348156
GCA_001913855.2-Fun_MLYV02001198.1_i000_011861	128	457	329	0.99697	0.629063
GCA_004802665.1-Fun_SGPJ01000098.1_i000_008422	128	457	329	0.99697	0.629063
GCA_000320605.2-Fun_KB445793.1_i000_002895	121	460	339	1.02727	0.640832
GCA_000209165.1-Fun_CP000499.1_i000_003743	129	446	317	0.960606	0.615534
GCA_016859295.1-Fun_CM029110.1_i000_005856	129	446	317	0.960606	0.615534
GCA_014839935.1-Fun_QTSX01036436.1_i000_019014	119	455	336	1.01818	0.685714
GCA_001865875.1-Pla_CM007367.1_i000_010798	114	438	324	0.981818	0.582734
GCA_013423385.1-Fun_BLZA01000002.1_i000_000030	131	474	343	1.03939	0.587329
GCA_008373055.1-Ani_VSRR010001753.1_i000_019993	30	345	315	0.954545	0.735981
GCA_000499845.1-Pla_CM002298.1_i000_026177	115	435	320	0.969697	0.57554
GCA_000142805.1-Fun_CU928180.1_i000_004456	134	458	324	0.981818	0.639053
GCA_000827495.1-Fun_KN817556.1_i000_008611	137	455	318	0.963636	0.558875
GCA_003185045.1-Pla_CM009906.1_i000_001490	258	565	307	0.930303	0.145154
GCA_001865355.1-Pro_LRBS01000060.1_i000_002854	117	448	331	1.00303	0.711828
GCA_000005425.2-Pla_AP008209.2_i000_008773	131	441	310	0.939394	0.557554
GCA_022432515.1-Fun_JAJKLA010000043.1_i000_007646	134	463	329	0.99697	0.641326
GCA_002166775.1-Fun_NHMM01000001.1_i000_000136	131	452	321	0.972727	0.606805
GCA_010093605.1-Fun_MU004183.1_i000_002613	130	461	331	1.00303	0.6341
GCA_000349305.2-Fun_HE999550.1_i000_003311	142	463	321	0.972727	0.596654
GCA_000510995.2-Pla_KQ155649.1_i000_012562	128	442	314	0.951515	0.566787
GCA_004681135.1-Fun_SFCI01000750.1_i000_009681	135	452	317	0.960606	0.55614
GCA_019627755.1-Fun_WSTS01001496.1_i000_002119	1	291	290	0.878788	0.783784
GCA_015499995.1-Fun_JADNRV010000030.1_i000_009350	127	455	328	0.993939	0.573427
GCA_000002165.1-Ani_CM000209.2_i000_000452	133	445	312	0.945455	0.58209
GCA_005959815.1-Ani_QOCX01001997.1_i000_009374	120	446	326	0.987879	0.523274
GCA_012932025.1-Fun_JAADJG010000245.1_i000_006280	138	465	327	0.990909	0.641176
GCA_007735645.1-Fun_CP042190.1_i000_004033	135	467	332	1.00606	0.652259
GCA_002900925.1-Fun_LN890539.1_i000_001212	133	457	324	0.981818	0.639053
GCA_003054445.1-Fun_CP028775.1_i000_002803	131	452	321	0.972727	0.613767
GCA_000320585.2-Fun_KI925456.1_i000_003899	135	452	317	0.960606	0.564057
GCA_000764455.1-Fun_JQFK01000034.1_i000_005316	131	453	322	0.975758	0.619231
GCA_001983325.1-Fun_MQVM01000025.1_i000_004112	131	453	322	0.975758	0.619231
GCA_021018615.1-Fun_JAEVFL010000007.1_i000_007796	121	451	330	1	0.567986
GCA_019804575.1-Fun_JAHQZX010000618.1_i000_003987	127	428	301	0.912121	0.703271
GCA_018855915.1-Fun_JABCKO010015891.1_i000_007461	124	447	323	0.978788	0.567663
GCA_017301755.1-Fun_CP054545.1_i000_002808	135	460	325	0.984848	0.584532
GCA_022376275.1-Fun_JAJNOH010000008.1_i000_013048	143	467	324	0.981818	0.627907
GCA_001298345.1-Ani_KQ459601.1_i000_012160	145	474	329	0.99697	0.686848
GCA_019343175.1-Ani_CM033276.1_i000_009185	133	445	312	0.945455	0.684211
GCA_000576695.1-Fun_HG793130.1_i000_005337	131	449	318	0.963636	0.611538
GCA_011032825.1-Fun_JAADJZ010000017.1_i000_004128	127	459	332	1.00606	0.670707
GCA_013305925.1-Fun_QVTG01000160.1_i000_000574	132	448	316	0.957576	0.607692
GCA_001481415.2-Fun_LNZH02000204.1_i000_004988	131	450	319	0.966667	0.291324
GCA_015342415.1-Fun_JACYCE010000055.1_i000_001615	132	449	317	0.960606	0.233432
GCA_013368295.1-Fun_JAACJJ010000033.1_i000_009701	123	455	332	1.00606	0.62406
GCA_021432655.1-Fun_MU271189.1_i000_000901	141	461	320	0.969697	0.537815
GCA_015179025.1-Fun_WHUX01000010.1_i000_000454	130	451	321	0.972727	0.577338
GCA_014282345.1-Pla_CM024979.1_i000_032690	185	500	315	0.954545	0.516393
GCA_000203795.1-Fun_GL882890.1_i000_006566	117	446	329	0.99697	0.635135
GCA_013364935.1-Fun_JABEVY010000219.1_i000_008860	554	875	321	0.972727	0.348156
GCA_013396075.1-Fun_JAAOAV010000003.1_i000_000782	554	875	321	0.972727	0.348156
GCA_013758895.1-Fun_JAAOAI010000107.1_i000_002477	554	875	321	0.972727	0.348156
GCA_011392965.1-Ani_WNWW01000907.1_i000_009563	145	479	334	1.01212	0.656189
GCA_003795275.1-Fun_LJZO01000021.1_i000_005041	136	467	331	1.00303	0.6341
GCA_015342435.1-Fun_JACYCD010000048.1_i000_001649	132	449	317	0.960606	0.22724
GCA_001929475.1-Fun_LXFE01001034.1_i000_001783	125	450	325	0.984848	0.414541
MEMA007.0722.00001.C001_00670	83	405	322	0.975758	0.676471
MEMA007.0722.00002.C001_00670	83	405	322	0.975758	0.676471
GCA_001970855.1-Fun_LSSN01002050.1_i000_005829	119	452	333	1.00909	0.639155
GCA_001970855.1-Fun_LSSN01002767.1_i000_007273	119	452	333	1.00909	0.639155
GCA_900332095.2-Pla_OOIL02002240.1_i000_023324	134	444	310	0.939394	0.550622
GCA_001654015.2-Ani_LSRL02000073.1_i000_007939	229	552	323	0.978788	0.513514
GCA_013396295.1-Fun_JAAGWQ010000124.1_i000_006660	140	464	324	0.981818	0.635294
GCA_015484465.1-Fun_MU155183.1_i000_005465	124	454	330	1	0.616822
GCA_004126415.1-Fun_SDEE01000023.1_i000_005713	135	449	314	0.951515	0.535836
GCA_022264855.1-Fun_JABYQU010000024.1_i000_004739	124	454	330	1	0.605505
GCA_900149145.1-Fun_LT671823.1_i000_002051	190	510	320	0.969697	0.546075
GCA_013266265.1-Fun_JABFAK010000213.1_i000_004489	190	514	324	0.981818	0.576512
GCA_014904935.1-Fun_MU123716.1_i000_004733	122	451	329	0.99697	0.61039
GCA_001970865.1-Fun_LSSM01004810.1_i000_008480	119	449	330	1	0.626186
GCA_000813385.1-Fun_KN714745.1_i000_007634	145	465	320	0.969697	0.61657
GCA_907164705.1-Ani_CAJQZP010000541.1_i000_007765	132	459	327	0.990909	0.707792
GCA_018857285.1-Fun_JABAKA010024084.1_i000_013246	140	461	321	0.972727	0.552496
GCA_009663055.1-Fun_CP023083.1_i000_009542	520	842	322	0.975758	0.363021
GCA_001640025.2-Fun_CP014500.1_i000_004208	138	468	330	1	0.633397
GCA_905219615.1-Fun_CAJMWW010000092.1_i000_003775	133	450	317	0.960606	0.24727
GCA_001654555.2-Fun_LUFC02000778.1_i000_009398	556	876	320	0.969697	0.347072
GCA_001939145.1-Pro_LSRX01000595.1_i000_022641	219	546	327	0.990909	0.54591
GCA_000347455.1-Pla_KD049566.1_i000_003932	125	441	316	0.957576	0.564286
GCA_002220415.3-Pla_CM022214.1_i000_014877	125	441	316	0.957576	0.564286
GCA_002220415.3-Pla_CM022216.1_i000_026947	125	441	316	0.957576	0.564286
GCA_900231445.1-Pla_LT934113.1_i000_009021	125	441	316	0.957576	0.564286
GCA_900411305.1-Pla_LS480641.1_i000_001035	125	441	316	0.957576	0.564286
GCA_008124465.1-Pla_CM017872.1_i000_000218	117	440	323	0.978788	0.553082
GCA_009663095.1-Fun_CP023095.1_i000_009514	521	840	319	0.966667	0.359639
GCA_009663115.1-Fun_CP023107.1_i000_009549	521	840	319	0.966667	0.359639
GCA_002251995.2-Fun_NDIQ01000001.1_i000_000731	140	446	306	0.927273	0.612
GCA_015731905.1-Pla_CM027671.1_i000_019653	117	440	323	0.978788	0.577818
GCA_013396035.1-Fun_JAAOAS010000020.1_i000_001016	560	881	321	0.972727	0.345905
GCA_000004655.2-Pla_CM000128.1_i000_011104	220	530	310	0.939394	0.471842
GCA_014282095.1-Pla_CM024924.1_i000_033458	181	481	300	0.909091	0.503356
GCA_013396015.1-Fun_JAAOAM010000442.1_i000_013149	555	877	322	0.975758	0.349241
GCA_900660285.1-Fun_CAACVR010000056.1_i000_004380	132	457	325	0.984848	0.639764
GCA_905219595.1-Fun_CAJMWU010002351.1_i000_004783	133	449	316	0.957576	0.224591
GCA_905219605.1-Fun_CAJMWV010007781.1_i000_008199	133	449	316	0.957576	0.224591
GCA_008694065.1-Fun_VYXO01000004.1_i000_006447	132	484	352	1.06667	0.699801
GCA_000349005.2-Fun_AFWA02000014.1_i000_001189	137	459	322	0.975758	0.612167
GCA_003144115.1-Fun_KZ819289.1_i000_002288	133	459	326	0.987879	0.601476
GCA_000271585.1-Fun_JH711785.1_i000_003664	126	453	327	0.990909	0.579787
GCA_901677955.1-Fun_CABFJX010000279.1_i000_007444	555	875	320	0.969697	0.347072
GCA_901677965.1-Fun_CABFJW010000474.1_i000_013240	555	875	320	0.969697	0.347072
GCA_902702945.1-Fun_CACRXN010000163.1_i000_002011	555	875	320	0.969697	0.347072
GCA_905330805.1-Ani_CAJNWK010000004.1_i000_002939	776	1109	333	1.00909	0.296
MEIN004.0722.00001.C001_00949	76	388	312	0.945455	0.802057
GCA_014636115.1-Fun_JAASFG010000007.1_i000_004514	217	542	325	0.984848	0.541667
GCA_004155935.1-Fun_QJNV01000458.1_i000_008470	140	463	323	0.978788	0.632094
GCA_003704355.1-Fun_QWIL01000730.1_i000_007046	131	465	334	1.01212	0.605072
GCA_003704385.1-Fun_QWIM01002752.1_i000_014594	131	465	334	1.01212	0.605072
GCA_000209555.1-Ani_FN654536.1_i000_010790	116	463	347	1.05152	0.708163
GCA_000147195.1-Ani_GL446831.1_i000_002985	125	457	332	1.00606	0.669355
GCA_013395995.1-Fun_JAAOAR010000163.1_i000_003569	554	875	321	0.972727	0.348156
GCA_022432375.1-Fun_JAJKKK010000031.1_i000_005926	129	460	331	1.00303	0.640232
GCA_020004485.1-Ani_JAATJU010022199.1_i000_010093	130	441	311	0.942424	0.51405
GCA_000180635.4-Ani_CM026579.1_i000_022944	112	444	332	1.00606	0.681725
GCA_021052385.1-Fun_JAIFAB010000019.1_i000_003182	143	463	320	0.969697	0.559441
GCA_021014935.1-Fun_MU267600.1_i000_001374	122	452	330	1	0.614525
GCA_018858115.1-Fun_JABCKT010000120.1_i000_003752	126	452	326	0.987879	0.570928
GCA_017552425.1-Pla_CM029811.1_i000_022221	117	439	322	0.975758	0.576029
GCA_000003835.1-Fun_CH408083.1_i000_005759	213	543	330	1	0.55
GCA_013085055.1-Fun_CP052045.1_i000_012758	534	852	318	0.963636	0.35177
GCA_003615075.1-Fun_MRCW01000124.1_i000_002061	535	852	317	0.960606	0.351831
GCA_003615095.1-Fun_MRCV01000028.1_i000_009049	535	852	317	0.960606	0.351831
GCA_003615155.1-Fun_MRCY01000036.1_i000_010037	535	852	317	0.960606	0.351831
GCA_013363075.1-Fun_JAAFOW010001048.1_i000_006447	535	852	317	0.960606	0.351831
GCA_013396195.1-Fun_JAAQRI010000035.1_i000_001968	557	877	320	0.969697	0.344828
GCA_003615165.1-Fun_MRCZ01000008.1_i000_016169	536	852	316	0.957576	0.350721
GCA_004141715.1-Fun_MQTW01000073.1_i000_017746	536	852	316	0.957576	0.350721
GCA_019616915.1-Fun_WSTI01012352.1_i000_013312	1	284	283	0.857576	0.729381
GCA_000259595.1-Fun_AHIQ01000042.1_i000_000606	103	424	321	0.972727	0.622093
GCA_902829235.1-Ani_CADEPI010000019.1_i000_003015	130	448	318	0.963636	0.582418
GCA_001447595.1-Ani_JYDH01000002.1_i000_000401	167	503	336	1.01818	0.316682
GCA_020875895.1-Ani_JNEY01000002.1_i000_001943	140	474	334	1.01212	0.634981
GCA_000827195.1-Fun_KN838546.1_i000_002769	137	454	317	0.960606	0.182499
GCA_000576695.1-Fun_HG793125.1_i000_000304	129	459	330	1	0.650888
GCA_013266175.1-Fun_JABFAI010000273.1_i000_009914	556	873	317	0.960606	0.343818
GCA_008271595.1-Pro_SMMQ01002475.1_i000_012061	111	446	335	1.01515	0.667331
GCA_012274485.2-Pla_MU105674.1_i000_011089	131	445	314	0.951515	0.586916
GCA_015499995.1-Fun_JADNRV010000053.1_i000_013578	62	395	333	1.00909	0.69958
GCA_905221635.1-Pro_CAJNDV010036218.1_i000_029836	223	551	328	0.993939	0.543947
GCA_000204515.1-Ani_GL888584.1_i000_011851	113	446	333	1.00909	0.517081
GCA_001673695.2-Fun_LYUB02000005.1_i000_002099	142	462	320	0.969697	0.613027
GCA_905231915.1-Pro_CAJNJA010029808.1_i000_017893	156	483	327	0.990909	0.522364
GCA_000441895.2-Ani_KE525025.1_i000_005871	118	448	330	1	0.608856
GCA_000230625.1-Fun_JH226131.1_i000_001864	133	454	321	0.972727	0.499222
GCA_004154925.1-Fun_QJNS01000272.1_i000_005053	135	464	329	0.99697	0.643836
GCA_004154975.1-Fun_QJNW01000545.1_i000_008215	135	464	329	0.99697	0.643836
GCA_004155895.1-Fun_QJNT01000346.1_i000_006885	135	464	329	0.99697	0.643836
GCA_013396025.1-Fun_JAAOAQ010000217.1_i000_006224	555	875	320	0.969697	0.347072
GCA_017607455.1-Ani_JAANHZ010000208.1_i000_000922	113	446	333	1.00909	0.516279
GCA_003589665.1-Fun_MVGC01000364.1_i000_007819	105	438	333	1.00909	0.651663
GCA_004114815.1-Pla_SDOW01000487.1_i000_034955	119	440	321	0.972727	0.576302
GCA_011074885.2-Fun_CP063136.1_i000_003571	127	448	321	0.972727	0.603383
GCA_014176175.1-Fun_JABCYN010000034.1_i000_003929	127	448	321	0.972727	0.603383
GCA_014176185.1-Fun_JABCYO010000002.1_i000_000214	127	448	321	0.972727	0.603383
GCA_905219645.1-Fun_CAJMWZ010002098.1_i000_002423	132	450	318	0.963636	0.268354
GCA_002105095.1-Fun_MCFJ01000003.1_i000_006932	132	462	330	1	0.642023
GCA_015342445.1-Pla_JACEFO010001687.1_i000_021343	142	454	312	0.945455	0.53886
GCA_008704595.1-Fun_SWFT01000116.1_i000_002025	133	460	327	0.990909	0.624046
GCA_018282025.1-Fun_JABCKI010000590.1_i000_004791	1	292	291	0.881818	0.723881
GCA_000142905.1-Pro_GL349446.1_i000_003455	123	456	333	1.00909	0.663347
GCA_021904315.1-Pla_CM038910.1_i000_006508	129	433	304	0.921212	0.698851
GCA_000334115.1-Fun_KB317726.1_i000_006971	351	644	293	0.887879	0.447328
GCA_001661345.1-Fun_KV454475.1_i000_000475	137	471	334	1.01212	0.606171
GCA_000827215.1-Fun_KN837079.1_i000_002959	126	457	331	1.00303	0.641473
GCA_000769215.1-Fun_JPYM01000010.1_i000_001628	139	459	320	0.969697	0.623782
GCA_018282135.1-Fun_JAGPUO010000012.1_i000_001978	139	459	320	0.969697	0.623782
GCA_020744115.1-Fun_JAGMVH010000001.1_i000_002104	139	459	320	0.969697	0.623782
GCA_003012285.1-Fun_PXOG01000228.1_i000_009019	145	459	314	0.951515	0.609709
GCA_013398155.1-Ani_VZRU01017503.1_i000_010811	56	389	333	1.00909	0.676829
GCA_010015725.1-Fun_ML977589.1_i000_007873	135	465	330	1	0.640777
GCA_000004255.1-Pla_GL348715.1_i000_008854	129	444	315	0.954545	0.59322
GCA_004931855.1-Fun_SELW01000121.1_i000_003724	131	451	320	0.969697	0.608365
GCA_022496205.1-Fun_WTXD01000024.1_i000_005126	126	449	323	0.978788	0.599258
GCA_905237085.1-Pro_CAJNNV010031529.1_i000_052088	120	452	332	1.00606	0.691667
GCA_905237095.1-Pro_CAJNNW010031279.1_i000_034317	120	452	332	1.00606	0.691667
GCA_003958685.2-Pla_CP039347.1_i000_012201	115	441	326	0.987879	0.586331
GCA_001531365.1-Pla_CM009735.1_i000_007460	128	201	73	0.221212	0.124361
GCA_001531365.1-Pla_CM009735.1_i000_007460	221	503	282	0.854545	0.480409
GCA_905237095.1-Pro_CAJNNW010026952.1_i000_026084	119	451	332	1.00606	0.472934
GCA_016618255.1-Pla_VFSX01000039.1_i000_000096	127	435	308	0.933333	0.616
GCA_900074715.1-Fun_LT598478.1_i000_000679	131	462	331	1.00303	0.651575
GCA_000818155.1-Fun_CM003099.1_i000_002503	142	466	324	0.981818	0.623077
GCA_015501535.1-Fun_JADNRW010000015.1_i000_005434	137	454	317	0.960606	0.590317
GCA_905338395.1-Ani_CAJPEW010007199.1_i000_011650	376	703	327	0.990909	0.386068
GCA_001632355.1-Fun_KV428152.1_i000_009531	130	460	330	1	0.630975
GCA_015952705.1-Pla_CM027682.1_i000_014741	131	441	310	0.939394	0.54386
GCA_003704685.1-Fun_QWIT01000002.1_i000_000163	135	466	331	1.00303	0.599638
GCA_000193285.1-Fun_GL876976.1_i000_009849	132	466	334	1.01212	0.639847
GCA_003614695.1-Fun_ML004446.1_i000_001979	128	439	311	0.942424	0.611002
GCA_003614695.1-Fun_ML004902.1_i000_004746	128	439	311	0.942424	0.611002
GCA_900576705.1-Ani_UXUI01007291.1_i000_001936	86	419	333	1.00909	0.714592
GCA_001276565.1-Ani_KQ435789.1_i000_006930	118	445	327	0.990909	0.563793
GCA_003086715.1-Fun_MBFS01002229.1_i000_005305	126	454	328	0.993939	0.601835
GCA_001895945.1-Fun_MNAD01000861.1_i000_013567	122	451	329	0.99697	0.608133
GCA_017552425.1-Pla_CM029811.1_i000_022228	109	434	325	0.984848	0.587703
GCA_020623625.1-Fun_CM036080.1_i000_000695	131	447	316	0.957576	0.619608
GCA_900491785.1-Fun_UFAJ01000463.1_i000_002400	131	447	316	0.957576	0.619608
GCA_013396175.1-Fun_JAAOAK010000288.1_i000_009312	554	875	321	0.972727	0.348156
GCA_004154915.1-Fun_QJNU01000058.1_i000_008978	143	462	319	0.966667	0.618217
GCA_000147195.1-Ani_GL452434.1_i000_012955	106	431	325	0.984848	0.703463
GCA_002117355.1-Fun_KZ110613.1_i000_011680	127	451	324	0.981818	0.668041
GCA_015832375.1-Fun_JADOXO010000058.1_i000_008682	127	451	324	0.981818	0.668041
GCA_001691785.2-Fun_JNHV02000271.1_i000_005017	124	452	328	0.993939	0.592058
GCA_019206915.1-Fun_JAHLUA010000002.1_i000_002466	135	461	326	0.987879	0.650699
GCA_022478985.1-Fun_JAKSZP010013325.1_i000_003813	92	451	359	1.08788	0.762208
GCA_000004155.2-Fun_KE546988.1_i000_001268	135	454	319	0.966667	0.635458
GCA_000004655.2-Pla_CM000128.1_i000_011103	131	441	310	0.939394	0.545775
GCA_001433935.1-Pla_AP014959.1_i000_012745	131	441	310	0.939394	0.545775
GCA_004007595.1-Pla_CM012943.1_i000_010153	131	441	310	0.939394	0.545775
GCA_009797565.1-Pla_CM020523.1_i000_010559	131	441	310	0.939394	0.545775
GCA_000733195.1-Pla_CM002871.1_i000_004651	131	437	306	0.927273	0.57845
GCA_001708105.1-Fun_CP014586.1_i000_003782	132	460	328	0.993939	0.66129
GCA_902728275.1-Fun_CACVBS010000073.1_i000_010494	137	457	320	0.969697	0.318408
GCA_013396205.1-Fun_JAAOAN010000475.1_i000_011870	552	873	321	0.972727	0.348156
GCA_007726485.1-Pla_CM017443.1_i000_024209	131	440	309	0.936364	0.551786
GCA_000218685.1-Fun_GL945431.1_i000_003302	133	452	319	0.966667	0.563604
GCA_000218725.1-Fun_GL945477.1_i000_003166	133	452	319	0.966667	0.563604
GCA_020921065.1-Pla_CM037159.1_i000_024284	211	537	326	0.987879	0.500768
GCA_003676035.1-Fun_NSGQ01000049.1_i000_003630	539	870	331	1.00303	0.365342
GCA_020536535.1-Pro_JAHLWZ010000680.1_i000_008610	118	445	327	0.990909	0.695745
GCA_910890315.1-Fun_CAJVGD010000042.1_i000_007648	136	462	326	0.987879	0.624521
GCA_001949185.1-Ani_BDGG01000003.1_i000_008470	111	444	333	1.00909	0.623596
GCA_001661415.1-Fun_KV453912.1_i000_002988	130	448	318	0.963636	0.615087
GCA_022496185.1-Fun_WTXG01000015.1_i000_002459	123	452	329	0.99697	0.598182
GCA_000803305.1-Ani_JPKZ01022854.1_i000_018488	148	480	332	1.00606	0.588652
GCA_011392965.1-Ani_WNWW01000907.1_i000_009562	76	407	331	1.00303	0.750567
GCA_013781345.1-Fun_JAAOAJ010000251.1_i000_006278	555	877	322	0.975758	0.349241
GCA_015473125.1-Pla_BNJQ01000023.1_i000_007756	136	430	294	0.890909	0.593939
GCA_000520075.1-Pro_KI913148.1_i000_011373	114	446	332	1.00606	0.65098
GCA_001630475.1-Fun_KV419411.1_i000_007113	134	455	321	0.972727	0.613767
GCA_916381525.1-Ani_CAKAEH010002025.1_i000_010127	131	461	330	1	0.558376
GCA_905337325.1-Fun_CAJPDR010000008.1_i000_000554	133	463	330	1	0.637066
GCA_001661395.1-Fun_KV454539.1_i000_001812	130	447	317	0.960606	0.608445
GCA_000005505.4-Pla_CM000880.3_i000_002303	124	440	316	0.957576	0.564286
GCA_006381635.2-Pla_VEPZ02000238.1_i000_007382	132	404	272	0.824242	0.671605
GCA_905221625.1-Pro_CAJNDU010058002.1_i000_035201	427	754	327	0.990909	0.364548
GCA_003675555.2-Fun_QOBI02000008.1_i000_004932	215	542	327	0.990909	0.542289
GCA_009498055.1-Fun_CP038491.1_i000_005532	215	542	327	0.990909	0.542289
GCA_009498075.1-Fun_CP039557.1_i000_005518	215	542	327	0.990909	0.542289
GCA_009498095.1-Fun_CP039659.1_i000_005540	215	542	327	0.990909	0.542289
GCA_009498115.1-Fun_CP039667.1_i000_005532	215	542	327	0.990909	0.542289
GCA_009498135.1-Fun_CP039625.1_i000_005535	215	542	327	0.990909	0.542289
GCA_003676015.1-Fun_NSDU01000013.1_i000_001968	129	438	309	0.936364	0.607073
GCA_001895945.1-Fun_MNAD01000413.1_i000_010142	131	452	321	0.972727	0.571174
GCA_019787685.1-Fun_JAHNUO010000004.1_i000_003427	123	456	333	1.00909	0.546798
GCA_004011775.1-Fun_NAJM01000045.1_i000_007067	134	452	318	0.963636	0.509615
GCA_001632375.1-Fun_KV425882.1_i000_000726	123	450	327	0.990909	0.545
GCA_007994515.1-Fun_VMNF01000012.1_i000_002144	579	888	309	0.936364	0.327331
GCA_019202795.1-Pla_CM032920.1_i000_033655	123	442	319	0.966667	0.600753
GCA_015342445.1-Pla_JACEFO010001626.1_i000_016311	130	442	312	0.945455	0.552212
GCA_019202805.1-Pla_CM032907.1_i000_033915	127	444	317	0.960606	0.596987
GCA_004332605.1-Fun_RWJN01000069.1_i000_010826	133	455	322	0.975758	0.591912
GCA_905216605.1-Pla_LR999453.1_i000_006324	120	440	320	0.969697	0.603774
GCA_021014945.1-Fun_MU266455.1_i000_008069	124	453	329	0.99697	0.618421
GCA_004155035.1-Fun_QJOB01000058.1_i000_010212	144	463	319	0.966667	0.620623
GCA_004355905.1-Fun_RRCK01000007.1_i000_011231	134	465	331	1.00303	0.645224
GCA_900537255.1-Ani_UPTC01002875.1_i000_008523	136	459	323	0.978788	0.559792
GCA_000365145.2-Fun_KB822711.1_i000_001248	117	456	339	1.02727	0.548544
GCA_014905795.1-Fun_JACBPP010000002.1_i000_001846	136	456	320	0.969697	0.63745
GCA_019616975.1-Fun_WSTL01000129.1_i000_001366	46	382	336	1.01818	0.646154
GCA_003546785.1-Pro_QUTF01009318.1_i000_003622	143	476	333	1.00909	0.618959
GCA_003788565.2-Fun_ML119666.1_i000_005172	55	380	325	0.984848	0.672878
GCA_001661425.1-Fun_KV453851.1_i000_002612	133	458	325	0.984848	0.642292
GCA_009078325.1-Fun_SSOP01000008.1_i000_008545	388	708	320	0.969697	0.19548
GCA_021604985.1-Pla_BQKI01000082.1_i000_047128	130	442	312	0.945455	0.55615
GCA_011745365.1-Fun_MU032349.1_i000_007780	136	465	329	0.99697	0.630268
GCA_000183025.1-Fun_ABRE01013036.1_i000_006591	32	354	322	0.975758	0.783455
GCA_000296195.2-Pro_AGNL01048377.1_i000_032492	190	512	322	0.975758	0.56
GCA_003546765.1-Pro_QUTG01006336.1_i000_012703	143	476	333	1.00909	0.618959
GCA_003546825.1-Pro_QUTH01003004.1_i000_006248	143	476	333	1.00909	0.618959
GCA_021604985.1-Pla_BQKI01000084.1_i000_049011	123	440	317	0.960606	0.567084
GCA_002197585.2-Pro_MZMZ02004209.1_i000_011793	144	477	333	1.00909	0.617811
GCA_002220415.3-Pla_CM022215.1_i000_021238	167	488	321	0.972727	0.52883
GCA_021524915.1-Fun_JAKELL010000039.1_i000_007316	127	452	325	0.984848	0.597426
GCA_003666305.1-Pro_QUTI01028117.1_i000_009245	144	477	333	1.00909	0.62594
GCA_900231445.1-Pla_LT934114.1_i000_014352	168	489	321	0.972727	0.527961
GCA_905231925.1-Pro_CAJNJV010057260.1_i000_038067	492	819	327	0.990909	0.339917
GCA_000149425.1-Fun_CH408157.1_i000_003220	129	439	310	0.939394	0.615079
GCA_000520115.1-Pro_KI913968.1_i000_008343	114	450	336	1.01818	0.680162
GCA_003546525.1-Pro_QUSY01000418.1_i000_005243	114	450	336	1.01818	0.680162
GCA_004000055.1-Fun_SAEB01000001.1_i000_005139	134	439	305	0.924242	0.563771
GCA_003032435.1-Pla_KZ772700.1_i000_006280	118	444	326	0.987879	0.608209
GCA_009936355.2-Pla_AP019867.1_i000_002957	118	444	326	0.987879	0.608209
GCA_013396095.1-Fun_JAAQRM010000093.1_i000_002916	1194	1514	320	0.969697	0.20526
GCA_003546545.1-Pro_QUTB01004123.1_i000_004218	145	478	333	1.00909	0.62243
GCA_003546585.1-Pro_QUTD01004685.1_i000_005136	145	478	333	1.00909	0.62243
GCA_003546605.1-Pro_QUTA01006754.1_i000_009163	145	478	333	1.00909	0.62243
GCA_003546625.1-Pro_QUTC01005989.1_i000_007798	145	478	333	1.00909	0.62243
GCA_003546805.1-Pro_QUTE01008924.1_i000_005019	145	478	333	1.00909	0.62243
GCA_020310875.1-Pla_CM035429.1_i000_021897	135	440	305	0.924242	0.616162
GCA_003546565.1-Pro_QUSZ01005658.1_i000_006924	147	476	329	0.99697	0.614953
GCA_001865875.1-Pla_CM007368.1_i000_013848	115	442	327	0.990909	0.465812
GCA_003795295.1-Fun_LKEB01000100.1_i000_009748	135	464	329	0.99697	0.514867
GCA_905219635.1-Fun_CAJMWY010003974.1_i000_006724	135	189	54	0.163636	0.0413793
GCA_905219635.1-Fun_CAJMWY010003974.1_i000_006724	185	312	127	0.384848	0.097318
GCA_905219635.1-Fun_CAJMWY010003974.1_i000_006724	314	493	179	0.542424	0.137165
GCA_017607525.1-Ani_JAANIA010000279.1_i000_005577	115	444	329	0.99697	0.511664
GCA_019364595.1-Fun_JAHRGV010000065.1_i000_006975	123	456	333	1.00909	0.595707
GCA_016584175.1-Fun_PUHR01000085.1_i000_005086	144	462	318	0.963636	0.628458
GCA_010094045.1-Fun_ML986692.1_i000_011273	131	463	332	1.00606	0.638462
GCA_902806785.1-Ani_CADCXU010035394.1_i000_024102	15	332	317	0.960606	0.690632
GCA_001477545.1-Fun_LFVZ01000017.1_i000_001600	116	443	327	0.990909	0.638672
GCA_000218685.1-Fun_GL945444.1_i000_012099	128	453	325	0.984848	0.599631
GCA_000218725.1-Fun_GL945490.1_i000_011613	128	453	325	0.984848	0.599631
GCA_000976065.2-Fun_CP006448.1_i000_003476	140	462	322	0.975758	0.638889
GCA_000977895.2-Fun_CP006419.1_i000_003387	140	462	322	0.975758	0.638889
GCA_022376435.1-Fun_JABYQE010000012.1_i000_001393	122	454	332	1.00606	0.599278
GCA_017607545.1-Ani_JAANIC010006140.1_i000_008128	115	447	332	1.00606	0.51633
GCA_013396185.1-Fun_JAAQPE010000359.1_i000_009920	1453	1773	320	0.969697	0.175921
GCA_903064755.1-Fun_CAEFZW010000003.1_i000_001920	144	461	317	0.960606	0.627723
GCA_903987035.1-Fun_CAJDZR010000003.1_i000_002221	144	461	317	0.960606	0.627723
GCA_000448345.1-Ani_KE670805.1_i000_008395	130	445	315	0.954545	0.574818
GCA_002120325.1-Fun_KZ112965.1_i000_009551	133	460	327	0.990909	0.646245
GCA_021604985.1-Pla_BQKI01000015.1_i000_023547	130	441	311	0.942424	0.557348
GCA_000836275.1-Fun_KN847521.1_i000_002855	134	453	319	0.966667	0.511218
GCA_000478725.1-Pla_KI517748.1_i000_021894	119	441	322	0.975758	0.600746
GCA_900622545.1-Ani_UYWY01023112.1_i000_015788	115	442	327	0.990909	0.632495
GCA_001477545.1-Fun_LFVZ01000010.1_i000_000308	136	459	323	0.978788	0.568662
GCA_015501585.1-Fun_JADNRY010000006.1_i000_018262	123	475	352	1.06667	0.625222
GCA_001594045.1-Ani_KQ976417.1_i000_002180	115	444	329	0.99697	0.510078
GCA_002007985.1-Fun_MSRX01000002.1_i000_002469	130	449	319	0.966667	0.609943
GCA_002008015.1-Fun_MSSE01000009.1_i000_005635	130	449	319	0.966667	0.609943
GCA_002008025.1-Fun_MSRY01000010.1_i000_000199	130	449	319	0.966667	0.609943
GCA_002008075.1-Fun_MSSB01000109.1_i000_000180	130	449	319	0.966667	0.609943
GCA_003260385.1-Pla_NQVE01000076.1_i000_002061	130	443	313	0.948485	0.53413
GCA_019973955.1-Ani_BMAV01006855.1_i000_012187	117	443	326	0.987879	0.698073
GCA_900231445.1-Pla_LT934112.1_i000_007187	125	441	316	0.957576	0.564286
GCA_000271585.1-Fun_JH711787.1_i000_005695	122	451	329	0.99697	0.608133
GCA_014529505.1-Pro_JABXOJ010000091.1_i000_000348	118	447	329	0.99697	0.707527
GCA_004217705.1-Fun_CP034459.1_i000_004208	137	456	319	0.966667	0.635458
GCA_000696155.1-Ani_KK852458.1_i000_000966	124	436	312	0.945455	0.715596
GCA_000585585.1-Fun_AMWN01000004.1_i000_004641	133	455	322	0.975758	0.511111
GCA_002891735.1-Pla_PGGS01000151.1_i000_005044	8	317	309	0.936364	0.788265
GCA_002120315.1-Fun_KZ111561.1_i000_006486	132	460	328	0.993939	0.644401
GCA_003434825.1-Pla_CM010633.1_i000_022064	122	443	321	0.972727	0.6
GCA_001633215.2-Pla_KV775879.1_i000_010044	139	433	294	0.890909	0.52973
GCA_015849285.1-Fun_JAAAHZ010000511.1_i000_007447	127	393	266	0.806061	0.675127
GCA_001045655.1-Ani_LBMM01000985.1_i000_002481	122	481	359	1.08788	0.732653
GCA_020744515.1-Fun_JAGPXF010000001.1_i000_002113	148	464	316	0.957576	0.612403
GCA_011066575.1-Fun_WIQW01000005.1_i000_007989	134	438	304	0.921212	0.559853
GCA_011066585.1-Fun_WIQY01000073.1_i000_010295	134	438	304	0.921212	0.559853
GCA_011066595.1-Fun_WIQZ01000177.1_i000_003287	134	438	304	0.921212	0.559853
GCA_011066605.1-Fun_WIQX01000172.1_i000_003631	134	438	304	0.921212	0.559853
GCA_011066695.1-Fun_WIRB01000168.1_i000_003203	134	438	304	0.921212	0.559853
GCA_011066875.1-Fun_JAABOE010000030.1_i000_006243	134	438	304	0.921212	0.559853
GCA_011066885.1-Fun_WIWS01000185.1_i000_003721	134	438	304	0.921212	0.559853
GCA_011066905.1-Fun_WIWT01000111.1_i000_001067	134	438	304	0.921212	0.559853
GCA_011066925.1-Fun_WIPF01000180.1_i000_003358	134	438	304	0.921212	0.559853
GCA_011066985.1-Fun_WIPG01000109.1_i000_000800	134	438	304	0.921212	0.559853
GCA_019924265.1-Fun_JAHFXL010000053.1_i000_005405	133	454	321	0.972727	0.499222
GCA_014595645.1-Fun_JACTAD010000011.1_i000_003811	136	465	329	0.99697	0.635135
GCA_900412535.3-Pla_LS974622.2_i000_031042	122	441	319	0.966667	0.596262
GCA_009768925.2-Pro_VHIT02000014.1_i000_002524	116	448	332	1.00606	0.712446
GCA_011068445.1-Fun_JAAGKP010000141.1_i000_002332	134	439	305	0.924242	0.561694
GCA_001541205.1-Fun_KQ954509.1_i000_005253	121	446	325	0.984848	0.606343
GCA_022376515.1-Fun_WTXI01000003.1_i000_007698	127	451	324	0.981818	0.598891
GCA_000142905.1-Pro_GL349439.1_i000_001757	121	451	330	1	0.634615
GCA_001641455.1-Pla_LVLJ01000678.1_i000_008966	217	541	324	0.981818	0.511041
GCA_003144295.1-Fun_KZ819638.1_i000_006100	140	460	320	0.969697	0.590406
GCA_016584205.1-Fun_PUHQ01000127.1_i000_001102	106	431	325	0.984848	0.612053
GCA_011074885.2-Fun_CP063136.1_i000_002684	118	450	332	1.00606	0.664
GCA_000375325.1-Pla_KB870807.1_i000_007360	152	476	324	0.981818	0.546374
GCA_001447935.2-Fun_LMYN01000010.1_i000_000884	129	448	319	0.966667	0.623047
GCA_002081605.1-Ani_MNPL01001452.1_i000_001292	67	445	378	1.14545	0.742633
GCA_011066565.1-Fun_WIRA01000084.1_i000_010858	134	438	304	0.921212	0.559853
GCA_001661415.1-Fun_KV453911.1_i000_002139	128	452	324	0.981818	0.645418
GCA_019973155.1-Fun_BPQB01000022.1_i000_007752	127	450	323	0.978788	0.607143
GCA_004369135.1-Fun_ML179102.1_i000_008180	138	451	313	0.948485	0.550088
GCA_900180425.1-Fun_FXLY01000004.1_i000_004895	145	461	316	0.957576	0.624506
GCA_000349005.2-Fun_AFWA02000006.1_i000_002962	116	447	331	1.00303	0.646484
GCA_000225545.1-Fun_JH119108.1_i000_008022	153	458	305	0.924242	0.542705
GCA_903632075.3-Ani_CAHIKZ030001046.1_i000_017296	115	445	330	1	0.665323
GCA_905231905.1-Pro_CAJNIZ010047748.1_i000_022909	40	371	331	1.00303	0.78436
GCA_000220395.1-Pro_GL984172.1_i000_005701	116	445	329	0.99697	0.716776
GCA_000143185.1-Fun_GL377302.1_i000_001216	140	456	316	0.957576	0.541096
GCA_900618365.1-Ani_UYYF01004286.1_i000_004367	111	447	336	1.01818	0.691358
GCA_014176185.1-Fun_JABCYO010000020.1_i000_002130	128	460	332	1.00606	0.65098
GCA_005059875.1-Fun_MXAQ01000010.1_i000_000474	121	446	325	0.984848	0.595238
GCA_000349385.1-Fun_KB706938.1_i000_007823	145	462	317	0.960606	0.619141
GCA_004369125.1-Fun_ML178851.1_i000_010836	129	457	328	0.993939	0.608534
GCA_002081605.1-Ani_MNPL01001525.1_i000_001359	124	467	343	1.03939	0.671233
GCA_014176175.1-Fun_JABCYN010000025.1_i000_002698	132	460	328	0.993939	0.643137
GCA_902155815.1-Fun_CABFWN010000005.1_i000_003902	132	460	328	0.993939	0.643137
GCA_002120305.1-Fun_KZ112508.1_i000_006590	138	463	325	0.984848	0.681342
GCA_003795315.1-Fun_LKEA01000053.1_i000_008950	143	468	325	0.984848	0.626204
GCA_003144195.1-Fun_KZ819359.1_i000_001787	132	461	329	0.99697	0.617261
GCA_903994135.1-Ani_CAJEWN010001068.1_i000_044049	136	460	324	0.981818	0.648
GCA_905221615.1-Pro_CAJNDT010000206.1_i000_004265	196	524	328	0.993939	0.531605
GCA_903994135.1-Ani_CAJEWN010000027.1_i000_006543	134	460	326	0.987879	0.652
GCA_003788595.2-Fun_ML120358.1_i000_001811	130	449	319	0.966667	0.295644
GCA_015179035.1-Fun_WHUY01000029.1_i000_004733	132	452	320	0.969697	0.566372
GCA_015679415.1-Fun_JAAAUT010000064.1_i000_008531	108	375	267	0.809091	0.712
GCA_010015585.1-Fun_ML975149.1_i000_000911	131	461	330	1	0.627376
GCA_900618405.1-Ani_UYSL01000289.1_i000_000592	125	462	337	1.02121	0.66998
GCA_003073855.1-Fun_KZ805800.1_i000_017065	140	462	322	0.975758	0.641434
GCA_010093785.1-Fun_MU003792.1_i000_005219	135	457	322	0.975758	0.56
GCA_008704595.1-Fun_SWFT01000027.1_i000_003311	131	451	320	0.969697	0.625
GCA_003709365.1-Pla_QOKY01000171.1_i000_002841	133	448	315	0.954545	0.61165
GCA_001481415.2-Fun_LNZH02000165.1_i000_000042	130	455	325	0.984848	0.564236
GCA_900617895.1-Ani_UZAF01019705.1_i000_016628	125	462	337	1.02121	0.66998
GCA_000583005.2-Pla_ASHM01002427.1_i000_004712	1	288	287	0.869697	0.7175
GCA_004768765.1-Fun_SOZJ01000007.1_i000_010200	134	438	304	0.921212	0.559853
GCA_011066715.1-Fun_WIWQ01000007.1_i000_010146	134	438	304	0.921212	0.559853
GCA_011066735.1-Fun_JAABOI010000012.1_i000_001402	134	438	304	0.921212	0.559853
GCA_011066745.1-Fun_JAABOH010000203.1_i000_004438	134	438	304	0.921212	0.559853
GCA_011066795.1-Fun_WIWR01000104.1_i000_000761	134	438	304	0.921212	0.559853
GCA_011067015.1-Fun_JAABLO010000059.1_i000_009151	134	438	304	0.921212	0.559853
GCA_900096595.1-Fun_FMSP01000005.1_i000_001918	123	447	324	0.981818	0.590164
GCA_010458925.1-Pla_CM021233.1_i000_017683	73	387	314	0.951515	0.323378
GCA_001276565.1-Ani_KQ435789.1_i000_006929	111	444	333	1.00909	0.586268
GCA_013368375.1-Fun_JAACJP010000022.1_i000_006996	122	459	337	1.02121	0.633459
GCA_019154785.2-Pro_JAGRRH010000019.1_i000_012172	129	475	346	1.04848	0.665385
GCA_001645005.2-Fun_LWDD02000602.1_i000_008096	129	462	333	1.00909	0.623596
GCA_001645045.2-Fun_LWDE02000858.1_i000_009205	129	462	333	1.00909	0.623596
GCA_009428265.1-Fun_RDSE01000796.1_i000_008769	129	462	333	1.00909	0.623596
GCA_009428275.1-Fun_RDSF01000858.1_i000_009197	129	462	333	1.00909	0.623596
GCA_009428285.1-Fun_RDSG01000810.1_i000_008867	129	462	333	1.00909	0.623596
GCA_905068135.1-Fun_CAJHJA010005055.1_i000_007312	129	462	333	1.00909	0.623596
GCA_905071715.1-Fun_CAJHJH010003101.1_i000_004574	129	462	333	1.00909	0.623596
GCA_905071735.1-Fun_CAJHJE010000099.1_i000_000153	129	462	333	1.00909	0.623596
GCA_905071745.1-Fun_CAJHJG010001149.1_i000_001815	129	462	333	1.00909	0.623596
GCA_905071755.1-Fun_CAJHJF010005857.1_i000_007459	129	462	333	1.00909	0.623596
GCA_905072865.1-Fun_CAJHJV010005576.1_i000_008146	129	462	333	1.00909	0.623596
GCA_013266165.1-Fun_JAAGWP010000370.1_i000_008554	145	463	318	0.963636	0.619883
GCA_021730765.1-Ani_JAIZAO010000106.1_i000_012024	693	1027	334	1.01212	0.31391
GCA_000221225.1-Fun_GL988040.1_i000_001786	135	463	328	0.993939	0.627151
GCA_019632305.1-Fun_WSTW01000557.1_i000_006982	125	458	333	1.00909	0.595707
GCA_003789085.1-Ani_QCYY01001345.1_i000_002576	123	447	324	0.981818	0.323031
GCA_003144235.1-Fun_KZ819832.1_i000_002933	126	459	333	1.00909	0.577123
GCA_001953115.1-Fun_LSSL01004360.1_i000_006296	122	451	329	0.99697	0.641326
GCA_013401375.1-Ani_WBNQ01077646.1_i000_006505	112	381	269	0.815152	0.706037
GCA_010093805.1-Fun_ML996110.1_i000_003314	147	469	322	0.975758	0.642715
GCA_020797215.1-Fun_JAGTTU010000019.1_i000_002938	129	448	319	0.966667	0.621832
GCA_020797225.1-Fun_JAGTTX010000015.1_i000_002942	129	448	319	0.966667	0.621832
GCA_020797355.1-Fun_JAGTUA010000015.1_i000_002920	129	448	319	0.966667	0.621832
GCA_001040885.1-Ani_LN609529.1_i000_006913	111	442	331	1.00303	0.719565
GCA_003704595.1-Fun_QWIO01005189.1_i000_016800	59	354	295	0.893939	0.833333
GCA_001636735.1-Fun_AZHA01000002.1_i000_003015	130	467	337	1.02121	0.666008
GCA_905252715.1-Ani_CAJNOU010001209.1_i000_019350	3	269	266	0.806061	0.985185
GCA_016584185.1-Fun_PUHS01000004.1_i000_003007	139	461	322	0.975758	0.62768
GCA_000223565.1-Fun_FR839628.1_i000_001227	139	462	323	0.978788	0.568662
GCA_022085475.1-Pla_JAIUZE010070098.1_i000_020414	123	442	319	0.966667	0.555749
GCA_904420315.1-Pla_LR881470.1_i000_019218	130	439	309	0.936364	0.66309
GCA_000530735.1-Fun_CBTC010000115.1_i000_008784	140	463	323	0.978788	0.627184
GCA_001984395.2-Fun_CP019503.1_i000_009382	140	463	323	0.978788	0.627184
GCA_903994135.1-Ani_CAJEWN010000315.1_i000_028393	136	460	324	0.981818	0.648
GCA_905071705.1-Fun_CAJHJC010008267.1_i000_009712	129	464	335	1.01515	0.623836
GCA_905071725.1-Fun_CAJHJD010005633.1_i000_007809	129	464	335	1.01515	0.623836
GCA_905071765.1-Fun_CAJHJB010000125.1_i000_003945	129	464	335	1.01515	0.623836
GCA_905071775.1-Fun_CAJHJJ010004626.1_i000_005554	129	464	335	1.01515	0.623836
GCA_905071785.1-Fun_CAJHJI010005857.1_i000_007424	129	464	335	1.01515	0.623836
GCA_900162805.1-Fun_FUGC01000022.1_i000_001515	140	461	321	0.972727	0.623301
GCA_000441935.1-Fun_KE525618.1_i000_005405	134	449	315	0.954545	0.576923
GCA_004104545.1-Ani_SAUD01000793.1_i000_001413	147	479	332	1.00606	0.647173
GCA_000328365.1-Ani_KB312061.1_i000_031002	118	445	327	0.990909	0.55802
GCA_019425555.1-Fun_MXQG01000002.1_i000_004328	144	464	320	0.969697	0.628684
GCA_900007375.1-Fun_LN649231.1_i000_013192	144	464	320	0.969697	0.628684
GCA_000804445.1-Fun_AZHE01000011.1_i000_001528	147	462	315	0.954545	0.617647
GCA_001466525.1-Fun_LLWO01000048.1_i000_002852	126	452	326	0.987879	0.634241
GCA_001466535.1-Fun_LMAA01000076.1_i000_003085	126	452	326	0.987879	0.634241
GCA_001466575.1-Fun_LLZY01000077.1_i000_003741	126	452	326	0.987879	0.634241
GCA_001466635.1-Fun_LLZZ01000114.1_i000_002353	126	452	326	0.987879	0.634241
GCA_020921065.1-Pla_CM037157.1_i000_018645	166	491	325	0.984848	0.540765
GCA_000027005.1-Fun_FN392322.1_i000_004349	130	450	320	0.969697	0.614203
GCA_000223565.1-Fun_FR839631.1_i000_004969	130	450	320	0.969697	0.614203
GCA_001708085.1-Fun_CP014711.1_i000_004331	130	450	320	0.969697	0.614203
GCA_001746955.1-Fun_CP014718.1_i000_004323	130	450	320	0.969697	0.614203
GCA_900235035.1-Fun_LT962479.1_i000_004954	130	450	320	0.969697	0.614203
GCA_903819125.2-Fun_LR813494.2_i000_003650	136	462	326	0.987879	0.646825
GCA_021605095.1-Ani_BPLR01013118.1_i000_049989	156	485	329	0.99697	0.645098
GCA_900618405.1-Ani_UYSL01026587.1_i000_021556	126	462	336	1.01818	0.667992
GCA_002007995.1-Fun_MSRZ01000103.1_i000_000052	130	449	319	0.966667	0.614644
GCA_002008095.1-Fun_MSSC01000085.1_i000_005181	130	449	319	0.966667	0.614644
GCA_020744135.1-Fun_JAGMVI010000004.1_i000_012200	139	463	324	0.981818	0.637795
GCA_002008065.1-Fun_MSSA01000065.1_i000_004604	130	449	319	0.966667	0.611111
GCA_002008085.1-Fun_MSSD01000032.1_i000_003196	130	449	319	0.966667	0.611111
GCA_022432365.1-Fun_JAJJXE010000002.1_i000_004376	135	461	326	0.987879	0.642998
GCA_001447505.1-Ani_JYDN01000020.1_i000_002454	1390	1725	335	1.01515	0.0859636
GCA_020797195.1-Fun_CM036810.1_i000_002742	124	452	328	0.993939	0.638132
GCA_020797205.1-Fun_JAGTTV010000019.1_i000_002931	124	452	328	0.993939	0.638132
GCA_900074765.1-Fun_LT598489.1_i000_000469	134	440	306	0.927273	0.607143
GCA_001566295.1-Fun_KQ964253.1_i000_007461	134	464	330	1	0.637066
GCA_002219185.1-Fun_CM008089.1_i000_003039	118	451	333	1.00909	0.649123
GCA_002219195.1-Fun_CM008103.1_i000_003037	118	451	333	1.00909	0.649123
GCA_020450195.1-Fun_CP053494.1_i000_002742	118	451	333	1.00909	0.649123
GCA_020450215.1-Fun_CP053520.1_i000_002740	118	451	333	1.00909	0.649123
GCA_020450235.1-Fun_CP053533.1_i000_002740	118	451	333	1.00909	0.649123
GCA_020450265.1-Fun_CP060151.1_i000_002739	118	451	333	1.00909	0.649123
GCA_000530735.1-Fun_CBTC010000034.1_i000_003106	135	460	325	0.984848	0.631068
GCA_001984395.2-Fun_CP019498.1_i000_006643	135	460	325	0.984848	0.631068
GCA_020536225.1-Fun_JAEUBG010001129.1_i000_002086	128	443	315	0.954545	0.633803
GCA_905331485.1-Ani_CAJNYT010002209.1_i000_014625	133	461	328	0.993939	0.687631
GCA_003016335.1-Fun_KZ678141.1_i000_013274	134	463	329	0.99697	0.632692
GCA_000977295.2-Fun_CP006399.1_i000_003448	140	462	322	0.975758	0.638889
GCA_000002545.2-Fun_CR380955.2_i000_002898	131	447	316	0.957576	0.615984
GCA_010111755.1-Fun_CP048126.1_i000_002931	131	447	316	0.957576	0.615984
GCA_020797185.1-Fun_CM036839.1_i000_002940	131	447	316	0.957576	0.615984
GCA_020797325.1-Fun_CM036847.1_i000_002930	131	447	316	0.957576	0.615984
GCA_012931995.1-Fun_JAADYS010000890.1_i000_006715	144	464	320	0.969697	0.628684
GCA_013266205.1-Fun_JAAGWO010000002.1_i000_000010	144	464	320	0.969697	0.628684
GCA_903819175.2-Fun_LR813596.2_i000_003650	136	460	324	0.981818	0.644135
GCA_000292725.1-Fun_CM001574.1_i000_002204	136	461	325	0.984848	0.64741
GCA_010405405.1-Fun_MU004238.1_i000_008372	133	464	331	1.00303	0.630476
GCA_009805785.1-Fun_WEHT01000144.1_i000_002034	128	453	325	0.984848	0.653924
GCA_001466565.1-Fun_LMAB01000021.1_i000_000560	130	449	319	0.966667	0.621832
GCA_001466565.1-Fun_LMAB01000099.1_i000_001861	130	449	319	0.966667	0.621832
GCA_001466685.1-Fun_LMAY01000102.1_i000_001758	130	449	319	0.966667	0.621832
GCA_007026445.1-Fun_VDMD01000002.1_i000_006137	140	451	311	0.942424	0.528912
GCA_014217725.1-Fun_CP048238.1_i000_002728	129	451	322	0.975758	0.62768
GCA_900096545.1-Fun_FMSJ01000051.1_i000_005024	129	451	322	0.975758	0.62768
GCA_900166875.1-Fun_FWDN01000051.1_i000_003257	129	451	322	0.975758	0.62768
GCA_900537275.1-Ani_UYRX01000034.1_i000_003920	109	443	334	1.01212	0.690083
GCA_003024175.1-Pro_MDYQ01000025.1_i000_008132	122	453	331	1.00303	0.328373
GCA_003076615.3-Ani_NJHN03000037.1_i000_002126	149	431	282	0.854545	0.502674
GCA_000091025.4-Fun_AE016816.3_i000_000911	134	461	327	0.990909	0.595628
GCA_000968835.1-Fun_CP002707.1_i000_000910	134	461	327	0.990909	0.595628
GCA_019633405.1-Fun_WSTX01001920.1_i000_003196	130	450	320	0.969697	0.645161
GCA_019925795.1-Pla_CM034302.1_i000_005859	129	455	326	0.987879	0.589512
GCA_001006365.1-Fun_LCUC01000255.1_i000_004468	143	468	325	0.984848	0.628627
GCA_001645055.2-Fun_LWDG02000071.1_i000_006822	130	462	332	1.00606	0.6171
GCA_009428295.1-Fun_RDSH01000110.1_i000_000483	130	462	332	1.00606	0.6171
GCA_019633425.1-Fun_WSUB01000001.1_i000_000125	136	451	315	0.954545	0.545927
GCA_019633485.1-Fun_WSUC01000001.1_i000_000130	136	451	315	0.954545	0.545927
GCA_012184355.1-Fun_LDUC01000016.1_i000_008105	134	450	316	0.957576	0.564286
GCA_000827425.1-Fun_KN822146.1_i000_016082	127	454	327	0.990909	0.60221
GCA_022432525.1-Fun_JAJKLB010000003.1_i000_005026	132	493	361	1.09394	0.717694
GCA_905250025.1-Ani_CAJNOJ010000129.1_i000_023445	112	439	327	0.990909	0.709328
GCA_003012295.1-Fun_PXXK01000011.1_i000_000697	144	464	320	0.969697	0.628684
GCA_020744385.1-Fun_JAHBOO010000005.1_i000_009642	144	464	320	0.969697	0.628684
GCA_003693665.1-Fun_QQSL01000086.1_i000_005475	134	453	319	0.966667	0.515347
GCA_002922495.1-Fun_PJQD01000038.1_i000_003766	121	446	325	0.984848	0.604089
GCA_003144135.1-Fun_KZ819333.1_i000_005333	131	457	326	0.987879	0.57193
GCA_004794745.1-Ani_QBLH01003970.1_i000_009833	801	1132	331	1.00303	0.241078
GCA_000293215.1-Fun_JH977558.1_i000_003065	124	449	325	0.984848	0.574205
GCA_000299215.2-Fun_JH925093.1_i000_004666	124	449	325	0.984848	0.574205
GCA_001747055.1-Fun_LPNN01000008.1_i000_003809	132	451	319	0.966667	0.641851
GCA_009805715.1-Fun_WEHR01000684.1_i000_002936	132	451	319	0.966667	0.641851
GCA_009805765.1-Fun_WEHS01000068.1_i000_002557	132	451	319	0.966667	0.641851
GCA_015025155.1-Fun_WITN01000012.1_i000_001784	123	452	329	0.99697	0.601463
GCA_900074745.1-Fun_LT598465.1_i000_002557	133	459	326	0.987879	0.640472
GCA_903819195.2-Fun_LR813613.2_i000_003594	140	462	322	0.975758	0.638889
GCA_019633495.1-Fun_WSUD01005379.1_i000_012260	127	421	294	0.890909	0.686916
GCA_001645015.2-Fun_LWDF02000240.1_i000_003937	130	461	331	1.00303	0.615242
GCA_009428345.1-Fun_RDSI01000130.1_i000_001179	130	461	331	1.00303	0.615242
GCA_009428365.1-Fun_RDSJ01000347.1_i000_005578	130	461	331	1.00303	0.615242
GCA_009792415.2-Pro_VHLK02000010.1_i000_003040	116	448	332	1.00606	0.712446
GCA_000412225.2-Fun_CP006025.1_i000_003675	131	462	331	1.00303	0.638996
GCA_014133895.1-Fun_CP059247.1_i000_001472	136	460	324	0.981818	0.63035
GCA_001329695.1-Fun_KQ474080.1_i000_004182	126	452	326	0.987879	0.580071
GCA_003704595.1-Fun_QWIO01005188.1_i000_016799	59	349	290	0.878788	0.830946
GCA_011074865.2-Fun_CP064812.1_i000_000355	132	458	326	0.987879	0.62572
GCA_000350225.2-Pro_HG002070.1_i000_000159	116	444	328	0.993939	0.570435
GCA_910393935.1-Fun_CAJSTJ010000022.1_i000_000449	139	464	325	0.984848	0.638507
GCA_001275005.1-Pro_JWZX01003164.1_i000_013818	128	427	299	0.906061	0.69213
GCA_000146045.2-Fun_BK006945.2_i000_003851	140	462	322	0.975758	0.638889
GCA_000149365.1-Fun_DS981519.1_i000_005147	140	462	322	0.975758	0.638889
GCA_000181435.1-Fun_AAFW02000169.1_i000_003731	140	462	322	0.975758	0.638889
GCA_000182175.1-Fun_ABSV01001636.1_i000_003193	140	462	322	0.975758	0.638889
GCA_000182315.2-Fun_ACFL01000004.1_i000_005104	140	462	322	0.975758	0.638889
GCA_000190235.1-Fun_CM001137.1_i000_002479	140	462	322	0.975758	0.638889
GCA_000190255.1-Fun_CM001121.1_i000_002265	140	462	322	0.975758	0.638889
GCA_000218975.1-Fun_FN393080.1_i000_003848	140	462	322	0.975758	0.638889
GCA_000260735.1-Fun_DG000048.1_i000_003715	140	462	322	0.975758	0.638889
GCA_000269885.1-Fun_CM001533.1_i000_003492	140	462	322	0.975758	0.638889
GCA_000325965.1-Fun_ADVV01000063.1_i000_002398	140	462	322	0.975758	0.638889
GCA_000326005.1-Fun_AEEZ01000066.1_i000_002206	140	462	322	0.975758	0.638889
GCA_000326105.1-Fun_AGVY01000041.1_i000_002810	140	462	322	0.975758	0.638889
GCA_000568005.1-Fun_CM002415.1_i000_003496	140	462	322	0.975758	0.638889
GCA_000568295.1-Fun_CM002343.1_i000_002645	140	462	322	0.975758	0.638889
GCA_000568365.1-Fun_CM002449.1_i000_003195	140	462	322	0.975758	0.638889
GCA_000662435.2-Fun_CP006467.1_i000_003466	140	462	322	0.975758	0.638889
GCA_000975585.2-Fun_CP006437.1_i000_003411	140	462	322	0.975758	0.638889
GCA_000975615.2-Fun_CP006438.1_i000_003435	140	462	322	0.975758	0.638889
GCA_000975645.3-Fun_CP004110.1_i000_003439	140	462	322	0.975758	0.638889
GCA_000975675.2-Fun_CP006377.1_i000_003431	140	462	322	0.975758	0.638889
GCA_000975705.2-Fun_CP006378.1_i000_003650	140	462	322	0.975758	0.638889
GCA_000975735.4-Fun_CP006435.1_i000_003639	140	462	322	0.975758	0.638889
GCA_000975765.2-Fun_CP006436.1_i000_003439	140	462	322	0.975758	0.638889
GCA_000975855.3-Fun_CP006441.1_i000_003443	140	462	322	0.975758	0.638889
GCA_000975885.2-Fun_CP006442.1_i000_003400	140	462	322	0.975758	0.638889
GCA_000975915.2-Fun_CP006443.1_i000_003427	140	462	322	0.975758	0.638889
GCA_000975945.2-Fun_CP006444.1_i000_003438	140	462	322	0.975758	0.638889
GCA_000975975.3-Fun_CP006445.1_i000_003456	140	462	322	0.975758	0.638889
GCA_000976005.2-Fun_CP006446.1_i000_003415	140	462	322	0.975758	0.638889
GCA_000976035.2-Fun_CP006447.1_i000_003405	140	462	322	0.975758	0.638889
GCA_000976095.2-Fun_CP006449.1_i000_003441	140	462	322	0.975758	0.638889
GCA_000976125.2-Fun_CP006450.1_i000_003412	140	462	322	0.975758	0.638889
GCA_000976155.4-Fun_CP006451.1_i000_003374	140	462	322	0.975758	0.638889
GCA_000976185.2-Fun_CP006452.1_i000_003474	140	462	322	0.975758	0.638889
GCA_000976215.2-Fun_CP006453.1_i000_003435	140	462	322	0.975758	0.638889
GCA_000976245.2-Fun_CP006454.1_i000_003414	140	462	322	0.975758	0.638889
GCA_000976275.4-Fun_CP006455.1_i000_003451	140	462	322	0.975758	0.638889
GCA_000976305.2-Fun_CP006456.1_i000_003477	140	462	322	0.975758	0.638889
GCA_000976335.2-Fun_CP006457.1_i000_003449	140	462	322	0.975758	0.638889
GCA_000976395.2-Fun_CP006459.1_i000_003625	140	462	322	0.975758	0.638889
GCA_000976425.2-Fun_CP006460.1_i000_003655	140	462	322	0.975758	0.638889
GCA_000976455.3-Fun_CP006461.1_i000_003451	140	462	322	0.975758	0.638889
GCA_000976485.2-Fun_CP006462.1_i000_003618	140	462	322	0.975758	0.638889
GCA_000976515.2-Fun_CP006463.1_i000_003645	140	462	322	0.975758	0.638889
GCA_000976545.2-Fun_CP006464.1_i000_003457	140	462	322	0.975758	0.638889
GCA_000976575.4-Fun_CP006465.1_i000_003652	140	462	322	0.975758	0.638889
GCA_000976605.3-Fun_CP006466.1_i000_003377	140	462	322	0.975758	0.638889
GCA_000976665.2-Fun_CP006468.1_i000_003647	140	462	322	0.975758	0.638889
GCA_000976695.3-Fun_CP006379.1_i000_003349	140	462	322	0.975758	0.638889
GCA_000976725.3-Fun_CP006380.1_i000_003447	140	462	322	0.975758	0.638889
GCA_000976755.2-Fun_CP006381.1_i000_003474	140	462	322	0.975758	0.638889
GCA_000976785.2-Fun_CP006382.1_i000_003432	140	462	322	0.975758	0.638889
GCA_000976815.3-Fun_CP006383.1_i000_003415	140	462	322	0.975758	0.638889
GCA_000976845.3-Fun_CP006384.1_i000_003408	140	462	322	0.975758	0.638889
GCA_000976905.2-Fun_CP006386.1_i000_003357	140	462	322	0.975758	0.638889
GCA_000976935.2-Fun_CP006387.1_i000_003458	140	462	322	0.975758	0.638889
GCA_000976995.2-Fun_CP006389.1_i000_003482	140	462	322	0.975758	0.638889
GCA_000977025.2-Fun_CP006390.1_i000_003408	140	462	322	0.975758	0.638889
GCA_000977055.3-Fun_CP006391.1_i000_003448	140	462	322	0.975758	0.638889
GCA_000977085.2-Fun_CP006392.1_i000_003472	140	462	322	0.975758	0.638889
GCA_000977115.3-Fun_CP006393.1_i000_003453	140	462	322	0.975758	0.638889
GCA_000977145.2-Fun_CP006394.1_i000_003474	140	462	322	0.975758	0.638889
GCA_000977175.3-Fun_CP006395.1_i000_003427	140	462	322	0.975758	0.638889
GCA_000977205.2-Fun_CP006396.1_i000_003462	140	462	322	0.975758	0.638889
GCA_000977235.2-Fun_CP006397.1_i000_003459	140	462	322	0.975758	0.638889
GCA_000977265.3-Fun_CP006398.1_i000_003427	140	462	322	0.975758	0.638889
GCA_000977325.2-Fun_CP006400.1_i000_003460	140	462	322	0.975758	0.638889
GCA_000977355.3-Fun_CP006401.1_i000_003486	140	462	322	0.975758	0.638889
GCA_000977415.2-Fun_CP006403.1_i000_003460	140	462	322	0.975758	0.638889
GCA_000977445.2-Fun_CP006404.1_i000_003443	140	462	322	0.975758	0.638889
GCA_000977475.3-Fun_CP006405.1_i000_003467	140	462	322	0.975758	0.638889
GCA_000977505.2-Fun_CP006406.1_i000_003443	140	462	322	0.975758	0.638889
GCA_000977535.2-Fun_CP006407.1_i000_003426	140	462	322	0.975758	0.638889
GCA_000977595.2-Fun_CP006409.1_i000_003444	140	462	322	0.975758	0.638889
GCA_000977625.2-Fun_CP006410.1_i000_003388	140	462	322	0.975758	0.638889
GCA_000977655.2-Fun_CP006411.1_i000_003467	140	462	322	0.975758	0.638889
GCA_000977685.2-Fun_CP006412.1_i000_003481	140	462	322	0.975758	0.638889
GCA_000977715.4-Fun_CP006413.1_i000_003456	140	462	322	0.975758	0.638889
GCA_000977745.2-Fun_CP006414.1_i000_003437	140	462	322	0.975758	0.638889
GCA_000977775.3-Fun_CP006415.1_i000_003455	140	462	322	0.975758	0.638889
GCA_000977805.2-Fun_CP006416.1_i000_003397	140	462	322	0.975758	0.638889
GCA_000977835.2-Fun_CP006417.1_i000_003483	140	462	322	0.975758	0.638889
GCA_000977865.2-Fun_CP006418.1_i000_003421	140	462	322	0.975758	0.638889
GCA_000977925.2-Fun_CP006420.1_i000_003378	140	462	322	0.975758	0.638889
GCA_000977955.2-Fun_CP006421.1_i000_003309	140	462	322	0.975758	0.638889
GCA_000977985.2-Fun_CP006422.1_i000_003405	140	462	322	0.975758	0.638889
GCA_000978015.2-Fun_CP006423.1_i000_003414	140	462	322	0.975758	0.638889
GCA_000978045.2-Fun_CP006424.1_i000_003401	140	462	322	0.975758	0.638889
GCA_000978075.3-Fun_CP006425.1_i000_003435	140	462	322	0.975758	0.638889
GCA_000978105.2-Fun_CP006426.1_i000_003431	140	462	322	0.975758	0.638889
GCA_000978135.2-Fun_CP006427.1_i000_003441	140	462	322	0.975758	0.638889
GCA_000978165.2-Fun_CP006428.1_i000_003545	140	462	322	0.975758	0.638889
GCA_000978195.2-Fun_CP006429.1_i000_003429	140	462	322	0.975758	0.638889
GCA_000978225.2-Fun_CP006430.1_i000_003648	140	462	322	0.975758	0.638889
GCA_000978255.2-Fun_CP006431.1_i000_003465	140	462	322	0.975758	0.638889
GCA_000978315.2-Fun_CP006433.1_i000_003435	140	462	322	0.975758	0.638889
GCA_000978345.2-Fun_CP006434.1_i000_003417	140	462	322	0.975758	0.638889
GCA_001298375.2-Fun_CM003548.1_i000_003446	140	462	322	0.975758	0.638889
GCA_001413975.1-Fun_CM003566.1_i000_003479	140	462	322	0.975758	0.638889
GCA_001983315.1-Fun_MQVN01000034.1_i000_002858	140	462	322	0.975758	0.638889
GCA_002335645.1-Fun_BEGW01000011.1_i000_003643	140	462	322	0.975758	0.638889
GCA_002571405.2-Fun_CP046092.1_i000_003767	140	462	322	0.975758	0.638889
GCA_002804325.1-Fun_PEJR01000107.1_i000_000149	140	462	322	0.975758	0.638889
GCA_003046695.1-Fun_PTEP01000031.1_i000_003140	140	462	322	0.975758	0.638889
GCA_003046745.1-Fun_PTER01000019.1_i000_001625	140	462	322	0.975758	0.638889
GCA_009014655.1-Fun_BKZN01000043.1_i000_002991	140	462	322	0.975758	0.638889
GCA_010356925.1-Fun_CM021138.1_i000_003742	140	462	322	0.975758	0.638889
GCA_010356935.1-Fun_CM021122.1_i000_003706	140	462	322	0.975758	0.638889
GCA_011022315.1-Fun_CP048993.1_i000_003344	140	462	322	0.975758	0.638889
GCA_012275245.1-Fun_WMJW01000052.1_i000_006372	140	462	322	0.975758	0.638889
GCA_014132375.1-Fun_BLZP01000004.1_i000_001862	140	462	322	0.975758	0.638889
GCA_014132395.1-Fun_BLZQ01000004.1_i000_001753	140	462	322	0.975758	0.638889
GCA_014905575.1-Fun_BNHH01000089.1_i000_003893	140	462	322	0.975758	0.638889
GCA_016858165.1-Fun_CM029100.1_i000_003757	140	462	322	0.975758	0.638889
GCA_016858175.1-Fun_CM029084.1_i000_003712	140	462	322	0.975758	0.638889
GCA_903819135.2-Fun_LR813545.2_i000_003692	140	462	322	0.975758	0.638889
GCA_903819145.2-Fun_LR813528.2_i000_003641	140	462	322	0.975758	0.638889
GCA_903819155.2-Fun_LR813511.2_i000_003686	140	462	322	0.975758	0.638889
GCA_905220315.1-Fun_LR999883.1_i000_003680	140	462	322	0.975758	0.638889
GCA_905220325.1-Fun_HG994151.1_i000_003675	140	462	322	0.975758	0.638889
GCA_002102555.1-Fun_MCFL01000008.1_i000_011809	122	446	324	0.981818	0.637795
GCA_001950575.1-Fun_BDGI01000126.1_i000_003008	131	451	320	0.969697	0.594796
GCA_019154785.2-Pro_JAGRRH010000001.1_i000_013134	129	481	352	1.06667	0.676923
GCA_003086715.1-Fun_MBFS01001688.1_i000_004755	113	455	342	1.03636	0.634508
GCA_000150035.1-Fun_DS480411.1_i000_002749	135	460	325	0.984848	0.639764
GCA_006981975.1-Fun_SPUL01000012.1_i000_007475	135	468	333	1.00909	0.659406
GCA_006981985.1-Fun_SPUK01000013.1_i000_008240	135	468	333	1.00909	0.659406
GCA_009739505.2-Ani_CM019180.2_i000_007960	124	457	333	1.00909	0.668675
GCA_900618345.1-Ani_UZAJ01039832.1_i000_012340	131	461	330	1	0.561224
GCA_021556665.1-Fun_JAKFGG010000294.1_i000_015460	108	440	332	1.00606	0.673428
GCA_000975825.2-Fun_CP006440.1_i000_003461	136	460	324	0.981818	0.642857
GCA_003046715.1-Fun_PTEQ01000304.1_i000_003747	136	460	324	0.981818	0.642857
GCA_008636185.1-Pla_VXIU01000020.1_i000_004426	143	457	314	0.951515	0.539519
GCA_000027005.1-Fun_FN392319.1_i000_001190	136	463	327	0.990909	0.659274
GCA_001708085.1-Fun_CP014708.1_i000_001157	136	463	327	0.990909	0.659274
GCA_001746955.1-Fun_CP014715.1_i000_001157	136	463	327	0.990909	0.659274
GCA_900235035.1-Fun_LT962476.1_i000_001205	136	463	327	0.990909	0.659274
GCA_000151355.1-Fun_GG698905.1_i000_006044	140	473	333	1.00909	0.5486
GCA_000190215.1-Fun_CM001105.1_i000_002369	136	462	326	0.987879	0.600368
GCA_903819205.2-Fun_LR813562.2_i000_003598	140	460	320	0.969697	0.634921
GCA_001708105.1-Fun_CP014585.1_i000_002073	130	450	320	0.969697	0.614203
GCA_000978285.2-Fun_CP006432.1_i000_003551	137	460	323	0.978788	0.633333
GCA_004114815.1-Pla_SDOW01000333.1_i000_025709	130	437	307	0.930303	0.565378
GCA_014298035.1-Fun_JABCIY010000007.1_i000_000847	136	454	318	0.963636	0.668067
GCA_002079055.1-Fun_CP020253.1_i000_003547	141	462	321	0.972727	0.636905
GCA_020310875.1-Pla_CM035435.1_i000_027147	131	438	307	0.930303	0.616466
GCA_000975795.2-Fun_CP006439.1_i000_003411	140	460	320	0.969697	0.634921
GCA_000976365.2-Fun_CP006458.1_i000_003390	140	460	320	0.969697	0.634921
GCA_000976965.3-Fun_CP006388.1_i000_003411	140	460	320	0.969697	0.634921
GCA_000599465.2-Ani_AWGT02010983.1_i000_016555	213	490	277	0.839394	0.495528
GCA_001651475.1-Pla_CM004363.1_i000_022965	130	441	311	0.942424	0.585687
GCA_019202795.1-Pla_CM032917.1_i000_022955	130	441	311	0.942424	0.585687
GCA_019202805.1-Pla_CM032904.1_i000_022283	130	441	311	0.942424	0.585687
GCA_902651935.1-Pla_CACRSJ010000110.1_i000_023445	130	441	311	0.942424	0.585687
GCA_900000165.1-Fun_CCYA01000217.1_i000_001655	390	717	327	0.990909	0.413924
GCA_000167075.2-Fun_JH797526.1_i000_002679	138	463	325	0.984848	0.643564
GCA_902705455.1-Pla_CACSHJ010000096.1_i000_023323	130	441	311	0.942424	0.58349
GCA_003260655.2-Pla_QGKV02000759.1_i000_030365	131	443	312	0.945455	0.58209
GCA_001651215.1-Pro_LXWW01000238.1_i000_003709	467	796	329	0.99697	0.397343
GCA_011823955.1-Ani_JAAKFY010000005.1_i000_008075	162	435	273	0.827273	0.605322
GCA_017639395.1-Pla_CM029887.1_i000_036303	130	442	312	0.945455	0.58209
GCA_000006515.1-Pro_DS989732.1_i000_002913	117	448	331	1.00303	0.711828
GCA_000326105.1-Fun_AGVY01000304.1_i000_007384	141	461	320	0.969697	0.632411
GCA_022376535.1-Fun_JAJJKD010000086.1_i000_011115	133	462	329	0.99697	0.638835
GCA_000180755.1-Ani_ADBV01000848.1_i000_002934	109	443	334	1.01212	0.70021
GCA_010094085.1-Fun_ML986488.1_i000_003375	139	466	327	0.990909	0.627639
GCA_000751015.1-Pla_LK032100.1_i000_012423	135	445	310	0.939394	0.579439
GCA_003434825.1-Pla_CM010636.1_i000_030432	135	445	310	0.939394	0.579439
GCA_900412535.3-Pla_LS974625.2_i000_041506	135	445	310	0.939394	0.579439
GCA_900491785.1-Fun_UFAJ01000178.1_i000_002759	124	459	335	1.01515	0.649225
GCA_001548555.1-Fun_CP014247.1_i000_003554	138	456	318	0.963636	0.584559
GCA_013397825.1-Ani_VZRK01000701.1_i000_011753	7	134	127	0.384848	0.279121
GCA_013397825.1-Ani_VZRK01000701.1_i000_011753	154	359	205	0.621212	0.450549
GCA_020623625.1-Fun_CM036080.1_i000_000219	124	460	336	1.01818	0.64
GCA_002105105.1-Fun_MCFI01000019.1_i000_002564	131	482	351	1.06364	0.722222
GCA_015476325.1-Pro_JADAQX010000149.1_i000_001421	152	482	330	1	0.639535
GCA_019633595.1-Fun_WSUI01000010.1_i000_000107	135	449	314	0.951515	0.544194
GCA_020379485.1-Pla_CM035454.1_i000_031900	138	448	310	0.939394	0.576208
GCA_020379485.1-Pla_JAGKQM010003136.1_i000_096408	138	448	310	0.939394	0.576208
GCA_005784505.1-Ani_VCAZ01000017.1_i000_004721	134	438	304	0.921212	0.542857
GCA_003426235.1-Fun_NQIM01000020.1_i000_003253	202	532	330	1	0.564103
GCA_001594055.1-Ani_KQ983203.1_i000_014029	115	445	330	1	0.471429
GCA_900622535.1-Ani_UYWW01012421.1_i000_011620	113	447	334	1.01212	0.681633
GCA_000611955.2-Ani_KK114435.1_i000_005994	121	452	331	1.00303	0.539088
GCA_000143415.2-Pla_GL377570.1_i000_005113	135	468	333	1.00909	0.649123
GCA_000143415.2-Pla_GL377639.1_i000_026503	135	468	333	1.00909	0.649123
GCA_020744415.1-Fun_JAGMWT010000001.1_i000_000389	130	460	330	1	0.639535
GCA_019974015.1-Ani_BMAW01081477.1_i000_045427	115	442	327	0.990909	0.695745
GCA_000002995.5-Ani_CAAKNF010000194.1_i000_005543	109	444	335	1.01515	0.6893
GCA_900622535.1-Ani_UYWW01012289.1_i000_011148	127	460	333	1.00909	0.563452
GCA_000348985.1-Fun_HE978320.1_i000_003575	131	448	317	0.960606	0.606119
GCA_022432385.1-Fun_JAJJXC010000027.1_i000_005333	131	460	329	0.99697	0.646365
GCA_014904985.1-Fun_MU129007.1_i000_010283	132	487	355	1.07576	0.630551
GCA_017301755.1-Fun_CP054537.1_i000_001277	117	448	331	1.00303	0.651575
GCA_020379485.1-Pla_CM035451.1_i000_023564	217	531	314	0.951515	0.131106
GCA_904066225.2-Ani_CAJFCW020000001.1_i000_000976	111	445	334	1.01212	0.724512
GCA_904067145.1-Ani_CAJFDH010000001.1_i000_000976	111	445	334	1.01212	0.724512
GCA_001661475.1-Fun_KV453842.1_i000_001975	127	460	333	1.00909	0.529412
GCA_011799765.1-Pla_JAANDH010000423.1_i000_014597	104	425	321	0.972727	0.564148
GCA_003260675.2-Pla_QGKX02001621.1_i000_031345	136	437	301	0.912121	0.561567
GCA_016771965.1-Pla_CM028698.1_i000_061169	136	437	301	0.912121	0.561567
GCA_008704415.1-Fun_VXIS01000292.1_i000_006146	133	455	322	0.975758	0.589744
GCA_900537255.1-Ani_UPTC01000195.1_i000_001951	110	443	333	1.00909	0.361171
GCA_005406065.1-Fun_BIMT01000060.1_i000_004170	131	457	326	0.987879	0.648111
GCA_020379485.1-Pla_CM035464.1_i000_084439	139	440	301	0.912121	0.558442
GCA_013694445.1-Fun_CP059268.1_i000_001416	136	461	325	0.984848	0.632296
GCA_001742945.1-Pla_DF973172.1_i000_006519	119	443	324	0.981818	0.591241
GCA_010015655.1-Fun_ML976664.1_i000_003460	130	463	333	1.00909	0.641618
GCA_900618025.1-Ani_UZAG01016385.1_i000_008214	132	467	335	1.01515	0.658153
GCA_016771965.1-Pla_CM028690.1_i000_019650	130	444	314	0.951515	0.588015
GCA_000227115.2-Fun_HE580267.1_i000_000177	137	460	323	0.978788	0.642147
GCA_900537205.1-Ani_UYRW01000474.1_i000_002702	109	445	336	1.01818	0.694215
GCA_003205855.1-Fun_LK052893.1_i000_001764	138	456	318	0.963636	0.623529
GCA_001661335.1-Fun_KV454427.1_i000_001337	131	444	313	0.948485	0.608949
GCA_900618355.1-Ani_UZAD01000061.1_i000_000990	104	439	335	1.01515	0.709746
GCA_018360255.1-Fun_SRPZ01000031.1_i000_004274	118	456	338	1.02424	0.562396
GCA_010015785.1-Fun_ML978726.1_i000_006314	128	458	330	1	0.575916
GCA_001661315.1-Fun_KV454413.1_i000_004642	132	451	319	0.966667	0.605313
GCA_019321695.1-Fun_JAHWGW010000009.1_i000_007970	143	466	323	0.978788	0.622351
GCA_018320845.1-Ani_CM031329.1_i000_017417	1	238	237	0.718182	0.929412
GCA_003012315.1-Fun_PXOF01000060.1_i000_004531	144	465	321	0.972727	0.630648
GCA_000976875.3-Fun_CP006385.1_i000_003418	140	462	322	0.975758	0.638889
GCA_000938715.1-Fun_LN736364.1_i000_002597	133	460	327	0.990909	0.64497
GCA_016984155.1-Ani_JAAWVP010005833.1_i000_008513	73	334	261	0.790909	0.779104
GCA_003019895.1-Fun_KZ678505.1_i000_007723	148	467	319	0.966667	0.613462
GCA_010015705.1-Fun_ML977170.1_i000_008558	134	466	332	1.00606	0.615955
GCA_000183805.3-Ani_JH712151.1_i000_006221	127	460	333	1.00909	0.585237
GCA_003814445.1-Fun_CP031385.1_i000_000644	141	464	323	0.978788	0.639604
GCA_002082055.1-Ani_MTYJ01000028.1_i000_005288	112	440	328	0.993939	0.607407
GCA_000977385.2-Fun_CP006402.1_i000_003432	140	462	322	0.975758	0.638889
GCA_000977565.2-Fun_CP006408.1_i000_003263	140	462	322	0.975758	0.638889
GCA_001634645.1-Fun_CM004305.1_i000_004043	140	462	322	0.975758	0.638889
GCA_006783055.1-Ani_VCRD01003279.1_i000_015753	125	454	329	0.99697	0.541118
GCA_000315915.1-Fun_HE806320.1_i000_003449	140	459	319	0.966667	0.621832
GCA_000836295.1-Fun_KN847548.1_i000_006082	128	457	329	0.99697	0.573171
GCA_000814955.1-Fun_AZNH01000012.1_i000_001857	142	464	322	0.975758	0.635108
GCA_000410735.1-Fun_KE148157.1_i000_005809	143	458	315	0.954545	0.616438
GCA_018360185.1-Fun_SRPU01000992.1_i000_003939	121	455	334	1.01212	0.55574
GCA_022376655.1-Fun_JAJJKE010000012.1_i000_001326	137	462	325	0.984848	0.638507
GCA_000150505.2-Fun_KE503206.1_i000_000943	127	439	312	0.945455	0.620278
GCA_000002515.1-Fun_CR382124.1_i000_002472	139	460	321	0.972727	0.625731
GCA_905221625.1-Pro_CAJNDU010000790.1_i000_001127	118	456	338	1.02424	0.664047
GCA_014904905.1-Fun_MU122092.1_i000_000122	132	459	327	0.990909	0.622857
GCA_001642005.1-Ani_LWCA01000021.1_i000_004091	137	458	321	0.972727	0.191527
GCA_020746995.1-Fun_JAGPXD010000003.1_i000_006459	137	468	331	1.00303	0.65286
GCA_018360225.1-Fun_SRPW01000306.1_i000_001174	124	452	328	0.993939	0.545757
GCA_007993695.1-Fun_CP042458.1_i000_002830	140	460	320	0.969697	0.620155
GCA_000222205.2-Fun_AEVR02000018.1_i000_000862	127	453	326	0.987879	0.594891
GCA_000320785.2-Fun_KB722667.1_i000_006524	127	453	326	0.987879	0.595978
GCA_003234015.1-Fun_LK052936.1_i000_008006	127	453	326	0.987879	0.595978
GCA_000988875.2-Fun_LCTV02000001.1_i000_000857	132	458	326	0.987879	0.589512
GCA_007990605.1-Fun_BJWK01000006.1_i000_002642	127	452	325	0.984848	0.593066
GCA_003946995.1-Fun_NKCK01000014.1_i000_003130	138	463	325	0.984848	0.694444
GCA_015852335.1-Fun_JAAAID010003431.1_i000_010762	130	394	264	0.8	0.581498
GCA_000835555.1-Fun_KN847479.1_i000_006748	133	453	320	0.969697	0.497667
GCA_020744255.1-Fun_JAGTJQ010000006.1_i000_011792	133	464	331	1.00303	0.646484
GCA_900100905.1-Fun_FMWP01000010.1_i000_002194	123	449	326	0.987879	0.598165
GCA_001983305.1-Fun_MPUK01000012.1_i000_004910	135	462	327	0.990909	0.641176
GCA_002847045.1-Fun_KZ559135.1_i000_004158	135	452	317	0.960606	0.550347
GCA_020536115.1-Fun_JAEUBD010000983.1_i000_002979	129	446	317	0.960606	0.636546
GCA_012274485.2-Pla_MU105707.1_i000_012641	131	443	312	0.945455	0.583178
GCA_000770705.1-Fun_ANFO01001245.1_i000_010743	131	466	335	1.01515	0.662055
GCA_002946385.1-Fun_NJPR01000070.1_i000_008529	136	455	319	0.966667	0.383875
GCA_002946425.1-Fun_NJPT01000031.1_i000_003739	136	455	319	0.966667	0.383875
GCA_902806785.1-Ani_CADCXU010022532.1_i000_015031	121	457	336	1.01818	0.667992
GCA_018360475.1-Fun_SRQQ01000083.1_i000_007710	120	454	334	1.01212	0.554817
GCA_018360535.1-Fun_SRQR01000295.1_i000_003646	120	454	334	1.01212	0.554817
GCA_018360675.1-Fun_SRQZ01000004.1_i000_004884	120	454	334	1.01212	0.554817
GCA_018360725.1-Fun_SRQU01000012.1_i000_000664	120	454	334	1.01212	0.554817
GCA_018360735.1-Fun_SRQX01000375.1_i000_004537	120	454	334	1.01212	0.554817
GCA_018360745.1-Fun_SRQT01000119.1_i000_000619	120	454	334	1.01212	0.554817
GCA_018360835.1-Fun_SRRB01000384.1_i000_004731	120	454	334	1.01212	0.554817
GCA_018360845.1-Fun_SRRE01000068.1_i000_006976	120	454	334	1.01212	0.554817
GCA_018360855.1-Fun_SRRF01000019.1_i000_002007	120	454	334	1.01212	0.554817
GCA_018360925.1-Fun_SRRJ01000497.1_i000_005927	120	454	334	1.01212	0.554817
GCA_000827465.1-Fun_KN822974.1_i000_004606	134	452	318	0.963636	0.550173
GCA_018360655.1-Fun_SRQS01000011.1_i000_000429	120	456	336	1.01818	0.559068
GCA_000814965.1-Fun_AZNG01000002.1_i000_005300	145	465	320	0.969697	0.629921
GCA_013426205.1-Fun_CP058933.1_i000_004487	145	465	320	0.969697	0.629921
GCA_010093815.1-Fun_ML996567.1_i000_002279	132	461	329	0.99697	0.645098
GCA_900102585.1-Fun_FMWQ01000035.1_i000_006539	150	475	325	0.984848	0.569177
GCA_001682635.1-Fun_JRHA01000004.1_i000_005613	131	466	335	1.01515	0.662055
GCA_000981605.1-Fun_HF936128.1_i000_010823	133	451	318	0.963636	0.621094
GCA_019633405.1-Fun_WSTX01000424.1_i000_001363	128	477	349	1.05758	0.616608
GCA_002871155.1-Fun_MRVG01000002.1_i000_004450	130	467	337	1.02121	0.666008
GCA_017311265.1-Fun_JABTEF010000001.1_i000_000148	128	459	331	1.00303	0.651575
GCA_021605075.1-Ani_BPLQ01006072.1_i000_021157	114	444	330	1	0.703625
GCA_003611235.1-Fun_MCBS01015976.1_i000_000500	125	456	331	1.00303	0.695378
GCA_000151665.1-Pro_FN668654.1_i000_003547	115	443	328	0.993939	0.606285
GCA_020744425.1-Fun_JAGMUV010000009.1_i000_020835	131	467	336	1.01818	0.672
GCA_001578225.1-Fun_LFZO01000223.1_i000_003461	136	457	321	0.972727	0.562172
GCA_020736575.1-Fun_JAGPYM010000003.1_i000_008397	124	455	331	1.00303	0.563884
GCA_000280675.1-Fun_JH725199.1_i000_009308	131	468	337	1.02121	0.666008
GCA_010099065.1-Fun_PPTI01000004.1_i000_005777	131	468	337	1.02121	0.666008
GCA_000004255.1-Pla_GL348718.1_i000_022459	121	441	320	0.969697	0.601504
GCA_019208005.1-Fun_JAHLVR010000002.1_i000_002324	129	445	316	0.957576	0.634538
GCA_006352295.1-Fun_SOZI01000054.1_i000_005904	125	452	327	0.990909	0.583929
GCA_900231445.1-Pla_LT934113.1_i000_009080	131	442	311	0.942424	0.670259
GCA_003709865.1-Fun_QRBJ01000059.1_i000_004212	134	453	319	0.966667	0.5104
GCA_001578235.1-Fun_LFZN01000173.1_i000_002918	136	454	318	0.963636	0.555944
GCA_009761265.1-Ani_VOSG01000685.1_i000_008861	114	445	331	1.00303	0.68815
GCA_001594075.1-Ani_KQ980575.1_i000_012033	121	452	331	1.00303	0.609576
GCA_905332105.1-Ani_CAJOBE010013932.1_i000_034715	112	378	266	0.806061	0.703704
GCA_010093925.1-Fun_ML994745.1_i000_020810	119	457	338	1.02424	0.575809
GCA_001298625.1-Fun_CM003577.1_i000_003544	146	460	314	0.951515	0.621782
GCA_905237095.1-Pro_CAJNNW010034418.1_i000_042636	166	498	332	1.00606	0.633588
GCA_013396695.1-Ani_VWZD01005403.1_i000_005568	112	441	329	0.99697	0.599271
GCA_002909625.1-Ani_PPHD01107353.1_i000_017066	5	263	258	0.781818	0.980989
GCA_013266195.1-Fun_JABEYC010000749.1_i000_008505	549	893	344	1.04242	0.374728
GCA_001049375.1-Pro_CDSF01000083.1_i000_003953	130	466	336	1.01818	0.587413
GCA_002850765.1-Fun_KZ559502.1_i000_000941	135	454	319	0.966667	0.55286
GCA_011022315.1-Fun_CP049009.1_i000_008959	136	461	325	0.984848	0.64741
GCA_001594115.1-Ani_KQ981193.1_i000_000445	101	429	328	0.993939	0.531605
GCA_000208925.2-Pro_DS571525.1_i000_000733	135	449	314	0.951515	0.624254
GCA_000338855.1-Pro_KB444678.1_i000_003916	135	449	314	0.951515	0.624254
GCA_000346345.1-Pro_KB638334.1_i000_005078	135	449	314	0.951515	0.624254
GCA_000365475.1-Pro_KB823384.1_i000_001362	135	449	314	0.951515	0.624254
GCA_001662325.1-Pro_BDEQ01000001.1_i000_007640	135	449	314	0.951515	0.624254
GCA_019633535.1-Fun_WSUE01000116.1_i000_001131	133	464	331	1.00303	0.601818
GCA_019633555.1-Fun_WSUG01000051.1_i000_010848	133	464	331	1.00303	0.601818
GCA_916381525.1-Ani_CAKAEH010001936.1_i000_009715	108	442	334	1.01212	0.690083
GCA_009761265.1-Ani_VOSG01000099.1_i000_003673	149	484	335	1.01515	0.636882
GCA_001749795.1-Fun_LPNL01000008.1_i000_003589	131	450	319	0.966667	0.641851
GCA_002003045.1-Fun_BDGU01000367.1_i000_008347	401	753	352	1.06667	0.404133
GCA_002271885.2-Pla_CM008451.1_i000_022537	117	391	274	0.830303	0.657074
GCA_002271895.2-Pla_CM008433.1_i000_006831	117	391	274	0.830303	0.657074
GCA_001907595.1-Fun_LFMY01000002.1_i000_001549	136	456	320	0.969697	0.547009
GCA_000375325.1-Pla_KB870810.1_i000_018747	146	459	313	0.948485	0.568058
GCA_002873125.1-Fun_PGCI01000037.1_i000_004167	154	479	325	0.984848	0.541667
GCA_001278495.1-Fun_LGSR01000006.1_i000_002183	121	453	332	1.00606	0.546952
GCA_900618345.1-Ani_UZAJ01039856.1_i000_012462	109	445	336	1.01818	0.702929
GCA_013399415.1-Ani_VWYJ01033730.1_i000_012636	45	309	264	0.8	0.854369
GCA_018361025.1-Fun_SRRH01000268.1_i000_003271	120	454	334	1.01212	0.554817
GCA_013401315.1-Ani_VYZW01065067.1_i000_011622	53	317	264	0.8	0.832808
GCA_001636815.1-Fun_AZHD01000003.1_i000_005858	138	463	325	0.984848	0.633528
MEVA001.0722.00001.C001_01532	84	398	314	0.951515	0.640816
GCA_000006445.2-Fun_CR382139.2_i000_005499	130	448	318	0.963636	0.615087
GCA_015039405.1-Fun_WJDU01000074.1_i000_015042	130	451	321	0.972727	0.581522
GCA_001636725.1-Fun_AZHB01000019.1_i000_003798	130	465	335	1.01515	0.664683
GCA_900119595.1-Fun_FQNF01000170.1_i000_000610	133	453	320	0.969697	0.64
GCA_900332095.2-Pla_OOIL02001381.1_i000_016626	130	442	312	0.945455	0.532423
GCA_013305495.1-Fun_JABUBV010000001.1_i000_000704	137	467	330	1	0.649606
GCA_900537205.1-Ani_UYRW01000461.1_i000_002649	131	461	330	1	0.561224
GCA_011066845.1-Fun_JAABOJ010000061.1_i000_009845	134	439	305	0.924242	0.561694
GCA_003144205.1-Fun_KZ819603.1_i000_003950	129	461	332	1.00606	0.628788
GCA_000820885.1-Fun_CCBQ010000027.1_i000_002145	145	461	316	0.957576	0.614786
GCA_003290485.1-Fun_CP030252.1_i000_001092	138	459	321	0.972727	0.597765
GCA_003691605.1-Fun_CP033149.1_i000_001263	138	459	321	0.972727	0.597765
GCA_019632275.1-Fun_WSTT01000223.1_i000_004007	129	466	337	1.02121	0.614964
GCA_019632285.1-Fun_WSTV01000631.1_i000_008055	129	466	337	1.02121	0.614964
GCA_000348985.1-Fun_HE978315.1_i000_000900	137	463	326	0.987879	0.653307
GCA_001640025.2-Fun_CP014503.1_i000_003123	126	451	325	0.984848	0.636008
GCA_001447515.1-Pro_LDAU01000073.1_i000_001700	115	446	331	1.00303	0.69392
GCA_019632265.1-Fun_WSTU01000942.1_i000_009618	129	466	337	1.02121	0.614964
GCA_910592255.1-Fun_CAJVPO010002007.1_i000_009232	114	449	335	1.01515	0.597148
GCA_000956045.1-Fun_KQ030498.1_i000_000055	128	454	326	0.987879	0.537954
GCA_000828355.1-Ani_JXLN01005820.1_i000_002066	144	433	289	0.875758	0.600832
GCA_003698175.1-Fun_NKUJ01000014.1_i000_002797	143	463	320	0.969697	0.625
GCA_003947005.1-Fun_NKCL01000042.1_i000_010274	143	463	320	0.969697	0.625
GCA_003947015.1-Fun_NKCJ01000046.1_i000_010161	143	463	320	0.969697	0.625
GCA_900074735.1-Fun_LT598476.1_i000_005013	129	460	331	1.00303	0.65286
GCA_003709825.1-Fun_QQXN01000007.1_i000_005072	134	454	320	0.969697	0.513644
GCA_020744495.1-Fun_JAGTJS010000013.1_i000_003653	140	461	321	0.972727	0.62818
GCA_000237345.1-Fun_HE576752.1_i000_001394	135	459	324	0.981818	0.635294
GCA_001890725.1-Fun_KV878211.1_i000_004219	135	455	320	0.969697	0.555556
GCA_001664045.1-Fun_AECK01000002.1_i000_001221	130	448	318	0.963636	0.634731
GCA_019207715.1-Fun_JAHLVL010000001.1_i000_001907	130	448	318	0.963636	0.634731
GCA_019207725.1-Fun_JAHLVK010000002.1_i000_002514	130	448	318	0.963636	0.634731
GCA_019207735.1-Fun_JAHLVJ010000007.1_i000_004594	130	448	318	0.963636	0.634731
GCA_019207815.1-Fun_JAHLVO010000001.1_i000_001879	130	448	318	0.963636	0.634731
GCA_019207825.1-Fun_JAHLVP010000002.1_i000_002146	130	448	318	0.963636	0.634731
GCA_019207835.1-Fun_JAHLVN010000001.1_i000_001620	130	448	318	0.963636	0.634731
GCA_019207905.1-Fun_JAHLVQ010000003.1_i000_003092	130	448	318	0.963636	0.634731
GCA_019207965.1-Fun_JAHLVM010000002.1_i000_002320	130	448	318	0.963636	0.634731
GCA_019207995.1-Fun_JAHLVT010000004.1_i000_003557	130	448	318	0.963636	0.634731
GCA_019208045.1-Fun_JAHLVS010000002.1_i000_002469	130	448	318	0.963636	0.634731
GCA_900660285.1-Fun_CAACVR010000012.1_i000_002374	131	450	319	0.966667	0.603025
GCA_905237085.1-Pro_CAJNNV010027271.1_i000_037542	251	583	332	1.00606	0.545156
GCA_012184315.1-Fun_LDDX01000119.1_i000_003433	136	441	305	0.924242	0.554545
GCA_900074755.1-Fun_LT598451.1_i000_001693	130	459	329	0.99697	0.650198
GCA_003957675.1-Fun_MIKF01000034.1_i000_009525	144	464	320	0.969697	0.623782
GCA_018360145.1-Fun_SRPY01000038.1_i000_004298	122	454	332	1.00606	0.555184
GCA_000827265.1-Fun_KN834807.1_i000_016393	138	476	338	1.02424	0.590909
GCA_018360135.1-Fun_SRPV01000105.1_i000_000200	118	452	334	1.01212	0.554817
GCA_000426965.1-Fun_KE384724.1_i000_002394	123	457	334	1.01212	0.552066
GCA_000426985.1-Fun_KE385404.1_i000_004930	123	457	334	1.01212	0.552066
GCA_000213175.1-Fun_GL891306.1_i000_005904	134	464	330	1	0.633397
GCA_000213195.1-Fun_GL891258.1_i000_009756	134	464	330	1	0.633397
GCA_000186865.1-Pro_GL833122.1_i000_001798	134	465	331	1.00303	0.655446
GCA_000002995.5-Ani_CAAKNF010000193.1_i000_003707	127	461	334	1.01212	0.558528
GCA_003614675.1-Fun_ML002380.1_i000_002166	118	459	341	1.03333	0.683367
GCA_000511025.2-Pla_CM002324.2_i000_008207	133	442	309	0.936364	0.531842
GCA_000182925.2-Fun_CM002242.1_i000_008898	134	461	327	0.990909	0.627639
GCA_000786625.1-Fun_KN389638.1_i000_002239	134	461	327	0.990909	0.627639
GCA_902498895.1-Fun_CABVLU010000001.1_i000_000682	131	450	319	0.966667	0.592937
GCA_000187245.3-Fun_CM002305.1_i000_003886	130	442	312	0.945455	0.622754
GCA_019207595.1-Fun_JAHLVG010000002.1_i000_002518	130	442	312	0.945455	0.622754
GCA_019207695.1-Fun_JAHLVH010000001.1_i000_001619	130	442	312	0.945455	0.622754
GCA_022453515.1-Fun_JAJNNY010000033.1_i000_006245	129	463	334	1.01212	0.647287
GCA_001653205.1-Fun_LSBH01000004.1_i000_005854	130	454	324	0.981818	0.542714
GCA_001653265.1-Fun_LSBI01000006.1_i000_006774	130	454	324	0.981818	0.542714
GCA_003144605.1-Fun_LCWV01000019.1_i000_004190	130	454	324	0.981818	0.542714
GCA_905178155.1-Pro_CAJINV010000002.1_i000_006509	126	457	331	1.00303	0.61183
GCA_022432505.1-Fun_JAJKKH010000006.1_i000_009057	134	462	328	0.993939	0.641879
GCA_019207555.1-Fun_JAHLUY010000001.1_i000_001825	129	443	314	0.951515	0.629259
GCA_000739145.1-Fun_JNNZ01000193.1_i000_008932	125	455	330	1	0.548173
GCA_000814975.1-Fun_AZNF01000001.1_i000_001470	125	455	330	1	0.548173
GCA_000827275.1-Fun_KN833715.1_i000_006880	1	266	265	0.80303	0.992509
GCA_011947395.2-Fun_JAATWM020000046.1_i000_009411	161	478	317	0.960606	0.604962
GCA_000026365.1-Fun_CU928178.1_i000_003746	139	461	322	0.975758	0.62768
GCA_001972345.1-Fun_BDGX01000021.1_i000_003862	139	461	322	0.975758	0.62768
GCA_021535285.1-Fun_JAKETS010000005.1_i000_003792	139	461	322	0.975758	0.62768
GCA_022432395.1-Fun_JAJKLJ010000010.1_i000_002022	127	452	325	0.984848	0.646123
GCA_003947005.1-Fun_NKCL01000121.1_i000_001761	124	455	331	1.00303	0.560068
GCA_008690995.1-Pro_VRMN01000003.1_i000_001667	116	450	334	1.01212	0.646035
GCA_002105055.1-Fun_MCGR01000043.1_i000_006259	121	452	331	1.00303	0.604015
GCA_010583015.1-Fun_MU007058.1_i000_008922	135	462	327	0.990909	0.616981
GCA_000166175.1-Fun_GL541683.1_i000_003981	123	449	326	0.987879	0.599265
GCA_900120095.1-Fun_FQNC01000086.1_i000_012524	123	449	326	0.987879	0.598165
GCA_000187425.2-Fun_ADNJ02000004.1_i000_007291	122	457	335	1.01515	0.553719
GCA_000591435.1-Fun_JELW01000018.1_i000_007249	122	457	335	1.01515	0.553719
GCA_000814965.1-Fun_AZNG01000004.1_i000_008248	122	457	335	1.01515	0.553719
GCA_013305495.1-Fun_JABUBV010000004.1_i000_008942	122	457	335	1.01515	0.553719
GCA_013426205.1-Fun_CP058935.1_i000_007178	122	457	335	1.01515	0.553719
GCA_020102295.1-Fun_JACEFI010000003.1_i000_002371	122	457	335	1.01515	0.553719
GCA_013398375.1-Ani_VZSI01000027.1_i000_005814	56	190	134	0.406061	0.263261
GCA_013398375.1-Ani_VZSI01000027.1_i000_005814	207	413	206	0.624242	0.404715
GCA_001194135.1-Ani_KQ424913.1_i000_027064	125	459	334	1.01212	0.484058
GCA_001417835.1-Fun_AP014603.1_i000_003215	144	460	316	0.957576	0.612403
GCA_001417885.1-Fun_AP012217.1_i000_003241	144	460	316	0.957576	0.612403
GCA_001702395.2-Fun_MAVT02000360.1_i000_005089	136	463	327	0.990909	0.52657
GCA_003698175.1-Fun_NKUJ01000005.1_i000_011976	124	455	331	1.00303	0.560068
GCA_003946995.1-Fun_NKCK01000302.1_i000_009633	124	455	331	1.00303	0.560068
GCA_003947015.1-Fun_NKCJ01000036.1_i000_008429	124	455	331	1.00303	0.560068
GCA_003947045.1-Fun_NIZV01000059.1_i000_013829	124	455	331	1.00303	0.560068
GCA_003957675.1-Fun_MIKF01000445.1_i000_011808	124	455	331	1.00303	0.560068
GCA_001854445.2-Fun_CP015058.1_i000_003322	140	456	316	0.957576	0.612403
GCA_018360975.1-Fun_SRRC01000008.1_i000_007793	120	454	334	1.01212	0.554817
GCA_004155945.1-Fun_QJNY01000092.1_i000_011802	125	462	337	1.02121	0.54886
GCA_000151355.1-Fun_GG698905.1_i000_005989	141	465	324	0.981818	0.629126
GCA_003946985.1-Fun_NKCI01000025.1_i000_007227	124	455	331	1.00303	0.560068
GCA_000835395.1-Fun_KN846953.1_i000_006887	133	451	318	0.963636	0.497653
GCA_000814945.1-Fun_AZNE01000004.1_i000_007630	124	452	328	0.993939	0.542149
GCA_003946985.1-Fun_NKCI01000027.1_i000_007769	145	457	312	0.945455	0.605825
GCA_000187425.2-Fun_ADNJ02000001.1_i000_000711	137	467	330	1	0.649606
GCA_000426965.1-Fun_KE384719.1_i000_000729	137	467	330	1	0.649606
GCA_000591435.1-Fun_JELW01000001.1_i000_001168	137	467	330	1	0.649606
GCA_000739145.1-Fun_JNNZ01000007.1_i000_000898	137	467	330	1	0.649606
GCA_000814945.1-Fun_AZNE01000030.1_i000_006453	137	467	330	1	0.649606
GCA_000814975.1-Fun_AZNF01000017.1_i000_003906	137	467	330	1	0.649606
GCA_020102295.1-Fun_JACEFI010000004.1_i000_003156	137	467	330	1	0.649606
GCA_000985935.1-Fun_CVMT01000013.1_i000_009501	134	451	317	0.960606	0.542808
GCA_905183005.1-Pro_CAJJDO010000007.1_i000_003624	117	444	327	0.990909	0.698718
GCA_018360435.1-Fun_SRQI01000150.1_i000_001367	120	454	334	1.01212	0.554817
GCA_018360445.1-Fun_SRQK01000014.1_i000_001112	120	454	334	1.01212	0.554817
GCA_018360595.1-Fun_SRQJ01000033.1_i000_004182	120	454	334	1.01212	0.554817
GCA_000348985.1-Fun_HE978323.1_i000_004347	129	449	320	0.969697	0.610687
GCA_018360045.1-Fun_SRPN01000069.1_i000_006782	121	454	333	1.00909	0.553156
GCA_018360065.1-Fun_SRPO01000008.1_i000_007141	121	454	333	1.00909	0.553156
GCA_000347355.1-Fun_CAGA01000002.1_i000_008366	120	454	334	1.01212	0.554817
GCA_018360565.1-Fun_SRQP01000047.1_i000_005376	120	454	334	1.01212	0.554817
GCA_018360585.1-Fun_SRQN01000058.1_i000_006193	120	454	334	1.01212	0.554817
GCA_018360605.1-Fun_SRQO01000001.1_i000_000041	120	454	334	1.01212	0.554817
GCA_018360755.1-Fun_SRQW01000038.1_i000_004613	120	454	334	1.01212	0.554817
GCA_018360765.1-Fun_SRQV01000001.1_i000_000074	120	454	334	1.01212	0.554817
GCA_018360825.1-Fun_SRRA01000013.1_i000_000984	120	454	334	1.01212	0.554817
GCA_018360865.1-Fun_SRRG01000010.1_i000_000073	120	454	334	1.01212	0.554817
GCA_018360905.1-Fun_SRRI01000020.1_i000_002380	120	454	334	1.01212	0.554817
GCA_018360935.1-Fun_SRRK01000563.1_i000_006421	120	454	334	1.01212	0.554817
GCA_018360955.1-Fun_SRQY01000064.1_i000_006740	120	454	334	1.01212	0.554817
GCA_001651435.1-Fun_LHPN01000002.1_i000_003099	134	454	320	0.969697	0.528053
GCA_018360685.1-Fun_SRRD01000003.1_i000_003694	120	456	336	1.01818	0.559068
GCA_002901185.1-Fun_NRSZ01000655.1_i000_000899	132	462	330	1	0.642023
GCA_007026445.1-Fun_VDMD01000021.1_i000_006594	127	460	333	1.00909	0.621269
GCA_019207475.1-Fun_JAHLUX010000002.1_i000_002161	130	443	313	0.948485	0.623506
GCA_016952305.1-Fun_CP064756.1_i000_010740	138	465	327	0.990909	0.647525
GCA_018360215.1-Fun_SRPX01000544.1_i000_005978	121	454	333	1.00909	0.553156
GCA_018360055.1-Fun_SRPP01000129.1_i000_000815	120	454	334	1.01212	0.554817
GCA_004155035.1-Fun_QJOB01000135.1_i000_002321	123	460	337	1.02121	0.552459
GCA_018360325.1-Fun_SRQG01000059.1_i000_006578	120	454	334	1.01212	0.554817
GCA_018360465.1-Fun_SRQM01000028.1_i000_003516	120	454	334	1.01212	0.554817
GCA_001675295.1-Fun_LYXU01000003.1_i000_008893	138	464	326	0.987879	0.640472
GCA_019609905.1-Fun_CM033787.1_i000_009490	138	464	326	0.987879	0.640472
GCA_000151425.1-Fun_GG700648.1_i000_007249	136	457	321	0.972727	0.530579
GCA_000616765.1-Fun_KK204002.1_i000_007522	136	457	321	0.972727	0.530579
GCA_000616805.1-Fun_KK207382.1_i000_007486	136	457	321	0.972727	0.530579
GCA_000616825.1-Fun_KK207919.1_i000_007508	136	457	321	0.972727	0.530579
GCA_000616845.1-Fun_KK208457.1_i000_007457	136	457	321	0.972727	0.530579
GCA_000616905.1-Fun_KK209428.1_i000_007504	136	457	321	0.972727	0.530579
GCA_000616945.1-Fun_KK209950.1_i000_007562	136	457	321	0.972727	0.530579
GCA_000616965.1-Fun_KK210305.1_i000_007338	136	457	321	0.972727	0.530579
GCA_000616985.1-Fun_KK210807.1_i000_007642	136	457	321	0.972727	0.530579
GCA_000622995.1-Fun_AOLB01000308.1_i000_007495	136	457	321	0.972727	0.530579
GCA_000812105.1-Fun_JPGR01000005.1_i000_001058	136	457	321	0.972727	0.530579
GCA_001651445.1-Fun_LHPM01000018.1_i000_003076	136	457	321	0.972727	0.530579
GCA_018360085.1-Fun_SRPR01000013.1_i000_000902	120	454	334	1.01212	0.55298
GCA_000814955.1-Fun_AZNH01000010.1_i000_000991	124	452	328	0.993939	0.543947
GCA_001661255.1-Fun_KV454211.1_i000_004419	131	447	316	0.957576	0.617188
GCA_000235365.1-Fun_CP002500.1_i000_002479	144	460	316	0.957576	0.615984
GCA_015476405.1-Fun_CM027201.1_i000_005658	126	476	350	1.06061	0.630631
GCA_021015755.1-Fun_JABWDW010000015.1_i000_002471	126	476	350	1.06061	0.630631
GCA_019207635.1-Fun_JAHLVE010000005.1_i000_003926	129	443	314	0.951515	0.625498
GCA_000226095.1-Fun_CP003006.1_i000_006713	142	465	323	0.978788	0.624758
GCA_015342795.1-Ani_CM027194.1_i000_019323	131	456	325	0.984848	0.583483
GCA_013364965.1-Fun_JAAMOD010000249.1_i000_007914	138	471	333	1.00909	0.659406
GCA_018360575.1-Fun_SRQL01000017.1_i000_001790	131	454	323	0.978788	0.536545
GCA_020744495.1-Fun_JAGTJS010000013.1_i000_003595	140	471	331	1.00303	0.544408
GCA_018360355.1-Fun_SRQC01000028.1_i000_003410	119	454	335	1.01515	0.556478
GCA_018360525.1-Fun_SRQD01000079.1_i000_007222	119	454	335	1.01515	0.556478
GCA_020736525.1-Fun_JAHBOE010000003.1_i000_006582	133	465	332	1.00606	0.65098
GCA_903986555.1-Ani_CAJDYZ010004582.1_i000_002242	73	404	331	1.00303	0.615242
GCA_018360175.1-Fun_SRPS01000017.1_i000_002179	120	454	334	1.01212	0.55298
GCA_000180635.4-Ani_CM026575.1_i000_000432	135	468	333	1.00909	0.64786
GCA_001691755.2-Fun_JNHY02000053.1_i000_005897	119	475	356	1.07879	0.735537
GCA_000968595.1-Fun_LASV01000095.1_i000_002371	134	454	320	0.969697	0.52459
GCA_001890105.1-Fun_KV878348.1_i000_007470	134	453	319	0.966667	0.546233
GCA_019633545.1-Fun_WSUF01000044.1_i000_009665	133	464	331	1.00303	0.601818
GCA_014235925.1-Fun_VUJX01000023.1_i000_007798	145	466	321	0.972727	0.635644
GCA_003611195.1-Fun_MCBQ01001930.1_i000_000740	125	457	332	1.00606	0.520376
GCA_018360385.1-Fun_SRQF01000053.1_i000_005576	120	454	334	1.01212	0.554817
GCA_004155055.1-Fun_QJNZ01000509.1_i000_007898	126	460	334	1.01212	0.543974
GCA_018360345.1-Fun_SRQH01000006.1_i000_006082	120	454	334	1.01212	0.55298
GCA_018360375.1-Fun_SRQE01000003.1_i000_003527	120	454	334	1.01212	0.55298
GCA_003316985.1-Fun_QKXC01000066.1_i000_010254	608	932	324	0.981818	0.332991
GCA_018360075.1-Fun_SRPQ01000006.1_i000_005724	116	455	339	1.02727	0.562189
GCA_000149035.1-Fun_GG697349.1_i000_005562	143	458	315	0.954545	0.628743
GCA_900618025.1-Ani_UZAG01016476.1_i000_008374	206	537	331	1.00303	0.493294
GCA_000002655.1-Fun_CM000171.1_i000_004407	135	455	320	0.969697	0.541455
GCA_000150145.1-Fun_DS499596.1_i000_005359	135	455	320	0.969697	0.541455
GCA_000731615.1-Fun_JHOI01000605.1_i000_006421	135	455	320	0.969697	0.541455
GCA_002234955.1-Fun_NKHT01000219.1_i000_003562	135	455	320	0.969697	0.541455
GCA_002234985.1-Fun_NKHS01000215.1_i000_003267	135	455	320	0.969697	0.541455
GCA_012656115.1-Fun_JAAAQC010000212.1_i000_003078	135	455	320	0.969697	0.541455
GCA_012656125.1-Fun_JAAAQD010000204.1_i000_003057	135	455	320	0.969697	0.541455
GCA_012656165.1-Fun_JAAAQB010000215.1_i000_002573	135	455	320	0.969697	0.541455
GCA_012656185.1-Fun_JAAAQA010000762.1_i000_007986	135	455	320	0.969697	0.541455
GCA_012656215.1-Fun_JAAAPZ010000125.1_i000_000664	135	455	320	0.969697	0.541455
GCA_020498725.1-Fun_JAIBPO010000001.1_i000_000017	135	455	320	0.969697	0.541455
GCA_020498735.1-Fun_JAIBPN010000117.1_i000_000783	135	455	320	0.969697	0.541455
GCA_020498745.1-Fun_JAIBPM010000127.1_i000_001146	135	455	320	0.969697	0.541455
GCA_020498755.1-Fun_JAIBPP010000026.1_i000_003738	135	455	320	0.969697	0.541455
GCA_020498765.1-Fun_JAIBPQ010000120.1_i000_000897	135	455	320	0.969697	0.541455
GCA_020498805.1-Fun_JAIBPR010000135.1_i000_001627	135	455	320	0.969697	0.541455
GCA_020498815.1-Fun_JAIBPS010000141.1_i000_002014	135	455	320	0.969697	0.541455
GCA_020498865.1-Fun_JAIBPV010000135.1_i000_001593	135	455	320	0.969697	0.541455
GCA_020498885.1-Fun_JAIBPT010000014.1_i000_001496	135	455	320	0.969697	0.541455
GCA_020498895.1-Fun_JAIBPU010000117.1_i000_000744	135	455	320	0.969697	0.541455
GCA_020498905.1-Fun_JAIBPX010000128.1_i000_001459	135	455	320	0.969697	0.541455
GCA_020498945.1-Fun_JAIBPY010000004.1_i000_005922	135	455	320	0.969697	0.541455
GCA_020498965.1-Fun_JAIBPZ010000248.1_i000_004443	135	455	320	0.969697	0.541455
GCA_020498985.1-Fun_JAIBQA010000120.1_i000_001128	135	455	320	0.969697	0.541455
GCA_020499005.1-Fun_JAIBQC010000145.1_i000_001896	135	455	320	0.969697	0.541455
GCA_020499015.1-Fun_JAIBQB010000115.1_i000_000958	135	455	320	0.969697	0.541455
GCA_020499035.1-Fun_JAIBQD010000048.1_i000_006744	135	455	320	0.969697	0.541455
GCA_020499045.1-Fun_JAIBQE010000129.1_i000_001143	135	455	320	0.969697	0.541455
GCA_020499075.1-Fun_JAIBQF010000130.1_i000_001346	135	455	320	0.969697	0.541455
GCA_020499115.1-Fun_JAIBQG010000191.1_i000_003208	135	455	320	0.969697	0.541455
GCA_020499125.1-Fun_JAIBQH010000132.1_i000_001363	135	455	320	0.969697	0.541455
GCA_020499155.1-Fun_JAIBQK010000106.1_i000_000450	135	455	320	0.969697	0.541455
GCA_020499185.1-Fun_JAIBQL010000128.1_i000_001195	135	455	320	0.969697	0.541455
GCA_020499195.1-Fun_JAIBQM010000128.1_i000_001187	135	455	320	0.969697	0.541455
GCA_020499225.1-Fun_JAIBQN010000118.1_i000_000945	135	455	320	0.969697	0.541455
GCA_020499245.1-Fun_JAIBQI010000550.1_i000_007488	135	455	320	0.969697	0.541455
GCA_020499255.1-Fun_JAIBQP010000127.1_i000_001149	135	455	320	0.969697	0.541455
GCA_020499265.1-Fun_JAIBQO010000123.1_i000_001148	135	455	320	0.969697	0.541455
GCA_020499315.1-Fun_JAIBQQ010000147.1_i000_001896	135	455	320	0.969697	0.541455
GCA_020499325.1-Fun_JAIBQS010000132.1_i000_001408	135	455	320	0.969697	0.541455
GCA_020499335.1-Fun_JAIBQT010000136.1_i000_001508	135	455	320	0.969697	0.541455
GCA_020499355.1-Fun_JAIBQU010000137.1_i000_001184	135	455	320	0.969697	0.541455
GCA_020499395.1-Fun_JAIBQV010000116.1_i000_000764	135	455	320	0.969697	0.541455
GCA_020499405.1-Fun_JAIBQW010000075.1_i000_008443	135	455	320	0.969697	0.541455
GCA_020499415.1-Fun_JAIBQX010000134.1_i000_001515	135	455	320	0.969697	0.541455
GCA_020499455.1-Fun_JAIBQY010000015.1_i000_001841	135	455	320	0.969697	0.541455
GCA_020499475.1-Fun_JAIBQZ010000130.1_i000_001227	135	455	320	0.969697	0.541455
GCA_020499485.1-Fun_JAIBRA010000140.1_i000_001731	135	455	320	0.969697	0.541455
GCA_020499495.1-Fun_JAIBRB010000132.1_i000_001283	135	455	320	0.969697	0.541455
GCA_020499505.1-Fun_JAIBRC010000189.1_i000_002969	135	455	320	0.969697	0.541455
GCA_020499565.1-Fun_JAIBRD010000126.1_i000_001166	135	455	320	0.969697	0.541455
GCA_020499575.1-Fun_JAIBRE010000130.1_i000_001371	135	455	320	0.969697	0.541455
GCA_020499585.1-Fun_JAIBRG010000139.1_i000_001578	135	455	320	0.969697	0.541455
GCA_020499595.1-Fun_JAIBRF010000092.1_i000_009035	135	455	320	0.969697	0.541455
GCA_020499605.1-Fun_JAIBRI010000134.1_i000_001500	135	455	320	0.969697	0.541455
GCA_020499645.1-Fun_JAIBRJ010000140.1_i000_001699	135	455	320	0.969697	0.541455
GCA_020499675.1-Fun_JAIBRZ010000047.1_i000_006280	135	455	320	0.969697	0.541455
GCA_020499685.1-Fun_JAIBSA010000098.1_i000_009217	135	455	320	0.969697	0.541455
GCA_020499695.1-Fun_JAIBRY010000106.1_i000_000616	135	455	320	0.969697	0.541455
GCA_020499715.1-Fun_JAIBSB010000115.1_i000_001048	135	455	320	0.969697	0.541455
GCA_020499755.1-Fun_JAIBSC010000036.1_i000_005229	135	455	320	0.969697	0.541455
GCA_020499775.1-Fun_JAIBSD010000118.1_i000_000965	135	455	320	0.969697	0.541455
GCA_020499785.1-Fun_JAIBSE010000097.1_i000_009436	135	455	320	0.969697	0.541455
GCA_020499805.1-Fun_JAIBSF010000048.1_i000_006294	135	455	320	0.969697	0.541455
GCA_020499815.1-Fun_JAIBSG010000001.1_i000_000176	135	455	320	0.969697	0.541455
GCA_020499825.1-Fun_JAIBSH010000119.1_i000_001194	135	455	320	0.969697	0.541455
GCA_020499865.1-Fun_JAIBSI010000117.1_i000_000982	135	455	320	0.969697	0.541455
GCA_020499885.1-Fun_JAIBRH010000140.1_i000_001723	135	455	320	0.969697	0.541455
GCA_020499905.1-Fun_JAIBRK010000116.1_i000_001015	135	455	320	0.969697	0.541455
GCA_020499915.1-Fun_JAIBRL010000112.1_i000_000892	135	455	320	0.969697	0.541455
GCA_020499935.1-Fun_JAIBRM010000010.1_i000_000238	135	455	320	0.969697	0.541455
GCA_020499975.1-Fun_JAIBRN010000126.1_i000_001383	135	455	320	0.969697	0.541455
GCA_020499985.1-Fun_JAIBRO010000138.1_i000_001797	135	455	320	0.969697	0.541455
GCA_020499995.1-Fun_JAIBRP010000132.1_i000_001611	135	455	320	0.969697	0.541455
GCA_020500025.1-Fun_JAIBRQ010000110.1_i000_000642	135	455	320	0.969697	0.541455
GCA_020500065.1-Fun_JAIBRT010000107.1_i000_000399	135	455	320	0.969697	0.541455
GCA_020500075.1-Fun_JAIBRR010000056.1_i000_007361	135	455	320	0.969697	0.541455
GCA_020500085.1-Fun_JAIBRS010000155.1_i000_002282	135	455	320	0.969697	0.541455
GCA_020500105.1-Fun_JAIBRU010000128.1_i000_001249	135	455	320	0.969697	0.541455
GCA_020500115.1-Fun_JAIBRV010000133.1_i000_001699	135	455	320	0.969697	0.541455
GCA_020500185.1-Fun_JAIBSL010000008.1_i000_008346	135	455	320	0.969697	0.541455
GCA_020500195.1-Fun_JAIBRX010000126.1_i000_001246	135	455	320	0.969697	0.541455
GCA_020500205.1-Fun_JAIBSJ010000008.1_i000_008513	135	455	320	0.969697	0.541455
GCA_020500215.1-Fun_JAIBSK010000070.1_i000_007979	135	455	320	0.969697	0.541455
GCA_020500235.1-Fun_JAIBSM010000243.1_i000_004345	135	455	320	0.969697	0.541455
GCA_020500275.1-Fun_JAIBSO010000009.1_i000_009092	135	455	320	0.969697	0.541455
GCA_020500285.1-Fun_JAIBSP010000068.1_i000_007783	135	455	320	0.969697	0.541455
GCA_020500295.1-Fun_JAIBSN010000007.1_i000_007857	135	455	320	0.969697	0.541455
GCA_020500305.1-Fun_JAIBSQ010000097.1_i000_009193	135	455	320	0.969697	0.541455
GCA_020500355.1-Fun_JAIBSS010000038.1_i000_005349	135	455	320	0.969697	0.541455
GCA_020500365.1-Fun_JAIBSR010000147.1_i000_002076	135	455	320	0.969697	0.541455
GCA_020500385.1-Fun_JAIBST010000060.1_i000_007287	135	455	320	0.969697	0.541455
GCA_020500395.1-Fun_JAIBSU010000106.1_i000_000519	135	455	320	0.969697	0.541455
GCA_020500445.1-Fun_JAIBSV010000128.1_i000_001469	135	455	320	0.969697	0.541455
GCA_020500455.1-Fun_JAIBSW010000139.1_i000_001805	135	455	320	0.969697	0.541455
GCA_020500465.1-Fun_JAIBSY010000134.1_i000_001708	135	455	320	0.969697	0.541455
GCA_020500475.1-Fun_JAIBSX010000006.1_i000_007049	135	455	320	0.969697	0.541455
GCA_020500485.1-Fun_JAIBSZ010000114.1_i000_000987	135	455	320	0.969697	0.541455
GCA_020500535.1-Fun_JAIBTB010000019.1_i000_003302	135	455	320	0.969697	0.541455
GCA_020500545.1-Fun_JAIBTC010000010.1_i000_000163	135	455	320	0.969697	0.541455
GCA_020500555.1-Fun_JAIBTD010000004.1_i000_005783	135	455	320	0.969697	0.541455
GCA_020500565.1-Fun_JAIBTE010000141.1_i000_001859	135	455	320	0.969697	0.541455
GCA_020500595.1-Fun_JAIBTF010000112.1_i000_000874	135	455	320	0.969697	0.541455
GCA_020500605.1-Fun_JAIBTG010000009.1_i000_009100	135	455	320	0.969697	0.541455
GCA_020500645.1-Fun_JAIBTH010000046.1_i000_006000	135	455	320	0.969697	0.541455
GCA_020500655.1-Fun_JAIBTI010000054.1_i000_006690	135	455	320	0.969697	0.541455
GCA_020500685.1-Fun_JAIBTJ010000065.1_i000_007672	135	455	320	0.969697	0.541455
GCA_020500695.1-Fun_JAIBTK010000004.1_i000_005476	135	455	320	0.969697	0.541455
GCA_020500705.1-Fun_JAIBTL010000056.1_i000_006926	135	455	320	0.969697	0.541455
GCA_020500765.1-Fun_JAIBTA010000113.1_i000_000922	135	455	320	0.969697	0.541455
GCA_020500775.1-Fun_JAIBTM010000108.1_i000_000667	135	455	320	0.969697	0.541455
GCA_020500785.1-Fun_JAIBTN010000061.1_i000_007321	135	455	320	0.969697	0.541455
GCA_020500805.1-Fun_JAIBTO010000002.1_i000_003238	135	455	320	0.969697	0.541455
GCA_020500815.1-Fun_JAIBTP010000002.1_i000_003155	135	455	320	0.969697	0.541455
GCA_020500845.1-Fun_JAIBTQ010000038.1_i000_005148	135	455	320	0.969697	0.541455
GCA_020500865.1-Fun_JAIBTS010000123.1_i000_001418	135	455	320	0.969697	0.541455
GCA_020500875.1-Fun_JAIBTR010000066.1_i000_007644	135	455	320	0.969697	0.541455
GCA_020500905.1-Fun_JAIBTT010000057.1_i000_006755	135	455	320	0.969697	0.541455
GCA_020500945.1-Fun_JAIBTV010000143.1_i000_001878	135	455	320	0.969697	0.541455
GCA_020500975.1-Fun_JAIBTX010000016.1_i000_002202	135	455	320	0.969697	0.541455
GCA_020500995.1-Fun_JAIBTY010000119.1_i000_000915	135	455	320	0.969697	0.541455
GCA_020501005.1-Fun_JAIBTZ010000165.1_i000_002584	135	455	320	0.969697	0.541455
GCA_020501045.1-Fun_JAIBUA010000035.1_i000_005934	135	455	320	0.969697	0.541455
GCA_020501075.1-Fun_JAIBUB010000138.1_i000_001662	135	455	320	0.969697	0.541455
GCA_020501095.1-Fun_JAIBUC010000139.1_i000_001648	135	455	320	0.969697	0.541455
GCA_020501105.1-Fun_JAIBUE010000044.1_i000_006048	135	455	320	0.969697	0.541455
GCA_020501115.1-Fun_JAIBUD010000122.1_i000_000947	135	455	320	0.969697	0.541455
GCA_020501135.1-Fun_JAIBUF010000139.1_i000_001605	135	455	320	0.969697	0.541455
GCA_020501145.1-Fun_JAIBUG010000031.1_i000_005264	135	455	320	0.969697	0.541455
GCA_020501175.1-Fun_JAIBUH010000080.1_i000_008863	135	455	320	0.969697	0.541455
GCA_020501185.1-Fun_JAIBUI010000013.1_i000_001515	135	455	320	0.969697	0.541455
GCA_020501235.1-Fun_JAIBUJ010000118.1_i000_000746	135	455	320	0.969697	0.541455
GCA_020501245.1-Fun_JAIBUK010000145.1_i000_001860	135	455	320	0.969697	0.541455
GCA_020501255.1-Fun_JAIBUO010000124.1_i000_001132	135	455	320	0.969697	0.541455
GCA_020501265.1-Fun_JAIBUM010000130.1_i000_001573	135	455	320	0.969697	0.541455
GCA_020501335.1-Fun_JAIBUN010000137.1_i000_001572	135	455	320	0.969697	0.541455
GCA_020501345.1-Fun_JAIBUP010000144.1_i000_001733	135	455	320	0.969697	0.541455
GCA_020501355.1-Fun_JAIBUQ010000039.1_i000_005903	135	455	320	0.969697	0.541455
GCA_020501375.1-Fun_JAIBUR010000013.1_i000_001242	135	455	320	0.969697	0.541455
GCA_020501405.1-Fun_JAIBUS010000010.1_i000_000246	135	455	320	0.969697	0.541455
GCA_020501425.1-Fun_JAIBUT010000121.1_i000_001262	135	455	320	0.969697	0.541455
GCA_020501465.1-Fun_JAIBUV010000138.1_i000_001483	135	455	320	0.969697	0.541455
GCA_020501475.1-Fun_JAIBUX010000126.1_i000_001172	135	455	320	0.969697	0.541455
GCA_020501495.1-Fun_JAIBUW010000158.1_i000_002444	135	455	320	0.969697	0.541455
GCA_020501535.1-Fun_JAIBUY010000044.1_i000_006224	135	455	320	0.969697	0.541455
GCA_020501545.1-Fun_JAIBUZ010000123.1_i000_001012	135	455	320	0.969697	0.541455
GCA_020501555.1-Fun_JAIBVA010000134.1_i000_001433	135	455	320	0.969697	0.541455
GCA_020501575.1-Fun_JAIBVB010000137.1_i000_001674	135	455	320	0.969697	0.541455
GCA_020501605.1-Fun_JAIBVC010000130.1_i000_001607	135	455	320	0.969697	0.541455
GCA_020501615.1-Fun_JAIBVD010000138.1_i000_001696	135	455	320	0.969697	0.541455
GCA_020501635.1-Fun_JAIBVE010000064.1_i000_007598	135	455	320	0.969697	0.541455
GCA_020501645.1-Fun_JAIBVF010000135.1_i000_001618	135	455	320	0.969697	0.541455
GCA_020501695.1-Fun_JAIBVG010000147.1_i000_001855	135	455	320	0.969697	0.541455
GCA_020501705.1-Fun_JAIBVI010000130.1_i000_001308	135	455	320	0.969697	0.541455
GCA_020501715.1-Fun_JAIBVH010000140.1_i000_001666	135	455	320	0.969697	0.541455
GCA_020501735.1-Fun_JAIBVJ010000134.1_i000_001427	135	455	320	0.969697	0.541455
GCA_020501765.1-Fun_JAIBVK010000006.1_i000_007555	135	455	320	0.969697	0.541455
GCA_020501785.1-Fun_JAIBVL010000134.1_i000_001461	135	455	320	0.969697	0.541455
GCA_020501805.1-Fun_JAIBVM010000136.1_i000_001570	135	455	320	0.969697	0.541455
GCA_020501815.1-Fun_JAIBVO010000137.1_i000_001651	135	455	320	0.969697	0.541455
GCA_020501835.1-Fun_JAIBVN010000124.1_i000_001133	135	455	320	0.969697	0.541455
GCA_020501875.1-Fun_JAIBVP010000136.1_i000_001581	135	455	320	0.969697	0.541455
GCA_020501885.1-Fun_JAIBVR010000138.1_i000_001613	135	455	320	0.969697	0.541455
GCA_020501895.1-Fun_JAIBVQ010000114.1_i000_000827	135	455	320	0.969697	0.541455
GCA_020501905.1-Fun_JAIBVS010000032.1_i000_005821	135	455	320	0.969697	0.541455
GCA_020501935.1-Fun_JAIBVT010000057.1_i000_007124	135	455	320	0.969697	0.541455
GCA_020501985.1-Fun_JAIBVU010000132.1_i000_001559	135	455	320	0.969697	0.541455
GCA_020501995.1-Fun_JAIBVV010000135.1_i000_001664	135	455	320	0.969697	0.541455
GCA_020502005.1-Fun_JAIBVW010000047.1_i000_006388	135	455	320	0.969697	0.541455
GCA_020502025.1-Fun_JAIBVX010000139.1_i000_001710	135	455	320	0.969697	0.541455
GCA_020502035.1-Fun_JAIBVY010000135.1_i000_001636	135	455	320	0.969697	0.541455
GCA_020502045.1-Fun_JAIBVZ010000108.1_i000_000617	135	455	320	0.969697	0.541455
GCA_020502095.1-Fun_JAIBWA010000115.1_i000_000985	135	455	320	0.969697	0.541455
GCA_020502105.1-Fun_JAIBWB010000059.1_i000_007241	135	455	320	0.969697	0.541455
GCA_020502115.1-Fun_JAIBWC010000126.1_i000_001128	135	455	320	0.969697	0.541455
GCA_020502125.1-Fun_JAIBWD010000084.1_i000_008704	135	455	320	0.969697	0.541455
GCA_020502165.1-Fun_JAIBWE010000132.1_i000_001414	135	455	320	0.969697	0.541455
GCA_020502215.1-Fun_JAIBWG010000143.1_i000_001782	135	455	320	0.969697	0.541455
GCA_020502225.1-Fun_JAIBWH010000125.1_i000_001110	135	455	320	0.969697	0.541455
GCA_020502235.1-Fun_JAIBWJ010000195.1_i000_003324	135	455	320	0.969697	0.541455
GCA_020502245.1-Fun_JAIBWI010000137.1_i000_001510	135	455	320	0.969697	0.541455
GCA_020502325.1-Fun_JAIBWK010000136.1_i000_001511	135	455	320	0.969697	0.541455
GCA_020502335.1-Fun_JAIBWL010000136.1_i000_001489	135	455	320	0.969697	0.541455
GCA_020502365.1-Fun_JAIBWM010000125.1_i000_001094	135	455	320	0.969697	0.541455
GCA_020502375.1-Fun_JAIBWN010000125.1_i000_001153	135	455	320	0.969697	0.541455
GCA_020502385.1-Fun_JAIBWO010000678.1_i000_007913	135	455	320	0.969697	0.541455
GCA_020502425.1-Fun_JAIBWP010000053.1_i000_007105	135	455	320	0.969697	0.541455
GCA_020502435.1-Fun_JAIBWQ010000095.1_i000_009250	135	455	320	0.969697	0.541455
GCA_020502455.1-Fun_JAIBWR010000120.1_i000_000922	135	455	320	0.969697	0.541455
GCA_020502485.1-Fun_JAIBWS010000077.1_i000_008542	135	455	320	0.969697	0.541455
GCA_020502525.1-Fun_JAIBWU010000123.1_i000_000986	135	455	320	0.969697	0.541455
GCA_020502575.1-Fun_JAIBWW010000132.1_i000_001417	135	455	320	0.969697	0.541455
GCA_020502605.1-Fun_JAIBWY010000191.1_i000_003045	135	455	320	0.969697	0.541455
GCA_020502615.1-Fun_JAIBWZ010000013.1_i000_001369	135	455	320	0.969697	0.541455
GCA_020502625.1-Fun_JAIBXA010000128.1_i000_001233	135	455	320	0.969697	0.541455
GCA_020502675.1-Fun_JAIBXB010000027.1_i000_004571	135	455	320	0.969697	0.541455
GCA_020502695.1-Fun_JAIBXC010000138.1_i000_001726	135	455	320	0.969697	0.541455
GCA_020502705.1-Fun_JAIBXD010000130.1_i000_001285	135	455	320	0.969697	0.541455
GCA_020502715.1-Fun_JAIBXE010000128.1_i000_001219	135	455	320	0.969697	0.541455
GCA_020502725.1-Fun_JAIBXF010000122.1_i000_000984	135	455	320	0.969697	0.541455
GCA_020502875.1-Fun_JAIBXG010000131.1_i000_001270	135	455	320	0.969697	0.541455
GCA_020502985.1-Fun_JAIBXH010000131.1_i000_001310	135	455	320	0.969697	0.541455
GCA_020502995.1-Fun_JAIBXI010000128.1_i000_001142	135	455	320	0.969697	0.541455
GCA_020503015.1-Fun_JAIBXJ010000092.1_i000_009154	135	455	320	0.969697	0.541455
GCA_020503055.1-Fun_JAIBXK010000120.1_i000_000894	135	455	320	0.969697	0.541455
GCA_020503065.1-Fun_JAIBXL010000131.1_i000_001473	135	455	320	0.969697	0.541455
GCA_020503085.1-Fun_JAIBXM010000121.1_i000_000943	135	455	320	0.969697	0.541455
GCA_020503095.1-Fun_JAIBXN010000125.1_i000_001123	135	455	320	0.969697	0.541455
GCA_020503105.1-Fun_JAIBXO010000138.1_i000_001592	135	455	320	0.969697	0.541455
GCA_020503165.1-Fun_JAIBXQ010000104.1_i000_000422	135	455	320	0.969697	0.541455
GCA_020503175.1-Fun_JAIBXP010000125.1_i000_001241	135	455	320	0.969697	0.541455
GCA_020503185.1-Fun_JAIBXR010000133.1_i000_001448	135	455	320	0.969697	0.541455
GCA_020503195.1-Fun_JAIBXT010000143.1_i000_001641	135	455	320	0.969697	0.541455
GCA_020503205.1-Fun_JAIBXS010000134.1_i000_001380	135	455	320	0.969697	0.541455
GCA_020503245.1-Fun_JAIBXU010000026.1_i000_004453	135	455	320	0.969697	0.541455
GCA_020503265.1-Fun_JAIBXV010000126.1_i000_001108	135	455	320	0.969697	0.541455
GCA_020503275.1-Fun_JAIBXW010000133.1_i000_001327	135	455	320	0.969697	0.541455
GCA_020503295.1-Fun_JAIBXX010000593.1_i000_007321	135	455	320	0.969697	0.541455
GCA_020503305.1-Fun_JAIBXY010000096.1_i000_009160	135	455	320	0.969697	0.541455
GCA_020503345.1-Fun_JAIBXZ010000133.1_i000_001413	135	455	320	0.969697	0.541455
GCA_020503375.1-Fun_JAIBYB010000137.1_i000_001585	135	455	320	0.969697	0.541455
GCA_020503395.1-Fun_JAIBYC010000025.1_i000_004193	135	455	320	0.969697	0.541455
GCA_020503435.1-Fun_JAIBYE010000119.1_i000_000962	135	455	320	0.969697	0.541455
GCA_020503445.1-Fun_JAIBYF010000142.1_i000_001847	135	455	320	0.969697	0.541455
GCA_020503455.1-Fun_JAIBYD010000141.1_i000_001694	135	455	320	0.969697	0.541455
GCA_020503465.1-Fun_JAIBYG010000023.1_i000_003799	135	455	320	0.969697	0.541455
GCA_020503515.1-Fun_JAIBYH010000021.1_i000_003495	135	455	320	0.969697	0.541455
GCA_020503535.1-Fun_JAIBYI010000082.1_i000_008910	135	455	320	0.969697	0.541455
GCA_020503545.1-Fun_JAIBYK010000129.1_i000_001209	135	455	320	0.969697	0.541455
GCA_020503555.1-Fun_JAIBYJ010000131.1_i000_001302	135	455	320	0.969697	0.541455
GCA_020503565.1-Fun_JAIBYL010000120.1_i000_000870	135	455	320	0.969697	0.541455
GCA_020503595.1-Fun_JAIBYM010000138.1_i000_001507	135	455	320	0.969697	0.541455
GCA_020503635.1-Fun_JAIBYN010000118.1_i000_000733	135	455	320	0.969697	0.541455
GCA_020503645.1-Fun_JAIBYO010000117.1_i000_000833	135	455	320	0.969697	0.541455
GCA_020503665.1-Fun_JAIBYP010000142.1_i000_001622	135	455	320	0.969697	0.541455
GCA_020503705.1-Fun_JAIBYQ010000144.1_i000_001820	135	455	320	0.969697	0.541455
GCA_020503715.1-Fun_JAIBYR010000125.1_i000_001066	135	455	320	0.969697	0.541455
GCA_020503725.1-Fun_JAIBYS010000138.1_i000_001555	135	455	320	0.969697	0.541455
GCA_020503735.1-Fun_JAIBYT010000035.1_i000_005101	135	455	320	0.969697	0.541455
GCA_020503745.1-Fun_JAIBYU010000135.1_i000_001516	135	455	320	0.969697	0.541455
GCA_020503795.1-Fun_JAIBYX010000053.1_i000_006979	135	455	320	0.969697	0.541455
GCA_020503805.1-Fun_JAIBYW010000130.1_i000_001294	135	455	320	0.969697	0.541455
GCA_020503815.1-Fun_JAIBYV010000141.1_i000_001721	135	455	320	0.969697	0.541455
GCA_020503825.1-Fun_JAIBYY010000136.1_i000_001668	135	455	320	0.969697	0.541455
GCA_020503885.1-Fun_JAIBYZ010000136.1_i000_001809	135	455	320	0.969697	0.541455
GCA_020503895.1-Fun_JAIBZA010000137.1_i000_001671	135	455	320	0.969697	0.541455
GCA_020503905.1-Fun_JAIBZB010000140.1_i000_001910	135	455	320	0.969697	0.541455
GCA_020503915.1-Fun_JAIBZC010000140.1_i000_001800	135	455	320	0.969697	0.541455
GCA_020503935.1-Fun_JAIBZD010000011.1_i000_000569	135	455	320	0.969697	0.541455
GCA_020510485.1-Fun_JAIBQR010000138.1_i000_001643	135	455	320	0.969697	0.541455
GCA_016584165.1-Fun_PUHT01000053.1_i000_003917	139	462	323	0.978788	0.623552
GCA_021193595.1-Fun_JAJJMK010000211.1_i000_008194	133	455	322	0.975758	0.626459
GCA_018360365.1-Fun_SRQA01000010.1_i000_000065	120	452	332	1.00606	0.553333
GCA_004155935.1-Fun_QJNV01000100.1_i000_000537	123	460	337	1.02121	0.54886
GCA_000151175.1-Fun_DS995748.1_i000_003137	134	458	324	0.981818	0.531148
GCA_000151455.1-Fun_GG698510.1_i000_002560	134	458	324	0.981818	0.531148
GCA_022453505.1-Fun_JAJLYR010000007.1_i000_010514	130	459	329	0.99697	0.642578
GCA_000616785.1-Fun_KK204674.1_i000_004569	134	458	324	0.981818	0.531148
GCA_000622975.1-Fun_AOKY01000337.1_i000_005258	134	458	324	0.981818	0.531148
GCA_900618365.1-Ani_UYYF01004510.1_i000_007448	129	458	329	0.99697	0.670061
GCA_000146945.2-Fun_CH476639.1_i000_002635	136	455	319	0.966667	0.559649
GCA_001857865.1-Fun_CP017818.1_i000_004185	136	455	319	0.966667	0.559649
GCA_000787575.2-Pro_DF837575.1_i000_010272	4	335	331	1.00303	0.692469
GCA_013202065.2-Ani_JAAOIC020000016.1_i000_001220	115	447	332	1.00606	0.560811
CAMA003.0722.00001.C001_01327	99	404	305	0.924242	0.745721
GCA_020080795.1-Fun_JAGHQM010000551.1_i000_006891	129	446	317	0.960606	0.51461
GCA_016584275.1-Fun_PUHV01000103.1_i000_000249	140	460	320	0.969697	0.610687
GCA_004936735.2-Pro_SCFC02000005.1_i000_001030	117	447	330	1	0.708155
GCA_020498875.1-Fun_JAIBPW010000129.1_i000_001420	135	450	315	0.954545	0.533898
GCA_020499135.1-Fun_JAIBQJ010000140.1_i000_001706	135	450	315	0.954545	0.533898
GCA_020500165.1-Fun_JAIBRW010000137.1_i000_001526	135	450	315	0.954545	0.533898
GCA_020500935.1-Fun_JAIBTU010000109.1_i000_000647	135	450	315	0.954545	0.533898
GCA_020500965.1-Fun_JAIBTW010000144.1_i000_001971	135	450	315	0.954545	0.533898
GCA_020501325.1-Fun_JAIBUL010000131.1_i000_001412	135	450	315	0.954545	0.533898
GCA_020501445.1-Fun_JAIBUU010000138.1_i000_001650	135	450	315	0.954545	0.533898
GCA_020502185.1-Fun_JAIBWF010000138.1_i000_001533	135	450	315	0.954545	0.533898
GCA_020502495.1-Fun_JAIBWT010000125.1_i000_001164	135	450	315	0.954545	0.533898
GCA_020502545.1-Fun_JAIBWV010000136.1_i000_001545	135	450	315	0.954545	0.533898
GCA_020502595.1-Fun_JAIBWX010000128.1_i000_001243	135	450	315	0.954545	0.533898
GCA_020503365.1-Fun_JAIBYA010000136.1_i000_001523	135	450	315	0.954545	0.533898
GCA_905066765.1-Fun_CAJHIA010000007.1_i000_002019	136	455	319	0.966667	0.56261
GCA_000303195.2-Fun_CM003200.1_i000_009110	138	471	333	1.00909	0.659406
GCA_001703955.2-Fun_CM004558.1_i000_008451	138	471	333	1.00909	0.659406
GCA_000340215.1-Fun_KB446558.1_i000_006228	136	452	316	0.957576	0.554386
GCA_001466525.1-Fun_LLWO01000043.1_i000_002480	138	456	318	0.963636	0.625984
GCA_001466535.1-Fun_LMAA01000077.1_i000_003165	138	456	318	0.963636	0.625984
GCA_001466565.1-Fun_LMAB01000132.1_i000_003707	138	456	318	0.963636	0.625984
GCA_001466575.1-Fun_LLZY01000069.1_i000_003807	138	456	318	0.963636	0.625984
GCA_001466635.1-Fun_LLZZ01000157.1_i000_004713	138	456	318	0.963636	0.625984
GCA_001466685.1-Fun_LMAY01000103.1_i000_001825	138	456	318	0.963636	0.625984
GCA_002219185.1-Fun_CM008081.1_i000_000165	138	456	318	0.963636	0.625984
GCA_002219195.1-Fun_CM008095.1_i000_000165	138	456	318	0.963636	0.625984
GCA_014217725.1-Fun_CP048230.1_i000_000169	138	456	318	0.963636	0.625984
GCA_020797195.1-Fun_CM036803.1_i000_000168	138	456	318	0.963636	0.625984
GCA_020797205.1-Fun_CM036825.1_i000_000167	138	456	318	0.963636	0.625984
GCA_020797215.1-Fun_CM036796.1_i000_000169	138	456	318	0.963636	0.625984
GCA_020797225.1-Fun_CM036814.1_i000_000170	138	456	318	0.963636	0.625984
GCA_020797355.1-Fun_CM036851.1_i000_000170	138	456	318	0.963636	0.625984
GCA_900096545.1-Fun_FMSJ01000120.1_i000_000433	138	456	318	0.963636	0.625984
GCA_900166875.1-Fun_FWDN01000120.1_i000_000583	138	456	318	0.963636	0.625984
GCA_018360755.1-Fun_SRQW01000233.1_i000_002739	137	448	311	0.942424	0.69265
GCA_012182645.1-Fun_JAATJQ010000145.1_i000_001218	133	459	326	0.987879	0.534426
GCA_012182655.1-Fun_JAAQVJ010000152.1_i000_001347	133	459	326	0.987879	0.534426
GCA_019359935.1-Fun_JAADCK010000150.1_i000_001396	133	459	326	0.987879	0.534426
GCA_000149405.2-Pro_CM000638.1_i000_000962	143	487	344	1.04242	0.649057
GCA_000690575.1-Pla_AYPS01000055.1_i000_000237	130	445	315	0.954545	0.654886
GCA_013368755.1-Fun_CP055899.1_i000_004416	134	451	317	0.960606	0.543739
GCA_017357885.1-Fun_CP063413.1_i000_009019	136	454	318	0.963636	0.556918
GCA_020536175.1-Fun_JAEUBF010001278.1_i000_004813	137	448	311	0.942424	0.619522
GCA_019669845.1-Fun_MU251245.1_i000_001877	121	454	333	1.00909	0.552239
GCA_021605095.1-Ani_BPLR01020297.1_i000_077269	118	445	327	0.990909	0.695745
GCA_900074725.1-Fun_LT598455.1_i000_002751	134	462	328	0.993939	0.648221
GCA_018360275.1-Fun_SRQB01000027.1_i000_003068	122	452	330	1	0.549085
GCA_000181695.1-Fun_AAYY01000001.1_i000_003873	143	459	316	0.957576	0.577697
GCA_004794745.1-Ani_QBLH01002196.1_i000_008584	124	458	334	1.01212	0.690083
GCA_019207455.1-Fun_JAHLUW010000002.1_i000_002275	130	446	316	0.957576	0.633267
GCA_019207505.1-Fun_JAHLUZ010000001.1_i000_001799	130	446	316	0.957576	0.633267
GCA_019207515.1-Fun_JAHLVA010000003.1_i000_002735	130	446	316	0.957576	0.633267
GCA_019207525.1-Fun_JAHLVB010000001.1_i000_001687	130	446	316	0.957576	0.633267
GCA_019207585.1-Fun_JAHLVF010000002.1_i000_002132	130	446	316	0.957576	0.633267
GCA_019207605.1-Fun_JAHLVD010000001.1_i000_001690	130	446	316	0.957576	0.633267
GCA_020744155.1-Fun_JAGPNQ010000007.1_i000_018552	139	472	333	1.00909	0.640385
GCA_001972345.1-Fun_BDGX01000045.1_i000_008768	136	461	325	0.984848	0.621415
GCA_000240135.3-Fun_CM000576.1_i000_009874	144	468	324	0.981818	0.637795
GCA_000599445.1-Fun_CM002653.1_i000_009741	144	468	324	0.981818	0.637795
GCA_002352725.1-Fun_NQOC01000002.1_i000_002536	144	468	324	0.981818	0.637795
GCA_900044135.1-Fun_HG970334.1_i000_010421	144	468	324	0.981818	0.637795
GCA_900073075.1-Fun_LT222055.1_i000_010463	144	468	324	0.981818	0.637795
GCA_901446245.1-Fun_CABDWO010000179.1_i000_007024	144	468	324	0.981818	0.637795
GCA_905359455.1-Fun_CAJPII010000059.1_i000_005183	144	468	324	0.981818	0.637795
GCA_905359475.1-Fun_CAJPIG010000154.1_i000_006781	144	468	324	0.981818	0.637795
GCA_001029325.1-Fun_KQ087362.1_i000_003038	136	448	312	0.945455	0.527919
GCA_019207235.1-Fun_JAHLUK010000002.1_i000_002671	130	447	317	0.960606	0.636546
GCA_019207285.1-Fun_JAHLUL010000002.1_i000_002732	130	447	317	0.960606	0.636546
GCA_910592215.1-Fun_CAJVPN010000350.1_i000_003195	115	449	334	1.01212	0.409816
GCA_001712635.2-Pro_MBAC02000992.1_i000_002257	1	279	278	0.842424	0.839879
GCA_019207375.1-Fun_JAHLUR010000006.1_i000_004446	128	445	317	0.960606	0.632735
GCA_019207405.1-Fun_JAHLUS010000005.1_i000_003818	128	445	317	0.960606	0.632735
GCA_001661255.1-Fun_KV454211.1_i000_003616	139	459	320	0.969697	0.634921
GCA_020450195.1-Fun_CP053486.1_i000_000165	169	488	319	0.966667	0.590741
GCA_020450215.1-Fun_CP053512.1_i000_000165	169	488	319	0.966667	0.590741
GCA_020450235.1-Fun_CP053525.1_i000_000165	169	488	319	0.966667	0.590741
GCA_020450265.1-Fun_CP060143.1_i000_000165	169	488	319	0.966667	0.590741
GCA_022432515.1-Fun_JAJKLA010000006.1_i000_009459	127	462	335	1.01515	0.537721
GCA_002812745.2-Fun_NCSJ02000139.1_i000_001611	136	458	322	0.975758	0.531353
GCA_000150955.2-Pro_CP001142.1_i000_001888	142	465	323	0.978788	0.633333
GCA_021176775.1-Fun_JAJEVK010000003.1_i000_003817	123	457	334	1.01212	0.571918
GCA_001268165.1-Fun_CVQI01037273.1_i000_020156	107	436	329	0.99697	0.721491
GCA_000271625.1-Fun_JH711578.1_i000_006097	120	443	323	0.978788	0.599258
GCA_000243375.1-Fun_HE616744.1_i000_001742	137	459	322	0.975758	0.631373
GCA_000412225.2-Fun_CP006022.1_i000_001344	132	450	318	0.963636	0.611538
GCA_001712635.2-Pro_MBAC02001470.1_i000_003440	1	280	279	0.845455	0.8429
GCA_004366825.1-Fun_QAPG01000071.1_i000_006307	162	474	312	0.945455	0.605825
GCA_004367215.1-Fun_RYZW01000034.1_i000_004623	162	474	312	0.945455	0.605825
GCA_019207325.1-Fun_JAHLUP010000001.1_i000_001729	130	445	315	0.954545	0.63253
GCA_019207365.1-Fun_JAHLUQ010000007.1_i000_004710	130	445	315	0.954545	0.63253
GCA_012274485.2-Pla_MU105828.1_i000_019865	130	439	309	0.936364	0.580827
GCA_019207165.1-Fun_JAHLUV010000009.1_i000_005230	130	445	315	0.954545	0.63253
GCA_019207175.1-Fun_JAHLUI010000006.1_i000_004525	130	445	315	0.954545	0.63253
GCA_004154915.1-Fun_QJNU01000112.1_i000_001057	126	460	334	1.01212	0.543974
GCA_018360205.1-Fun_SRPT01000940.1_i000_007966	120	456	336	1.01818	0.56
GCA_010093945.1-Fun_ML993879.1_i000_001801	120	459	339	1.02727	0.583477
GCA_021365345.1-Fun_JAAZTN010000006.1_i000_008990	571	907	336	1.01818	0.318483
GCA_000091025.4-Fun_AE016819.5_i000_003549	131	447	316	0.957576	0.615984
GCA_018360375.1-Fun_SRQE01000336.1_i000_003914	137	447	310	0.939394	0.690423
GCA_000151125.2-Fun_ABSU01000024.1_i000_001986	190	513	323	0.978788	0.487915
GCA_000804445.1-Fun_AZHE01000005.1_i000_006755	121	457	336	1.01818	0.551724
GCA_018360765.1-Fun_SRQV01000004.1_i000_004691	142	459	317	0.960606	0.621569
GCA_001890805.1-Fun_KV878935.1_i000_011154	135	453	318	0.963636	0.544521
GCA_019206905.1-Fun_JAHLUB010000001.1_i000_001953	130	447	317	0.960606	0.636546
GCA_019206915.1-Fun_JAHLUA010000005.1_i000_003898	130	447	317	0.960606	0.636546
GCA_019206925.1-Fun_JAHLUE010000008.1_i000_005023	130	447	317	0.960606	0.636546
GCA_019206965.1-Fun_JAHLUF010000007.1_i000_004776	130	447	317	0.960606	0.636546
GCA_019206985.1-Fun_JAHLUC010000008.1_i000_004959	130	447	317	0.960606	0.636546
GCA_019207005.1-Fun_JAHLUH010000007.1_i000_004700	130	447	317	0.960606	0.636546
GCA_019207125.1-Fun_JAHLUD010000003.1_i000_003164	130	447	317	0.960606	0.636546
GCA_019207185.1-Fun_JAHLUG010000003.1_i000_003086	130	447	317	0.960606	0.636546
GCA_019207205.1-Fun_JAHLUJ010000002.1_i000_002546	130	447	317	0.960606	0.636546
GCA_019207265.1-Fun_JAHLUN010000009.1_i000_005287	130	447	317	0.960606	0.636546
GCA_019207295.1-Fun_JAHLUM010000002.1_i000_002761	130	447	317	0.960606	0.636546
GCA_019207315.1-Fun_JAHLUO010000002.1_i000_002549	130	447	317	0.960606	0.636546
GCA_019207415.1-Fun_JAHLUU010000001.1_i000_001708	130	447	317	0.960606	0.636546
GCA_019207435.1-Fun_JAHLUT010000001.1_i000_001746	130	447	317	0.960606	0.636546
GCA_022376655.1-Fun_JAJJKE010000064.1_i000_009384	123	461	338	1.02424	0.558678
GCA_002204255.1-Fun_MZNU01000061.1_i000_008194	131	441	310	0.939394	0.451237
GCA_022432505.1-Fun_JAJKKH010000001.1_i000_000715	126	461	335	1.01515	0.537721
GCA_020360975.1-Fun_JAIZPD010000009.1_i000_007948	130	451	321	0.972727	0.54223
GCA_021029115.1-Pro_JAFCAG010000002.1_i000_007747	85	414	329	0.99697	0.75286
GCA_018360145.1-Fun_SRPY01000599.1_i000_006015	143	464	321	0.972727	0.597765
GCA_000151665.1-Pro_FN668683.1_i000_004713	151	486	335	1.01515	0.644231
GCA_002916505.1-Fun_PKSG01001023.1_i000_005368	164	497	333	1.00909	0.597846
GCA_015039405.1-Fun_WJDU01000017.1_i000_004161	132	452	320	0.969697	0.57971
GCA_008522505.1-Fun_VSWC01000053.1_i000_012529	126	449	323	0.978788	0.562718
GCA_002738505.1-Pla_KZ305034.1_i000_012314	131	444	313	0.948485	0.553982
GCA_018360675.1-Fun_SRQZ01000108.1_i000_000319	147	459	312	0.945455	0.611765
GCA_000006405.1-Pro_GG674889.1_i000_000801	124	468	344	1.04242	0.661538
GCA_014839625.1-Fun_WIWV01000003.1_i000_004170	130	453	323	0.978788	0.565674
GCA_014839855.1-Fun_WIWU01000006.1_i000_006221	130	453	323	0.978788	0.565674
GCA_002847485.1-Fun_MSFM01000001.1_i000_000810	135	451	316	0.957576	0.548611
GCA_000600275.1-Fun_KK088465.1_i000_009723	135	456	321	0.972727	0.549658
GCA_005059885.1-Fun_NAJL01000001.1_i000_000293	134	449	315	0.954545	0.516393
GCA_018360255.1-Fun_SRPZ01000190.1_i000_002368	134	451	317	0.960606	0.701327
GCA_000347355.1-Fun_CAGA01000003.1_i000_008027	148	459	311	0.942424	0.609804
GCA_020736575.1-Fun_JAGPYM010000003.1_i000_008318	132	462	330	1	0.649606
GCA_021365365.1-Fun_JAJTIX010000016.1_i000_005173	131	466	335	1.01515	0.659449
GCA_001717485.1-Fun_JXNT01000020.1_i000_005303	135	453	318	0.963636	0.544521
GCA_003698115.1-Fun_RAQS01000443.1_i000_007449	135	452	317	0.960606	0.539116
GCA_021399435.1-Fun_JAJTUP010000011.1_i000_002417	148	466	318	0.963636	0.609195
GCA_002237265.2-Fun_NKHU02000178.1_i000_002584	135	456	321	0.972727	0.543147
GCA_000616865.1-Fun_KK208920.1_i000_007512	136	457	321	0.972727	0.530579
GCA_000968835.1-Fun_CP002710.1_i000_003548	131	451	320	0.969697	0.620155
GCA_019804575.1-Fun_JAHQZX010000285.1_i000_002586	132	467	335	1.01515	0.551895
GCA_000787575.2-Pro_DF837595.1_i000_002966	119	451	332	1.00606	0.513138
GCA_900074765.1-Fun_LT598487.1_i000_000145	130	447	317	0.960606	0.599244
GCA_018360445.1-Fun_SRQK01000016.1_i000_001518	143	456	313	0.948485	0.612524
GCA_018360575.1-Fun_SRQL01000029.1_i000_003578	143	456	313	0.948485	0.612524
GCA_018360595.1-Fun_SRQJ01000122.1_i000_000779	143	456	313	0.948485	0.612524
GCA_020726525.1-Fun_JAGPXC010000005.1_i000_010457	130	444	314	0.951515	0.625498
GCA_000236905.1-Fun_HE612861.1_i000_002689	137	460	323	0.978788	0.634578
GCA_018994065.1-Fun_JAFKAH010000377.1_i000_008572	92	420	328	0.993939	0.706897
GCA_003426965.1-Fun_QUQM01000007.1_i000_010299	135	458	323	0.978788	0.546531
GCA_004798825.1-Fun_SOSA01000004.1_i000_007668	135	458	323	0.978788	0.546531
GCA_009193595.1-Fun_ML736175.1_i000_002925	134	456	322	0.975758	0.555172
GCA_018360355.1-Fun_SRQC01000015.1_i000_001275	144	457	313	0.948485	0.606589
GCA_015476325.1-Pro_JADAQX010000103.1_i000_000812	118	434	316	0.957576	0.718182
GCA_902602495.3-Pro_CACKRE030005273.1_i000_025461	127	451	324	0.981818	0.567426
GCA_000350065.2-Fun_AMCV02000033.1_i000_010373	144	466	322	0.975758	0.637624
GCA_004565275.1-Pro_SDOX01000007.1_i000_007586	130	457	327	0.990909	0.656627
GCA_018282135.1-Fun_JAGPUO010000012.1_i000_002008	213	540	327	0.990909	0.480882
GCA_014281895.1-Fun_JACBAE010001244.1_i000_002116	135	457	322	0.975758	0.544839
GCA_014281915.1-Fun_JACBAG010001762.1_i000_002410	135	457	322	0.975758	0.544839
GCA_002573585.1-Fun_PDNB01000041.1_i000_007111	136	456	320	0.969697	0.515298
GCA_000187405.1-Fun_GL698478.1_i000_001945	145	463	318	0.963636	0.619883
GCA_019434415.1-Fun_JAGRQK010000025.1_i000_008809	145	463	318	0.963636	0.619883
GCA_004022145.1-Fun_RCNU01000001.1_i000_000551	134	445	311	0.942424	0.520067
GCA_018360325.1-Fun_SRQG01000035.1_i000_004592	143	462	319	0.966667	0.620623
GCA_001653235.2-Fun_CM008055.1_i000_001292	125	456	331	1.00303	0.546205
GCA_013400875.1-Ani_VZTV01113784.1_i000_009269	1	266	265	0.80303	0.757143
GCA_001937105.1-Fun_MPGH01000089.1_i000_009978	145	462	317	0.960606	0.620352
GCA_010085365.1-Ani_VULK01000172.1_i000_003442	1	267	266	0.806061	0.762178
GCA_003260565.1-Fun_QKRW01000046.1_i000_008602	136	454	318	0.963636	0.559859
GCA_008692225.1-Fun_VICG01000002.1_i000_001557	136	454	318	0.963636	0.558875
GCA_009299455.1-Fun_VIGI01000001.1_i000_000192	136	454	318	0.963636	0.558875
GCA_016906325.1-Fun_RKRL01000002.1_i000_000968	136	454	318	0.963636	0.558875
GCA_020536225.1-Fun_JAEUBG010001205.1_i000_002248	130	450	320	0.969697	0.632411
GCA_000149925.1-Fun_DS178318.1_i000_004036	182	505	323	0.978788	0.512698
GCA_020379485.1-Pla_CM035462.1_i000_077135	143	457	314	0.951515	0.13784
GCA_016584275.1-Fun_PUHV01000073.1_i000_004270	119	447	328	0.993939	0.635659
GCA_000151665.1-Pro_FN668689.1_i000_005352	124	455	331	1.00303	0.672764
GCA_000503235.1-Fun_KI628564.1_i000_002302	136	453	317	0.960606	0.555166
GCA_000585515.1-Fun_AMGW01000005.1_i000_007630	135	453	318	0.963636	0.476762
GCA_001792695.1-Fun_LYCR01000157.1_i000_011243	135	455	320	0.969697	0.553633
GCA_013115135.1-Pro_JABANP010000222.1_i000_004689	42	383	341	1.03333	0.771493
GCA_000209125.2-Pro_DS550445.1_i000_001524	115	445	330	1	0.639535
GCA_000165425.1-Pro_CT868668.1_i000_037037	117	445	328	0.993939	0.700855
GCA_018360065.1-Fun_SRPO01000086.1_i000_007413	137	466	329	0.99697	0.648915
GCA_002234965.2-Fun_NKHV02000219.1_i000_003952	135	456	321	0.972727	0.54223
GCA_013235015.1-Ani_BGPR01003933.1_i000_088106	118	444	326	0.987879	0.687764
GCA_018994065.1-Fun_JAFKAH010000493.1_i000_019019	121	448	327	0.990909	0.661943
GCA_905219565.1-Fun_CAJMWR010002484.1_i000_004493	131	456	325	0.984848	0.565217
GCA_009739505.2-Ani_CM019170.2_i000_015568	121	447	326	0.987879	0.594891
GCA_000310025.1-Pro_FN649749.1_i000_009588	125	446	321	0.972727	0.57424
GCA_004154925.1-Fun_QJNS01000082.1_i000_010258	122	460	338	1.02424	0.550489
GCA_905337345.1-Fun_CAJPDS010000063.1_i000_007469	120	432	312	0.945455	0.400513
GCA_004154975.1-Fun_QJNW01000170.1_i000_002288	122	460	338	1.02424	0.550489
GCA_004155895.1-Fun_QJNT01000048.1_i000_008615	122	460	338	1.02424	0.550489
GCA_001417835.1-Fun_AP014600.1_i000_001113	119	448	329	0.99697	0.641326
GCA_001417885.1-Fun_AP012214.1_i000_001112	119	448	329	0.99697	0.641326
GCA_001854445.2-Fun_CP015055.1_i000_001152	119	448	329	0.99697	0.641326
GCA_000150975.2-Fun_DS989822.1_i000_008222	133	461	328	0.993939	0.541254
GCA_020744375.1-Fun_JAGMUU010000002.1_i000_006438	131	467	336	1.01818	0.672
GCA_000149645.3-Fun_DS027690.1_i000_005855	135	457	322	0.975758	0.544839
GCA_016748045.1-Fun_WHVT01000025.1_i000_003909	135	457	322	0.975758	0.544839
GCA_000701005.1-Ani_KL363199.1_i000_003623	120	456	336	1.01818	0.644914
GCA_000701025.1-Ani_KL367583.1_i000_010411	120	456	336	1.01818	0.644914
GCA_001653235.2-Fun_CM008058.1_i000_007229	136	461	325	0.984848	0.634766
GCA_001268145.1-Fun_CVQH01021674.1_i000_013261	137	463	326	0.987879	0.639216
GCA_016771965.1-Pla_JAAMPC010000105.1_i000_091083	125	439	314	0.951515	0.315578
GCA_012932025.1-Fun_JAADJG010000495.1_i000_010313	124	454	330	1	0.555556
GCA_002847465.1-Fun_MSZS01000013.1_i000_002787	135	457	322	0.975758	0.544839
GCA_000530735.1-Fun_CBTC010000022.1_i000_001932	130	447	317	0.960606	0.601518
GCA_001984395.2-Fun_CP019494.1_i000_003715	130	447	317	0.960606	0.601518
GCA_000149615.1-Fun_CH476598.1_i000_006640	135	474	339	1.02727	0.587522
GCA_016808415.1-Fun_JAAWWR010000004.1_i000_002011	135	474	339	1.02727	0.587522
GCA_003724135.2-Fun_RBVV01000080.1_i000_008561	137	464	327	0.990909	0.641176
GCA_001045655.1-Ani_LBMM01000512.1_i000_001419	113	444	331	1.00303	0.526232
GCA_002892995.1-Fun_PHNU01000158.1_i000_001973	142	466	324	0.981818	0.635294
GCA_002893045.1-Fun_PHNX01000154.1_i000_001806	142	466	324	0.981818	0.635294
GCA_003320035.1-Fun_CM010353.1_i000_009074	142	466	324	0.981818	0.635294
GCA_004109745.1-Fun_CM014047.1_i000_006397	142	466	324	0.981818	0.635294
GCA_011066465.2-Fun_MU009611.1_i000_008913	142	466	324	0.981818	0.635294
GCA_018994095.1-Fun_JAEMWZ010000018.1_i000_003861	142	466	324	0.981818	0.635294
GCA_001636795.1-Fun_AZHF01000009.1_i000_010661	134	466	332	1.00606	0.654832
GCA_001040885.1-Ani_LN609529.1_i000_008532	127	460	333	1.00909	0.690871
GCA_016584165.1-Fun_PUHT01000005.1_i000_003787	130	447	317	0.960606	0.621569
GCA_001593445.1-Pro_JIBK01000043.1_i000_002431	117	447	330	1	0.708155
GCA_020726575.1-Fun_JAGSXJ010000012.1_i000_001728	137	467	330	1	0.650888
GCA_018360365.1-Fun_SRQA01000310.1_i000_004006	137	434	297	0.9	0.684332
GCA_000313485.1-Fun_CAIF01000076.1_i000_003833	130	447	317	0.960606	0.619141
GCA_003709845.1-Fun_QQXO01000012.1_i000_000701	131	453	322	0.975758	0.513557
GCA_012184295.1-Fun_LDUD01000006.1_i000_004911	135	443	308	0.933333	0.557971
GCA_902459845.2-Pro_CABPSV020000652.1_i000_003348	116	448	332	1.00606	0.664
GCA_002105025.1-Fun_MCFA01000340.1_i000_009511	115	455	340	1.0303	0.58319
GCA_001984395.2-Fun_CP019502.1_i000_008753	128	445	317	0.960606	0.602662
GCA_000150675.2-Fun_DS572697.1_i000_008504	137	468	331	1.00303	0.64775
GCA_002892985.1-Fun_MPSH01000018.1_i000_002804	137	468	331	1.00303	0.64775
GCA_002893025.1-Fun_PHNV01000131.1_i000_001148	137	468	331	1.00303	0.64775
GCA_011066485.2-Fun_MU009762.1_i000_001692	137	468	331	1.00303	0.64775
GCA_020726535.1-Fun_JAHEWJ010000019.1_i000_004623	137	468	331	1.00303	0.64775
GCA_001660665.1-Fun_LGUA01000025.1_i000_003677	1	267	266	0.806061	0.836478
GCA_001676915.1-Ani_KV584939.1_i000_000856	60	397	337	1.02121	0.735808
GCA_019207935.1-Fun_JAHLVI010000005.1_i000_003925	130	442	312	0.945455	0.622754
GCA_011692745.1-Fun_JAACJD010000001.1_i000_000950	135	456	321	0.972727	0.533223
GCA_902829235.1-Ani_CADEPI010000128.1_i000_008781	126	457	331	1.00303	0.660679
GCA_013398115.1-Ani_VZRV01009661.1_i000_012200	1	265	264	0.8	0.73743
GCA_002918395.1-Fun_PEDP01000203.1_i000_001427	124	458	334	1.01212	0.660079
GCA_000365165.2-Fun_KB822703.1_i000_003353	135	455	320	0.969697	0.47976
GCA_000143925.2-Ani_GL379851.1_i000_013115	92	429	337	1.02121	0.745575
GCA_000825705.1-Fun_CDHN01000001.1_i000_000126	125	452	327	0.990909	0.551433
GCA_001511075.1-Fun_CDMC01000009.1_i000_010753	135	446	311	0.942424	0.539931
GCA_003144205.1-Fun_KZ819604.1_i000_004947	132	453	321	0.972727	0.582577
GCA_002249935.1-Ani_KZ269981.1_i000_001664	131	468	337	1.02121	0.566387
GCA_000769215.1-Fun_JPYM01000010.1_i000_001595	126	454	328	0.993939	0.554054
GCA_013396485.1-Ani_VWYY01007350.1_i000_013413	1	238	237	0.718182	0.995798
GCA_020744115.1-Fun_JAGMVH010000001.1_i000_002068	126	454	328	0.993939	0.55312
GCA_001661425.1-Fun_KV453848.1_i000_001057	129	450	321	0.972727	0.616123
GCA_000006405.1-Pro_GG671079.1_i000_010208	123	467	344	1.04242	0.670565
GCA_003635345.1-Fun_QVQW01000020.1_i000_003150	129	459	330	1	0.587189
GCA_900074745.1-Fun_LT598466.1_i000_001225	130	450	320	0.969697	0.628684
GCA_018340605.1-Fun_BHVY01000004.1_i000_006441	135	457	322	0.975758	0.544839
GCA_013397115.1-Ani_VWZW01006798.1_i000_011151	111	440	329	0.99697	0.650198
GCA_010183535.1-Ani_CM021148.1_i000_016301	125	462	337	1.02121	0.691992
GCA_012931995.1-Fun_JAADYS010000257.1_i000_002010	126	484	358	1.08485	0.599665
GCA_000149515.1-Ani_DS268467.1_i000_014429	125	462	337	1.02121	0.691992
GCA_019343175.1-Ani_JAFNEN010000228.1_i000_018675	126	459	333	1.00909	0.593583
GCA_002220415.3-Pla_CM022214.1_i000_014939	131	442	311	0.942424	0.670259
GCA_013400155.1-Ani_VXBM01003795.1_i000_013422	1	267	266	0.806061	0.757835
GCA_018360135.1-Fun_SRPV01000173.1_i000_002229	1	282	281	0.851515	0.996454
GCA_000002545.2-Fun_CR380947.2_i000_000165	138	456	318	0.963636	0.625984
GCA_010111755.1-Fun_CP048118.1_i000_000167	138	456	318	0.963636	0.625984
GCA_020797185.1-Fun_CM036832.1_i000_000170	138	456	318	0.963636	0.625984
GCA_020797325.1-Fun_CM036842.1_i000_000170	138	456	318	0.963636	0.625984
GCA_010093745.1-Fun_MU005991.1_i000_005050	127	461	334	1.01212	0.609489
GCA_000150035.1-Fun_DS480396.1_i000_003582	131	448	317	0.960606	0.616732
GCA_002895965.2-Ani_PIJE02001409.1_i000_022269	160	423	263	0.79697	0.621749
GCA_015178995.1-Fun_WHVE01000318.1_i000_006351	132	457	325	0.984848	0.621415
GCA_000497085.1-Fun_BAUL01000098.1_i000_005612	134	454	320	0.969697	0.537815
GCA_001653215.1-Fun_LUKN01001547.1_i000_004330	131	467	336	1.01818	0.667992
GCA_000835455.1-Fun_KN846970.1_i000_003306	134	452	318	0.963636	0.490741
GCA_001642475.1-Fun_LVKK01000040.1_i000_007332	134	452	318	0.963636	0.490741
GCA_001646965.1-Fun_LVCJ01000023.1_i000_004530	134	452	318	0.963636	0.490741
GCA_020310725.1-Fun_LGJB01000029.1_i000_011060	134	452	318	0.963636	0.490741
GCA_000835435.1-Fun_KN846960.1_i000_008119	134	452	318	0.963636	0.476762
GCA_020744515.1-Fun_JAGPXF010000001.1_i000_002075	126	454	328	0.993939	0.55312
GCA_013396205.1-Fun_JAAOAN010000219.1_i000_006632	133	455	322	0.975758	0.543002
GCA_013266185.1-Fun_JABEXW010000135.1_i000_002736	142	464	322	0.975758	0.626459
GCA_000516985.1-Fun_KI912118.1_i000_012259	135	456	321	0.972727	0.634387
GCA_019434415.1-Fun_JAGRQK010000004.1_i000_006546	122	455	333	1.00909	0.550413
GCA_000836115.1-Fun_KN847498.1_i000_009765	133	451	318	0.963636	0.503165
GCA_019096205.1-Ani_CM032498.1_i000_002521	119	445	326	0.987879	0.623327
GCA_905067625.1-Fun_LR898474.1_i000_004698	131	459	328	0.993939	0.522293
GCA_001263375.1-Fun_LAVV01003265.1_i000_002460	152	477	325	0.984848	0.543478
GCA_902728155.2-Pla_CACVBM020001240.1_i000_028376	122	443	321	0.972727	0.602251
GCA_000418435.1-Fun_KE374994.1_i000_001479	131	459	328	0.993939	0.522293
GCA_900519115.1-Fun_LR026990.1_i000_004995	131	459	328	0.993939	0.522293
GCA_003357145.1-Fun_NPIC01000001.1_i000_001228	134	433	299	0.906061	0.418182
GCA_002120305.1-Fun_KZ112482.1_i000_005199	128	461	333	1.00909	0.53451
GCA_904845305.1-Ani_CAJGYM010000005.1_i000_002776	125	500	375	1.13636	0.581395
GCA_910591825.1-Fun_CAJVPQ010002229.1_i000_007969	108	437	329	0.99697	0.497731
GCA_013115115.1-Pro_JABAHT010000144.1_i000_001617	122	463	341	1.03333	0.649524
GCA_003611215.1-Fun_MCBR01018006.1_i000_004773	128	459	331	1.00303	0.519623
GCA_016861735.1-Fun_AP024417.1_i000_002127	135	453	318	0.963636	0.545455
GCA_003033665.1-Fun_PVEM01000004.1_i000_009568	534	854	320	0.969697	0.356745
GCA_016952355.1-Fun_CP064748.1_i000_004841	534	854	320	0.969697	0.356745
GCA_013402915.1-Fun_CP058608.1_i000_003366	138	461	323	0.978788	0.624758
GCA_002120335.1-Fun_KZ111242.1_i000_004174	128	462	334	1.01212	0.536116
GCA_000827325.1-Fun_KN832873.1_i000_005271	133	451	318	0.963636	0.468336
GCA_009014675.2-Fun_BKZM02000006.1_i000_005050	135	474	339	1.02727	0.587522
GCA_009932835.1-Fun_BLJY01000011.1_i000_008320	135	474	339	1.02727	0.587522
GCA_001865345.1-Pro_LRBP01000039.1_i000_001817	117	447	330	1	0.708155
GCA_017607565.1-Ani_JAANIB010009931.1_i000_008050	115	445	330	1	0.513219
GCA_000825705.1-Fun_CDHN01000007.1_i000_010314	138	457	319	0.966667	0.624266
GCA_000003125.1-Fun_EQ962654.1_i000_002683	135	448	313	0.948485	0.53322
GCA_000829775.1-Fun_DF933830.1_i000_004871	142	459	317	0.960606	0.552265
GCA_001483515.1-Pro_JTAI01000028.1_i000_002734	117	446	329	0.99697	0.707527
GCA_001593465.1-Pro_JIBM01000109.1_i000_003066	117	446	329	0.99697	0.707527
GCA_001593475.1-Pro_JIBN01000026.1_i000_000500	117	446	329	0.99697	0.707527
GCA_002223825.1-Pro_LN877949.1_i000_001041	117	446	329	0.99697	0.707527
GCA_002271885.2-Pla_CM008454.1_i000_028334	115	391	276	0.836364	0.695214
GCA_007210665.1-Pro_PYHZ01000003.1_i000_001127	117	446	329	0.99697	0.706009
GCA_015245375.1-Pro_CP044420.1_i000_001066	117	446	329	0.99697	0.706009
GCA_000760515.2-Fun_JMKJ01000555.1_i000_002572	126	462	336	1.01818	0.496307
GCA_000208925.2-Pro_DS571281.1_i000_002940	110	447	337	1.02121	0.743929
GCA_000338855.1-Pro_KB445484.1_i000_007257	110	447	337	1.02121	0.743929
GCA_000344925.1-Pro_KB610852.1_i000_003512	110	447	337	1.02121	0.743929
GCA_000346345.1-Pro_KB637333.1_i000_001223	110	447	337	1.02121	0.743929
GCA_000365475.1-Pro_KB823713.1_i000_002525	110	447	337	1.02121	0.743929
GCA_001662325.1-Pro_BDEQ01000001.1_i000_005364	110	447	337	1.02121	0.743929
GCA_020744425.1-Fun_JAGMUV010000009.1_i000_020918	130	453	323	0.978788	0.550256
GCA_001747045.1-Fun_LPNM01000007.1_i000_003274	131	447	316	0.957576	0.604207
GCA_018360205.1-Fun_SRPT01000465.1_i000_005116	137	448	311	0.942424	0.69265
GCA_000165345.1-Pro_CM000431.1_i000_001028	118	447	329	0.99697	0.704497
GCA_001245095.1-Fun_CDQK01000002.1_i000_001798	131	448	317	0.960606	0.619141
GCA_001661405.1-Fun_KV453935.1_i000_004282	131	448	317	0.960606	0.619141
GCA_905116875.3-Ani_CAJHNJ030000025.1_i000_007504	119	444	325	0.984848	0.621415
GCA_000513255.1-Fun_HG792015.1_i000_002166	133	453	320	0.969697	0.555556
GCA_015533775.1-Fun_JABCSE010000003.1_i000_001827	133	453	320	0.969697	0.555556
GCA_002382835.1-Fun_NPFJ01000003.1_i000_005331	142	464	322	0.975758	0.560976
GCA_002382855.1-Fun_NPFK01000005.1_i000_008078	142	464	322	0.975758	0.560976
GCA_011392495.1-Fun_QMIJ01000002.1_i000_004791	142	464	322	0.975758	0.560976
GCA_000313525.1-Fun_HE796948.1_i000_002259	123	456	333	1.00909	0.624765
GCA_000835505.1-Fun_KN847321.1_i000_009026	133	451	318	0.963636	0.499215
GCA_019434395.1-Fun_JAGRQL010000056.1_i000_009093	101	438	337	1.02121	0.578045
GCA_000835515.1-Fun_KN847343.1_i000_010184	133	451	318	0.963636	0.501577
GCA_002234975.2-Fun_NIDN02000221.1_i000_003866	135	448	313	0.948485	0.529611
GCA_002251995.2-Fun_NDIQ01000022.1_i000_002829	130	448	318	0.963636	0.629703
GCA_001445595.3-Fun_DF977537.1_i000_011586	128	463	335	1.01515	0.651751
GCA_902728155.2-Pla_CACVBM020001240.1_i000_028375	123	443	320	0.969697	0.574506
GCA_000151505.1-Fun_ACYE01000336.1_i000_002305	191	514	323	0.978788	0.487179
GCA_905183005.1-Pro_CAJJDO010000001.1_i000_000408	117	445	328	0.993939	0.700855
GCA_003019875.1-Fun_KZ679007.1_i000_001826	131	451	320	0.969697	0.550775
GCA_021605075.1-Ani_BPLQ01010561.1_i000_036441	118	445	327	0.990909	0.695745
GCA_002287525.1-Ani_LIAE01009803.1_i000_018372	163	498	335	1.01515	0.602518
GCA_006912115.1-Fun_VCMJ01000117.1_i000_000400	125	455	330	1	0.518053
GCA_000151525.2-Fun_ADAS02000057.1_i000_006824	126	451	325	0.984848	0.572183
GCA_001445615.2-Fun_BCLY01000004.1_i000_001467	135	455	320	0.969697	0.541455
GCA_905183005.1-Pro_CAJJDO010000006.1_i000_003302	117	446	329	0.99697	0.702991
GCA_003184545.1-Fun_MSFL01000001.1_i000_000105	135	456	321	0.972727	0.544992
GCA_905319865.3-Ani_CAJNRD030001118.1_i000_004049	17	331	314	0.951515	0.725173
GCA_020800285.1-Fun_JAGTJO010000008.1_i000_010214	135	464	329	0.99697	0.625475
GCA_019207615.1-Fun_JAHLVC010000002.1_i000_002358	130	446	316	0.957576	0.633267
GCA_900162805.1-Fun_FUGC01000001.1_i000_004905	130	450	320	0.969697	0.607211
GCA_002893035.1-Fun_PHNW01000098.1_i000_010244	137	468	331	1.00303	0.64775
GCA_000530735.1-Fun_CBTC010000075.1_i000_006312	130	449	319	0.966667	0.608779
GCA_015039405.1-Fun_WJDU01000007.1_i000_014622	125	437	312	0.945455	0.577778
GCA_003144115.1-Fun_KZ819305.1_i000_006120	137	459	322	0.975758	0.543919
GCA_010723835.1-Fun_BLKC01000029.1_i000_004872	135	457	322	0.975758	0.544839
GCA_010724135.1-Fun_BLKE01000140.1_i000_006799	135	457	322	0.975758	0.544839
GCA_010724255.1-Fun_BLKF01000035.1_i000_004740	135	457	322	0.975758	0.544839
GCA_010724335.1-Fun_BLKG01000070.1_i000_006247	135	457	322	0.975758	0.544839
GCA_010724795.1-Fun_BLKK01000081.1_i000_004265	135	457	322	0.975758	0.544839
GCA_000187405.1-Fun_GL698491.1_i000_003597	122	455	333	1.00909	0.550413
GCA_000426985.1-Fun_KE385535.1_i000_008173	137	467	330	1	0.649606
GCA_022376535.1-Fun_JAJJKD010000183.1_i000_003808	128	459	331	1.00303	0.524564
GCA_018360215.1-Fun_SRPX01000059.1_i000_006291	137	434	297	0.9	0.684332
GCA_013398855.1-Ani_VZTA01001344.1_i000_000790	54	357	303	0.918182	0.848739
GCA_012656225.1-Fun_JAAAPY010000099.1_i000_010571	135	455	320	0.969697	0.541455
GCA_012656285.1-Fun_JAAAPX010000095.1_i000_010187	135	455	320	0.969697	0.541455
GCA_012656295.1-Fun_JAAAPW010000092.1_i000_009951	135	455	320	0.969697	0.541455
GCA_012656325.1-Fun_JAAAPV010000098.1_i000_010441	135	455	320	0.969697	0.541455
GCA_000347455.1-Pla_KD283606.1_i000_023314	107	419	312	0.945455	0.707483
GCA_019616345.1-Fun_WSTH01003284.1_i000_013979	119	442	323	0.978788	0.351852
GCA_013396635.1-Ani_WBMW01001895.1_i000_004084	1	267	266	0.806061	0.766571
GCA_013390065.1-Ani_WEIW01006478.1_i000_013158	1	238	237	0.718182	0.995798
GCA_011058875.1-Fun_SWKT01000015.1_i000_003299	128	453	325	0.984848	0.64741
GCA_014621435.1-Fun_JAANBA010000220.1_i000_005567	128	453	325	0.984848	0.64741
GCA_000338955.1-Fun_KB445550.1_i000_000388	133	451	318	0.963636	0.669474
GCA_013399155.1-Ani_VWYG01000256.1_i000_000166	53	317	264	0.8	0.832808
GCA_001983305.1-Fun_MPUK01000015.1_i000_005204	130	450	320	0.969697	0.622568
GCA_003205855.1-Fun_LK052914.1_i000_000573	130	450	320	0.969697	0.622568
GCA_013054445.1-Fun_JAAMPI010000326.1_i000_008746	134	426	292	0.884848	0.434524
GCA_001194135.1-Ani_KQ415811.1_i000_000692	115	451	336	1.01818	0.669323
GCA_001896365.1-Fun_MIKG01000001.1_i000_000867	144	464	320	0.969697	0.559441
GCA_010724455.1-Fun_BLKH01000019.1_i000_004007	135	457	322	0.975758	0.544839
GCA_010724575.1-Fun_BLKI01000047.1_i000_007248	135	457	322	0.975758	0.544839
GCA_010724635.1-Fun_BLKJ01000037.1_i000_006625	135	457	322	0.975758	0.544839
GCA_010724915.1-Fun_BLKL01000036.1_i000_005609	135	457	322	0.975758	0.544839
GCA_014621405.1-Fun_JAANBC010000032.1_i000_004619	134	465	331	1.00303	0.539088
GCA_004367935.1-Fun_QAPF01000064.1_i000_004159	162	474	312	0.945455	0.605825
GCA_018360185.1-Fun_SRPU01000150.1_i000_000934	137	431	294	0.890909	0.682135
GCA_900660405.1-Pro_CAACVS010000006.1_i000_000381	135	472	337	1.02121	0.658203
GCA_001661245.1-Fun_KV454011.1_i000_001032	129	451	322	0.975758	0.622824
GCA_001078395.2-Fun_BBXM02000002.1_i000_003055	135	458	323	0.978788	0.547458
GCA_013401215.1-Ani_VZUJ01084531.1_i000_007428	1	265	264	0.8	0.743662
GCA_011074865.2-Fun_CP064812.1_i000_000870	132	448	316	0.957576	0.577697
GCA_010723975.1-Fun_BLKD01000019.1_i000_004057	135	457	322	0.975758	0.544839
GCA_012656335.1-Fun_JAAAPU010000108.1_i000_000283	135	457	322	0.975758	0.544839
GCA_012656375.1-Fun_JAAAPT010000148.1_i000_001819	135	457	322	0.975758	0.544839
GCA_012656395.1-Fun_JAAAPS010000159.1_i000_002175	135	457	322	0.975758	0.544839
GCA_012656435.1-Fun_JAAAPP010000166.1_i000_002536	135	457	322	0.975758	0.544839
GCA_012656445.1-Fun_JAAAPR010000161.1_i000_002374	135	457	322	0.975758	0.544839
GCA_012656455.1-Fun_JAAAPQ010000172.1_i000_002604	135	457	322	0.975758	0.544839
GCA_019044685.2-Pla_JAGTXX020000015.1_i000_008438	133	449	316	0.957576	0.638384
GCA_019202925.1-Pla_JAHPZM010000006.1_i000_002493	133	449	316	0.957576	0.638384
GCA_002749805.1-Fun_NEXV01000672.1_i000_005843	133	454	321	0.972727	0.555363
GCA_009193545.1-Fun_ML737161.1_i000_008952	133	454	321	0.972727	0.556326
GCA_018360275.1-Fun_SRQB01000254.1_i000_002856	131	428	297	0.9	0.693925
GCA_001048715.1-Fun_CDHK01000002.1_i000_002409	130	450	320	0.969697	0.561404
GCA_001908125.1-Fun_MNBE01000708.1_i000_011353	133	454	321	0.972727	0.563158
GCA_001636745.1-Fun_AZHC01000008.1_i000_008140	147	466	319	0.966667	0.629191
GCA_007866325.1-Fun_SBHS01000002.1_i000_002961	147	466	319	0.966667	0.629191
GCA_014898415.1-Fun_RCTD01000016.1_i000_006901	136	456	320	0.969697	0.564374
GCA_000956085.1-Fun_JZEE01000308.1_i000_002228	133	454	321	0.972727	0.555363
GCA_009176385.1-Fun_ML734946.1_i000_003016	133	454	321	0.972727	0.555363
GCA_009176405.1-Fun_ML733434.1_i000_006863	133	454	321	0.972727	0.555363
GCA_009193505.1-Fun_ML738297.1_i000_001900	133	454	321	0.972727	0.555363
GCA_009193525.1-Fun_ML741770.1_i000_002781	133	454	321	0.972727	0.555363
GCA_000006405.1-Pro_GG682243.1_i000_011656	124	468	344	1.04242	0.425743
GCA_003610855.1-Fun_MCFK01002518.1_i000_001473	124	439	315	0.954545	0.62253
GCA_001664025.1-Fun_LXPE01000086.1_i000_004566	131	454	323	0.978788	0.648594
GCA_004155925.1-Fun_QJNX01000006.1_i000_009987	123	460	337	1.02121	0.530709
GCA_004155915.1-Fun_QJOA01000203.1_i000_003444	126	460	334	1.01212	0.543974
GCA_016584195.1-Fun_PUHU01000099.1_i000_005317	131	449	318	0.963636	0.595506
GCA_021365295.1-Fun_JAJTIW010000011.1_i000_001665	133	441	308	0.933333	0.471669
GCA_013115125.1-Pro_JABANN010000490.1_i000_006688	114	451	337	1.02121	0.678068
GCA_000002985.3-Ani_BX284605.5_i000_014692	125	464	339	1.02727	0.697531
GCA_006381635.2-Pla_VEPZ02001051.1_i000_038914	125	401	276	0.836364	0.678133
GCA_012980515.1-Fun_JAACLJ010000006.1_i000_005793	121	450	329	0.99697	0.491045
GCA_008520325.1-Fun_VDEP01000035.1_i000_002975	126	449	323	0.978788	0.562718
GCA_016584265.1-Fun_PUHW01000089.1_i000_005113	131	450	319	0.966667	0.597378
GCA_003589665.1-Fun_MVGC01000068.1_i000_002859	136	456	320	0.969697	0.541455
GCA_019669825.1-Fun_MU253831.1_i000_003569	132	456	324	0.981818	0.477172
GCA_020740775.1-Fun_JAHEWK010000010.1_i000_002956	130	462	332	1.00606	0.652259
GCA_008520325.1-Fun_VDEP01000173.1_i000_012855	126	449	323	0.978788	0.5637
GCA_008522505.1-Fun_VSWC01000066.1_i000_014831	126	449	323	0.978788	0.5637
GCA_018404265.1-Fun_BOPL01000003.1_i000_003864	135	457	322	0.975758	0.545763
GCA_003012285.1-Fun_PXOG01000256.1_i000_009602	132	457	325	0.984848	0.545302
GCA_000469055.2-Fun_AVOT02000057.1_i000_000496	135	463	328	0.993939	0.565517
GCA_000743755.1-Pro_JPUL02000309.1_i000_004599	11	350	339	1.02727	0.957627
GCA_008124465.1-Pla_VOII01113469.1_i000_027077	81	396	315	0.954545	0.567568
GCA_001664035.1-Fun_LXTC01000003.1_i000_003350	138	464	326	0.987879	0.657258
GCA_000583005.2-Pla_ASHM01017750.1_i000_022203	117	440	323	0.978788	0.589416
GCA_015951145.1-Fun_MU167246.1_i000_005047	131	461	330	1	0.577933
GCA_020744275.1-Fun_JAGTJR010000008.1_i000_013577	123	457	334	1.01212	0.594306
GCA_000302655.1-Fun_AHHD01000462.1_i000_010651	123	457	334	1.01212	0.59325
GCA_001305275.1-Fun_LHCL01000002.1_i000_003404	142	458	316	0.957576	0.549565
GCA_003324165.2-Pro_PYSW02000005.1_i000_002126	119	460	341	1.03333	0.576988
GCA_019968535.1-Ani_JAIFTH010000474.1_i000_002713	126	419	293	0.887879	0.699284
GCA_003672135.1-Ani_CM010856.1_i000_000660	130	461	331	1.00303	0.68107
GCA_013677255.1-Pla_CM025225.1_i000_011194	126	394	268	0.812121	0.680203
GCA_001661345.1-Fun_KV454477.1_i000_002248	131	448	317	0.960606	0.566071
GCA_001515345.1-Fun_BCMY01000002.1_i000_001845	135	453	318	0.963636	0.549223
GCA_001890745.1-Fun_KV878198.1_i000_006502	135	453	318	0.963636	0.549223
GCA_003184835.1-Fun_KZ824575.1_i000_010385	135	453	318	0.963636	0.549223
GCA_013340325.1-Fun_BLWE01000006.1_i000_004514	135	453	318	0.963636	0.549223
GCA_006542485.1-Fun_VIFY01000038.1_i000_005296	134	447	313	0.948485	0.538726
GCA_001566295.1-Fun_KQ964245.1_i000_000161	129	461	332	1.00606	0.557047
GCA_003184625.1-Fun_KZ821466.1_i000_007258	135	453	318	0.963636	0.549223
GCA_000304475.1-Fun_HE650824.1_i000_002357	130	448	318	0.963636	0.634731
GCA_003184925.1-Fun_KZ821614.1_i000_000507	135	453	318	0.963636	0.549223
GCA_905182995.1-Pro_CAJJDP010000006.1_i000_002430	117	445	328	0.993939	0.700855
GCA_003184755.1-Fun_KZ825057.1_i000_003405	135	453	318	0.963636	0.549223
GCA_001594055.1-Ani_KQ982482.1_i000_005181	177	512	335	1.01515	0.621521
GCA_000257125.1-Pro_JH929511.1_i000_005390	111	447	336	1.01818	0.741722
GCA_002287525.1-Ani_LIAE01010577.1_i000_025368	126	461	335	1.01515	0.646718
GCA_000836435.1-Fun_KN848068.1_i000_004593	134	458	324	0.981818	0.495413
GCA_001646985.1-Fun_LVCI01000056.1_i000_006946	134	458	324	0.981818	0.495413
GCA_002317995.1-Fun_MVNX01000092.1_i000_008153	131	444	313	0.948485	0.492138
GCA_001191645.1-Fun_AJIL01000063.1_i000_008551	126	451	325	0.984848	0.568182
GCA_021901695.1-Fun_CM038869.1_i000_001542	126	451	325	0.984848	0.568182
GCA_012411365.1-Ani_CM022765.1_i000_013721	134	454	320	0.969697	0.568384
GCA_020726445.1-Fun_JAGJXA010000008.1_i000_009571	133	469	336	1.01818	0.660118
GCA_004217705.1-Fun_CP034457.1_i000_001965	130	449	319	0.966667	0.630435
GCA_014905795.1-Fun_JACBPP010000004.1_i000_003748	130	449	319	0.966667	0.630435
GCA_902810595.1-Ani_LR778262.1_i000_011586	124	439	315	0.954545	0.59322
GCA_905332055.1-Fun_CAJOAW010000116.1_i000_011126	1163	1486	323	0.978788	0.211526
GCA_003184635.1-Fun_KZ826398.1_i000_010509	135	444	309	0.936364	0.530928
GCA_021432635.1-Fun_MU270017.1_i000_001674	132	464	332	1.00606	0.645914
GCA_013201755.1-Fun_QPMR01000004.1_i000_001586	149	452	303	0.918182	0.591797
GCA_013201765.1-Fun_QPMQ01000075.1_i000_005795	149	452	303	0.918182	0.591797
GCA_013201785.1-Fun_QPMP01000017.1_i000_006174	149	452	303	0.918182	0.591797
GCA_013201865.1-Fun_QPMU01000092.1_i000_014767	149	452	303	0.918182	0.591797
GCA_013390195.1-Fun_QPNA01000006.1_i000_009292	149	452	303	0.918182	0.591797
GCA_000304475.1-Fun_HE650822.1_i000_001204	130	452	322	0.975758	0.645291
GCA_005350895.1-Fun_PJEX01000392.1_i000_009814	145	462	317	0.960606	0.620352
GCA_001189435.1-Fun_LFRF01000002.1_i000_001238	132	454	322	0.975758	0.52443
GCA_918797485.1-Pro_CAKKNE010000002.1_i000_005754	118	455	337	1.02121	0.676707
GCA_001636715.1-Fun_AZGZ01000014.1_i000_001334	135	467	332	1.00606	0.57539
GCA_008330625.1-Pro_VLTM01000065.1_i000_005308	123	448	325	0.984848	0.643564
GCA_008330635.1-Pro_VLTL01000009.1_i000_001068	123	448	325	0.984848	0.643564
GCA_008330645.1-Pro_VLTN01000060.1_i000_007018	123	448	325	0.984848	0.643564
GCA_008330665.1-Pro_VLTO01000036.1_i000_005293	123	448	325	0.984848	0.643564
GCA_000313795.2-Fun_CACQ02005684.1_i000_011117	147	460	313	0.948485	0.613725
GCA_001672515.1-Fun_CM004461.1_i000_012004	147	460	313	0.948485	0.613725
GCA_004920355.1-Fun_MWPZ01000007.1_i000_011565	147	460	313	0.948485	0.613725
GCA_008694065.1-Fun_VYXO01000001.1_i000_000859	128	462	334	1.01212	0.532695
GCA_011114355.1-Pla_CM022100.1_i000_018288	131	444	313	0.948485	0.564982
GCA_021901655.1-Fun_CM038887.1_i000_001550	126	451	325	0.984848	0.568182
GCA_905359465.1-Fun_CAJPIH010000691.1_i000_005558	1227	1550	323	0.978788	0.203017
GCA_905359485.1-Fun_CAJPIJ010000134.1_i000_006077	1227	1550	323	0.978788	0.203017
GCA_013396025.1-Fun_JAAOAQ010000039.1_i000_001205	133	456	323	0.978788	0.544688
GCA_003184535.1-Fun_MSFU01000024.1_i000_005136	136	454	318	0.963636	0.549223
GCA_905332025.1-Fun_CAJOAV010000106.1_i000_004321	1234	1557	323	0.978788	0.202128
GCA_000414095.2-Pla_KE344566.1_i000_010831	117	475	358	1.08485	0.696498
GCA_000006515.1-Pro_DS989729.1_i000_002397	127	464	337	1.02121	0.689162
GCA_018360045.1-Fun_SRPN01000283.1_i000_003478	137	431	294	0.890909	0.682135
GCA_002072405.1-Fun_MDDG01000008.1_i000_006541	133	453	320	0.969697	0.555556
GCA_014872705.1-Fun_CM026498.1_i000_007871	124	447	323	0.978788	0.590494
GCA_000300555.1-Fun_JH971390.1_i000_005337	125	448	323	0.978788	0.587273
GCA_001661475.1-Fun_KV453844.1_i000_004542	126	447	321	0.972727	0.607955
GCA_001890685.1-Fun_KV878238.1_i000_003305	135	454	319	0.966667	0.55095
GCA_002220415.3-Pla_CM022216.1_i000_027036	122	443	321	0.972727	0.690323
GCA_002072255.1-Fun_MDYP01000012.1_i000_004134	134	455	321	0.972727	0.559233
GCA_001185155.1-Pla_LFYR01000182.1_i000_001757	176	491	315	0.954545	0.537543
GCA_020726485.1-Fun_JAHEWH010000013.1_i000_002850	133	452	319	0.966667	0.399749
GCA_001572075.1-Fun_JOOL01000318.1_i000_002198	134	454	320	0.969697	0.545145
GCA_001592465.1-Fun_JPDO01000608.1_i000_008920	134	454	320	0.969697	0.545145
GCA_013115145.1-Pro_JAAPAO010000361.1_i000_006244	125	464	339	1.02727	0.667323
GCA_001747045.1-Fun_LPNM01000008.1_i000_004126	124	455	331	1.00303	0.646484
GCA_009193485.1-Fun_ML738674.1_i000_009233	133	454	321	0.972727	0.555363
GCA_009193585.1-Fun_ML737594.1_i000_003263	133	454	321	0.972727	0.555363
GCA_009193665.1-Fun_ML735723.1_i000_005209	133	454	321	0.972727	0.555363
GCA_019096155.1-Fun_JAHCVI010000001.1_i000_004047	133	460	327	0.990909	0.636187
GCA_000710275.1-Fun_CM002801.1_i000_011086	132	456	324	0.981818	0.56446
GCA_905182995.1-Pro_CAJJDP010000005.1_i000_001931	117	446	329	0.99697	0.702991
GCA_009193445.1-Fun_ML743571.1_i000_005731	133	455	322	0.975758	0.559028
GCA_000165365.1-Pro_AAGK01000002.1_i000_001753	118	423	305	0.924242	0.717647
GCA_016584185.1-Fun_PUHS01000111.1_i000_000500	131	453	322	0.975758	0.618042
GCA_000239835.2-Fun_DF126451.1_i000_002717	135	455	320	0.969697	0.552677
GCA_001602395.1-Fun_BCWF01000017.1_i000_001764	135	455	320	0.969697	0.552677
GCA_016861625.1-Fun_AP024425.1_i000_000792	135	455	320	0.969697	0.552677
GCA_016865315.1-Fun_AP024434.1_i000_000754	135	455	320	0.969697	0.552677
GCA_015342795.1-Ani_CM027194.1_i000_017986	119	446	327	0.990909	0.688421
GCA_001594115.1-Ani_KQ981424.1_i000_003691	122	458	336	1.01818	0.691358
GCA_001890705.1-Fun_KV878584.1_i000_004030	136	452	316	0.957576	0.542955
GCA_014235935.1-Fun_WIGM01000187.1_i000_005969	143	464	321	0.972727	0.630648
GCA_905182975.1-Pro_CAJJDM010000008.1_i000_003368	117	445	328	0.993939	0.700855
GCA_001700775.1-Fun_LGRB01000014.1_i000_008193	135	485	350	1.06061	0.524738
GCA_002072365.1-Fun_MLQL01000029.1_i000_007547	132	456	324	0.981818	0.56446
GCA_905183005.1-Pro_CAJJDO010000015.1_i000_007369	117	445	328	0.993939	0.700855
GCA_000319635.2-Fun_ANPB02000008.1_i000_013969	151	460	309	0.936364	0.602339
GCA_009771025.1-Fun_SSNE01000071.1_i000_016053	151	460	309	0.936364	0.602339
GCA_012932255.1-Fun_QLYQ01000598.1_i000_001569	151	460	309	0.936364	0.602339
GCA_013201745.1-Fun_QPMT01000008.1_i000_003695	151	460	309	0.936364	0.602339
GCA_013201795.1-Fun_QPMS01000009.1_i000_003949	151	460	309	0.936364	0.602339
GCA_013201875.1-Fun_QPMV01000186.1_i000_014616	151	460	309	0.936364	0.602339
GCA_013201905.1-Fun_QPMW01000160.1_i000_014886	151	460	309	0.936364	0.602339
GCA_013201925.1-Fun_QPMY01000079.1_i000_011070	151	460	309	0.936364	0.602339
GCA_013390205.1-Fun_QPMX01000006.1_i000_009544	151	460	309	0.936364	0.602339
GCA_022432525.1-Fun_JAJKLB010000002.1_i000_004453	128	462	334	1.01212	0.532695
GCA_016508695.1-Fun_VNKQ01000002.1_i000_000612	136	453	317	0.960606	0.361872
GCA_019632275.1-Fun_WSTT01000155.1_i000_002267	126	452	326	0.987879	0.549747
GCA_019632285.1-Fun_WSTV01000113.1_i000_000640	126	452	326	0.987879	0.549747
GCA_004009835.2-Fun_RIBY02001545.1_i000_004452	136	455	319	0.966667	0.527273
GCA_001651985.1-Fun_LVYI01000005.1_i000_008893	134	455	321	0.972727	0.490826
GCA_011392555.1-Fun_QMFL01000026.1_i000_000226	133	450	317	0.960606	0.55614
GCA_013399815.1-Ani_VZZX01005405.1_i000_006247	56	380	324	0.981818	0.677824
GCA_904066235.2-Ani_CAJFCV020000005.1_i000_011705	125	458	333	1.00909	0.672727
GCA_904067135.1-Ani_CAJFDI010000005.1_i000_011705	125	458	333	1.00909	0.672727
GCA_015844325.1-Fun_VCAU01000009.1_i000_012417	132	448	316	0.957576	0.545769
GCA_014066305.1-Fun_JACCJC010000006.1_i000_002546	136	456	320	0.969697	0.42328
GCA_000004555.3-Ani_FR847121.2_i000_015363	126	463	337	1.02121	0.693416
GCA_903987035.1-Fun_CAJDZR010000002.1_i000_001107	131	447	316	0.957576	0.624506
GCA_004786265.1-Fun_PQXO01000114.1_i000_003249	134	454	320	0.969697	0.559441
GCA_017639395.1-Pla_CM029884.1_i000_027526	128	447	319	0.966667	0.591837
GCA_010093815.1-Fun_ML996565.1_i000_000122	117	458	341	1.03333	0.577966
GCA_002572855.1-Fun_PDND01000163.1_i000_002297	135	445	310	0.939394	0.47619
GCA_022496225.1-Fun_WTXE01000115.1_i000_001444	135	465	330	1	0.585106
GCA_014281935.1-Fun_JACBAF010001866.1_i000_006568	135	450	315	0.954545	0.532995
GCA_903064755.1-Fun_CAEFZW010000002.1_i000_001097	129	448	319	0.966667	0.630435
GCA_903987035.1-Fun_CAJDZR010000002.1_i000_001711	129	448	319	0.966667	0.630435
GCA_000769745.1-Fun_JQFZ01000341.1_i000_010227	129	455	326	0.987879	0.565972
GCA_000769755.1-Fun_JQFX01000787.1_i000_007310	129	455	326	0.987879	0.565972
GCA_001204775.2-Fun_JNOM01000146.1_i000_006044	135	455	320	0.969697	0.553633
GCA_009176395.1-Fun_ML734298.1_i000_007184	135	455	320	0.969697	0.553633
GCA_009193645.1-Fun_ML736765.1_i000_005400	135	455	320	0.969697	0.553633
GCA_004379285.1-Fun_PHWZ01000353.1_i000_009024	140	460	320	0.969697	0.557491
GCA_000226545.1-Fun_CU633459.1_i000_007031	140	469	329	0.99697	0.642578
GCA_900290415.1-Fun_LR026968.1_i000_006929	140	469	329	0.99697	0.642578
GCA_000769735.1-Fun_JQFY01000141.1_i000_009228	129	455	326	0.987879	0.566957
GCA_002916505.1-Fun_PKSG01001006.1_i000_005151	133	483	350	1.06061	0.570962
GCA_001594045.1-Ani_KQ976490.1_i000_006122	149	487	338	1.02424	0.657588
GCA_011058885.1-Fun_SWKS01000016.1_i000_002750	132	443	311	0.942424	0.541812
GCA_014235945.1-Fun_WIGO01000163.1_i000_009941	143	466	323	0.978788	0.634578
GCA_001008285.1-Fun_LCZI01001214.1_i000_007001	135	451	316	0.957576	0.485407
GCA_905182995.1-Pro_CAJJDP010000010.1_i000_004383	117	446	329	0.99697	0.702991
GCA_010093705.1-Fun_MU006090.1_i000_001382	126	452	326	0.987879	0.581105
GCA_022179045.1-Fun_BPPX01000026.1_i000_010281	143	435	292	0.884848	0.671264
GCA_014235955.1-Fun_WIGN01000086.1_i000_006299	146	465	319	0.966667	0.62549
GCA_003704645.1-Fun_QWIR01000357.1_i000_005250	134	451	317	0.960606	0.518822
GCA_003704615.1-Fun_QWIQ01000040.1_i000_008331	134	450	316	0.957576	0.51634
GCA_002760635.1-Fun_AYKW01000001.1_i000_000384	130	448	318	0.963636	0.561837
GCA_002901185.1-Fun_NRSZ01000686.1_i000_001114	171	526	355	1.07576	0.543645
GCA_002016555.1-Fun_LJBN01000122.1_i000_003986	130	449	319	0.966667	0.39726
GCA_003704385.1-Fun_QWIM01000306.1_i000_003925	114	431	317	0.960606	0.535473
GCA_014281905.1-Fun_JACBAD010001963.1_i000_002140	135	455	320	0.969697	0.541455
GCA_002072425.1-Fun_MOOB01000052.1_i000_008412	134	449	315	0.954545	0.54878
GCA_000235365.1-Fun_CP002497.1_i000_000453	131	448	317	0.960606	0.616732
GCA_013461495.1-Fun_JABFCT010000011.1_i000_007887	136	454	318	0.963636	0.557895
GCA_001594075.1-Ani_KQ978782.1_i000_002095	189	524	335	1.01515	0.605787
GCA_000978885.1-Fun_LBBL01000146.1_i000_003005	128	468	340	1.0303	0.681363
GCA_004786125.1-Fun_PQXH01000078.1_i000_006367	136	454	318	0.963636	0.556918
GCA_004786245.1-Fun_PQXK01000146.1_i000_007730	136	454	318	0.963636	0.556918
GCA_004916875.1-Fun_PQXL01000186.1_i000_006422	136	454	318	0.963636	0.556918
GCA_014898285.1-Fun_RCSV01000001.1_i000_000404	136	454	318	0.963636	0.556918
GCA_014898425.1-Fun_RCSZ01000003.1_i000_002726	136	454	318	0.963636	0.556918
GCA_009806415.1-Fun_WOWK01000093.1_i000_008614	159	468	309	0.936364	0.59309
GCA_000785585.1-Fun_JSEJ01000059.1_i000_008415	134	455	321	0.972727	0.491577
GCA_000835495.1-Fun_KN847046.1_i000_011842	134	455	321	0.972727	0.491577
GCA_002072375.1-Fun_MLKD01000014.1_i000_007345	127	448	321	0.972727	0.563158
GCA_000011425.1-Fun_BN001306.1_i000_006601	135	452	317	0.960606	0.540956
GCA_000149205.2-Fun_CH236922.1_i000_005857	135	452	317	0.960606	0.540956
GCA_000143535.4-Fun_CP009809.1_i000_004317	136	454	318	0.963636	0.559859
GCA_000227075.1-Fun_FQ790347.1_i000_012784	136	454	318	0.963636	0.559859
GCA_000349525.1-Fun_KB707880.1_i000_005478	136	454	318	0.963636	0.559859
GCA_004786145.1-Fun_PQXI01000039.1_i000_003752	136	455	319	0.966667	0.558669
GCA_903064755.1-Fun_CAEFZW010000002.1_i000_000815	129	450	321	0.972727	0.634387
GCA_017607525.1-Ani_JAANIA010001848.1_i000_002870	176	511	335	1.01515	0.621521
GCA_000006275.3-Fun_AAIH03000093.1_i000_004120	133	454	321	0.972727	0.555363
GCA_000952835.1-Fun_JZDT01000003.1_i000_006459	133	454	321	0.972727	0.555363
GCA_002443195.2-Fun_NWUI02000282.1_i000_000079	133	454	321	0.972727	0.555363
GCA_002443215.2-Fun_NWUG02001517.1_i000_001512	133	454	321	0.972727	0.555363
GCA_002456175.2-Fun_NWUH02000292.1_i000_007482	133	454	321	0.972727	0.555363
GCA_003709025.1-Fun_QQZZ01000032.1_i000_008204	133	454	321	0.972727	0.555363
GCA_009017415.1-Fun_CP044618.1_i000_007306	133	454	321	0.972727	0.555363
GCA_009176455.1-Fun_ML732764.1_i000_000333	133	454	321	0.972727	0.555363
GCA_014117465.1-Fun_CP059869.1_i000_006439	133	454	321	0.972727	0.555363
GCA_014117485.1-Fun_CP059861.1_i000_006480	133	454	321	0.972727	0.555363
GCA_014784225.2-Fun_CP061807.2_i000_007379	133	454	321	0.972727	0.555363
GCA_020536065.1-Fun_JAEUBE010000295.1_i000_003895	130	446	316	0.957576	0.628231
GCA_002894225.1-Fun_MTQA01000070.1_i000_013289	133	455	322	0.975758	0.543919
GCA_003184645.1-Fun_KZ825825.1_i000_002801	135	456	321	0.972727	0.548718
GCA_002127715.1-Fun_MUNK01000208.1_i000_004185	134	451	317	0.960606	0.518822
GCA_003704685.1-Fun_QWIT01000561.1_i000_012413	134	451	317	0.960606	0.518822
GCA_000798715.1-Fun_JNVN01001454.1_i000_003065	125	441	316	0.957576	0.625743
GCA_003704355.1-Fun_QWIL01000164.1_i000_002428	134	451	317	0.960606	0.517974
GCA_003704385.1-Fun_QWIM01001068.1_i000_009126	134	451	317	0.960606	0.517974
GCA_003704575.1-Fun_QWIN01000166.1_i000_004084	134	451	317	0.960606	0.517974
GCA_003704585.1-Fun_QWIP01000441.1_i000_009727	134	451	317	0.960606	0.517974
GCA_000769765.1-Fun_JQGA01000606.1_i000_006696	128	457	329	0.99697	0.571181
GCA_003704595.1-Fun_QWIO01000377.1_i000_004351	134	451	317	0.960606	0.517129
GCA_002127715.1-Fun_MUNK01000033.1_i000_005847	134	451	317	0.960606	0.516287
GCA_003704585.1-Fun_QWIP01000095.1_i000_015760	134	451	317	0.960606	0.516287
GCA_003704675.1-Fun_QWIS01000309.1_i000_005091	134	451	317	0.960606	0.516287
GCA_003704685.1-Fun_QWIT01000959.1_i000_016896	134	451	317	0.960606	0.516287
GCA_013138035.1-Fun_JAASRZ010000044.1_i000_011795	129	446	317	0.960606	0.56912
GCA_021365285.1-Fun_JAJTJA010000008.1_i000_012504	133	453	320	0.969697	0.547945
GCA_000315645.2-Fun_JH993646.1_i000_002368	133	456	323	0.978788	0.560764
GCA_000315665.1-Fun_JH993715.1_i000_002137	133	456	323	0.978788	0.560764
GCA_012295545.2-Fun_JAAQRF020000027.1_i000_008010	133	456	323	0.978788	0.560764
GCA_016767815.1-Fun_CP060778.1_i000_007872	133	456	323	0.978788	0.560764
GCA_014898295.1-Fun_RCSW01000010.1_i000_005739	136	454	318	0.963636	0.556918
GCA_000225605.1-Fun_JH126399.1_i000_000486	143	478	335	1.01515	0.616943
GCA_014898465.1-Fun_RCTA01000003.1_i000_002709	136	454	318	0.963636	0.555944
GCA_003184845.1-Fun_KZ824455.1_i000_008188	135	454	319	0.966667	0.54717
GCA_003072535.2-Pro_CP056071.1_i000_001313	117	422	305	0.924242	0.715962
GCA_020744475.1-Fun_JAGMUX010000015.1_i000_004770	133	456	323	0.978788	0.544688
GCA_002865655.1-Fun_KZ613953.1_i000_014257	135	449	314	0.951515	0.441011
GCA_001306435.1-Fun_LKCW01000448.1_i000_009074	138	465	327	0.990909	0.641176
GCA_001889945.1-Fun_KV878680.1_i000_002152	136	456	320	0.969697	0.550775
GCA_021399445.1-Fun_JAJTUQ010000001.1_i000_001016	135	456	321	0.972727	0.527961
GCA_000241205.2-Fun_BABT02000090.1_i000_003663	128	460	332	1.00606	0.557047
GCA_000708205.1-Fun_KL411546.1_i000_003516	128	460	332	1.00606	0.557047
GCA_001445595.3-Fun_DF977513.1_i000_010624	129	454	325	0.984848	0.517516
GCA_002844615.1-Fun_MVDW01000034.1_i000_005372	134	460	326	0.987879	0.575972
GCA_003704595.1-Fun_QWIO01000060.1_i000_001041	134	450	316	0.957576	0.513821
GCA_002865645.1-Fun_KZ613785.1_i000_005577	135	444	309	0.936364	0.387704
GCA_003704345.1-Fun_QWIJ01001152.1_i000_001212	134	446	312	0.945455	0.509804
GCA_003704375.1-Fun_QWIK01000942.1_i000_016273	134	446	312	0.945455	0.509804
GCA_003184525.1-Fun_MSFK01000022.1_i000_005224	135	444	309	0.936364	0.530017
GCA_002072235.1-Fun_MDYO01000015.1_i000_004989	132	448	316	0.957576	0.549565
GCA_004786205.1-Fun_PQXM01000044.1_i000_001667	136	454	318	0.963636	0.556918
GCA_014898435.1-Fun_RCTB01000004.1_i000_002700	136	454	318	0.963636	0.556918
GCA_014898485.1-Fun_RCTC01000004.1_i000_003059	136	454	318	0.963636	0.556918
GCA_014898535.1-Fun_RCSX01000002.1_i000_001287	136	454	318	0.963636	0.556918
GCA_014898555.1-Fun_RCSY01000001.1_i000_000308	136	454	318	0.963636	0.556918
GCA_000986645.1-Fun_JZBS01002119.1_i000_005129	135	451	316	0.957576	0.541096
GCA_000986665.1-Fun_JYKN01002330.1_i000_004910	135	451	316	0.957576	0.541096
GCA_002846915.2-Fun_MSFN02000003.1_i000_004504	135	451	316	0.957576	0.541096
GCA_004786065.1-Fun_ML220130.1_i000_006105	132	453	321	0.972727	0.606805
GCA_001278595.1-Fun_LHQQ01000093.1_i000_012710	130	449	319	0.966667	0.554783
GCA_000743665.3-Fun_JMRO03000063.1_i000_003355	125	447	322	0.975758	0.545763
GCA_020744375.1-Fun_JAGMUU010000002.1_i000_006524	132	452	320	0.969697	0.545145
GCA_001561935.1-Fun_LHQR01000069.1_i000_006632	132	456	324	0.981818	0.565445
GCA_001890125.1-Fun_KV878127.1_i000_004149	136	450	314	0.951515	0.539519
GCA_000346795.1-Fun_KB644412.1_i000_005095	130	485	355	1.07576	0.621716
GCA_000820885.1-Fun_CCBQ010000045.1_i000_004049	131	445	314	0.951515	0.613281
GCA_019633535.1-Fun_WSUE01000003.1_i000_007410	126	452	326	0.987879	0.550676
GCA_019633545.1-Fun_WSUF01000035.1_i000_008077	126	452	326	0.987879	0.550676
GCA_018856295.1-Fun_JAFLHD010017843.1_i000_009910	136	454	318	0.963636	0.562832
GCA_002072345.1-Fun_MDYN01000002.1_i000_000931	132	457	325	0.984848	0.565217
GCA_017607545.1-Ani_JAANIC010005341.1_i000_007022	176	512	336	1.01818	0.623377
GCA_002980475.2-Fun_PVQB02000090.1_i000_002558	132	454	322	0.975758	0.543919
GCA_905182995.1-Pro_CAJJDP010000014.1_i000_005608	117	445	328	0.993939	0.700855
GCA_000166155.1-Fun_GL538363.1_i000_000887	135	453	318	0.963636	0.501577
GCA_905182985.1-Pro_CAJJDN010000008.1_i000_004311	117	444	327	0.990909	0.698718
GCA_000446055.1-Fun_AMYD01002021.1_i000_009031	161	461	300	0.909091	0.573614
GCA_021307315.1-Fun_JAJSPD010000016.1_i000_004109	132	448	316	0.957576	0.480243
GCA_014621375.1-Fun_JAAOZQ010000007.1_i000_008653	134	455	321	0.972727	0.558261
GCA_001653205.1-Fun_LSBH01000010.1_i000_010611	130	464	334	1.01212	0.651072
GCA_001653265.1-Fun_LSBI01000002.1_i000_002068	130	464	334	1.01212	0.651072
GCA_000304475.1-Fun_HE650832.1_i000_005314	141	440	299	0.906061	0.598
GCA_015341985.1-Fun_JACYCC010000036.1_i000_001690	132	455	323	0.978788	0.232207
GCA_000513335.1-Fun_HG793140.1_i000_005274	131	453	322	0.975758	0.56
GCA_002120315.1-Fun_KZ111547.1_i000_004845	132	463	331	1.00303	0.533011
GCA_000820605.1-Fun_AWTV01000004.1_i000_000725	136	466	330	1	0.634615
GCA_002317995.1-Fun_MVNX01000153.1_i000_010730	133	421	288	0.872727	0.453543
GCA_007825325.1-Fun_QGMG01001408.1_i000_008554	122	446	324	0.981818	0.466187
GCA_013115125.1-Pro_JABANN010000148.1_i000_001557	122	463	341	1.03333	0.322306
GCA_000004985.1-Pro_GG738885.1_i000_009377	119	458	339	1.02727	0.585492
GCA_008080495.1-Fun_CP023326.1_i000_001610	148	476	328	0.993939	0.607407
GCA_001605985.2-Pla_KZ503304.1_i000_022299	133	390	257	0.778788	0.486742
GCA_003369625.1-Fun_PVWQ01000003.1_i000_006188	135	440	305	0.924242	0.524957
GCA_000001985.1-Fun_DS995899.1_i000_008140	144	460	316	0.957576	0.532884
GCA_000750115.1-Fun_JPOX01000010.1_i000_003373	144	460	316	0.957576	0.532884
GCA_009556855.1-Fun_CP045653.1_i000_000424	144	460	316	0.957576	0.532884
GCA_009650675.1-Fun_CM018873.1_i000_001897	144	460	316	0.957576	0.532884
GCA_013396255.1-Fun_JAAOAY010000076.1_i000_003003	133	455	322	0.975758	0.543002
GCA_000474925.1-Fun_KI440845.1_i000_003957	146	467	321	0.972727	0.613767
GCA_000961545.1-Fun_AXCR01000010.1_i000_008127	146	467	321	0.972727	0.613767
GCA_015342405.1-Fun_JACYCF010000002.1_i000_005346	135	458	323	0.978788	0.231707
GCA_021365275.1-Fun_JAJTIY010000002.1_i000_008385	127	461	334	1.01212	0.541329
GCA_900044065.1-Fun_FCQH01000016.1_i000_015571	133	455	322	0.975758	0.543002
GCA_011800055.1-Fun_WVTB01000082.1_i000_013605	176	476	300	0.909091	0.557621
GCA_001513925.1-Fun_LLXE01000019.1_i000_003189	134	449	315	0.954545	0.547826
GCA_002072265.1-Fun_MDYM01000018.1_i000_009479	134	449	315	0.954545	0.547826
GCA_001014755.1-Fun_LDEV01003351.1_i000_007922	135	455	320	0.969697	0.504732
GCA_000142805.1-Fun_CU928180.1_i000_005048	129	449	320	0.969697	0.626223
GCA_003184745.1-Fun_KZ821693.1_i000_004567	135	448	313	0.948485	0.532313
GCA_001636675.1-Fun_AZGY01000005.1_i000_006481	120	452	332	1.00606	0.545156
GCA_000389695.3-Fun_APWK03000132.1_i000_001316	128	464	336	1.01818	0.677419
GCA_001661325.1-Fun_KV454296.1_i000_004670	139	459	320	0.969697	0.592593
GCA_018360225.1-Fun_SRPW01001007.1_i000_003551	481	774	293	0.887879	0.378553
GCA_020080175.1-Fun_JAGHQL010000217.1_i000_003094	129	452	323	0.978788	0.515974
GCA_000585535.1-Fun_AMGX01000035.1_i000_012586	134	452	318	0.963636	0.490741
GCA_000835475.1-Fun_KN846986.1_i000_005379	134	452	318	0.963636	0.490741
GCA_010093985.1-Fun_ML992665.1_i000_002460	134	461	327	0.990909	0.57672
GCA_000184455.3-Fun_BA000052.1_i000_006378	133	454	321	0.972727	0.555363
GCA_000269785.2-Fun_AKHY01000127.1_i000_004212	133	454	321	0.972727	0.555363
GCA_000691885.1-Fun_AMCJ01000158.1_i000_008960	133	454	321	0.972727	0.555363
GCA_002007945.1-Fun_MKZY01000003.1_i000_003622	133	454	321	0.972727	0.555363
GCA_009176375.1-Fun_ML734689.1_i000_011990	133	454	321	0.972727	0.555363
GCA_902155815.1-Fun_CABFWN010000004.1_i000_003182	126	396	270	0.818182	0.681818
GCA_016584175.1-Fun_PUHR01000088.1_i000_005143	129	438	309	0.936364	0.702273
GCA_016584175.1-Fun_PUHR01000223.1_i000_002271	129	438	309	0.936364	0.702273
GCA_000003525.2-Fun_EQ999977.1_i000_005079	135	455	320	0.969697	0.504732
GCA_000003855.2-Fun_GG657470.1_i000_008402	135	455	320	0.969697	0.504732
GCA_000151595.1-Fun_GG749423.1_i000_006571	135	455	320	0.969697	0.504732
GCA_009176345.1-Fun_ML732154.1_i000_000834	135	454	319	0.966667	0.554783
GCA_905337355.1-Fun_CAJPDT010000026.1_i000_004074	165	484	319	0.966667	0.405852
GCA_007821475.1-Fun_QGMF01001152.1_i000_009038	134	458	324	0.981818	0.457627
GCA_000709125.1-Fun_AMGV01000002.1_i000_003002	134	452	318	0.963636	0.499215
GCA_002072245.1-Fun_MDYL01000005.1_i000_002256	129	451	322	0.975758	0.564912
GCA_007825375.1-Fun_QGML01001565.1_i000_005810	133	459	326	0.987879	0.458509
GCA_003144605.1-Fun_LCWV01000006.1_i000_010866	161	495	334	1.01212	0.613971
GCA_010093825.1-Fun_ML995875.1_i000_008373	286	604	318	0.963636	0.421192
GCA_905182985.1-Pro_CAJJDN010000035.1_i000_015575	117	444	327	0.990909	0.698718
GCA_001773325.1-Fun_LXJU01000016.1_i000_007983	134	449	315	0.954545	0.547826
GCA_013396195.1-Fun_JAAQRI010000035.1_i000_001930	133	455	322	0.975758	0.543919
GCA_000226115.1-Fun_CP003011.1_i000_006056	137	463	326	0.987879	0.619772
GCA_905337325.1-Fun_CAJPDR010000072.1_i000_002796	136	456	320	0.969697	0.424403
GCA_001636675.1-Fun_AZGY01000015.1_i000_002589	145	464	319	0.966667	0.62549
GCA_001189435.1-Fun_LFRF01000048.1_i000_006943	136	467	331	1.00303	0.651575
GCA_001548555.1-Fun_CP014244.1_i000_001730	131	448	317	0.960606	0.600379
GCA_019633555.1-Fun_WSUG01000082.1_i000_013751	126	452	326	0.987879	0.550676
GCA_013266265.1-Fun_JABFAK010000153.1_i000_003201	127	454	327	0.990909	0.547739
GCA_000340195.1-Fun_KB446537.1_i000_003742	134	458	324	0.981818	0.557659
GCA_021927905.1-Pro_BLLK01000029.1_i000_005132	145	481	336	1.01818	0.644914
GCA_019632265.1-Fun_WSTU01000123.1_i000_000950	344	669	325	0.984848	0.401235
GCA_011947485.2-Fun_JAATWK020000022.1_i000_005792	153	468	315	0.954545	0.603448
GCA_900343105.1-Fun_OUUZ01000013.1_i000_006844	133	461	328	0.993939	0.624762
GCA_006783085.1-Fun_PUHP01000917.1_i000_007962	146	464	318	0.963636	0.623529
GCA_013398315.1-Ani_VZSG01002345.1_i000_013059	1	266	265	0.80303	0.752841
GCA_014282085.1-Pla_CM024903.1_i000_004214	113	391	278	0.842424	0.681373
GCA_016861865.1-Fun_AP024445.1_i000_004945	136	453	317	0.960606	0.544674
GCA_003072545.2-Pro_CP056068.1_i000_001407	117	421	304	0.921212	0.713615
GCA_903994135.1-Ani_CAJEWN010000143.1_i000_018843	104	440	336	1.01818	0.629213
GCA_002003505.1-Fun_BDMC01000021.1_i000_007091	129	462	333	1.00909	0.650391
GCA_002742065.1-Fun_CM008508.1_i000_011653	134	462	328	0.993939	0.579505
GCA_014773135.1-Ani_JABEBT010000023.1_i000_004243	3	309	306	0.927273	0.334792
GCA_019915245.1-Fun_CM034120.1_i000_009814	133	455	322	0.975758	0.543919
GCA_003316975.2-Fun_CM010973.1_i000_009354	133	455	322	0.975758	0.543919
GCA_013395995.1-Fun_JAAOAR010000367.1_i000_007402	133	455	322	0.975758	0.543919
GCA_013390185.1-Fun_QPNB01000007.1_i000_010525	148	465	317	0.960606	0.620352
GCA_021432615.1-Fun_MU270215.1_i000_008316	148	465	317	0.960606	0.620352
GCA_000002715.1-Fun_DS027056.1_i000_003641	135	456	321	0.972727	0.54223
GCA_013781345.1-Fun_JAAOAJ010000598.1_i000_011601	133	455	322	0.975758	0.543919
GCA_000315915.1-Fun_HE806317.1_i000_001313	131	448	317	0.960606	0.613153
GCA_000149955.2-Fun_CM000597.1_i000_014820	133	455	322	0.975758	0.543002
GCA_000259975.2-Fun_JH650830.1_i000_004594	133	455	322	0.975758	0.543002
GCA_000260155.3-Fun_JH651399.1_i000_014269	133	455	322	0.975758	0.543002
GCA_000260175.2-Fun_JH657930.1_i000_006854	133	455	322	0.975758	0.543002
GCA_000260195.2-Fun_JH658282.1_i000_007500	133	455	322	0.975758	0.543002
GCA_000260495.2-Fun_JH659333.1_i000_008502	133	455	322	0.975758	0.543002
GCA_000271705.2-Fun_JH717907.1_i000_014571	133	455	322	0.975758	0.543002
GCA_000271745.2-Fun_JH717845.1_i000_010609	133	455	322	0.975758	0.543002
GCA_000350345.1-Fun_KB730092.1_i000_003173	133	455	322	0.975758	0.543002
GCA_000350365.1-Fun_KB726235.1_i000_001497	133	455	322	0.975758	0.543002
GCA_003615075.1-Fun_MRCW01000087.1_i000_017320	133	455	322	0.975758	0.543002
GCA_003615085.1-Fun_CM010805.1_i000_011113	133	455	322	0.975758	0.543002
GCA_003615095.1-Fun_MRCV01000028.1_i000_009087	133	455	322	0.975758	0.543002
GCA_003615115.1-Fun_MRCX01000011.1_i000_001201	133	455	322	0.975758	0.543002
GCA_003615155.1-Fun_MRCY01000036.1_i000_010080	133	455	322	0.975758	0.543002
GCA_003615165.1-Fun_MRCZ01000008.1_i000_016210	133	455	322	0.975758	0.543002
GCA_003615185.1-Fun_MRDA01000028.1_i000_008081	133	455	322	0.975758	0.543002
GCA_004141715.1-Fun_MQTW01000073.1_i000_017786	133	455	322	0.975758	0.543002
GCA_005930515.1-Fun_SRMI01000009.1_i000_015120	133	455	322	0.975758	0.543002
GCA_007994515.1-Fun_VMNF01000012.1_i000_002101	133	455	322	0.975758	0.543002
GCA_013085055.1-Fun_CP052045.1_i000_012719	133	455	322	0.975758	0.543002
GCA_013363075.1-Fun_JAAFOW010000207.1_i000_001309	133	455	322	0.975758	0.543002
GCA_019157295.1-Fun_JAELUQ010000007.1_i000_015230	133	455	322	0.975758	0.543002
GCA_020744335.1-Fun_JAHBOG010000012.1_i000_003946	133	455	322	0.975758	0.543002
GCA_020796175.1-Fun_JAJGYP010000007.1_i000_017313	133	455	322	0.975758	0.543002
GCA_021365365.1-Fun_JAJTIX010000016.1_i000_005077	125	451	326	0.987879	0.555366
GCA_000325965.1-Fun_ADVV01000081.1_i000_003156	127	448	321	0.972727	0.682979
GCA_000204055.1-Fun_GL883105.1_i000_006180	120	455	335	1.01515	0.623836
GCA_009732865.1-Fun_ML769344.1_i000_016133	135	437	302	0.915152	0.424157
GCA_000143365.1-Fun_CH408035.1_i000_000617	136	467	331	1.00303	0.64775
GCA_013396005.1-Fun_JAAOAO010000525.1_i000_011178	133	455	322	0.975758	0.543919
GCA_000260075.2-Fun_JH650974.1_i000_010837	133	454	321	0.972727	0.541315
GCA_000260235.2-Fun_JH658369.1_i000_005279	133	454	321	0.972727	0.541315
GCA_019157275.1-Fun_JAELUR010000005.1_i000_014875	133	454	321	0.972727	0.541315
GCA_000165425.1-Pro_CT868318.1_i000_023334	117	445	328	0.993939	0.700855
GCA_000151065.3-Fun_HF943546.1_i000_004288	131	459	328	0.993939	0.526485
GCA_013396035.1-Fun_JAAOAS010000006.1_i000_000104	133	455	322	0.975758	0.543919
GCA_020726525.1-Fun_JAGPXC010000002.1_i000_005195	128	459	331	1.00303	0.553512
GCA_019456465.1-Fun_JAHXPR010000015.1_i000_006314	132	459	327	0.990909	0.435419
GCA_012932015.1-Fun_JAADJF010000167.1_i000_006852	133	455	322	0.975758	0.543002
GCA_000222805.1-Fun_AFQF01001995.1_i000_006500	133	455	322	0.975758	0.543002
GCA_000260215.2-Fun_KK033188.1_i000_006241	133	455	322	0.975758	0.543002
GCA_014154955.1-Fun_CM024368.1_i000_011894	133	455	322	0.975758	0.543002
GCA_018894095.1-Fun_RSAI01000012.1_i000_003890	133	455	322	0.975758	0.543002
GCA_004353045.1-Fun_SKBQ01000026.1_i000_004440	138	453	315	0.954545	0.609284
GCA_000149555.1-Fun_CM000584.1_i000_011330	133	455	322	0.975758	0.567901
GCA_013396175.1-Fun_JAAOAK010000289.1_i000_009342	133	455	322	0.975758	0.543919
GCA_001702695.2-Fun_CM008293.1_i000_011487	133	455	322	0.975758	0.559028
GCA_020726465.1-Fun_JAGIZQ010000006.1_i000_009807	136	467	331	1.00303	0.64775
GCA_020744455.1-Fun_JAHEWL010000007.1_i000_015209	133	455	322	0.975758	0.543002
GCA_911649665.1-Fun_CAJVRL010000101.1_i000_011973	134	440	306	0.927273	0.34382
GCA_009733575.1-Fun_ML769608.1_i000_019673	130	462	332	1.00606	0.577391
GCA_000190715.1-Pro_GL871019.1_i000_003946	115	448	333	1.00909	0.61326
GCA_002572885.1-Fun_PDNC01000113.1_i000_000814	133	451	318	0.963636	0.503962
GCA_000376725.2-Ani_KZ309230.1_i000_016016	123	486	363	1.1	0.700772
GCA_020744355.1-Fun_JAHEVI010000007.1_i000_014532	160	482	322	0.975758	0.519355
GCA_018296305.1-Fun_JADFTW010000201.1_i000_005565	133	455	322	0.975758	0.548552
GCA_001883825.1-Fun_LGRN01000460.1_i000_005887	135	455	320	0.969697	0.496124
GCA_010093935.1-Fun_ML993586.1_i000_004128	134	455	321	0.972727	0.559233
GCA_014066315.1-Fun_JACCJB010000009.1_i000_010926	136	456	320	0.969697	0.42328
GCA_013398055.1-Ani_VZRS01013060.1_i000_011346	53	317	264	0.8	0.832808
GCA_001749795.1-Fun_LPNL01000003.1_i000_001203	131	464	333	1.00909	0.651663
GCA_013396095.1-Fun_JAAQRM010000093.1_i000_002956	133	455	322	0.975758	0.543002
GCA_013396075.1-Fun_JAAOAV010000003.1_i000_000739	133	455	322	0.975758	0.543002
GCA_002906115.4-Pla_PKMF03002623.1_i000_009146	136	454	318	0.963636	0.536256
GCA_905178165.1-Pro_CAJINU010000059.1_i000_018751	122	454	332	1.00606	0.697479
GCA_903994135.1-Ani_CAJEWN010000477.1_i000_033853	79	412	333	1.00909	0.663347
GCA_011032825.1-Fun_JAADJZ010000007.1_i000_012938	125	456	331	1.00303	0.579685
GCA_019650295.1-Fun_BOLY01000003.1_i000_005682	134	461	327	0.990909	0.577739
GCA_022453885.1-Ani_CP092624.1_i000_014149	758	1092	334	1.01212	0.299015
GCA_013364935.1-Fun_JABEVY010000110.1_i000_005062	163	485	322	0.975758	0.516854
GCA_005406105.1-Fun_BIMX01000022.1_i000_003823	135	458	323	0.978788	0.607143
GCA_905182975.1-Pro_CAJJDM010000003.1_i000_001292	117	445	328	0.993939	0.700855
GCA_000281105.1-Fun_JH767562.1_i000_002478	126	447	321	0.972727	0.54223
GCA_000330505.1-Pro_KB207085.1_i000_010113	114	448	334	1.01212	0.624299
GCA_003184865.1-Fun_KZ824326.1_i000_010125	135	449	314	0.951515	0.533107
GCA_002352805.1-Ani_KZ347291.1_i000_009833	1	292	291	0.881818	0.643805
GCA_003260635.2-Pla_QGKW02000717.1_i000_045106	126	447	321	0.972727	0.708609
GCA_010093885.1-Fun_ML995496.1_i000_009115	134	456	322	0.975758	0.58018
GCA_013266195.1-Fun_JABEYC010000533.1_i000_006773	127	455	328	0.993939	0.542149
GCA_018296245.1-Fun_JADFTV010000236.1_i000_007233	133	455	322	0.975758	0.548552
GCA_018296265.1-Fun_JADFTU010000233.1_i000_007261	133	455	322	0.975758	0.548552
GCA_018296285.1-Fun_JADFTT010000285.1_i000_008095	133	455	322	0.975758	0.548552
GCA_018296325.1-Fun_JADFTY010000033.1_i000_001981	133	455	322	0.975758	0.548552
GCA_018296345.1-Fun_JADFTX010000195.1_i000_005390	133	455	322	0.975758	0.548552
GCA_003144195.1-Fun_KZ819419.1_i000_006067	137	448	311	0.942424	0.527119
GCA_900000165.1-Fun_CCYA01000250.1_i000_003316	137	448	311	0.942424	0.527119
GCA_002591415.1-Fun_NJET01000053.1_i000_006149	131	451	320	0.969697	0.516129
GCA_900180425.1-Fun_FXLY01000010.1_i000_005164	130	445	315	0.954545	0.62253
GCA_002933655.1-Fun_PNEN01000556.1_i000_010285	134	464	330	1	0.583039
GCA_001636745.1-Fun_AZHC01000007.1_i000_007966	124	454	330	1	0.547264
GCA_007866325.1-Fun_SBHS01000001.1_i000_000374	124	454	330	1	0.547264
GCA_000750735.1-Fun_JPJU01000693.1_i000_002323	136	432	296	0.89697	0.485246
GCA_001855235.1-Fun_KV842202.1_i000_011565	143	464	321	0.972727	0.630648
GCA_000190195.1-Fun_CM001092.1_i000_003335	131	448	317	0.960606	0.67019
GCA_000190255.1-Fun_CM001124.1_i000_003236	131	448	317	0.960606	0.67019
GCA_000260735.1-Fun_DG000051.1_i000_005262	119	446	327	0.990909	0.639922
GCA_002335645.1-Fun_BEGW01000002.1_i000_004757	119	446	327	0.990909	0.639922
GCA_000190235.1-Fun_CM001140.1_i000_003526	130	449	319	0.966667	0.678723
GCA_000977895.2-Fun_CP005664.2_i000_004767	127	448	321	0.972727	0.62818
GCA_903819145.2-Fun_LR813531.2_i000_005138	127	448	321	0.972727	0.62818
GCA_002865625.1-Fun_KZ613468.1_i000_002430	135	437	302	0.915152	0.425952
GCA_021193595.1-Fun_JAJJMK010000548.1_i000_011847	2	320	318	0.963636	0.675159
GCA_014621425.1-Fun_JAANBB010000059.1_i000_010689	131	467	336	1.01818	0.661417
GCA_900180425.1-Fun_FXLY01000005.1_i000_002417	131	448	317	0.960606	0.626482
GCA_000003225.1-Pro_CR940348.1_i000_001574	119	446	327	0.990909	0.659274
GCA_904066225.2-Ani_CAJFCW020000005.1_i000_011335	125	473	348	1.05455	0.698795
GCA_904067145.1-Ani_CAJFDH010000005.1_i000_011335	125	473	348	1.05455	0.698795
GCA_011022315.1-Fun_CP048996.1_i000_004816	130	447	317	0.960606	0.625247
GCA_905337335.1-Fun_CAJPDQ010000002.1_i000_000788	133	454	321	0.972727	0.445833
GCA_013396015.1-Fun_JAAOAM010000226.1_i000_009536	159	481	322	0.975758	0.520194
GCA_001747055.1-Fun_LPNN01000005.1_i000_002908	131	464	333	1.00909	0.651663
GCA_009805715.1-Fun_WEHR01000356.1_i000_000812	131	464	333	1.00909	0.651663
GCA_009805765.1-Fun_WEHS01000049.1_i000_000834	131	464	333	1.00909	0.651663
GCA_009805785.1-Fun_WEHT01000151.1_i000_002289	131	464	333	1.00909	0.651663
GCA_014905575.1-Fun_BNHH01000052.1_i000_002931	128	450	322	0.975758	0.630137
GCA_000326105.1-Fun_AGVY01000048.1_i000_004002	130	451	321	0.972727	0.647177
GCA_000968475.1-Fun_APLS01000032.1_i000_001965	131	466	335	1.01515	0.67
GCA_014764975.1-Fun_JACYFE010005670.1_i000_007428	127	456	329	0.99697	0.554806
GCA_001625265.1-Fun_LFIV01000024.1_i000_005595	145	464	319	0.966667	0.626719
GCA_009176365.1-Fun_ML733101.1_i000_009371	133	456	323	0.978788	0.552137
GCA_009193605.1-Fun_ML735261.1_i000_006901	133	456	323	0.978788	0.552137
GCA_013421405.2-Fun_SPNV01000009.1_i000_012311	133	456	323	0.978788	0.552137
GCA_013758895.1-Fun_JAAOAI010000961.1_i000_012755	163	485	322	0.975758	0.516854
GCA_002742825.1-Ani_CM008513.1_i000_019482	764	1098	334	1.01212	0.297418
GCA_900096695.1-Fun_FMJY01000007.1_i000_004500	133	455	322	0.975758	0.543002
GCA_000976815.3-Fun_CP005628.2_i000_004890	126	448	322	0.975758	0.622824
GCA_000978345.2-Fun_CP005679.2_i000_004890	126	448	322	0.975758	0.622824
GCA_002211085.2-Pla_CM008054.2_i000_031950	136	447	311	0.942424	0.546573
GCA_903819195.2-Fun_LR813616.2_i000_005097	126	449	323	0.978788	0.628405
GCA_010093895.1-Fun_ML996091.1_i000_008861	122	455	333	1.00909	0.583187
GCA_003184705.1-Fun_KZ825118.1_i000_003616	135	448	313	0.948485	0.53322
GCA_001306435.1-Fun_LKCW01000087.1_i000_012078	124	456	332	1.00606	0.557047
GCA_003184685.1-Fun_KZ825591.1_i000_010400	135	448	313	0.948485	0.532313
GCA_003184785.1-Fun_KZ824775.1_i000_002461	135	448	313	0.948485	0.532313
GCA_003434825.1-Pla_CM010629.1_i000_007482	129	444	315	0.954545	0.59434
GCA_001890905.1-Fun_KV878970.1_i000_000706	135	448	313	0.948485	0.532313
GCA_900119595.1-Fun_FQNF01000053.1_i000_000161	131	466	335	1.01515	0.656863
GCA_010356995.1-Fun_ML996697.1_i000_006025	113	459	346	1.04848	0.616756
GCA_905183005.1-Pro_CAJJDO010000004.1_i000_002281	123	463	340	1.0303	0.701031
GCA_000976365.2-Fun_CP005611.2_i000_004870	127	446	319	0.966667	0.620623
GCA_000977745.2-Fun_CP005659.2_i000_004908	127	446	319	0.966667	0.620623
GCA_903819155.2-Fun_LR813514.2_i000_005183	127	446	319	0.966667	0.620623
GCA_021491975.1-Ani_CP090895.1_i000_014266	765	1099	334	1.01212	0.297153
GCA_903819205.2-Fun_LR813565.2_i000_005111	127	453	326	0.987879	0.637965
GCA_000977415.2-Fun_CP005648.2_i000_004927	128	451	323	0.978788	0.628405
GCA_000977955.2-Fun_CP005666.2_i000_004701	125	448	323	0.978788	0.628405
GCA_010093535.1-Fun_MU003496.1_i000_003223	118	455	337	1.02121	0.587108
GCA_003184585.1-Fun_KZ821292.1_i000_009843	135	447	312	0.945455	0.530612
GCA_000750665.1-Fun_JPJS01000421.1_i000_001496	137	428	291	0.881818	0.469355
GCA_000750675.1-Fun_JPJR01000340.1_i000_002120	137	428	291	0.881818	0.469355
GCA_000750795.1-Fun_JPJX01001830.1_i000_005406	137	428	291	0.881818	0.469355
GCA_000750815.1-Fun_JPJZ01001073.1_i000_005992	137	428	291	0.881818	0.469355
GCA_016097325.1-Fun_JADPPX010000001.1_i000_001898	135	451	316	0.957576	0.545769
GCA_000751015.1-Pla_LK032924.1_i000_043300	119	432	313	0.948485	0.59619
GCA_000750755.1-Fun_JPJW01001171.1_i000_003550	135	425	290	0.878788	0.473083
GCA_000409485.1-Fun_KE145353.1_i000_000860	133	456	323	0.978788	0.513514
GCA_001634645.1-Fun_CM004308.1_i000_005692	126	449	323	0.978788	0.628405
GCA_900074725.1-Fun_LT598458.1_i000_002830	130	446	316	0.957576	0.612403
GCA_014621425.1-Fun_JAANBB010000096.1_i000_013593	124	453	329	0.99697	0.561433
GCA_013396415.1-Ani_VWPT01000008.1_i000_012172	137	278	141	0.427273	0.289528
GCA_013396415.1-Ani_VWPT01000008.1_i000_012172	274	464	190	0.575758	0.390144
GCA_003184695.1-Fun_KZ825319.1_i000_002288	135	448	313	0.948485	0.532313
GCA_003184765.1-Fun_KZ824941.1_i000_002699	135	448	313	0.948485	0.532313
GCA_003184825.1-Fun_KZ824645.1_i000_005816	135	448	313	0.948485	0.532313
GCA_002591405.1-Fun_NJEU01000001.1_i000_000006	129	452	323	0.978788	0.520968
GCA_001023035.1-Fun_JRVG01000060.1_i000_010151	133	457	324	0.981818	0.546374
GCA_001023045.1-Fun_JRVF01000498.1_i000_008285	133	457	324	0.981818	0.546374
GCA_001023065.1-Fun_JRVH01002846.1_i000_010681	133	457	324	0.981818	0.546374
GCA_003290285.1-Fun_PKMI01000001.1_i000_001130	133	457	324	0.981818	0.546374
GCA_003615215.1-Fun_MRDB01000063.1_i000_012693	133	457	324	0.981818	0.546374
GCA_009663055.1-Fun_CP023083.1_i000_009500	133	457	324	0.981818	0.546374
GCA_009663095.1-Fun_CP023095.1_i000_009474	133	457	324	0.981818	0.546374
GCA_009663115.1-Fun_CP023107.1_i000_009509	133	457	324	0.981818	0.546374
GCA_013396165.1-Fun_JAAQPF010000392.1_i000_008727	133	457	324	0.981818	0.546374
GCA_017309865.1-Fun_PKMH01000079.1_i000_003958	133	457	324	0.981818	0.546374
GCA_017309875.1-Fun_PKMG01000089.1_i000_009332	133	457	324	0.981818	0.546374
GCA_017309895.1-Fun_PKMJ01000010.1_i000_011063	133	457	324	0.981818	0.546374
GCA_900029915.1-Fun_FCQG01000012.1_i000_011293	133	457	324	0.981818	0.546374
GCA_900079805.1-Fun_HF679029.1_i000_010257	133	457	324	0.981818	0.546374
GCA_900096505.1-Fun_FMSL01000015.1_i000_002267	133	457	324	0.981818	0.546374
GCA_900096605.1-Fun_FMJS01000015.1_i000_008130	133	457	324	0.981818	0.546374
GCA_900096615.1-Fun_FMJV01000016.1_i000_004219	133	457	324	0.981818	0.546374
GCA_900096625.1-Fun_FMJX01000016.1_i000_012574	133	457	324	0.981818	0.546374
GCA_900096635.1-Fun_FMJW01000007.1_i000_004989	133	457	324	0.981818	0.546374
GCA_900096645.1-Fun_FMJU01000013.1_i000_002861	133	457	324	0.981818	0.546374
GCA_900096685.1-Fun_FMSM01000015.1_i000_011130	133	457	324	0.981818	0.546374
GCA_900096705.1-Fun_FMJT01000015.1_i000_005470	133	457	324	0.981818	0.546374
GCA_901677955.1-Fun_CABFJX010000279.1_i000_007484	133	457	324	0.981818	0.546374
GCA_901677965.1-Fun_CABFJW010000090.1_i000_003401	133	457	324	0.981818	0.546374
GCA_902702945.1-Fun_CACRXN010000163.1_i000_001971	133	457	324	0.981818	0.546374
GCA_000750995.1-Fun_JPKE01002186.1_i000_005753	136	455	319	0.966667	0.507154
GCA_001662595.1-Fun_KV456032.1_i000_002100	135	402	267	0.809091	0.433442
GCA_000326005.1-Fun_AEEZ01000093.1_i000_003034	129	447	318	0.963636	0.618677
GCA_000975765.2-Fun_CP005589.2_i000_004903	129	447	318	0.963636	0.618677
GCA_000975855.3-Fun_CP005594.2_i000_004849	129	447	318	0.963636	0.618677
GCA_000978105.2-Fun_CP005671.2_i000_004895	129	447	318	0.963636	0.618677
GCA_014132375.1-Fun_BLZP01000002.1_i000_001098	129	447	318	0.963636	0.618677
GCA_014132395.1-Fun_BLZQ01000003.1_i000_001470	129	447	318	0.963636	0.618677
GCA_016584175.1-Fun_PUHR01000260.1_i000_002680	63	381	318	0.963636	0.722727
GCA_002895965.2-Ani_PIJE02017940.1_i000_035163	1	265	264	0.8	0.767442
GCA_013995675.1-Pro_VWRR01000006.1_i000_004310	121	454	333	1.00909	0.720779
GCA_001006345.1-Fun_LCWF01000072.1_i000_005720	133	447	314	0.951515	0.503205
GCA_000182175.1-Fun_ABSV01002237.1_i000_004212	128	451	323	0.978788	0.628405
GCA_001983315.1-Fun_MQVN01000017.1_i000_001761	130	449	319	0.966667	0.639279
GCA_903819175.2-Fun_LR813599.2_i000_005167	126	448	322	0.975758	0.633858
GCA_001661175.1-Pla_LSRQ01001521.1_i000_008628	114	436	322	0.975758	0.565905
GCA_000750805.1-Fun_JPJY01001425.1_i000_007483	136	423	287	0.869697	0.4592
GCA_000750875.1-Fun_JPKA01000517.1_i000_003125	136	423	287	0.869697	0.4592
GCA_000975825.2-Fun_CP005593.1_i000_004910	129	449	320	0.969697	0.626223
GCA_003046695.1-Fun_PTEP01000006.1_i000_004427	129	449	320	0.969697	0.626223
GCA_003046715.1-Fun_PTEQ01000068.1_i000_004762	129	449	320	0.969697	0.626223
GCA_003046745.1-Fun_PTER01000002.1_i000_003285	129	449	320	0.969697	0.626223
GCA_000975975.3-Fun_CP005598.2_i000_004915	128	451	323	0.978788	0.628405
GCA_000976005.2-Fun_CP005599.2_i000_004880	128	451	323	0.978788	0.628405
GCA_000976125.2-Fun_CP005603.1_i000_004871	128	451	323	0.978788	0.628405
GCA_000976155.4-Fun_CP005604.2_i000_004836	128	451	323	0.978788	0.628405
GCA_000976215.2-Fun_CP005606.2_i000_004881	128	451	323	0.978788	0.628405
GCA_000976245.2-Fun_CP005607.2_i000_004867	128	451	323	0.978788	0.628405
GCA_000976305.2-Fun_CP005609.2_i000_004939	128	451	323	0.978788	0.628405
GCA_000976905.2-Fun_CP005631.2_i000_004812	128	451	323	0.978788	0.628405
GCA_000976995.2-Fun_CP005634.2_i000_004949	128	451	323	0.978788	0.628405
GCA_000977115.3-Fun_CP005638.2_i000_004914	128	451	323	0.978788	0.628405
GCA_000977355.3-Fun_CP005646.2_i000_004952	128	451	323	0.978788	0.628405
GCA_000977655.2-Fun_CP005656.1_i000_004934	128	451	323	0.978788	0.628405
GCA_000977775.3-Fun_CP005660.2_i000_004890	128	451	323	0.978788	0.628405
GCA_000977835.2-Fun_CP005662.2_i000_004951	128	451	323	0.978788	0.628405
GCA_000977865.2-Fun_CP005663.1_i000_004862	128	451	323	0.978788	0.628405
GCA_000977925.2-Fun_CP005665.2_i000_004845	128	451	323	0.978788	0.628405
GCA_000978255.2-Fun_CP005676.2_i000_004934	128	451	323	0.978788	0.628405
GCA_002804325.1-Fun_PEJR01000174.1_i000_001496	128	451	323	0.978788	0.628405
GCA_903819135.2-Fun_LR813548.2_i000_005205	128	451	323	0.978788	0.628405
GCA_020509005.2-Fun_CP090172.1_i000_012013	134	459	325	0.984848	0.560345
GCA_000977475.3-Fun_CP005650.2_i000_004933	130	449	319	0.966667	0.617021
GCA_000977715.4-Fun_CP005658.2_i000_004917	130	448	318	0.963636	0.622309
GCA_000218975.1-Fun_FN394216.1_i000_005443	130	451	321	0.972727	0.63189
GCA_000975735.4-Fun_CP005588.2_i000_005087	130	451	321	0.972727	0.63189
GCA_000976875.3-Fun_CP005630.2_i000_004836	130	451	321	0.972727	0.63189
GCA_000977685.2-Fun_CP005657.2_i000_004947	130	451	321	0.972727	0.63189
GCA_002079055.1-Fun_CP020256.1_i000_005016	127	450	323	0.978788	0.632094
GCA_021399465.1-Fun_JAJTUS010000037.1_i000_010447	135	443	308	0.933333	0.355248
GCA_010015825.1-Fun_ML977315.1_i000_003746	125	451	326	0.987879	0.566957
GCA_011058875.1-Fun_SWKT01000002.1_i000_004647	132	459	327	0.990909	0.536946
GCA_001625285.1-Fun_LFIW01001979.1_i000_004877	204	523	319	0.966667	0.56162
GCA_013398595.1-Ani_WBND01001521.1_i000_012538	54	317	263	0.79697	0.829653
GCA_000975585.2-Fun_CP005590.2_i000_004861	130	448	318	0.963636	0.615087
GCA_000977055.3-Fun_CP005636.2_i000_004895	130	448	318	0.963636	0.615087
GCA_000977445.2-Fun_CP005649.2_i000_004883	130	448	318	0.963636	0.615087
GCA_000977595.2-Fun_CP005654.2_i000_004898	130	448	318	0.963636	0.615087
GCA_000978015.2-Fun_CP005668.2_i000_004864	130	448	318	0.963636	0.615087
GCA_000978135.2-Fun_CP005672.2_i000_004895	130	448	318	0.963636	0.615087
GCA_000976095.2-Fun_CP005602.2_i000_004889	130	448	318	0.963636	0.629703
GCA_001636725.1-Fun_AZHB01000011.1_i000_001779	128	456	328	0.993939	0.549414
GCA_013399515.1-Ani_VXAN01000965.1_i000_013425	54	317	263	0.79697	0.829653
GCA_013398405.1-Ani_VZSJ01039739.1_i000_012152	54	317	263	0.79697	0.829653
GCA_000977265.3-Fun_CP005643.1_i000_004885	130	449	319	0.966667	0.624266
GCA_000977985.2-Fun_CP005667.2_i000_004855	131	448	317	0.960606	0.624016
GCA_000146045.2-Fun_BK006948.2_i000_005441	130	447	317	0.960606	0.620352
GCA_000149365.1-Fun_CH408045.1_i000_003862	130	447	317	0.960606	0.620352
GCA_000182315.2-Fun_ACFL01000078.1_i000_003442	130	447	317	0.960606	0.620352
GCA_000190215.1-Fun_CM001108.1_i000_003445	130	447	317	0.960606	0.620352
GCA_000269885.1-Fun_CM001536.1_i000_004938	130	447	317	0.960606	0.620352
GCA_000568005.1-Fun_CM002418.1_i000_004891	130	447	317	0.960606	0.620352
GCA_000568365.1-Fun_CM002452.1_i000_004541	130	447	317	0.960606	0.620352
GCA_000662435.2-Fun_CP005620.2_i000_004943	130	447	317	0.960606	0.620352
GCA_000975615.2-Fun_CP005591.2_i000_004808	130	447	317	0.960606	0.620352
GCA_000975645.3-Fun_CP004113.1_i000_004904	130	447	317	0.960606	0.620352
GCA_000975705.2-Fun_CP005623.1_i000_005120	130	447	317	0.960606	0.620352
GCA_000975795.2-Fun_CP005592.2_i000_004874	130	447	317	0.960606	0.620352
GCA_000975885.2-Fun_CP005595.2_i000_004864	130	447	317	0.960606	0.620352
GCA_000975915.2-Fun_CP005596.2_i000_004889	130	447	317	0.960606	0.620352
GCA_000975945.2-Fun_CP005597.2_i000_004898	130	447	317	0.960606	0.620352
GCA_000976035.2-Fun_CP005600.2_i000_004867	130	447	317	0.960606	0.620352
GCA_000976065.2-Fun_CP005601.2_i000_004945	130	447	317	0.960606	0.620352
GCA_000976185.2-Fun_CP005605.2_i000_004927	130	447	317	0.960606	0.620352
GCA_000976275.4-Fun_CP005608.2_i000_004920	130	447	317	0.960606	0.620352
GCA_000976395.2-Fun_CP005612.2_i000_005093	130	447	317	0.960606	0.620352
GCA_000976425.2-Fun_CP005613.1_i000_005126	130	447	317	0.960606	0.620352
GCA_000976455.3-Fun_CP005614.2_i000_004917	130	447	317	0.960606	0.620352
GCA_000976485.2-Fun_CP005615.2_i000_005097	130	447	317	0.960606	0.620352
GCA_000976515.2-Fun_CP005616.2_i000_005122	130	447	317	0.960606	0.620352
GCA_000976545.2-Fun_CP005617.2_i000_004918	130	447	317	0.960606	0.620352
GCA_000976575.4-Fun_CP005618.2_i000_005129	130	447	317	0.960606	0.620352
GCA_000976605.3-Fun_CP005619.2_i000_004856	130	447	317	0.960606	0.620352
GCA_000976665.2-Fun_CP005621.2_i000_005126	130	447	317	0.960606	0.620352
GCA_000976845.3-Fun_CP005629.2_i000_004879	130	447	317	0.960606	0.620352
GCA_000976935.2-Fun_CP005632.2_i000_004832	130	447	317	0.960606	0.620352
GCA_000976965.3-Fun_CP005633.1_i000_004874	130	447	317	0.960606	0.620352
GCA_000977145.2-Fun_CP005639.2_i000_004940	130	447	317	0.960606	0.620352
GCA_000977175.3-Fun_CP005640.2_i000_004897	130	447	317	0.960606	0.620352
GCA_000977205.2-Fun_CP005641.2_i000_004897	130	447	317	0.960606	0.620352
GCA_000977235.2-Fun_CP005642.2_i000_004933	130	447	317	0.960606	0.620352
GCA_000977295.2-Fun_CP005644.2_i000_004867	130	447	317	0.960606	0.620352
GCA_000977325.2-Fun_CP005645.2_i000_004936	130	447	317	0.960606	0.620352
GCA_000977385.2-Fun_CP005647.2_i000_004899	130	447	317	0.960606	0.620352
GCA_000977805.2-Fun_CP005661.2_i000_004861	130	447	317	0.960606	0.620352
GCA_000978075.3-Fun_CP005670.2_i000_004906	130	447	317	0.960606	0.620352
GCA_000978165.2-Fun_CP005673.1_i000_005010	130	447	317	0.960606	0.620352
GCA_000978195.2-Fun_CP005674.2_i000_004874	130	447	317	0.960606	0.620352
GCA_000978225.2-Fun_CP005675.2_i000_005109	130	447	317	0.960606	0.620352
GCA_000978285.2-Fun_CP005677.2_i000_005006	130	447	317	0.960606	0.620352
GCA_001298375.2-Fun_CM003551.1_i000_004533	130	447	317	0.960606	0.620352
GCA_001413975.1-Fun_CM003569.1_i000_004574	130	447	317	0.960606	0.620352
GCA_002571405.2-Fun_CP046095.1_i000_005312	130	447	317	0.960606	0.620352
GCA_009014655.1-Fun_BKZN01000033.1_i000_002468	130	447	317	0.960606	0.620352
GCA_010356925.1-Fun_CM021141.1_i000_005294	130	447	317	0.960606	0.620352
GCA_010356935.1-Fun_CM021125.1_i000_005259	130	447	317	0.960606	0.620352
GCA_016858165.1-Fun_CM029103.1_i000_005307	130	447	317	0.960606	0.620352
GCA_016858175.1-Fun_CM029087.1_i000_005250	130	447	317	0.960606	0.620352
GCA_905220315.1-Fun_LR999886.1_i000_005195	130	447	317	0.960606	0.620352
GCA_905220325.1-Fun_HG994154.1_i000_005184	130	447	317	0.960606	0.620352
GCA_003184595.1-Fun_KZ821338.1_i000_000089	110	429	319	0.966667	0.574775
GCA_000750925.1-Fun_JPKC01002459.1_i000_008259	135	432	297	0.9	0.47293
GCA_002220415.3-Pla_CM022215.1_i000_021034	125	442	317	0.960606	0.684665
GCA_000976335.2-Fun_CP005610.2_i000_004901	129	448	319	0.966667	0.624266
GCA_903819125.2-Fun_LR813497.2_i000_005165	120	451	331	1.00303	0.655446
GCA_008403515.1-Pro_VFQX01000029.1_i000_004410	123	460	337	1.02121	0.584055
GCA_002591395.1-Fun_NJES01000336.1_i000_003745	121	450	329	0.99697	0.490313
GCA_010093795.1-Fun_MU006569.1_i000_003833	50	387	337	1.02121	0.668651
GCA_000977565.2-Fun_CP005653.1_i000_004714	130	450	320	0.969697	0.615385
GCA_016906555.1-Fun_CP059642.1_i000_000770	132	446	314	0.951515	0.244168
GCA_000464535.1-Fun_KE721051.1_i000_004501	134	453	319	0.966667	0.425333
GCA_002211485.2-Fun_NKJJ02000003.1_i000_005465	135	454	319	0.966667	0.565603
GCA_001625195.1-Fun_CM004176.1_i000_007237	99	424	325	0.984848	0.577265
GCA_001831195.1-Fun_MJBS01000015.1_i000_003101	155	449	294	0.890909	0.57874
GCA_021399475.1-Fun_JAJTUR010000069.1_i000_014547	136	422	286	0.866667	0.403955
GCA_012275245.1-Fun_WMJW01000017.1_i000_002633	129	449	320	0.969697	0.620155
GCA_001660665.1-Fun_LGUA01002297.1_i000_003328	129	446	317	0.960606	0.501582
GCA_000568055.1-Fun_CM002436.1_i000_004194	130	450	320	0.969697	0.626223
GCA_020536175.1-Fun_JAEUBF010000443.1_i000_001828	131	450	319	0.966667	0.612284
GCA_900412535.3-Pla_LS974618.2_i000_009803	122	436	314	0.951515	0.561717
GCA_000977025.2-Fun_CP005635.2_i000_004854	129	448	319	0.966667	0.617021
GCA_903994135.1-Ani_CAJEWN010000048.1_i000_009965	169	503	334	1.01212	0.558528
GCA_000740895.1-Pro_AP011947.1_i000_001744	179	483	304	0.921212	0.62423
GCA_001661235.1-Fun_KV454006.1_i000_005007	130	399	269	0.815152	0.670823
GCA_000230395.2-Fun_ACJE01000010.1_i000_005549	136	453	317	0.960606	0.546552
GCA_003344505.1-Fun_KZ851850.1_i000_004343	136	453	317	0.960606	0.546552
GCA_003344705.1-Fun_KZ851967.1_i000_011675	136	453	317	0.960606	0.546552
GCA_003344945.1-Fun_KZ852045.1_i000_006000	136	453	317	0.960606	0.546552
GCA_003850985.1-Fun_BDHI01000001.1_i000_001152	136	453	317	0.960606	0.546552
GCA_900248155.1-Fun_OGUI01000007.1_i000_010113	136	453	317	0.960606	0.546552
GCA_000569095.1-Pro_CM002467.1_i000_005852	1	289	288	0.872727	0.872727
GCA_011022315.1-Fun_CP049005.1_i000_008041	127	450	323	0.978788	0.624758
GCA_001179505.1-Pro_CDMY01001052.1_i000_022846	124	464	340	1.0303	0.628466
GCA_001683735.1-Fun_LUGG01000010.1_i000_008224	132	455	323	0.978788	0.568662
GCA_014621435.1-Fun_JAANBA010000284.1_i000_007468	132	459	327	0.990909	0.536946
GCA_000968615.1-Fun_LAEV01000214.1_i000_000726	127	458	331	1.00303	0.658052
GCA_013396795.1-Ani_VWZH01000008.1_i000_011722	137	278	141	0.427273	0.289528
GCA_013396795.1-Ani_VWZH01000008.1_i000_011722	274	464	190	0.575758	0.390144
GCA_000203815.1-Pro_GL883029.1_i000_011605	116	445	329	0.99697	0.541118
GCA_000181435.1-Fun_AAFW02000032.1_i000_005012	129	449	320	0.969697	0.626223
GCA_000975675.2-Fun_CP005622.2_i000_004874	129	449	320	0.969697	0.626223
GCA_000976725.3-Fun_CP005625.2_i000_004907	129	449	320	0.969697	0.626223
GCA_000976755.2-Fun_CP005626.2_i000_004939	129	449	320	0.969697	0.626223
GCA_000976785.2-Fun_CP005627.2_i000_004871	129	449	320	0.969697	0.626223
GCA_017639395.1-Pla_CM029880.1_i000_011324	129	439	310	0.939394	0.584906
GCA_017607565.1-Ani_JAANIB010005791.1_i000_004160	176	512	336	1.01818	0.623377
GCA_009193465.1-Fun_ML742114.1_i000_005631	134	448	314	0.951515	0.548951
GCA_000687475.2-Fun_CP072753.1_i000_000755	123	456	333	1.00909	0.551325
GCA_000965225.2-Fun_BBTG02000005.1_i000_001300	123	456	333	1.00909	0.551325
GCA_020744155.1-Fun_JAGPNQ010000007.1_i000_018648	126	451	325	0.984848	0.553663
GCA_005406105.1-Fun_BIMX01000022.1_i000_003794	129	449	320	0.969697	0.617761
GCA_021432605.1-Fun_MU271151.1_i000_008404	129	462	333	1.00909	0.590426
GCA_001990825.1-Fun_KV907494.1_i000_001688	136	453	317	0.960606	0.615534
GCA_020740775.1-Fun_JAHEWK010000010.1_i000_002898	124	453	329	0.99697	0.560477
GCA_000978045.2-Fun_CP005669.2_i000_004847	130	447	317	0.960606	0.620352
GCA_000236905.1-Fun_HE612862.1_i000_002860	130	450	320	0.969697	0.622568
GCA_000750895.1-Fun_JPKB01000367.1_i000_002431	135	435	300	0.909091	0.482315
GCA_001662655.1-Fun_KV460238.1_i000_006829	135	435	300	0.909091	0.482315
GCA_004104545.1-Ani_SAUD01003735.1_i000_006311	2	276	274	0.830303	0.789625
GCA_001618945.2-Fun_CM038149.1_i000_004539	133	455	322	0.975758	0.542088
GCA_000976695.3-Fun_CP005624.2_i000_004802	130	450	320	0.969697	0.622568
GCA_000977085.2-Fun_CP005637.2_i000_004907	130	450	320	0.969697	0.622568
GCA_004104545.1-Ani_SAUD01031839.1_i000_015550	2	276	274	0.830303	0.787356
GCA_003316985.1-Fun_QKXC01000297.1_i000_006429	125	454	329	0.99697	0.551089
GCA_011503125.2-Fun_WWBZ02000040.1_i000_009231	124	456	332	1.00606	0.588652
GCA_011503125.2-Fun_WWBZ02000082.1_i000_013469	124	456	332	1.00606	0.588652
GCA_000583005.2-Pla_ASHM01032079.1_i000_032585	1	286	285	0.863636	0.725191
GCA_000977625.2-Fun_CP005655.2_i000_004841	131	448	317	0.960606	0.609615
GCA_002220415.3-Pla_CM022220.1_i000_049772	130	439	309	0.936364	0.534602
GCA_010094025.1-Fun_ML991780.1_i000_002806	136	462	326	0.987879	0.586331
GCA_001292635.1-Fun_JXCE01000012.1_i000_001306	128	454	326	0.987879	0.546064
GCA_003012315.1-Fun_PXOF01000142.1_i000_009004	128	454	326	0.987879	0.546064
GCA_000170175.2-Fun_GL636488.1_i000_002449	135	453	318	0.963636	0.523888
GCA_018416015.1-Fun_CP075069.1_i000_002989	135	453	318	0.963636	0.523888
GCA_000184105.1-Fun_GL573198.1_i000_002247	135	426	291	0.881818	0.467846
GCA_001641265.1-Fun_KV441394.1_i000_004267	135	426	291	0.881818	0.467846
GCA_910393935.1-Fun_CAJSTJ010000022.1_i000_000484	125	454	329	0.99697	0.552013
GCA_019627685.1-Fun_WSTO01002798.1_i000_008916	128	353	225	0.681818	0.442913
GCA_019627685.1-Fun_WSTO01002798.1_i000_008916	361	484	123	0.372727	0.242126
GCA_000298775.1-Fun_JH921435.1_i000_004101	132	456	324	0.981818	0.496172
GCA_905221625.1-Pro_CAJNDU010008459.1_i000_010222	154	477	323	0.978788	0.245254
GCA_007821535.1-Fun_QGMI01000460.1_i000_005811	133	450	317	0.960606	0.461426
GCA_911693285.1-Fun_CAJVRM010000003.1_i000_000262	134	440	306	0.927273	0.343434
GCA_002900925.1-Fun_LN890542.1_i000_001439	130	446	316	0.957576	0.618395
GCA_001298625.1-Fun_CM003589.1_i000_002446	131	446	315	0.954545	0.609284
GCA_022432395.1-Fun_JAJKLJ010000005.1_i000_010407	132	459	327	0.990909	0.540496
GCA_000227115.2-Fun_HE580271.1_i000_002702	129	448	319	0.966667	0.609943
GCA_000150705.2-Fun_KN294005.1_i000_005382	136	455	319	0.966667	0.35883
GCA_020744255.1-Fun_JAGTJQ010000001.1_i000_000449	129	460	331	1.00303	0.601818
GCA_000977505.2-Fun_CP005651.2_i000_004882	130	448	318	0.963636	0.615087
GCA_000977535.2-Fun_CP005652.2_i000_004869	130	448	318	0.963636	0.615087
GCA_000978315.2-Fun_CP005678.2_i000_004879	130	448	318	0.963636	0.615087
GCA_014607435.1-Fun_JAACFV010000098.1_i000_012463	135	456	321	0.972727	0.429719
GCA_005059845.1-Fun_NAJN01000045.1_i000_009846	135	456	321	0.972727	0.356667
GCA_900157425.1-Fun_FUEG01000003.1_i000_014034	134	471	337	1.02121	0.578045
GCA_016771965.1-Pla_CM028693.1_i000_034188	132	442	310	0.939394	0.579439
GCA_018902385.1-Fun_JABSSW010000026.1_i000_005827	160	473	313	0.948485	0.404393
GCA_003012295.1-Fun_PXXK01000377.1_i000_010635	125	454	329	0.99697	0.551089
GCA_020744385.1-Fun_JAHBOO010000005.1_i000_009605	125	454	329	0.99697	0.551089
GCA_905182985.1-Pro_CAJJDN010000197.1_i000_047156	123	466	343	1.03939	0.702869
GCA_001654555.2-Fun_LUFC02000232.1_i000_003919	133	456	323	0.978788	0.544688
GCA_000750935.1-Fun_JPKD01002179.1_i000_007499	136	422	286	0.866667	0.459807
GCA_005059865.1-Fun_NAJQ01000390.1_i000_008276	136	458	322	0.975758	0.517685
GCA_001563125.1-Fun_JFFI01000791.1_i000_003781	150	461	311	0.942424	0.612205
GCA_000385595.1-Fun_KB916303.1_i000_005401	125	457	332	1.00606	0.586572
GCA_000966595.1-Fun_LAFY01000460.1_i000_004861	135	447	312	0.945455	0.545455
GCA_900184105.1-Fun_LT854273.1_i000_000384	135	447	312	0.945455	0.545455
GCA_013677255.1-Pla_CM025219.1_i000_000386	58	324	266	0.806061	0.820988
GCA_000167075.2-Fun_JH797452.1_i000_002506	220	537	317	0.960606	0.512945
GCA_000750745.1-Fun_JPJV01002202.1_i000_005679	135	422	287	0.869697	0.457006
GCA_000238015.2-Fun_JH413869.1_i000_004195	133	452	319	0.966667	0.385732
GCA_001563115.1-Fun_JEMN01001384.1_i000_010134	147	463	316	0.957576	0.622047
GCA_001563135.1-Fun_JFBX01000863.1_i000_012886	147	463	316	0.957576	0.622047
GCA_011075155.1-Fun_JAAJBS010000012.1_i000_012943	147	463	316	0.957576	0.622047
GCA_018906675.1-Fun_JAESDO010000008.1_i000_013416	147	463	316	0.957576	0.622047
GCA_018906765.1-Fun_JAESDN010000008.1_i000_013458	147	463	316	0.957576	0.622047
GCA_018907675.1-Fun_JAESDM010000008.1_i000_013643	147	463	316	0.957576	0.622047
GCA_017365405.1-Fun_JAFJYH010000304.1_i000_013247	128	447	319	0.966667	0.499218
GCA_000219625.1-Fun_CM001196.1_i000_000338	135	447	312	0.945455	0.545455
GCA_900091695.1-Fun_LT853692.1_i000_000392	135	447	312	0.945455	0.545455
GCA_900099495.1-Fun_LT882676.1_i000_000399	135	447	312	0.945455	0.545455
GCA_900184115.1-Fun_LT854253.1_i000_000392	135	447	312	0.945455	0.545455
GCA_001645015.2-Fun_LWDF02000201.1_i000_003132	129	452	323	0.978788	0.535655
GCA_001645055.2-Fun_LWDG02000263.1_i000_003331	129	452	323	0.978788	0.535655
GCA_009428295.1-Fun_RDSH01000045.1_i000_005346	129	452	323	0.978788	0.535655
GCA_009428345.1-Fun_RDSI01000327.1_i000_004851	129	452	323	0.978788	0.535655
GCA_009428365.1-Fun_RDSJ01000206.1_i000_003181	129	452	323	0.978788	0.535655
GCA_009078325.1-Fun_SSOP01000005.1_i000_006880	129	406	277	0.839394	0.493761
GCA_000751015.1-Pla_LK033097.1_i000_045211	130	442	312	0.945455	0.587571
GCA_000956335.1-Pro_KQ001704.1_i000_004286	118	449	331	1.00303	0.698312
GCA_000147175.1-Ani_GL445031.1_i000_014780	111	452	341	1.03333	0.505185
GCA_000750715.1-Fun_JPJT01001936.1_i000_003364	135	427	292	0.884848	0.476346
GCA_003260635.2-Pla_QGKW02000717.1_i000_045385	130	444	314	0.951515	0.590226
GCA_013266175.1-Fun_JABFAI010000273.1_i000_009873	133	456	323	0.978788	0.544688
GCA_000582985.1-Fun_JARH01001073.1_i000_013458	150	461	311	0.942424	0.612205
GCA_905182995.1-Pro_CAJJDP010000009.1_i000_004041	124	460	336	1.01818	0.692784
GCA_900617915.1-Ani_UYRT01001655.1_i000_001383	1	291	290	0.878788	0.77748
GCA_000938715.1-Fun_LN736364.1_i000_002313	126	445	319	0.966667	0.618217
GCA_900097035.1-Pro_LT969559.1_i000_002219	117	448	331	1.00303	0.705757
GCA_902206195.3-Pla_CABITT030000001.1_i000_003085	123	440	317	0.960606	0.598113
GCA_900067095.1-Fun_FJOF01000005.1_i000_008222	134	454	320	0.969697	0.539629
GCA_003711515.1-Fun_ML119051.1_i000_000248	142	465	323	0.978788	0.625969
GCA_001662575.1-Fun_KV454995.1_i000_004102	135	424	289	0.875758	0.4624
GCA_001883805.1-Fun_LGTZ01000830.1_i000_009460	134	449	315	0.954545	0.49763
GCA_001662585.1-Fun_KV454580.1_i000_002467	135	422	287	0.869697	0.461415
GCA_001662645.1-Fun_KV459563.1_i000_008654	135	422	287	0.869697	0.461415
GCA_905332125.1-Ani_CAJOBJ010064450.1_i000_031595	135	399	264	0.8	0.661654
GCA_014621405.1-Fun_JAANBC010000656.1_i000_008256	130	457	327	0.990909	0.431398
GCA_000441915.1-Pla_KE528228.1_i000_003957	122	392	270	0.818182	0.688776
GCA_003339415.1-Fun_PDHQ01000337.1_i000_003439	132	448	316	0.957576	0.455988
GCA_000236905.1-Fun_HE612864.1_i000_003478	163	478	315	0.954545	0.583333
GCA_022264835.1-Fun_JAIFHY010000016.1_i000_003538	122	454	332	1.00606	0.586572
GCA_010405405.1-Fun_MU004239.1_i000_009148	118	455	337	1.02121	0.59646
GCA_012977835.1-Fun_SDJM01000038.1_i000_007227	132	456	324	0.981818	0.563478
GCA_000956045.1-Fun_KQ030504.1_i000_002211	130	464	334	1.01212	0.654902
GCA_000002515.1-Fun_CR382126.1_i000_004252	129	449	320	0.969697	0.626223
GCA_000320565.2-Fun_KB456262.1_i000_003286	134	460	326	0.987879	0.573944
GCA_900074735.1-Fun_LT598476.1_i000_004728	126	447	321	0.972727	0.62089
GCA_010094025.1-Fun_ML991820.1_i000_008156	135	457	322	0.975758	0.497682
GCA_003704345.1-Fun_QWIJ01000009.1_i000_014793	131	465	334	1.01212	0.605072
GCA_007993695.1-Fun_CP042456.1_i000_001173	131	449	318	0.963636	0.622309
GCA_900005855.1-Pro_CVMV01000022.1_i000_004461	116	449	333	1.00909	0.714592
GCA_000209125.2-Pro_DS548704.1_i000_006340	113	447	334	1.01212	0.734066
GCA_010093715.1-Fun_MU005781.1_i000_010944	115	458	343	1.03939	0.600701
GCA_013396185.1-Fun_JAAQPE010000422.1_i000_010916	163	484	321	0.972727	0.516077
GCA_002573605.1-Fun_PDNA01000140.1_i000_001800	134	450	316	0.957576	0.37619
GCA_007825345.1-Fun_QGMK01002118.1_i000_008948	134	456	322	0.975758	0.460658
GCA_910592205.1-Fun_CAJVPJ010000358.1_i000_003305	117	452	335	1.01515	0.450269
GCA_020747065.1-Fun_JAGMVK010000010.1_i000_001529	128	455	327	0.990909	0.50541
GCA_900088555.1-Pro_FLQV01001490.1_i000_005240	118	448	330	1	0.684647
GCA_900088565.1-Pro_FLQU01000223.1_i000_001589	118	448	330	1	0.684647
GCA_900090035.2-Pro_FLRI01000560.1_i000_006233	118	448	330	1	0.684647
GCA_002895985.1-Fun_NKHZ01000081.1_i000_001767	133	457	324	0.981818	0.5625
GCA_010093745.1-Fun_MU005957.1_i000_000083	133	461	328	0.993939	0.563574
GCA_002849105.1-Fun_MSFO01000002.1_i000_005384	134	453	319	0.966667	0.554783
GCA_012934285.1-Fun_JAAVMX010000005.1_i000_004498	133	466	333	1.00909	0.655512
GCA_003426235.1-Fun_NQIM01000182.1_i000_002707	133	460	327	0.990909	0.49696
GCA_002276475.2-Fun_NCSK02000020.1_i000_003033	136	436	300	0.909091	0.265018
GCA_900005765.1-Pro_LN835303.1_i000_001466	117	449	332	1.00606	0.712446
GCA_000150055.1-Fun_DS268114.1_i000_000549	135	453	318	0.963636	0.523888
GCA_000149335.2-Fun_GG704916.1_i000_000563	135	453	318	0.963636	0.523888
GCA_000149895.1-Fun_DS028097.1_i000_002781	135	453	318	0.963636	0.523888
GCA_000151335.1-Fun_ACFW01000030.1_i000_003712	135	453	318	0.963636	0.523888
GCA_004115165.2-Fun_RHJW02000001.1_i000_000698	135	452	317	0.960606	0.523102
GCA_022432365.1-Fun_JAJJXE010000001.1_i000_001412	126	462	336	1.01818	0.548124
GCA_000516985.1-Fun_KI912114.1_i000_009166	133	463	330	1	0.539216
GCA_000149585.1-Fun_CH476656.1_i000_006397	136	457	321	0.972727	0.505512
GCA_017310585.1-Fun_CP069115.1_i000_004225	136	457	321	0.972727	0.505512
GCA_000150475.2-Fun_KN305540.1_i000_006293	94	411	317	0.960606	0.522241
GCA_003073865.1-Fun_KZ804147.1_i000_009790	128	454	326	0.987879	0.480118
GCA_001865355.1-Pro_LRBS01000070.1_i000_002028	128	465	337	1.02121	0.689162
GCA_020360975.1-Fun_JAIZPD010000016.1_i000_010580	142	458	316	0.957576	0.618395
GCA_900625125.1-Ani_UYYG01001165.1_i000_004734	93	414	321	0.972727	0.769784
GCA_000150115.1-Fun_GG663364.1_i000_007342	136	453	317	0.960606	0.498428
GCA_017355575.1-Fun_CP069120.1_i000_006089	136	453	317	0.960606	0.498428
GCA_017607465.1-Fun_JAEVHI010000002.1_i000_003356	136	453	317	0.960606	0.498428
GCA_007735645.1-Fun_CP042191.1_i000_004586	128	461	333	1.00909	0.577123
GCA_003369665.1-Fun_PDLM01000012.1_i000_003486	135	448	313	0.948485	0.508117
GCA_000303195.2-Fun_CM003200.1_i000_009074	126	457	331	1.00303	0.554439
GCA_001703955.2-Fun_CM004558.1_i000_008417	126	457	331	1.00303	0.554439
GCA_016952305.1-Fun_CP064756.1_i000_010706	126	457	331	1.00303	0.554439
GCA_905182985.1-Pro_CAJJDN010000007.1_i000_003610	123	469	346	1.04848	0.713402
GCA_902829315.1-Ani_CADEPM010000001.1_i000_000793	125	461	336	1.01818	0.697095
GCA_009193565.1-Fun_ML739037.1_i000_000505	134	453	319	0.966667	0.544369
GCA_003426265.1-Fun_NQIL01000006.1_i000_009764	133	460	327	0.990909	0.529984
GCA_022376275.1-Fun_JAJNOH010000004.1_i000_008952	132	460	328	0.993939	0.467903
GCA_002135145.1-Ani_MUJZ01047101.1_i000_009806	98	342	244	0.739394	0.71345
GCA_010799875.2-Ani_VXIV02003450.1_i000_023533	115	434	319	0.966667	0.611111
GCA_019924155.1-Fun_JAHFXD010011905.1_i000_022318	4	306	302	0.915152	0.974194
GCA_013266165.1-Fun_JAAGWP010000270.1_i000_006826	125	452	327	0.990909	0.550505
GCA_002269645.1-Ani_NIVC01000915.1_i000_019979	124	445	321	0.972727	0.590074
GCA_013396295.1-Fun_JAAGWQ010000124.1_i000_006694	127	451	324	0.981818	0.545455
GCA_004917495.1-Fun_QZBE01000059.1_i000_007939	171	494	323	0.978788	0.624758
GCA_010583015.1-Fun_MU007060.1_i000_009171	121	454	333	1.00909	0.553156
GCA_000150735.2-Fun_KN275965.1_i000_006622	136	453	317	0.960606	0.488444
GCA_001713695.1-Fun_LYUC01000081.1_i000_007673	136	453	317	0.960606	0.488444
GCA_001713645.1-Fun_LZYO01000619.1_i000_006591	136	453	317	0.960606	0.487692
GCA_008761655.1-Pla_CM018222.1_i000_042113	123	436	313	0.948485	0.557932
GCA_013402915.1-Fun_CP058609.1_i000_003503	130	443	313	0.948485	0.612524
GCA_001272575.2-Fun_LAZP02000672.1_i000_007126	128	451	323	0.978788	0.451117
GCA_905182975.1-Pro_CAJJDM010000004.1_i000_002156	123	463	340	1.0303	0.701031
GCA_000151005.2-Fun_DS990638.1_i000_006543	136	449	313	0.948485	0.492138
GCA_000151035.1-Fun_GG692432.1_i000_001855	136	449	313	0.948485	0.492138
GCA_017310615.1-Fun_CP069105.1_i000_006478	136	449	313	0.948485	0.492138
GCA_009194965.1-Fun_VSMA01000022.1_i000_010256	135	460	325	0.984848	0.644841
GCA_905332115.1-Ani_CAJOBH010038677.1_i000_028109	2	297	295	0.893939	0.976821
GCA_003260635.2-Pla_QGKW02001988.1_i000_020586	122	398	276	0.836364	0.50365
GCA_001653215.1-Fun_LUKN01003658.1_i000_000591	129	455	326	0.987879	0.549747
GCA_010093995.1-Fun_ML992501.1_i000_000198	135	456	321	0.972727	0.555363
GCA_006912115.1-Fun_VCMJ01007113.1_i000_005454	5	317	312	0.945455	0.871508
GCA_017309325.2-Fun_JAESVG020000003.1_i000_002694	135	455	320	0.969697	0.553633
GCA_002269645.1-Ani_NIVC01000337.1_i000_009579	124	441	317	0.960606	0.581651
GCA_002269645.1-Ani_NIVC01004176.1_i000_046565	124	441	317	0.960606	0.581651
GCA_001662605.1-Fun_KV458781.1_i000_000590	135	422	287	0.869697	0.461415
GCA_013235015.1-Ani_BGPR01005086.1_i000_097142	60	387	327	0.990909	0.703226
GCA_002818225.1-Fun_KZ454988.1_i000_001107	137	462	325	0.984848	0.610902
GCA_002240705.1-Fun_NPHW01006087.1_i000_006104	134	451	317	0.960606	0.515447
GCA_021176775.1-Fun_JAJEVK010000004.1_i000_006512	134	470	336	1.01818	0.658824
GCA_000965225.2-Fun_BBTG02000003.1_i000_000853	133	462	329	0.99697	0.640078
GCA_000271645.1-Fun_JH711544.1_i000_007655	132	445	313	0.948485	0.543403
GCA_004522665.1-Fun_SNSD01000010.1_i000_005879	128	468	340	1.0303	0.589255
GCA_900257145.2-Pro_LT990239.1_i000_002347	118	449	331	1.00303	0.705757
GCA_020746875.1-Fun_JAGTJL010000008.1_i000_015683	128	456	328	0.993939	0.516535
GCA_900074755.1-Fun_LT598453.1_i000_003973	128	449	321	0.972727	0.62089
GCA_001636795.1-Fun_AZHF01000010.1_i000_002294	132	452	320	0.969697	0.541455
GCA_013364965.1-Fun_JAAMOD010000249.1_i000_007950	163	482	319	0.966667	0.508772
GCA_001619985.1-Fun_KV407455.1_i000_001600	134	445	311	0.942424	0.509836
GCA_004522655.2-Fun_SNSC02000010.1_i000_006013	128	469	341	1.03333	0.590988
GCA_905182995.1-Pro_CAJJDP010000003.1_i000_000987	123	464	341	1.03333	0.703093
GCA_000004825.1-Pro_GL291012.1_i000_011184	113	448	335	1.01515	0.615809
GCA_000237345.1-Fun_HE576753.1_i000_001588	130	448	318	0.963636	0.617476
GCA_020379485.1-Pla_JAGKQM010002591.1_i000_095093	141	451	310	0.939394	0.684327
GCA_007821545.1-Fun_QGMJ01000381.1_i000_005069	134	460	326	0.987879	0.463068
GCA_002157705.1-Pro_BDQF01000009.1_i000_001635	116	449	333	1.00909	0.702532
GCA_000296195.2-Pro_AGNL01046624.1_i000_030321	32	380	348	1.05455	0.742004
GCA_001633055.2-Fun_LKCN02000004.1_i000_005498	129	453	324	0.981818	0.469565
GCA_900088485.1-Pro_FLRD01000064.1_i000_001918	118	447	329	0.99697	0.675565
GCA_900088545.1-Pro_FLRE01000081.1_i000_001942	118	447	329	0.99697	0.675565
GCA_008636195.1-Fun_VXIT01000002.1_i000_004187	135	451	316	0.957576	0.423025
GCA_001500285.1-Fun_KQ947418.1_i000_009299	127	432	305	0.924242	0.453195
GCA_905183005.1-Pro_CAJJDO010000008.1_i000_003989	123	463	340	1.0303	0.701031
GCA_011057905.1-Fun_WUBL01000036.1_i000_006590	133	461	328	0.993939	0.51735
GCA_001972345.1-Fun_BDGX01000045.1_i000_008801	131	449	318	0.963636	0.616279
GCA_017607445.1-Fun_JAEVHH010000001.1_i000_000323	136	445	309	0.936364	0.485086
GCA_018924745.1-Fun_CM032184.1_i000_005893	136	470	334	1.01212	0.577855
GCA_021527035.1-Fun_JAKELG010000005.1_i000_008264	112	434	322	0.975758	0.669439
GCA_013266185.1-Fun_JABEXW010001040.1_i000_013522	128	456	328	0.993939	0.547579
GCA_000204515.1-Ani_GL888624.1_i000_012360	176	512	336	1.01818	0.623377
GCA_017607455.1-Ani_JAANHZ010000868.1_i000_004390	176	512	336	1.01818	0.623377
GCA_000448365.1-Fun_KE652523.1_i000_002997	132	463	331	1.00303	0.651575
GCA_000149515.1-Ani_DS268411.1_i000_027635	111	457	346	1.04848	0.700405
GCA_001696595.2-Fun_MBFL02000434.1_i000_008500	133	455	322	0.975758	0.560976
GCA_000723685.1-Pro_HG810771.1_i000_002898	118	448	330	1	0.703625
GCA_001601855.1-Pro_CM003851.1_i000_002126	118	448	330	1	0.703625
GCA_900097025.1-Pro_LT969573.1_i000_002583	118	448	330	1	0.703625
GCA_003013795.1-Fun_NHZQ01000072.1_i000_004620	133	456	323	0.978788	0.560764
GCA_005382405.1-Fun_PTQR01000081.1_i000_008223	133	456	323	0.978788	0.560764
GCA_004917615.1-Fun_QZAY01000063.1_i000_008672	135	461	326	0.987879	0.601476
GCA_000523435.1-Fun_KI964564.1_i000_003203	125	451	326	0.987879	0.572935
GCA_004917795.1-Fun_QZBL01000474.1_i000_006713	135	464	329	0.99697	0.609259
GCA_022453505.1-Fun_JAJLYR010000009.1_i000_011780	133	460	327	0.990909	0.528271
GCA_004917135.1-Fun_QZAJ01000195.1_i000_002628	135	464	329	0.99697	0.609259
GCA_004917275.1-Fun_QZAO01000394.1_i000_006126	135	464	329	0.99697	0.609259
GCA_000240725.1-Pro_JH470846.1_i000_001235	1	290	289	0.875758	0.932258
GCA_010093605.1-Fun_MU004181.1_i000_000798	131	454	323	0.978788	0.550256
GCA_002591405.1-Fun_NJEU01000029.1_i000_003715	128	467	339	1.02727	0.664706
GCA_001680005.1-Pro_CP016246.1_i000_002246	118	449	331	1.00303	0.698312
GCA_000006355.3-Pro_AM910990.2_i000_001634	118	449	331	1.00303	0.698312
GCA_002140095.1-Pro_NETL01000024.1_i000_000273	118	449	331	1.00303	0.698312
GCA_900005025.2-Pro_CWHR02000028.1_i000_000307	118	449	331	1.00303	0.698312
GCA_015832175.1-Fun_WJXW01000016.1_i000_012559	179	509	330	1	0.525478
GCA_009982845.1-Fun_JAADKB010000006.1_i000_007396	134	437	303	0.918182	0.526957
GCA_002249905.1-Ani_NNAY01000126.1_i000_001566	130	204	74	0.224242	0.123746
GCA_002249905.1-Ani_NNAY01000126.1_i000_001566	193	470	277	0.839394	0.463211
GCA_022453515.1-Fun_JAJNNY010000012.1_i000_001393	128	457	329	0.99697	0.527244
GCA_004918275.1-Fun_QZBR01000023.1_i000_004289	148	474	326	0.987879	0.588448
GCA_001883845.1-Fun_MNUE01000020.1_i000_003337	124	459	335	1.01515	0.597148
GCA_001645045.2-Fun_LWDE02001842.1_i000_002783	127	452	325	0.984848	0.528455
GCA_009428265.1-Fun_RDSE01001816.1_i000_002601	127	452	325	0.984848	0.528455
GCA_001645005.2-Fun_LWDD02001812.1_i000_002590	127	452	325	0.984848	0.526742
GCA_009428275.1-Fun_RDSF01000922.1_i000_009475	127	452	325	0.984848	0.526742
GCA_009428285.1-Fun_RDSG01000857.1_i000_009069	127	452	325	0.984848	0.526742
GCA_905068135.1-Fun_CAJHJA010001693.1_i000_002694	127	452	325	0.984848	0.526742
GCA_905071705.1-Fun_CAJHJC010004711.1_i000_006238	127	452	325	0.984848	0.526742
GCA_905071715.1-Fun_CAJHJH010000783.1_i000_001416	127	452	325	0.984848	0.526742
GCA_905071725.1-Fun_CAJHJD010001690.1_i000_002892	127	452	325	0.984848	0.526742
GCA_905071735.1-Fun_CAJHJE010003729.1_i000_005143	127	452	325	0.984848	0.526742
GCA_905071745.1-Fun_CAJHJG010002066.1_i000_002968	127	452	325	0.984848	0.526742
GCA_905071755.1-Fun_CAJHJF010002240.1_i000_003608	127	452	325	0.984848	0.526742
GCA_905071765.1-Fun_CAJHJB010000113.1_i000_003708	127	452	325	0.984848	0.526742
GCA_905071775.1-Fun_CAJHJJ010000256.1_i000_000350	127	452	325	0.984848	0.526742
GCA_905071785.1-Fun_CAJHJI010004431.1_i000_006038	127	452	325	0.984848	0.526742
GCA_905072865.1-Fun_CAJHJV010005009.1_i000_007256	127	452	325	0.984848	0.526742
GCA_004917555.1-Fun_QZBJ01000009.1_i000_009730	137	458	321	0.972727	0.593346
GCA_004917815.1-Fun_QZBQ01000019.1_i000_003162	137	458	321	0.972727	0.593346
GCA_000338975.1-Fun_KB445594.1_i000_012934	125	451	326	0.987879	0.575972
GCA_000354255.1-Fun_KB733452.1_i000_005019	125	451	326	0.987879	0.575972
GCA_019454015.1-Fun_JAHUAA010000015.1_i000_004409	125	451	326	0.987879	0.575972
GCA_003369635.1-Fun_PDLN01000013.1_i000_003126	135	450	315	0.954545	0.511364
GCA_000338995.1-Fun_KB445637.1_i000_001234	126	451	325	0.984848	0.575221
GCA_009613015.1-Fun_VXCB01000087.1_i000_013602	125	431	306	0.927273	0.46015
GCA_000687475.2-Fun_CP072756.1_i000_005213	136	466	330	1	0.652174
GCA_001879275.1-Fun_KV875100.1_i000_009260	147	466	319	0.966667	0.613462
GCA_004917355.1-Fun_QZAS01000019.1_i000_003067	134	457	323	0.978788	0.597043
GCA_903819635.1-Fun_CAIJEN010000002.1_i000_001953	134	459	325	0.984848	0.659229
GCA_000721785.1-Fun_KL584974.1_i000_000885	137	458	321	0.972727	0.593346
GCA_004917115.1-Fun_QZAI01000550.1_i000_002231	137	458	321	0.972727	0.593346
GCA_004917155.1-Fun_QZAG01001266.1_i000_001244	137	458	321	0.972727	0.593346
GCA_004917185.1-Fun_QZAL01000196.1_i000_003607	137	458	321	0.972727	0.593346
GCA_004917255.1-Fun_QZAM01000084.1_i000_010015	137	458	321	0.972727	0.593346
GCA_004917305.1-Fun_QZAP01000299.1_i000_005506	137	458	321	0.972727	0.593346
GCA_004917375.1-Fun_QZAT01000018.1_i000_003032	137	458	321	0.972727	0.593346
GCA_004917415.1-Fun_QZAX01000980.1_i000_010537	137	458	321	0.972727	0.593346
GCA_004917435.1-Fun_QZBA01000158.1_i000_002315	137	458	321	0.972727	0.593346
GCA_004917445.1-Fun_QZBB01000152.1_i000_002461	137	458	321	0.972727	0.593346
GCA_004917485.1-Fun_QZBD01000466.1_i000_006634	137	458	321	0.972727	0.593346
GCA_004917505.1-Fun_QZBF01000145.1_i000_001999	137	458	321	0.972727	0.593346
GCA_004917525.1-Fun_QZBG01000201.1_i000_002845	137	458	321	0.972727	0.593346
GCA_004917595.1-Fun_QZAQ01001755.1_i000_003058	137	458	321	0.972727	0.593346
GCA_004917605.1-Fun_QZAU01001331.1_i000_001653	137	458	321	0.972727	0.593346
GCA_004917685.1-Fun_QZBI01001091.1_i000_000463	137	458	321	0.972727	0.593346
GCA_004917705.1-Fun_QZBK01000454.1_i000_006720	137	458	321	0.972727	0.593346
GCA_004917755.1-Fun_QZBO01000152.1_i000_002099	137	458	321	0.972727	0.593346
GCA_004918115.1-Fun_QZBT01000229.1_i000_004499	137	458	321	0.972727	0.593346
GCA_004918145.1-Fun_QZBV01000071.1_i000_009410	137	458	321	0.972727	0.593346
GCA_004918165.1-Fun_QZBW01000679.1_i000_009274	137	458	321	0.972727	0.593346
GCA_004918195.1-Fun_QZCA01000021.1_i000_003413	137	458	321	0.972727	0.593346
GCA_004918245.1-Fun_QZBX01000013.1_i000_001526	137	458	321	0.972727	0.593346
GCA_004918505.1-Fun_QZCB01000314.1_i000_004787	137	458	321	0.972727	0.593346
GCA_004918575.1-Fun_QZBY01000538.1_i000_007297	137	458	321	0.972727	0.593346
GCA_004786225.1-Fun_PQXJ01000182.1_i000_006300	136	453	317	0.960606	0.555166
GCA_004917205.1-Fun_QZAN01000092.1_i000_010070	180	507	327	0.990909	0.55802
GCA_000721755.1-Fun_KL584750.1_i000_001370	135	460	325	0.984848	0.601852
GCA_015679605.1-Fun_JAAAVE010000507.1_i000_007617	120	442	322	0.975758	0.646586
GCA_000240135.3-Fun_CM000576.1_i000_009911	132	453	321	0.972727	0.538591
GCA_000599445.1-Fun_CM002653.1_i000_009707	132	453	321	0.972727	0.538591
GCA_002352725.1-Fun_NQOC01000002.1_i000_002573	132	453	321	0.972727	0.538591
GCA_900044135.1-Fun_HG970334.1_i000_010383	132	453	321	0.972727	0.538591
GCA_900073075.1-Fun_LT222055.1_i000_010424	132	453	321	0.972727	0.538591
GCA_903819485.1-Fun_CAIJDU010000003.1_i000_002725	154	476	322	0.975758	0.575
GCA_001563735.1-Fun_KQ962655.1_i000_008413	119	400	281	0.851515	0.69727
GCA_004918105.1-Fun_QZBS01000753.1_i000_009544	137	458	321	0.972727	0.593346
GCA_019973955.1-Ani_BMAV01009158.1_i000_016230	113	454	341	1.03333	0.614414
GCA_003033665.1-Fun_PVEM01000004.1_i000_009532	132	453	321	0.972727	0.538591
GCA_016952355.1-Fun_CP064748.1_i000_004807	132	453	321	0.972727	0.538591
GCA_900169345.1-Fun_FWEW01000268.1_i000_007465	135	451	316	0.957576	0.423025
GCA_017366145.1-Fun_JAFJYG010000075.1_i000_002910	128	458	330	1	0.484581
GCA_001642045.1-Fun_KV441560.1_i000_012987	125	457	332	1.00606	0.578397
GCA_002906115.4-Pla_PKMF03007331.1_i000_026918	124	442	318	0.963636	0.453638
GCA_900097015.1-Pro_LT969419.1_i000_002308	118	448	330	1	0.703625
GCA_004917145.1-Fun_QZAE01000330.1_i000_005243	180	509	329	0.99697	0.561433
GCA_900492705.2-Fun_UIHA02000073.1_i000_008788	163	482	319	0.966667	0.508772
GCA_901446245.1-Fun_CABDWO010000179.1_i000_007061	163	482	319	0.966667	0.508772
GCA_905359455.1-Fun_CAJPII010000059.1_i000_005145	163	482	319	0.966667	0.508772
GCA_905359475.1-Fun_CAJPIG010000154.1_i000_006819	163	482	319	0.966667	0.508772
GCA_001972345.1-Fun_BDGX01000021.1_i000_003895	129	438	309	0.936364	0.605882
GCA_010093485.1-Fun_MU001513.1_i000_013951	125	457	332	1.00606	0.577391
GCA_905332025.1-Fun_CAJOAV010000106.1_i000_004283	164	483	319	0.966667	0.507962
GCA_905332055.1-Fun_CAJOAW010000116.1_i000_011161	164	483	319	0.966667	0.507962
GCA_905359465.1-Fun_CAJPIH010000764.1_i000_006323	164	483	319	0.966667	0.507962
GCA_905359485.1-Fun_CAJPIJ010000134.1_i000_006113	164	483	319	0.966667	0.507962
GCA_020341155.1-Ani_JAHMML010000006.1_i000_008391	161	497	336	1.01818	0.637571
GCA_004918215.1-Fun_QZBP01001305.1_i000_001417	181	502	321	0.972727	0.547782
GCA_019924115.1-Fun_JAHFXA010000449.1_i000_002986	134	444	310	0.939394	0.688889
GCA_019924275.1-Fun_JAHFXJ010000501.1_i000_003603	134	444	310	0.939394	0.688889
GCA_022343325.1-Fun_JACTNT010000013.1_i000_003447	118	459	341	1.03333	0.597198
GCA_000243375.1-Fun_HE616743.1_i000_000899	133	446	313	0.948485	0.621032
GCA_004917165.1-Fun_QZAK01000230.1_i000_004362	173	494	321	0.972727	0.555363
GCA_004917335.1-Fun_QZAR01000023.1_i000_004342	173	494	321	0.972727	0.555363
GCA_004917425.1-Fun_QZAZ01000139.1_i000_001394	173	494	321	0.972727	0.555363
GCA_004917625.1-Fun_QZBC01000007.1_i000_008653	173	494	321	0.972727	0.555363
GCA_004917665.1-Fun_QZBH01000033.1_i000_005190	173	494	321	0.972727	0.555363
GCA_010093685.1-Fun_MU006217.1_i000_001946	112	448	336	1.01818	0.601073
GCA_004917105.1-Fun_QZAF01000084.1_i000_009640	181	502	321	0.972727	0.547782
GCA_004917385.1-Fun_QZAV01000048.1_i000_007647	181	502	321	0.972727	0.547782
GCA_004917745.1-Fun_QZBN01000198.1_i000_003753	181	502	321	0.972727	0.547782
GCA_004917825.1-Fun_QZBZ01000270.1_i000_004885	181	502	321	0.972727	0.547782
GCA_004918535.1-Fun_QZBU01002010.1_i000_005800	181	502	321	0.972727	0.547782
GCA_007182795.1-Fun_VFLP01000034.1_i000_005387	133	460	327	0.990909	0.528271
GCA_004786275.1-Fun_PQXN01000002.1_i000_000192	136	454	318	0.963636	0.556918
GCA_000165425.1-Pro_CT868540.1_i000_029696	123	459	336	1.01818	0.692784
GCA_010093695.1-Fun_MU006334.1_i000_010558	118	459	341	1.03333	0.590988
GCA_000002765.3-Pro_LN999944.1_i000_002547	118	448	330	1	0.703625
GCA_000149665.2-Pro_CH671979.1_i000_002440	118	448	330	1	0.703625
GCA_000150435.3-Pro_KE123618.1_i000_002820	118	448	330	1	0.703625
GCA_000150455.3-Pro_KE123495.1_i000_002726	118	448	330	1	0.703625
GCA_000401695.2-Pro_KE123814.1_i000_002758	118	448	330	1	0.703625
GCA_000401715.2-Pro_KE124574.1_i000_002835	118	448	330	1	0.703625
GCA_000521015.1-Pro_KI925079.1_i000_002741	118	448	330	1	0.703625
GCA_000521035.1-Pro_KI925546.1_i000_002743	118	448	330	1	0.703625
GCA_000521055.1-Pro_KI926414.1_i000_002789	118	448	330	1	0.703625
GCA_000521075.1-Pro_KI926048.1_i000_002895	118	448	330	1	0.703625
GCA_000521095.1-Pro_KI927303.1_i000_001275	118	448	330	1	0.703625
GCA_000521115.1-Pro_KI927515.1_i000_002717	118	448	330	1	0.703625
GCA_000521155.1-Pro_KI927891.1_i000_001800	118	448	330	1	0.703625
GCA_002831795.1-Pro_NYMT01000016.1_i000_004583	118	448	330	1	0.703625
GCA_012898025.1-Pro_QFXU01000017.1_i000_003020	118	448	330	1	0.703625
GCA_900095595.1-Pro_LT963423.1_i000_002617	118	448	330	1	0.703625
GCA_000166005.1-Fun_GL535264.1_i000_006368	126	451	325	0.984848	0.569177
GCA_009728635.1-Fun_WJSK01000003.1_i000_002813	126	451	325	0.984848	0.569177
GCA_009728645.1-Fun_WJSL01000004.1_i000_004314	126	451	325	0.984848	0.569177
GCA_009728655.1-Fun_WJSN01000003.1_i000_003554	126	451	325	0.984848	0.569177
GCA_009728665.1-Fun_WJSO01000003.1_i000_003605	126	451	325	0.984848	0.569177
GCA_009728675.1-Fun_WJSM01000003.1_i000_002661	126	451	325	0.984848	0.569177
GCA_900231935.2-Fun_OCTF02000005.1_i000_006027	126	451	325	0.984848	0.569177
GCA_900232045.3-Fun_HG992981.1_i000_006568	126	451	325	0.984848	0.569177
GCA_019924615.1-Fun_JAHFXW010004806.1_i000_014762	97	423	326	0.987879	0.653307
GCA_011058905.1-Fun_SWKU01000020.1_i000_004667	116	453	337	1.02121	0.601786
GCA_002049455.2-Pro_KV919330.1_i000_011351	148	457	309	0.936364	0.544014
GCA_012550715.1-Fun_JAANYQ010000001.1_i000_000117	147	476	329	0.99697	0.530645
GCA_005059855.1-Fun_NAJP01000035.1_i000_009337	136	451	315	0.954545	0.520661
GCA_001602025.1-Pro_CM003865.1_i000_002193	118	448	330	1	0.703625
GCA_900240055.1-Pro_LT969447.1_i000_002332	118	448	330	1	0.703625
GCA_003016335.1-Fun_KZ678130.1_i000_003296	122	457	335	1.01515	0.582609
GCA_010094085.1-Fun_ML986487.1_i000_002858	121	451	330	1	0.557432
GCA_000611835.1-Ani_KK107324.1_i000_010424	111	444	333	1.00909	0.49925
GCA_003672135.1-Ani_CM010861.1_i000_005616	111	444	333	1.00909	0.49925
GCA_900073065.1-Fun_FJOG01000011.1_i000_012792	54	373	319	0.966667	0.747073
GCA_000359705.1-Fun_KB908559.1_i000_004395	126	451	325	0.984848	0.571178
GCA_003268335.1-Fun_QGDH01000078.1_i000_008010	57	381	324	0.981818	0.641584
GCA_000611835.1-Ani_KK107921.1_i000_015752	132	463	331	1.00303	0.650295
GCA_002003505.1-Fun_BDMC01000013.1_i000_005133	133	459	326	0.987879	0.510972
GCA_905178165.1-Pro_CAJINU010000010.1_i000_005230	113	449	336	1.01818	0.697095
GCA_001191545.1-Fun_LGLR01000185.1_i000_004605	60	384	324	0.981818	0.637795
GCA_003268315.1-Fun_QGDG01000031.1_i000_004173	60	384	324	0.981818	0.637795
GCA_000816705.1-Ani_KN716616.1_i000_010916	124	471	347	1.05152	0.681729
GCA_010093505.1-Fun_MU001640.1_i000_008225	130	450	320	0.969697	0.525452
GCA_019924315.1-Fun_JAHFXH010000719.1_i000_004633	134	462	328	0.993939	0.609665
GCA_019924355.1-Fun_JAHFXO010001326.1_i000_009510	134	462	328	0.993939	0.609665
GCA_019924395.1-Fun_JAHFXN010000354.1_i000_002841	134	462	328	0.993939	0.609665
GCA_019924485.1-Fun_JAHFXR010001560.1_i000_009839	134	462	328	0.993939	0.609665
GCA_019924675.1-Fun_JAHFXY010000834.1_i000_004971	134	462	328	0.993939	0.609665
GCA_019924755.1-Fun_JAHFYB010000722.1_i000_004443	134	462	328	0.993939	0.609665
GCA_020747015.1-Fun_JAGTJM010000018.1_i000_003639	118	456	338	1.02424	0.58885
GCA_014235945.1-Fun_WIGO01000117.1_i000_008332	98	450	352	1.06667	0.568659
GCA_001675295.1-Fun_LYXU01000003.1_i000_008853	132	456	324	0.981818	0.546374
GCA_014133895.1-Fun_CP059253.1_i000_004547	132	448	316	0.957576	0.620825
GCA_019925055.1-Fun_JAHFYR010000004.1_i000_004502	135	456	321	0.972727	0.596654
GCA_020726505.1-Fun_JAHLEZ010000010.1_i000_002352	132	444	312	0.945455	0.45614
GCA_021432625.1-Fun_MU270344.1_i000_005146	132	444	312	0.945455	0.45614
GCA_010405375.1-Fun_MU004360.1_i000_008425	46	387	341	1.03333	0.677932
GCA_016801405.1-Fun_CP069028.1_i000_006001	117	458	341	1.03333	0.602473
GCA_020557385.1-Fun_JAIRDT010000022.1_i000_010936	117	458	341	1.03333	0.602473
GCA_020567955.1-Fun_JAIRGA010000023.1_i000_011287	117	458	341	1.03333	0.602473
GCA_020568045.1-Fun_JAIRGB010000053.1_i000_015297	117	458	341	1.03333	0.602473
GCA_020568055.1-Fun_JAIRGC010000018.1_i000_007404	117	458	341	1.03333	0.602473
GCA_020568095.1-Fun_JAIRGD010000023.1_i000_011815	117	458	341	1.03333	0.602473
GCA_020568205.1-Fun_JAIRGE010000022.1_i000_011367	117	458	341	1.03333	0.602473
GCA_020568325.1-Fun_JAIRDU010000019.1_i000_010236	117	458	341	1.03333	0.602473
GCA_020568415.1-Fun_JAIRDV010000036.1_i000_013581	117	458	341	1.03333	0.602473
GCA_020568465.1-Fun_JAIRDW010000021.1_i000_011961	117	458	341	1.03333	0.602473
GCA_020568635.1-Fun_JAIRDX010000026.1_i000_013112	117	458	341	1.03333	0.602473
GCA_020568705.1-Fun_JAIRGF010000018.1_i000_008978	117	458	341	1.03333	0.602473
GCA_020568765.1-Fun_JAIRDY010000042.1_i000_016142	117	458	341	1.03333	0.602473
GCA_020568775.1-Fun_JAIRGG010000053.1_i000_014034	117	458	341	1.03333	0.602473
GCA_020568935.1-Fun_JAIRGH010000022.1_i000_011465	117	458	341	1.03333	0.602473
GCA_020568945.1-Fun_JAIRDZ010000021.1_i000_010158	117	458	341	1.03333	0.602473
GCA_020569145.1-Fun_JAIREA010000020.1_i000_010819	117	458	341	1.03333	0.602473
GCA_020569235.1-Fun_JAIREB010000021.1_i000_011709	117	458	341	1.03333	0.602473
GCA_020569285.1-Fun_JAIREC010000001.1_i000_000779	117	458	341	1.03333	0.602473
GCA_020569485.1-Fun_JAIRGI010000024.1_i000_012857	117	458	341	1.03333	0.602473
GCA_020569495.1-Fun_JAIRED010000045.1_i000_015373	117	458	341	1.03333	0.602473
GCA_020569505.1-Fun_JAIREE010000021.1_i000_011362	117	458	341	1.03333	0.602473
GCA_020569515.1-Fun_JAIRGJ010000023.1_i000_011590	117	458	341	1.03333	0.602473
GCA_020569685.1-Fun_JAIRGK010000002.1_i000_015344	117	458	341	1.03333	0.602473
GCA_020569895.1-Fun_JAIRGL010000017.1_i000_009456	117	458	341	1.03333	0.602473
GCA_020569945.1-Fun_JAIREF010000019.1_i000_009612	117	458	341	1.03333	0.602473
GCA_020570015.1-Fun_JAIREG010000001.1_i000_000317	117	458	341	1.03333	0.602473
GCA_020570045.1-Fun_JAIREI010000001.1_i000_000819	117	458	341	1.03333	0.602473
GCA_020570345.1-Fun_JAIRGM010000001.1_i000_000318	117	458	341	1.03333	0.602473
GCA_020570355.1-Fun_JAIREH010000001.1_i000_000767	117	458	341	1.03333	0.602473
GCA_020570395.1-Fun_JAIRGN010000002.1_i000_002247	117	458	341	1.03333	0.602473
GCA_020570405.1-Fun_JAIREJ010000002.1_i000_002416	117	458	341	1.03333	0.602473
GCA_020570415.1-Fun_JAIRGO010000002.1_i000_002404	117	458	341	1.03333	0.602473
GCA_020570525.1-Fun_JAIREK010000001.1_i000_000105	117	458	341	1.03333	0.602473
GCA_020570635.1-Fun_JAIRGP010000001.1_i000_000783	117	458	341	1.03333	0.602473
GCA_020570685.1-Fun_JAIRGQ010000036.1_i000_015097	117	458	341	1.03333	0.602473
GCA_020570735.1-Fun_JAIRGR010000001.1_i000_000710	117	458	341	1.03333	0.602473
GCA_020570935.1-Fun_JAIREL010000003.1_i000_002947	117	458	341	1.03333	0.602473
GCA_020570965.1-Fun_JAIRGS010000002.1_i000_001902	117	458	341	1.03333	0.602473
GCA_020570975.1-Fun_JAIRGT010000046.1_i000_016350	117	458	341	1.03333	0.602473
GCA_020571265.1-Fun_JAIREM010000034.1_i000_014175	117	458	341	1.03333	0.602473
GCA_020571295.1-Fun_JAIRGU010000022.1_i000_012228	117	458	341	1.03333	0.602473
GCA_020571325.1-Fun_JAIREN010000019.1_i000_009579	117	458	341	1.03333	0.602473
GCA_020571545.1-Fun_JAIREO010000023.1_i000_010831	117	458	341	1.03333	0.602473
GCA_020571575.1-Fun_JAIRGV010000001.1_i000_000164	117	458	341	1.03333	0.602473
GCA_020571605.1-Fun_JAIRGW010000015.1_i000_006295	117	458	341	1.03333	0.602473
GCA_020571815.1-Fun_JAIRGX010000022.1_i000_009767	117	458	341	1.03333	0.602473
GCA_020571885.1-Fun_JAIRGY010000049.1_i000_015878	117	458	341	1.03333	0.602473
GCA_020571895.1-Fun_JAIREP010000001.1_i000_000818	117	458	341	1.03333	0.602473
GCA_020571965.1-Fun_JAIRGZ010000002.1_i000_001664	117	458	341	1.03333	0.602473
GCA_020572075.1-Fun_JAIRHA010000017.1_i000_008281	117	458	341	1.03333	0.602473
GCA_020572205.1-Fun_JAIREQ010000021.1_i000_011072	117	458	341	1.03333	0.602473
GCA_020572305.1-Fun_JAIRHC010000023.1_i000_009346	117	458	341	1.03333	0.602473
GCA_020572315.1-Fun_JAIRHB010000020.1_i000_012043	117	458	341	1.03333	0.602473
GCA_020572345.1-Fun_JAIRHD010000001.1_i000_000164	117	458	341	1.03333	0.602473
GCA_020572395.1-Fun_JAIRHG010000020.1_i000_009022	117	458	341	1.03333	0.602473
GCA_020572635.1-Fun_JAIRHE010000005.1_i000_016820	117	458	341	1.03333	0.602473
GCA_020572645.1-Fun_JAIRHF010000030.1_i000_011572	117	458	341	1.03333	0.602473
GCA_020572675.1-Fun_JAIRHH010000056.1_i000_013641	117	458	341	1.03333	0.602473
GCA_020572945.1-Fun_JAIRHJ010000001.1_i000_016759	117	458	341	1.03333	0.602473
GCA_020572955.1-Fun_JAIRHI010000046.1_i000_015413	117	458	341	1.03333	0.602473
GCA_020572985.1-Fun_JAIRER010000015.1_i000_007321	117	458	341	1.03333	0.602473
GCA_020572995.1-Fun_JAIRES010000019.1_i000_009374	117	458	341	1.03333	0.602473
GCA_020573275.1-Fun_JAIRHK010000022.1_i000_010372	117	458	341	1.03333	0.602473
GCA_020573285.1-Fun_JAIRHL010000020.1_i000_011298	117	458	341	1.03333	0.602473
GCA_020573315.1-Fun_JAIRHM010000023.1_i000_010956	117	458	341	1.03333	0.602473
GCA_020573325.1-Fun_JAIRET010000019.1_i000_012172	117	458	341	1.03333	0.602473
GCA_020573495.1-Fun_JAIRHN010000018.1_i000_008070	117	458	341	1.03333	0.602473
GCA_020573595.1-Fun_JAIRHO010000021.1_i000_009592	117	458	341	1.03333	0.602473
GCA_020573605.1-Fun_JAIRHP010000049.1_i000_017205	117	458	341	1.03333	0.602473
GCA_020573625.1-Fun_JAIRHQ010000019.1_i000_009672	117	458	341	1.03333	0.602473
GCA_020573725.1-Fun_JAIREU010000059.1_i000_016887	117	458	341	1.03333	0.602473
GCA_020573765.1-Fun_JAIREV010000046.1_i000_015442	117	458	341	1.03333	0.602473
GCA_020573915.1-Fun_JAIRHR010000049.1_i000_013873	117	458	341	1.03333	0.602473
GCA_020574055.1-Fun_JAIRHS010000025.1_i000_011086	117	458	341	1.03333	0.602473
GCA_020574085.1-Fun_JAIRHT010000024.1_i000_013475	117	458	341	1.03333	0.602473
GCA_020574115.1-Fun_JAIRHU010000018.1_i000_008039	117	458	341	1.03333	0.602473
GCA_020574145.1-Fun_JAIREW010000002.1_i000_001907	117	458	341	1.03333	0.602473
GCA_020574155.1-Fun_JAIREX010000020.1_i000_011229	117	458	341	1.03333	0.602473
GCA_020574265.1-Fun_JAIREY010000040.1_i000_015516	117	458	341	1.03333	0.602473
GCA_020574295.1-Fun_JAIRHV010000002.1_i000_001728	117	458	341	1.03333	0.602473
GCA_020574345.1-Fun_JAIREZ010000016.1_i000_009880	117	458	341	1.03333	0.602473
GCA_020574365.1-Fun_JAIRHW010000016.1_i000_008840	117	458	341	1.03333	0.602473
GCA_020574375.1-Fun_JAIRFA010000023.1_i000_012513	117	458	341	1.03333	0.602473
GCA_020574385.1-Fun_JAIRFB010000048.1_i000_015278	117	458	341	1.03333	0.602473
GCA_020574405.1-Fun_JAIRHY010000020.1_i000_010245	117	458	341	1.03333	0.602473
GCA_020574595.1-Fun_JAIRHX010000019.1_i000_010729	117	458	341	1.03333	0.602473
GCA_020574615.1-Fun_JAIRHZ010000002.1_i000_014919	117	458	341	1.03333	0.602473
GCA_020574715.1-Fun_JAIRFC010000001.1_i000_000650	117	458	341	1.03333	0.602473
GCA_020574725.1-Fun_JAIRFD010000024.1_i000_012971	117	458	341	1.03333	0.602473
GCA_020574755.1-Fun_JAIRIA010000053.1_i000_016144	117	458	341	1.03333	0.602473
GCA_020574825.1-Fun_JAIRIB010000023.1_i000_012588	117	458	341	1.03333	0.602473
GCA_020574875.1-Fun_JAIRIC010000020.1_i000_010140	117	458	341	1.03333	0.602473
GCA_020575035.1-Fun_JAIRFE010000019.1_i000_010658	117	458	341	1.03333	0.602473
GCA_020575105.1-Fun_JAIRID010000021.1_i000_010781	117	458	341	1.03333	0.602473
GCA_020575195.1-Fun_JAIRIE010000025.1_i000_010251	117	458	341	1.03333	0.602473
GCA_020575285.1-Fun_JAIRIF010000019.1_i000_007798	117	458	341	1.03333	0.602473
GCA_020575355.1-Fun_JAIRIH010000026.1_i000_012536	117	458	341	1.03333	0.602473
GCA_020575375.1-Fun_JAIRIG010000009.1_i000_005622	117	458	341	1.03333	0.602473
GCA_020575405.1-Fun_JAIRII010000001.1_i000_000322	117	458	341	1.03333	0.602473
GCA_020575445.1-Fun_JAIRIJ010000016.1_i000_007506	117	458	341	1.03333	0.602473
GCA_020575485.1-Fun_JAIRIK010000019.1_i000_009252	117	458	341	1.03333	0.602473
GCA_020575615.1-Fun_JAIRIL010000021.1_i000_009463	117	458	341	1.03333	0.602473
GCA_020575645.1-Fun_JAIRIM010000013.1_i000_007175	117	458	341	1.03333	0.602473
GCA_020575775.1-Fun_JAIRIN010000021.1_i000_009988	117	458	341	1.03333	0.602473
GCA_020575955.1-Fun_JAIRIO010000024.1_i000_008442	117	458	341	1.03333	0.602473
GCA_020575975.1-Fun_JAIRFF010000019.1_i000_008078	117	458	341	1.03333	0.602473
GCA_020575995.1-Fun_JAIRIP010000007.1_i000_004363	117	458	341	1.03333	0.602473
GCA_020576185.1-Fun_JAIRIQ010000001.1_i000_000105	117	458	341	1.03333	0.602473
GCA_020576195.1-Fun_JAIRFG010000001.1_i000_000036	117	458	341	1.03333	0.602473
GCA_020576365.1-Fun_JAIRFI010000047.1_i000_014307	117	458	341	1.03333	0.602473
GCA_020577795.1-Fun_JAIRFH010000046.1_i000_014856	117	458	341	1.03333	0.602473
GCA_020577805.1-Fun_JAIRFJ010000043.1_i000_014387	117	458	341	1.03333	0.602473
GCA_020577855.1-Fun_JAIRFK010000045.1_i000_013952	117	458	341	1.03333	0.602473
GCA_020577905.1-Fun_JAIRFL010000046.1_i000_014794	117	458	341	1.03333	0.602473
GCA_020577915.1-Fun_JAIRFM010000042.1_i000_013484	117	458	341	1.03333	0.602473
GCA_020578075.1-Fun_JAIRFO010000047.1_i000_014422	117	458	341	1.03333	0.602473
GCA_020578085.1-Fun_JAIRFN010000007.1_i000_003888	117	458	341	1.03333	0.602473
GCA_020578095.1-Fun_JAIRFP010000049.1_i000_014267	117	458	341	1.03333	0.602473
GCA_020578105.1-Fun_JAIRFQ010000047.1_i000_014401	117	458	341	1.03333	0.602473
GCA_020578115.1-Fun_JAIRFR010000047.1_i000_014218	117	458	341	1.03333	0.602473
GCA_020578205.1-Fun_JAIRFS010000010.1_i000_006152	117	458	341	1.03333	0.602473
GCA_020578265.1-Fun_JAIRIR010000049.1_i000_015321	117	458	341	1.03333	0.602473
GCA_020578295.1-Fun_JAIRIT010000021.1_i000_011437	117	458	341	1.03333	0.602473
GCA_020578315.1-Fun_JAIRIS010000037.1_i000_013652	117	458	341	1.03333	0.602473
GCA_020578375.1-Fun_JAIRFT010000023.1_i000_012588	117	458	341	1.03333	0.602473
GCA_020578445.1-Fun_JAIRIU010000048.1_i000_015113	117	458	341	1.03333	0.602473
GCA_020578515.1-Fun_JAIRIV010000045.1_i000_013878	117	458	341	1.03333	0.602473
GCA_020578585.1-Fun_JAIRIW010000020.1_i000_010653	117	458	341	1.03333	0.602473
GCA_020578615.1-Fun_JAIRIX010000047.1_i000_015988	117	458	341	1.03333	0.602473
GCA_020579815.1-Fun_JAIRIZ010000002.1_i000_001978	117	458	341	1.03333	0.602473
GCA_020579825.1-Fun_JAIRIY010000022.1_i000_009283	117	458	341	1.03333	0.602473
GCA_020579835.1-Fun_JAIRJA010000003.1_i000_000108	117	458	341	1.03333	0.602473
GCA_020579845.1-Fun_JAIRJB010000021.1_i000_010542	117	458	341	1.03333	0.602473
GCA_020579855.1-Fun_JAIRFU010000021.1_i000_009508	117	458	341	1.03333	0.602473
GCA_020580075.1-Fun_JAIRJC010000018.1_i000_009084	117	458	341	1.03333	0.602473
GCA_020580085.1-Fun_JAIRJD010000018.1_i000_009380	117	458	341	1.03333	0.602473
GCA_020580115.1-Fun_JAIRFV010000018.1_i000_009169	117	458	341	1.03333	0.602473
GCA_020580145.1-Fun_JAIRJE010000025.1_i000_010507	117	458	341	1.03333	0.602473
GCA_020580155.1-Fun_JAIRJF010000041.1_i000_016190	117	458	341	1.03333	0.602473
GCA_020580305.1-Fun_JAIRJG010000025.1_i000_011754	117	458	341	1.03333	0.602473
GCA_020580415.1-Fun_JAIRFW010000021.1_i000_009839	117	458	341	1.03333	0.602473
GCA_020580425.1-Fun_JAIRJH010000018.1_i000_008885	117	458	341	1.03333	0.602473
GCA_020580485.1-Fun_JAIRJI010000036.1_i000_013018	117	458	341	1.03333	0.602473
GCA_020580655.1-Fun_JAIRFX010000018.1_i000_010169	117	458	341	1.03333	0.602473
GCA_020580665.1-Fun_JAIRFY010000019.1_i000_010722	117	458	341	1.03333	0.602473
GCA_020580695.1-Fun_JAIRJK010000052.1_i000_015689	117	458	341	1.03333	0.602473
GCA_020580725.1-Fun_JAIRJJ010000019.1_i000_010549	117	458	341	1.03333	0.602473
GCA_020580775.1-Fun_JAIRJL010000057.1_i000_013699	117	458	341	1.03333	0.602473
GCA_020580905.1-Fun_JAIRFZ010000022.1_i000_010588	117	458	341	1.03333	0.602473
GCA_020581045.1-Fun_JAIRJM010000019.1_i000_009803	117	458	341	1.03333	0.602473
GCA_020581155.1-Fun_JAIRJN010000019.1_i000_008190	117	458	341	1.03333	0.602473
GCA_020581165.1-Fun_JAIRJO010000003.1_i000_001429	117	458	341	1.03333	0.602473
GCA_020581275.1-Fun_JAIRJP010000056.1_i000_015469	117	458	341	1.03333	0.602473
GCA_002111425.1-Fun_KZ107830.1_i000_007691	124	459	335	1.01515	0.596085
GCA_008931885.1-Fun_VCHE01000010.1_i000_000400	124	459	335	1.01515	0.596085
GCA_012971845.1-Fun_QCYV01000263.1_i000_010935	124	459	335	1.01515	0.596085
GCA_000349385.1-Fun_KB705796.1_i000_002220	126	461	335	1.01515	0.477208
GCA_902085965.1-Fun_CABFNS010000694.1_i000_002992	132	456	324	0.981818	0.549153
GCA_014461115.1-Fun_JACAZE010000001.1_i000_000524	137	460	323	0.978788	0.615238
GCA_000146915.2-Fun_CH445332.1_i000_010258	132	473	341	1.03333	0.586919
GCA_000523455.1-Fun_KI964013.1_i000_007398	126	451	325	0.984848	0.575221
GCA_004014815.1-Fun_RYZI01000001.1_i000_000118	128	454	326	0.987879	0.469065
GCA_000338975.1-Fun_KB445585.1_i000_011749	125	451	326	0.987879	0.575972
GCA_010093585.1-Fun_MU002012.1_i000_009648	119	459	340	1.0303	0.596491
GCA_019925775.1-Fun_JAHFYE010000890.1_i000_008492	134	462	328	0.993939	0.609665
GCA_000836255.1-Fun_DF938591.1_i000_001932	122	458	336	1.01818	0.584348
GCA_002591385.1-Fun_NJEV01000360.1_i000_006757	128	485	357	1.08182	0.593023
GCA_019425555.1-Fun_MXQG01000002.1_i000_004367	128	452	324	0.981818	0.544538
GCA_020744135.1-Fun_JAGMVI010000004.1_i000_012164	128	452	324	0.981818	0.544538
GCA_900007375.1-Fun_LN649231.1_i000_013153	128	452	324	0.981818	0.544538
GCA_019924905.1-Fun_JAHFYL010008367.1_i000_019278	97	417	320	0.969697	0.641283
GCA_000166005.1-Fun_GL534973.1_i000_005684	135	401	266	0.806061	0.663342
GCA_004917225.1-Fun_QZAH01000722.1_i000_008788	137	458	321	0.972727	0.593346
GCA_000026365.1-Fun_CU928178.1_i000_003779	130	447	317	0.960606	0.61079
GCA_021535285.1-Fun_JAKETS010000005.1_i000_003823	130	447	317	0.960606	0.61079
GCA_019609905.1-Fun_CM033787.1_i000_009449	132	456	324	0.981818	0.546374
GCA_900074715.1-Fun_LT598481.1_i000_002216	127	447	320	0.969697	0.614203
GCA_001642005.1-Ani_LWCA01000064.1_i000_007115	112	445	333	1.00909	0.723913
GCA_019924995.1-Fun_JAHFYO010000003.1_i000_006790	136	460	324	0.981818	0.605607
GCA_000721765.1-Fun_KL584718.1_i000_008030	136	462	326	0.987879	0.601476
GCA_019924955.1-Fun_JAHFYN010000018.1_i000_002388	136	462	326	0.987879	0.601476
GCA_000165425.1-Pro_CT868207.1_i000_019990	123	490	367	1.11212	0.728175
GCA_019924555.1-Fun_JAHFXU010001150.1_i000_008364	136	463	327	0.990909	0.607807
GCA_000715545.1-Ani_KL596804.1_i000_009728	126	456	330	1	0.578947
GCA_020736565.1-Fun_JAHBOF010000007.1_i000_023599	128	448	320	0.969697	0.603774
GCA_003351075.1-Fun_QFBF01000054.1_i000_010926	131	464	333	1.00909	0.577123
GCA_019924775.1-Fun_JAHFYC010004786.1_i000_010980	134	461	327	0.990909	0.639922
GCA_019924575.1-Fun_JAHFXX010004846.1_i000_014693	97	417	320	0.969697	0.641283
GCA_013694445.1-Fun_CP059273.1_i000_004094	132	446	314	0.951515	0.619329
GCA_011947485.2-Fun_JAATWK020000168.1_i000_003721	117	451	334	1.01212	0.55298
GCA_900625125.1-Ani_UYYG01000055.1_i000_005253	129	464	335	1.01515	0.706751
GCA_019924135.1-Fun_JAHFXB010013006.1_i000_025207	2	292	290	0.878788	0.976431
GCA_021605095.1-Ani_BPLR01001972.1_i000_007572	120	455	335	1.01515	0.605787
GCA_902006505.2-Fun_CABFNO020001301.1_i000_003428	133	455	322	0.975758	0.546689
GCA_000448365.1-Fun_KE652187.1_i000_000363	128	449	321	0.972727	0.481982
GCA_012934285.1-Fun_JAAVMX010000006.1_i000_005827	128	449	321	0.972727	0.481982
GCA_001990785.1-Ani_KV894095.1_i000_005564	150	480	330	1	0.555556
GCA_902077795.2-Fun_CABFNQ020000436.1_i000_000283	133	455	322	0.975758	0.546689
GCA_019925215.1-Fun_JAHFYS010004900.1_i000_010697	134	461	327	0.990909	0.607807
GCA_002116315.1-Fun_KZ107840.1_i000_003642	103	455	352	1.06667	0.630824
GCA_019721275.1-Fun_JAASLF010000047.1_i000_006894	103	455	352	1.06667	0.630824
GCA_019925085.1-Fun_JAHFYT010000100.1_i000_010236	136	461	325	0.984848	0.605214
GCA_902141235.2-Fun_CABFOC020000002.1_i000_001598	129	454	325	0.984848	0.550847
GCA_019924025.1-Fun_JAHFWX010000230.1_i000_003126	136	463	327	0.990909	0.607807
GCA_019924215.1-Fun_JAHFXC010000457.1_i000_003284	136	463	327	0.990909	0.607807
GCA_019924375.1-Fun_JAHFXM010000325.1_i000_002627	136	463	327	0.990909	0.607807
GCA_019924415.1-Fun_JAHFXV010000011.1_i000_001294	136	463	327	0.990909	0.607807
GCA_019924435.1-Fun_JAHFXP010000798.1_i000_004779	136	463	327	0.990909	0.607807
GCA_019924655.1-Fun_JAHFXZ010000375.1_i000_002974	136	463	327	0.990909	0.607807
GCA_019924695.1-Fun_JAHFYA010000346.1_i000_002740	136	463	327	0.990909	0.607807
GCA_019924735.1-Fun_JAHFYD010000386.1_i000_003081	136	463	327	0.990909	0.607807
GCA_019924875.1-Fun_JAHFYK010000206.1_i000_003223	136	463	327	0.990909	0.607807
GCA_019924895.1-Fun_JAHFYM010000260.1_i000_008900	136	463	327	0.990909	0.607807
GCA_019925035.1-Fun_JAHFYQ010000005.1_i000_006033	136	463	327	0.990909	0.607807
GCA_004337985.1-Fun_CM014985.1_i000_000669	133	453	320	0.969697	0.529801
GCA_012980515.1-Fun_JAACLJ010000002.1_i000_002146	136	465	329	0.99697	0.651485
GCA_019924425.1-Fun_JAHFXT010000026.1_i000_004075	134	456	322	0.975758	0.598513
GCA_000721775.1-Fun_KL584848.1_i000_008643	135	456	321	0.972727	0.596654
GCA_019925005.1-Fun_JAHFYP010000016.1_i000_002708	135	456	321	0.972727	0.596654
GCA_019924195.1-Fun_JAHFXF010000085.1_i000_018672	135	461	326	0.987879	0.605948
GCA_019924255.1-Fun_JAHFXK010000004.1_i000_010116	135	461	326	0.987879	0.605948
GCA_019924995.1-Fun_JAHFYO010000011.1_i000_000231	135	461	326	0.987879	0.605948
GCA_019924015.1-Fun_JAHFWZ010000020.1_i000_003184	136	463	327	0.990909	0.607807
GCA_014904845.1-Fun_MU119214.1_i000_003486	127	463	336	1.01818	0.518519
GCA_011058895.1-Fun_SWKV01000059.1_i000_008739	117	454	337	1.02121	0.592267
GCA_019924555.1-Fun_JAHFXU010002067.1_i000_011724	193	521	328	0.993939	0.549414
GCA_009194965.1-Fun_VSMA01000018.1_i000_007112	139	464	325	0.984848	0.612053
GCA_000225605.1-Fun_JH126405.1_i000_008503	128	450	322	0.975758	0.540268
GCA_001636735.1-Fun_AZHA01000002.1_i000_003416	130	456	326	0.987879	0.548822
GCA_010093805.1-Fun_ML996179.1_i000_009278	123	452	329	0.99697	0.568221
GCA_000003515.2-Fun_CH476619.1_i000_007126	136	449	313	0.948485	0.514803
GCA_019924725.1-Fun_JAHFYF010000001.1_i000_000392	233	559	326	0.987879	0.512579
GCA_019924825.1-Fun_JAHFYH010000001.1_i000_000376	233	559	326	0.987879	0.512579
GCA_010094045.1-Fun_ML986593.1_i000_003972	131	456	325	0.984848	0.562284
GCA_017639395.1-Pla_CM029880.1_i000_011180	134	443	309	0.936364	0.694382
GCA_003339455.1-Fun_PDHP01000007.1_i000_006188	132	462	330	1	0.643275
GCA_004794785.1-Ani_SJOL01005477.1_i000_003279	127	457	330	1	0.578947
GCA_021605095.1-Ani_BPLR01019448.1_i000_074193	119	447	328	0.993939	0.653386
GCA_005059855.1-Fun_NAJP01000114.1_i000_001738	136	451	315	0.954545	0.506431
GCA_007821495.1-Fun_QGMH01000093.1_i000_005718	133	460	327	0.990909	0.469154
GCA_020921065.1-Pla_CM037152.1_i000_006282	94	419	325	0.984848	0.768322
GCA_019702505.1-Fun_JAANER010000010.1_i000_001940	126	449	323	0.978788	0.562718
GCA_000524495.1-Pro_KI965466.1_i000_002170	191	522	331	1.00303	0.605119
GCA_014235925.1-Fun_VUJX01000028.1_i000_008918	113	452	339	1.02727	0.55122
GCA_018446385.1-Pla_CM031524.1_i000_061220	146	472	326	0.987879	0.515008
GCA_013036055.1-Fun_JAAABM010000007.1_i000_006990	125	449	324	0.981818	0.56446
GCA_000236345.1-Ani_DF142836.1_i000_010038	150	480	330	1	0.557432
GCA_001572055.1-Fun_LPVP01000042.1_i000_011495	126	449	323	0.978788	0.562718
GCA_001642055.1-Fun_KV441470.1_i000_001757	126	449	323	0.978788	0.562718
GCA_003574525.1-Fun_QPFE01000105.1_i000_005311	126	449	323	0.978788	0.562718
GCA_004154735.1-Fun_PDXE01000062.1_i000_010828	126	449	323	0.978788	0.562718
GCA_004154745.1-Fun_PDXA01000001.1_i000_000021	126	449	323	0.978788	0.562718
GCA_004154755.1-Fun_PDXD01000033.1_i000_007973	126	449	323	0.978788	0.562718
GCA_004154765.1-Fun_PDXG01000031.1_i000_008378	126	449	323	0.978788	0.562718
GCA_004154815.1-Fun_PEJP01000095.1_i000_012708	126	449	323	0.978788	0.562718
GCA_004154835.1-Fun_PDUP01000063.1_i000_010839	126	449	323	0.978788	0.562718
GCA_004154845.1-Fun_PDXH01000065.1_i000_011462	126	449	323	0.978788	0.562718
GCA_004155955.1-Fun_PDWY01000042.1_i000_008511	126	449	323	0.978788	0.562718
GCA_004156015.1-Fun_PDXB01000034.1_i000_007432	126	449	323	0.978788	0.562718
GCA_004156025.2-Fun_PDWZ02000008.1_i000_011726	126	449	323	0.978788	0.562718
GCA_004156035.1-Fun_PDXC01000009.1_i000_013337	126	449	323	0.978788	0.562718
GCA_004168565.1-Fun_PDXF01000030.1_i000_006970	126	449	323	0.978788	0.562718
GCA_020736535.1-Fun_JAHBNJ010000009.1_i000_012363	126	449	323	0.978788	0.562718
GCA_004917725.1-Fun_QZBM01000666.1_i000_008325	137	458	321	0.972727	0.593346
GCA_001937105.1-Fun_MPGH01000111.1_i000_001033	123	452	329	0.99697	0.531502
GCA_009769405.1-Fun_WNWR01000483.1_i000_009191	129	464	335	1.01515	0.580589
GCA_009769445.1-Fun_WNWQ01000219.1_i000_004009	129	464	335	1.01515	0.580589
GCA_000002415.2-Pro_CM000449.1_i000_001721	118	449	331	1.00303	0.691023
GCA_000320625.2-Pro_KQ234266.1_i000_002197	118	449	331	1.00303	0.691023
GCA_000320645.2-Pro_KQ234811.1_i000_002580	118	449	331	1.00303	0.691023
GCA_000320665.2-Pro_KQ235038.1_i000_002370	118	449	331	1.00303	0.691023
GCA_000320685.2-Pro_KQ235353.1_i000_002471	118	449	331	1.00303	0.691023
GCA_900093535.1-Pro_LT615263.1_i000_001833	118	449	331	1.00303	0.691023
GCA_900093545.1-Pro_LT615246.1_i000_001865	118	449	331	1.00303	0.691023
GCA_914969965.1-Pro_CAJZCX010000009.1_i000_003610	118	449	331	1.00303	0.691023
GCA_900093555.2-Pro_LT635619.1_i000_001930	118	449	331	1.00303	0.691023
GCA_019924815.1-Fun_JAHFYJ010000001.1_i000_000404	297	622	325	0.984848	0.464286
GCA_019565615.1-Fun_CP075866.1_i000_005450	119	453	334	1.01212	0.565144
GCA_019923975.1-Fun_JAHFWY010000048.1_i000_006916	136	425	289	0.875758	0.537175
GCA_019924025.1-Fun_JAHFWX010000983.1_i000_007604	136	425	289	0.875758	0.537175
GCA_019924175.1-Fun_JAHFXG010000034.1_i000_005241	136	425	289	0.875758	0.537175
GCA_019924295.1-Fun_JAHFXI010004634.1_i000_010909	136	425	289	0.875758	0.537175
GCA_019924715.1-Fun_JAHFYG010000012.1_i000_001190	136	425	289	0.875758	0.537175
GCA_019924835.1-Fun_JAHFYI010000002.1_i000_000946	136	425	289	0.875758	0.537175
GCA_019924875.1-Fun_JAHFYK010000618.1_i000_006349	136	425	289	0.875758	0.537175
GCA_000091205.1-Pro_AP006502.2_i000_004781	123	459	336	1.01818	0.652427
GCA_001633055.2-Fun_LKCN02000016.1_i000_002565	131	462	331	1.00303	0.64775
GCA_010094035.1-Fun_ML987194.1_i000_007326	122	457	335	1.01515	0.579585
GCA_020341155.1-Ani_JAHMML010000017.1_i000_002977	112	447	335	1.01515	0.577586
GCA_900090005.1-Pro_LT594496.1_i000_001364	118	448	330	1	0.703625
GCA_006981975.1-Fun_SPUL01000010.1_i000_006693	129	451	322	0.975758	0.544839
GCA_006981985.1-Fun_SPUK01000008.1_i000_006219	129	451	322	0.975758	0.544839
GCA_003604175.2-Ani_CM030370.1_i000_007595	126	456	330	1	0.580986
GCA_000230375.1-Fun_FP929139.1_i000_011384	118	460	342	1.03636	0.591696
GCA_022343315.1-Fun_JACTNS010000008.1_i000_003023	118	460	342	1.03636	0.591696
GCA_000446055.1-Fun_AMYD01000812.1_i000_003567	6	323	317	0.960606	0.652263
GCA_008080495.1-Fun_CP023326.1_i000_002018	128	448	320	0.969697	0.536913
GCA_900088575.1-Pro_FLQW01003590.1_i000_004273	118	448	330	1	0.703625
GCA_900090045.1-Pro_LT594629.1_i000_001754	118	448	330	1	0.703625
GCA_010099065.1-Fun_PPTI01000004.1_i000_005362	93	416	323	0.978788	0.573712
GCA_015529505.1-Fun_JAAAUI010000387.1_i000_005702	127	381	254	0.769697	0.666667
GCA_015529515.1-Fun_JAAAUJ010000086.1_i000_009259	127	381	254	0.769697	0.666667
GCA_013397325.1-Ani_VZTC01000119.1_i000_000136	55	376	321	0.972727	0.758865
GCA_010094145.1-Fun_ML978961.1_i000_003065	118	454	336	1.01818	0.589474
GCA_011058865.1-Fun_SWKW01000106.1_i000_000656	117	454	337	1.02121	0.592267
GCA_020726555.1-Fun_JAHBNH010000008.1_i000_011407	117	453	336	1.01818	0.602151
GCA_016771965.1-Pla_CM028697.1_i000_055240	141	454	313	0.948485	0.572212
GCA_004011705.1-Fun_RZGK01000007.1_i000_003994	117	454	337	1.02121	0.591228
GCA_010093595.1-Fun_MU003710.1_i000_012659	131	454	323	0.978788	0.547458
GCA_002022785.1-Fun_LVVK01000011.1_i000_008730	119	453	334	1.01212	0.565144
GCA_019677335.1-Fun_WSLM01002875.1_i000_011577	125	424	299	0.906061	0.703529
GCA_000277445.1-Pro_AJWJ01000099.1_i000_003225	117	438	321	0.972727	0.502347
GCA_021365335.1-Fun_JAJTIZ010000060.1_i000_012981	123	463	340	1.0303	0.61706
GCA_900074905.1-Fun_FJUX01000114.1_i000_010243	132	455	323	0.978788	0.479941
GCA_900074885.1-Fun_FJUW01000012.1_i000_007633	130	447	317	0.960606	0.471025
GCA_905182975.1-Pro_CAJJDM010000001.1_i000_000139	123	463	340	1.0303	0.701031
GCA_900074895.1-Fun_FJVC01000229.1_i000_008088	128	448	320	0.969697	0.473373
GCA_000193285.1-Fun_GL876966.1_i000_000043	134	452	318	0.963636	0.527363
GCA_000190715.1-Pro_GL871008.1_i000_003509	115	454	339	1.02727	0.627778
GCA_010015635.1-Fun_ML976052.1_i000_006951	95	454	359	1.08788	0.6179
GCA_011800055.1-Fun_WVTB01000042.1_i000_006966	117	451	334	1.01212	0.549342
GCA_013201745.1-Fun_QPMT01000079.1_i000_014045	117	451	334	1.01212	0.549342
GCA_013201755.1-Fun_QPMR01000010.1_i000_003932	117	451	334	1.01212	0.549342
GCA_013201785.1-Fun_QPMP01000023.1_i000_007458	117	451	334	1.01212	0.549342
GCA_013201795.1-Fun_QPMS01000007.1_i000_003036	117	451	334	1.01212	0.549342
GCA_013201865.1-Fun_QPMU01000037.1_i000_010902	117	451	334	1.01212	0.549342
GCA_013390185.1-Fun_QPNB01000002.1_i000_002124	117	451	334	1.01212	0.549342
GCA_013390195.1-Fun_QPNA01000002.1_i000_003858	117	451	334	1.01212	0.549342
GCA_000319635.2-Fun_ANPB02000005.1_i000_008766	117	451	334	1.01212	0.549342
GCA_009771025.1-Fun_SSNE01000018.1_i000_004453	117	451	334	1.01212	0.549342
GCA_012932255.1-Fun_QLYQ01000014.1_i000_010901	117	451	334	1.01212	0.549342
GCA_013201875.1-Fun_QPMV01000005.1_i000_001569	117	451	334	1.01212	0.549342
GCA_013201905.1-Fun_QPMW01000007.1_i000_002005	117	451	334	1.01212	0.549342
GCA_013201925.1-Fun_QPMY01000007.1_i000_001788	117	451	334	1.01212	0.549342
GCA_013390205.1-Fun_QPMX01000002.1_i000_003973	117	451	334	1.01212	0.549342
GCA_003339455.1-Fun_PDHP01000015.1_i000_001440	129	454	325	0.984848	0.4683
GCA_009806415.1-Fun_WOWK01000038.1_i000_014796	117	453	336	1.01818	0.552632
GCA_900095555.1-Pro_LT608178.1_i000_002866	117	449	332	1.00606	0.707889
GCA_002591415.1-Fun_NJET01000063.1_i000_006693	129	462	333	1.00909	0.64786
GCA_003171515.3-Fun_CM025796.1_i000_004457	126	450	324	0.981818	0.582734
GCA_003171545.1-Fun_NQWZ01000127.1_i000_005282	126	450	324	0.981818	0.582734
GCA_003231325.2-Fun_MVBF02000002.1_i000_004774	126	450	324	0.981818	0.582734
GCA_003231345.1-Fun_MVBI01000127.1_i000_005325	126	450	324	0.981818	0.582734
GCA_003231355.1-Fun_MVBG01000054.1_i000_003297	126	450	324	0.981818	0.582734
GCA_003231365.1-Fun_MVBH01000002.1_i000_000262	126	450	324	0.981818	0.582734
GCA_003231415.2-Fun_MUXC02000002.1_i000_004836	126	450	324	0.981818	0.582734
GCA_003231425.1-Fun_NRDI01000135.1_i000_005698	126	450	324	0.981818	0.582734
GCA_008692205.1-Fun_SAXQ01000002.1_i000_004686	126	450	324	0.981818	0.582734
GCA_001644525.1-Fun_KV441710.1_i000_006033	116	456	340	1.0303	0.599647
GCA_001272575.2-Fun_LAZP02000308.1_i000_003922	132	464	332	1.00606	0.65873
GCA_010015745.1-Fun_ML978300.1_i000_012511	116	456	340	1.0303	0.595447
GCA_002269645.1-Ani_NIVC01000179.1_i000_006203	124	458	334	1.01212	0.615101
GCA_002269645.1-Ani_NIVC01001589.1_i000_028791	124	458	334	1.01212	0.615101
GCA_002269645.1-Ani_NIVC01002030.1_i000_033414	124	458	334	1.01212	0.615101
GCA_000770705.1-Fun_ANFO01001118.1_i000_009892	130	456	326	0.987879	0.548822
GCA_000280675.1-Fun_JH725156.1_i000_003602	132	450	318	0.963636	0.532663
GCA_021365345.1-Fun_JAAZTN010000006.1_i000_009415	132	450	318	0.963636	0.532663
GCA_010093625.1-Fun_MU006749.1_i000_012033	117	454	337	1.02121	0.592267
GCA_010015815.1-Fun_ML977498.1_i000_000745	118	455	337	1.02121	0.59331
GCA_001006355.1-Fun_LAQI01000133.1_i000_001666	123	460	337	1.02121	0.600713
GCA_001975905.1-Fun_MSZU01000113.1_i000_006434	123	460	337	1.02121	0.600713
GCA_020747045.1-Fun_JAGTJN010000002.1_i000_006478	116	457	341	1.03333	0.600352
GCA_009769425.1-Fun_WNWS01000511.1_i000_010302	135	463	328	0.993939	0.470588
GCA_000149985.1-Fun_DS231616.1_i000_009032	126	450	324	0.981818	0.567426
GCA_001630375.1-Fun_JYNV01000176.1_i000_003861	117	454	337	1.02121	0.590193
GCA_004011695.1-Fun_RYYQ01000019.1_i000_009366	117	454	337	1.02121	0.590193
GCA_002105095.1-Fun_MCFJ01000012.1_i000_002601	133	457	324	0.981818	0.539101
GCA_015832175.1-Fun_WJXW01000012.1_i000_010486	142	460	318	0.963636	0.617476
GCA_016647635.1-Fun_JABBWG010000020.1_i000_005382	127	398	271	0.821212	0.669136
GCA_021432635.1-Fun_MU270074.1_i000_017983	133	450	317	0.960606	0.489198
GCA_020379485.1-Pla_CM035457.1_i000_049325	126	444	318	0.963636	0.713004
GCA_017911135.1-Fun_JABVCJ010000015.1_i000_000356	3	236	233	0.706061	0.970833
GCA_000709005.1-Pro_KL446946.1_i000_001400	117	449	332	1.00606	0.707889
GCA_900681995.1-Pro_LR215068.1_i000_003275	117	449	332	1.00606	0.707889
GCA_002077065.1-Fun_NAJO01000009.1_i000_018370	133	448	315	0.954545	0.523256
GCA_001186125.1-Pro_KQ242173.1_i000_007347	125	458	333	1.00909	0.689441
GCA_001682635.1-Fun_JRHA01000004.1_i000_006029	132	450	318	0.963636	0.532663
GCA_002871155.1-Fun_MRVG01000002.1_i000_004017	130	456	326	0.987879	0.548822
GCA_000524515.1-Pro_KI965398.1_i000_002477	117	449	332	1.00606	0.707889
GCA_903994235.1-Pro_LR865417.1_i000_003586	117	449	332	1.00606	0.707889
GCA_903994265.1-Pro_LR865433.1_i000_003630	117	449	332	1.00606	0.707889
GCA_900074925.1-Fun_FJUY01000004.1_i000_004984	135	458	323	0.978788	0.576786
GCA_020736505.1-Fun_JAHBNI010000005.1_i000_008808	126	451	325	0.984848	0.572183
GCA_900617775.1-Ani_UYRU01076123.1_i000_014815	63	395	332	1.00606	0.807786
GCA_013389905.1-Ani_WEKW01009522.1_i000_003658	1	265	264	0.8	0.754286
GCA_010094095.1-Fun_ML979134.1_i000_003974	116	456	340	1.0303	0.60177
GCA_009887335.1-Ani_SGJC01007666.1_i000_007188	119	445	326	0.987879	0.680585
GCA_900622495.1-Ani_UYWX01020583.1_i000_008734	117	435	318	0.963636	0.724374
GCA_903994205.1-Pro_LR865390.1_i000_003407	117	449	332	1.00606	0.707889
GCA_900088565.1-Pro_FLQU01001693.1_i000_007481	117	448	331	1.00303	0.719565
GCA_903994225.1-Pro_LR865374.1_i000_003500	117	449	332	1.00606	0.707889
GCA_907166805.1-Fun_CAJRGZ010000017.1_i000_003793	126	449	323	0.978788	0.562718
GCA_900002335.2-Pro_LK022889.2_i000_003353	117	449	332	1.00606	0.707889
GCA_900095565.1-Pro_LT608206.1_i000_003008	117	449	332	1.00606	0.707889
GCA_900095605.1-Pro_LT608164.1_i000_003017	117	449	332	1.00606	0.707889
GCA_900095625.1-Pro_LT608192.1_i000_002997	117	449	332	1.00606	0.707889
GCA_004355905.1-Fun_CM015042.1_i000_000965	141	461	320	0.969697	0.522876
GCA_021442365.1-Fun_PHFK01000004.1_i000_006121	133	453	320	0.969697	0.534224
GCA_004337975.1-Fun_RRCJ01000005.1_i000_000767	133	453	320	0.969697	0.534224
GCA_000002495.2-Fun_CM001231.1_i000_001067	133	453	320	0.969697	0.534224
GCA_000691945.2-Pro_FO082872.1_i000_001225	118	427	309	0.936364	0.72028
GCA_014839935.1-Fun_QTSX01003481.1_i000_002867	14	331	317	0.960606	0.819121
GCA_021845515.1-Fun_VIDS01000002.1_i000_004849	133	452	319	0.966667	0.533445
GCA_004346965.1-Fun_CP034204.1_i000_001183	133	452	319	0.966667	0.532554
GCA_013201765.1-Fun_QPMQ01000007.1_i000_000893	118	425	307	0.930303	0.507438
GCA_000182925.2-Fun_CM002237.1_i000_002562	133	453	320	0.969697	0.536013
GCA_000213175.1-Fun_GL891305.1_i000_005443	133	453	320	0.969697	0.536013
GCA_000213195.1-Fun_GL891247.1_i000_007840	133	453	320	0.969697	0.536013
GCA_000786625.1-Fun_KN389652.1_i000_003871	133	453	320	0.969697	0.536013
GCA_000326105.1-Fun_AGVY01000369.1_i000_008224	150	419	269	0.815152	0.642005
GCA_900604375.1-Ani_UXSR01005197.1_i000_005462	116	432	316	0.957576	0.728111
GCA_910592345.1-Fun_CAJVPI010000006.1_i000_000134	126	450	324	0.981818	0.634051
GCA_019669835.1-Fun_MU251626.1_i000_008723	131	445	314	0.951515	0.3925
GCA_000696135.1-Fun_JMSE01001300.1_i000_009608	118	445	327	0.990909	0.525723
GCA_009768925.2-Pro_VHIT02000011.1_i000_003183	126	484	358	1.08485	0.718876
GCA_001594065.1-Ani_KQ977126.1_i000_003524	1	293	292	0.884848	0.909657
GCA_000150825.1-Fun_DS985219.1_i000_004755	120	477	357	1.08182	0.59699
GCA_000220395.1-Pro_GL984229.1_i000_006344	119	458	339	1.02727	0.696099
GCA_020744215.1-Fun_JAGMVJ010000002.1_i000_007283	127	458	331	1.00303	0.578671
GCA_000149035.1-Fun_GG697353.1_i000_006295	118	445	327	0.990909	0.52657
GCA_011745365.1-Fun_MU032347.1_i000_005817	122	455	333	1.00909	0.5625
GCA_000292585.1-Fun_JH793404.1_i000_005945	133	453	320	0.969697	0.512
GCA_000292605.1-Fun_JH795555.1_i000_010518	133	453	320	0.969697	0.512
GCA_010015565.1-Fun_ML975945.1_i000_003065	127	460	333	1.00909	0.578125
GCA_905219625.1-Fun_CAJMWX010001121.1_i000_005906	126	448	322	0.975758	0.58018
CANI013.0722.00001.C001_01162	94	413	319	0.966667	0.754137
CANI014.0722.00001.C001_00701	94	413	319	0.966667	0.754137
GCA_000465215.2-Fun_KE747810.1_i000_001575	106	431	325	0.984848	0.588768
GCA_010015605.1-Fun_ML975459.1_i000_010615	124	452	328	0.993939	0.566494
GCA_001618945.2-Fun_CM038150.1_i000_007237	132	466	334	1.01212	0.65748
GCA_001625195.1-Fun_CM004176.1_i000_005980	132	466	334	1.01212	0.65748
GCA_000342415.1-Pro_CP001669.1_i000_000585	120	432	312	0.945455	0.718894
GCA_001658105.1-Fun_KV448223.1_i000_004818	133	473	340	1.0303	0.614828
GCA_003025095.1-Fun_KZ679676.1_i000_001878	119	454	335	1.01515	0.563973
GCA_002838845.1-Fun_NQLC01000509.1_i000_009420	119	454	335	1.01515	0.563973
GCA_004366825.1-Fun_QAPG01000009.1_i000_000786	76	447	371	1.12424	0.601297
GCA_004367215.1-Fun_RYZW01000017.1_i000_003021	76	447	371	1.12424	0.601297
GCA_004367935.1-Fun_QAPF01000070.1_i000_004417	76	447	371	1.12424	0.601297
GCA_004353045.1-Fun_SKBQ01000060.1_i000_009190	139	460	321	0.972727	0.548718
GCA_001625285.1-Fun_LFIW01001200.1_i000_001591	75	446	371	1.12424	0.595506
GCA_001855235.1-Fun_KV841764.1_i000_000904	75	446	371	1.12424	0.595506
GCA_000004255.1-Pla_GL348718.1_i000_022457	92	419	327	0.990909	0.721854
GCA_003672135.1-Ani_CM010856.1_i000_000658	131	460	329	0.99697	0.170466
GCA_903853725.1-Fun_CAINUL010000002.1_i000_001919	118	444	326	0.987879	0.619772
CANI009.0722.00001.C001_02593	95	425	330	1	0.736607
GCA_900618005.1-Ani_UYRS01018678.1_i000_007747	126	459	333	1.00909	0.583187
GCA_022432375.1-Fun_JAJKKK010000023.1_i000_004402	133	460	327	0.990909	0.522364
GCA_022179045.1-Fun_BPPX01000012.1_i000_006588	75	445	370	1.12121	0.5939
GCA_001625265.1-Fun_LFIV01000012.1_i000_001306	75	445	370	1.12121	0.592949
GCA_000350065.2-Fun_AMCV02000003.1_i000_002124	74	447	373	1.1303	0.604538
GCA_011066345.1-Fun_QLNT01000004.1_i000_008524	119	453	334	1.01212	0.565144
GCA_000988865.1-Fun_JOKZ01000466.1_i000_009832	119	453	334	1.01212	0.56229
GCA_005350895.1-Fun_PJEX01000031.1_i000_002249	119	452	333	1.00909	0.53451
GCA_905219635.1-Fun_CAJMWY010002170.1_i000_004960	164	485	321	0.972727	0.522801
GCA_020744415.1-Fun_JAGMWT010000004.1_i000_009802	116	452	336	1.01818	0.588441
GCA_006783085.1-Fun_PUHP01000134.1_i000_002503	119	453	334	1.01212	0.536977
GCA_020045945.2-Fun_CM034696.1_i000_005352	119	453	334	1.01212	0.565144
GCA_010015585.1-Fun_ML975159.1_i000_005588	136	454	318	0.963636	0.561837
GCA_000203815.1-Pro_GL883006.1_i000_000116	114	444	330	1	0.292294
GCA_011066465.2-Fun_MU009564.1_i000_008211	121	472	351	1.06364	0.553628
GCA_000150675.2-Fun_DS572709.1_i000_006302	121	468	347	1.05152	0.529771
GCA_002892985.1-Fun_MPSH01000001.1_i000_000481	121	468	347	1.05152	0.529771
GCA_002892995.1-Fun_PHNU01000042.1_i000_006776	121	468	347	1.05152	0.529771
GCA_002893025.1-Fun_PHNV01000288.1_i000_004695	121	468	347	1.05152	0.529771
GCA_002893035.1-Fun_PHNW01000286.1_i000_004200	121	468	347	1.05152	0.529771
GCA_002893045.1-Fun_PHNX01000065.1_i000_008514	121	468	347	1.05152	0.529771
GCA_003320035.1-Fun_CM010351.1_i000_006822	121	468	347	1.05152	0.529771
GCA_004109745.1-Fun_CM014045.1_i000_004388	121	468	347	1.05152	0.529771
GCA_011066485.2-Fun_MU010195.1_i000_008262	121	468	347	1.05152	0.529771
GCA_018994095.1-Fun_JAEMWZ010000005.1_i000_013720	121	468	347	1.05152	0.529771
GCA_020726535.1-Fun_JAHEWJ010000007.1_i000_010567	121	468	347	1.05152	0.529771
GCA_009982855.1-Fun_JAADKA010000051.1_i000_010296	118	453	335	1.01515	0.58669
GCA_003724135.2-Fun_RBVV01000025.1_i000_004413	121	474	353	1.0697	0.538931
GCA_000313795.2-Fun_CACQ02005590.1_i000_010977	74	407	333	1.00909	0.576125
GCA_014839935.1-Fun_QTSX01033277.1_i000_017997	118	410	292	0.884848	0.707022
GCA_003019895.1-Fun_KZ678440.1_i000_005493	122	454	332	1.00606	0.559865
GCA_000769265.1-Fun_JPKY01000096.1_i000_008791	127	455	328	0.993939	0.52818
GCA_004920355.1-Fun_MWPZ01000005.1_i000_009570	89	423	334	1.01212	0.56229
GCA_014235955.1-Fun_WIGN01000112.1_i000_007328	76	450	374	1.13333	0.6042
GCA_001692915.1-Fun_KV750114.1_i000_009292	134	430	296	0.89697	0.683603
GCA_000765035.1-Fun_CCBP010000125.1_i000_006059	133	469	336	1.01818	0.569492
GCA_014235935.1-Fun_WIGM01000250.1_i000_007164	76	449	373	1.1303	0.599678
GCA_016800925.1-Fun_JABCPU010000153.1_i000_003810	126	398	272	0.824242	0.671605
GCA_000145635.1-Fun_GL385400.1_i000_010754	133	454	321	0.972727	0.53411
GCA_015852335.1-Fun_JAAAID010001196.1_i000_006975	131	443	312	0.945455	0.636735
GCA_010015735.1-Fun_ML978067.1_i000_003717	115	454	339	1.02727	0.609712
GCA_020744225.1-Fun_JAGMWG010000002.1_i000_006712	116	457	341	1.03333	0.599297
GCA_001672515.1-Fun_LTAN01000007.1_i000_010922	119	450	331	1.00303	0.532154
GCA_021605075.1-Ani_BPLQ01002810.1_i000_009613	118	447	329	0.99697	0.716776
GCA_018994105.1-Fun_JAFKAI010005321.1_i000_001793	121	448	327	0.990909	0.470504
GCA_000392275.1-Fun_KB932824.1_i000_001035	134	449	315	0.954545	0.496845
GCA_020726575.1-Fun_JAGSXJ010000016.1_i000_003012	117	458	341	1.03333	0.529503
GCA_010015615.1-Fun_ML976615.1_i000_004664	121	457	336	1.01818	0.571429
GCA_021432615.1-Fun_MU270217.1_i000_009304	118	444	326	0.987879	0.538843
GCA_001642045.1-Fun_KV441561.1_i000_013570	139	462	323	0.978788	0.625969
GCA_903819455.1-Fun_CAIJDQ010000018.1_i000_008574	154	480	326	0.987879	0.581105
GCA_020631695.1-Fun_CM036090.1_i000_005898	118	454	336	1.01818	0.55814
GCA_903819495.1-Fun_CAIJDT010000003.1_i000_002238	154	475	321	0.972727	0.57424
GCA_001268145.1-Fun_CVQH01017779.1_i000_008843	121	457	336	1.01818	0.315493
GCA_903819465.1-Fun_CAIJDR010000013.1_i000_008845	154	476	322	0.975758	0.575
GCA_003711515.1-Fun_ML119051.1_i000_000641	134	456	322	0.975758	0.477745
GCA_010093515.1-Fun_MU001675.1_i000_003071	126	454	328	0.993939	0.645669
GCA_002894145.1-Fun_MTYI01000063.1_i000_009763	119	453	334	1.01212	0.56229
GCA_002077065.1-Fun_NAJO01000016.1_i000_003867	134	449	315	0.954545	0.523256
GCA_000226095.1-Fun_CP003008.1_i000_008373	133	444	311	0.942424	0.511513
GCA_022432385.1-Fun_JAJJXC010000006.1_i000_010727	133	461	328	0.993939	0.481645
GCA_002591385.1-Fun_NJEV01000217.1_i000_004195	169	499	330	1	0.603291
GCA_000182805.2-Fun_CABT02000056.1_i000_001125	133	454	321	0.972727	0.540404
GCA_008692325.1-Fun_NMPR01000082.1_i000_009035	133	454	321	0.972727	0.540404
GCA_020800285.1-Fun_JAGTJO010000001.1_i000_001719	133	454	321	0.972727	0.540404
GCA_000170995.2-Fun_ABDF02000092.1_i000_000422	118	453	335	1.01515	0.564924
GCA_020647635.1-Fun_CP071109.1_i000_005153	118	453	335	1.01515	0.564924
GCA_015025155.1-Fun_WITN01000029.1_i000_008469	141	429	288	0.872727	0.548571
GCA_900002375.2-Pro_LK023127.2_i000_003150	117	449	332	1.00606	0.707889
GCA_900044335.1-Pro_LT160032.1_i000_003098	117	449	332	1.00606	0.707889
GCA_900088445.1-Pro_LT614638.1_i000_002939	117	449	332	1.00606	0.707889
GCA_900095545.1-Pro_LT608148.1_i000_002935	117	449	332	1.00606	0.707889
GCA_900095585.1-Pro_LT608276.1_i000_002950	117	449	332	1.00606	0.707889
GCA_900095635.1-Pro_LT608260.1_i000_002930	117	449	332	1.00606	0.707889
GCA_001563125.1-Fun_JFFI01000399.1_i000_001687	74	452	378	1.14545	0.613636
GCA_016695485.1-Fun_MU172348.1_i000_012891	123	405	282	0.854545	0.629464
GCA_900618005.1-Ani_UYRS01000890.1_i000_002015	118	435	317	0.960606	0.722096
GCA_004768795.1-Fun_SKBN01000181.1_i000_002939	133	458	325	0.984848	0.482912
GCA_900290415.1-Fun_LR026969.1_i000_008140	132	452	320	0.969697	0.588235
GCA_000226545.1-Fun_CU638744.1_i000_008566	132	452	320	0.969697	0.586081
GCA_000264995.1-Fun_JH687539.1_i000_002113	127	399	272	0.824242	0.673267
GCA_000003085.2-Pro_AABL01001848.1_i000_002600	117	449	332	1.00606	0.707889
GCA_000505035.1-Pro_KI635790.1_i000_004173	117	449	332	1.00606	0.707889
GCA_900002385.2-Pro_LM993666.2_i000_004043	117	449	332	1.00606	0.707889
GCA_900002395.1-Pro_LK934640.1_i000_003399	117	449	332	1.00606	0.707889
GCA_021066465.1-Fun_JAJKFY010000144.1_i000_004274	97	432	335	1.01515	0.589789
GCA_009792415.2-Pro_VHLK02000057.1_i000_001784	125	468	343	1.03939	0.704312
GCA_001531365.1-Pla_CM009742.1_i000_015070	129	433	304	0.921212	0.59375
GCA_019202795.1-Pla_CM032923.1_i000_046164	117	445	328	0.993939	0.681913
GCA_010093485.1-Fun_MU001501.1_i000_008076	138	462	324	0.981818	0.629126
GCA_010015805.1-Fun_ML978131.1_i000_009501	141	459	318	0.963636	0.567857
GCA_003012105.1-Fun_PXOA01000193.1_i000_003384	118	453	335	1.01515	0.557404
GCA_010015675.1-Fun_ML977025.1_i000_013295	130	456	326	0.987879	0.56993
GCA_003025105.1-Fun_KZ679256.1_i000_000402	119	454	335	1.01515	0.567797
GCA_013423425.1-Fun_BLZH01000001.1_i000_000270	119	454	335	1.01515	0.567797
GCA_020647865.1-Fun_CP084944.1_i000_004173	119	454	335	1.01515	0.567797
GCA_000171015.2-Fun_ABDG02000027.1_i000_002035	119	454	335	1.01515	0.567797
GCA_000334115.1-Fun_KB317696.1_i000_000092	132	468	336	1.01818	0.236121
GCA_003025115.1-Fun_KZ680213.1_i000_004731	118	453	335	1.01515	0.553719
GCA_000224845.2-Pro_KN042496.1_i000_006488	116	425	309	0.936364	0.72028
GCA_000256705.2-Pro_ML130720.1_i000_004687	116	425	309	0.936364	0.72028
GCA_001831195.1-Fun_MJBS01000031.1_i000_007690	74	452	378	1.14545	0.605769
GCA_006369765.1-Pro_RRYP01003083.1_i000_004097	115	449	334	1.01212	0.738938
GCA_010015725.1-Fun_ML977556.1_i000_000511	125	453	328	0.993939	0.562607
GCA_000005005.6-Pla_CM000782.4_i000_024669	371	615	244	0.739394	0.396748
GCA_014595645.1-Fun_JACTAD010000007.1_i000_013519	122	457	335	1.01515	0.561139
GCA_003339415.1-Fun_PDHQ01000022.1_i000_002258	132	463	331	1.00303	0.650295
GCA_022160335.1-Fun_MU274920.1_i000_008322	127	395	268	0.812121	0.676768
GCA_020746995.1-Fun_JAGPXD010000007.1_i000_012206	119	473	354	1.07273	0.547141
CANI020.0722.00001.C001_03385	90	416	326	0.987879	0.75463
CANI003.0722.00001.C001_01089	84	408	324	0.981818	0.788321
GCA_011947395.2-Fun_JAATWM020000026.1_i000_005269	76	456	380	1.15152	0.616883
GCA_900618355.1-Ani_UZAD01013129.1_i000_007815	207	574	367	1.11212	0.513287
GCA_003073855.1-Fun_KZ805317.1_i000_003770	127	445	318	0.963636	0.560847
GCA_000751175.1-Pro_CCKQ01005390.1_i000_005493	113	447	334	1.01212	0.742222
GCA_013396595.1-Ani_VWZB01003567.1_i000_012634	53	312	259	0.784848	0.830128
GCA_900618435.1-Ani_UYSU01036572.1_i000_011458	102	435	333	1.00909	0.736726
GCA_010093635.1-Fun_MU006842.1_i000_012665	132	452	320	0.969697	0.565371
GCA_003025155.1-Fun_KZ679133.1_i000_006332	118	453	335	1.01515	0.554636
GCA_000499385.1-Pro_HG723058.1_i000_003141	119	460	341	1.03333	0.680639
GCA_015476325.1-Pro_JADAQX010000836.1_i000_000720	120	459	339	1.02727	0.639623
GCA_900618435.1-Ani_UYSU01036901.1_i000_011909	130	435	305	0.924242	0.683857
GCA_015342795.1-Ani_CM027194.1_i000_019322	127	456	329	0.99697	0.609259
GCA_000499545.1-Pro_HG673812.1_i000_001181	119	474	355	1.07576	0.708583
GCA_020647705.1-Fun_CP071117.1_i000_004933	118	453	335	1.01515	0.564924
GCA_012184305.1-Fun_LDUB01000091.1_i000_004457	146	424	278	0.842424	0.544031
GCA_002895965.2-Ani_PIJE02009480.1_i000_032200	45	349	304	0.921212	0.698851
GCA_000524195.1-Ani_APAU02000002.1_i000_010770	113	431	318	0.963636	0.731034
GCA_001481775.2-Fun_JPDN02000003.1_i000_005315	119	454	335	1.01515	0.567797
GCA_002894205.1-Fun_MTYH01000056.1_i000_007829	119	454	335	1.01515	0.567797
GCA_905178155.1-Pro_CAJINV010000008.1_i000_016997	115	471	356	1.07879	0.738589
GCA_000715545.1-Ani_KL596729.1_i000_007155	120	440	320	0.969697	0.715884
GCA_001990785.1-Ani_KV898249.1_i000_007859	120	440	320	0.969697	0.715884
GCA_002895965.2-Ani_PIJE02002588.1_i000_026611	46	350	304	0.921212	0.692483
GCA_013358455.1-Pla_JABWDY010000907.1_i000_000659	135	440	305	0.924242	0.686937
GCA_902439185.1-Ani_CABPRJ010001441.1_i000_009711	121	448	327	0.990909	0.54591
NIUR001.0722.00001.C001_02134	84	404	320	0.969697	0.649087
GCA_001563115.1-Fun_JEMN01000017.1_i000_000191	112	421	309	0.936364	0.502439
GCA_001563135.1-Fun_JFBX01000347.1_i000_005420	112	421	309	0.936364	0.502439
GCA_011075155.1-Fun_JAAJBS010000009.1_i000_010298	112	421	309	0.936364	0.502439
GCA_018906675.1-Fun_JAESDO010000003.1_i000_007503	112	421	309	0.936364	0.502439
GCA_018906765.1-Fun_JAESDN010000003.1_i000_007528	112	421	309	0.936364	0.502439
GCA_018907675.1-Fun_JAESDM010000003.1_i000_007696	112	421	309	0.936364	0.502439
GCA_018994095.1-Fun_JAEMWZ010000033.1_i000_009507	138	463	325	0.984848	0.643564
GCA_000006565.2-Pro_CM002041.1_i000_002472	117	469	352	1.06667	0.718367
GCA_001970955.1-Pro_MPUH01001582.1_i000_007305	122	458	336	1.01818	0.580311
GCA_021399435.1-Fun_JAJTUP010000127.1_i000_003630	123	460	337	1.02121	0.528213
GCA_000582985.1-Fun_JARH01000220.1_i000_002732	112	421	309	0.936364	0.502439
GCA_000150015.2-Pro_KI544499.1_i000_003288	117	471	354	1.07273	0.722449
GCA_000325525.2-Pro_KN003127.1_i000_005686	117	471	354	1.07273	0.722449
GCA_020726445.1-Fun_JAGJXA010000005.1_i000_006631	133	451	318	0.963636	0.52562
GCA_002591395.1-Fun_NJES01000008.1_i000_006892	139	468	329	0.99697	0.651485
GCA_000208865.2-Pro_FR823388.1_i000_002057	117	469	352	1.06667	0.718367
GCA_001865345.1-Pro_LRBP01000022.1_i000_001240	125	463	338	1.02424	0.677355
GCA_905216605.1-Pla_LR999456.1_i000_016192	118	440	322	0.975758	0.616858
GCA_001293395.1-Pro_LGTL01000022.1_i000_007842	136	465	329	0.99697	0.683992
GCA_009835225.1-Ani_VUJU01007000.1_i000_021354	81	407	326	0.987879	0.572935
GCA_001929475.1-Fun_LXFE01004217.1_i000_000720	69	378	309	0.936364	0.741007
NIAD001.0722.00001.C001_00489	83	403	320	0.969697	0.57554
NIMA002.0722.00001.C001_01520	84	407	323	0.978788	0.687234
GCA_021556725.1-Ani_CM038612.1_i000_000603	158	478	320	0.969697	0.666667
GCA_000330505.1-Pro_KB206537.1_i000_005247	116	449	333	1.00909	0.727074
GCA_001275765.2-Fun_LCTW02000583.1_i000_010494	77	368	291	0.881818	0.529091
GCA_902702965.1-Ani_CACRXP010000160.1_i000_009767	131	432	301	0.912121	0.690367
GCA_003604175.2-Ani_CM030369.1_i000_005363	125	442	317	0.960606	0.709172
GCA_009761285.1-Ani_VYZN01000001.1_i000_000713	120	449	329	0.99697	0.575175
GCA_010015655.1-Fun_ML976665.1_i000_003716	115	455	340	1.0303	0.589255
GCA_001970955.1-Pro_MPUH01000373.1_i000_017450	122	457	335	1.01515	0.571672
GCA_004170445.1-Pla_CM014329.1_i000_033435	135	362	227	0.687879	0.371522
GCA_004170445.1-Pla_CM014329.1_i000_033435	406	533	127	0.384848	0.207856
GCA_001006365.1-Fun_LCUC01000114.1_i000_000533	120	456	336	1.01818	0.563758
GCA_000226115.1-Fun_CP003014.1_i000_008988	133	440	307	0.930303	0.502455
GCA_900343105.1-Fun_OUUZ01000004.1_i000_005531	133	440	307	0.930303	0.502455
GCA_000004825.1-Pro_GL290998.1_i000_009029	116	454	338	1.02424	0.546926
GCA_002563875.1-Pro_CM008349.1_i000_003148	120	475	355	1.07576	0.714286
GCA_000469725.3-Ani_LN902841.1_i000_002047	115	435	320	0.969697	0.728929
GCA_019321695.1-Fun_JAHWGW010000008.1_i000_007312	123	459	336	1.01818	0.56661
GCA_004936735.2-Pro_SCFC02000045.1_i000_003668	125	463	338	1.02424	0.68008
GCA_007210665.1-Pro_PYHZ01000002.1_i000_000456	125	467	342	1.03636	0.686747
GCA_001702395.2-Fun_MAVT02000972.1_i000_009044	123	457	334	1.01212	0.563238
GCA_017918215.1-Pro_CM030482.1_i000_001821	96	421	325	0.984848	0.720621
GCA_001447515.1-Pro_LDAU01000123.1_i000_012120	123	459	336	1.01818	0.648649
GCA_010405425.1-Fun_MU005585.1_i000_009386	130	451	321	0.972727	0.559233
GCA_013099955.1-Pro_CM023088.1_i000_002527	117	469	352	1.06667	0.718367
GCA_014773135.1-Ani_JABEBT010000031.1_i000_005451	619	970	351	1.06364	0.357798
GCA_000827895.1-Ani_JWZT01002547.1_i000_006063	118	455	337	1.02121	0.732609
GCA_000189635.1-Pro_GG662547.1_i000_018264	122	461	339	1.02727	0.664706
GCA_001643675.2-Pro_LSRY02000014.1_i000_002410	128	454	326	0.987879	0.617424
GCA_902702965.1-Ani_CACRXP010000637.1_i000_020474	127	458	331	1.00303	0.574653
GCA_017916335.1-Pro_CM030446.1_i000_001878	96	422	326	0.987879	0.722838
CANI004.0722.00001.C001_00558	93	412	319	0.966667	0.723356
GCA_001050175.1-Fun_LFMI01000838.1_i000_009053	118	454	336	1.01818	0.554455
GCA_000167675.2-Fun_GL985064.1_i000_004442	118	454	336	1.01818	0.555372
GCA_000513815.1-Fun_KI911148.1_i000_005029	118	454	336	1.01818	0.555372
GCA_019425475.1-Pro_NLFJ01000114.1_i000_001755	126	463	337	1.02121	0.702083
GCA_021307395.1-Pro_SOPI01000535.1_i000_012669	126	463	337	1.02121	0.702083
GCA_020002365.1-Fun_JAINEY010000007.1_i000_009248	118	455	337	1.02121	0.557025
GCA_002600585.1-Pro_MIGC01001157.1_i000_002753	120	435	315	0.954545	0.6
GCA_000755165.1-Pro_CP009384.1_i000_001750	97	420	323	0.978788	0.727477
GCA_009731335.1-Pro_BLBS01000019.1_i000_001975	96	421	325	0.984848	0.731982
GCA_003185045.1-Pla_CM009907.1_i000_009895	68	328	260	0.787879	0.787879
CANI005.0722.00001.C001_01591	83	402	319	0.966667	0.750588
GCA_018994095.1-Fun_JAEMWZ010000033.1_i000_009508	125	444	319	0.966667	0.360452
GCA_000002845.2-Pro_FR798989.1_i000_001791	97	420	323	0.978788	0.727477
GCA_900537975.1-Pro_LS997614.1_i000_001969	97	420	323	0.978788	0.727477
CANI001.0722.00001.C001_01587	84	407	323	0.978788	0.747685
GCA_010015705.1-Fun_ML977176.1_i000_009296	128	461	333	1.00909	0.560606
GCA_009731335.1-Pro_BLBS01000011.1_i000_001083	133	467	334	1.01212	0.704641
GCA_000002725.2-Pro_FR796406.1_i000_001092	132	467	335	1.01515	0.708245
GCA_916722125.1-Pro_OU755544.1_i000_001115	132	467	335	1.01515	0.708245
NISP011.0722.00001.C001_00259	83	408	325	0.984848	0.755814
GCA_019974015.1-Ani_BMAW01132838.1_i000_072019	121	454	333	1.00909	0.54323
GCA_900412535.3-Pla_LS974618.2_i000_009585	132	442	310	0.939394	0.698198
GCA_000732125.1-Fun_JOWA01000106.1_i000_005101	123	436	313	0.948485	0.514803
GCA_001939145.1-Pro_LSRX01000555.1_i000_021616	198	329	131	0.39697	0.152503
GCA_001939145.1-Pro_LSRX01000555.1_i000_021616	607	818	211	0.639394	0.245634
NIVI001.0722.00001.C001_01739	93	412	319	0.966667	0.726651
NIPI001.0722.00001.C001_02012	84	407	323	0.978788	0.648594
GCA_001592805.2-Fun_CP051140.1_i000_003168	119	453	334	1.01212	0.588028
GCA_000002875.2-Pro_FR796447.1_i000_001883	96	420	324	0.981818	0.72809
GCA_000227135.2-Pro_FR799602.2_i000_001852	96	420	324	0.981818	0.72809
GCA_003719575.1-Pro_CP029514.1_i000_002044	96	420	324	0.981818	0.72809
GCA_900635355.2-Pro_LR812635.1_i000_001953	96	420	324	0.981818	0.72809
GCA_017918235.1-Pro_CM030518.1_i000_001686	96	420	324	0.981818	0.723214
GCA_003704385.1-Fun_QWIM01003667.1_i000_015955	1	270	269	0.815152	0.751397
GCA_015252655.1-Ani_JTDF01003074.1_i000_004390	126	481	355	1.07576	0.616319
GCA_001606155.1-Pro_LODT01000041.1_i000_008314	75	448	373	1.1303	0.569466
GCA_000005005.6-Pla_CM007648.1_i000_010253	68	322	254	0.769697	0.740525
GCA_004794785.1-Ani_SJOL01007241.1_i000_007018	120	439	319	0.966667	0.341542
CANI016.0722.00001.C001_01439	84	405	321	0.972727	0.663223
CANI010.0722.00001.C001_02036	93	425	332	1.00606	0.741071
GCA_013368495.1-Ani_LUCH01006601.1_i000_009254	138	470	332	1.00606	0.566553
GCA_000234665.4-Pro_FR799568.1_i000_002135	96	420	324	0.981818	0.724832
GCA_000002875.2-Pro_FR796442.1_i000_001058	132	467	335	1.01515	0.708245
GCA_000227135.2-Pro_FR799597.2_i000_001046	132	467	335	1.01515	0.708245
GCA_003719575.1-Pro_CP029509.1_i000_001117	132	467	335	1.01515	0.708245
GCA_003730175.1-Pro_RHLD01000045.1_i000_006653	132	467	335	1.01515	0.708245
GCA_003730215.1-Pro_RHLC01000036.1_i000_006159	132	467	335	1.01515	0.708245
GCA_900500625.2-Pro_LR812943.1_i000_001093	132	467	335	1.01515	0.708245
GCA_900635355.2-Pro_LR812630.1_i000_001094	132	467	335	1.01515	0.708245
GCA_001460835.1-Pro_CYKH01000638.1_i000_005221	107	445	338	1.02424	0.747788
GCA_000165345.1-Pro_CM000430.1_i000_000390	126	464	338	1.02424	0.677355
GCA_015245375.1-Pro_CP044421.1_i000_000810	126	464	338	1.02424	0.677355
GCA_000234665.4-Pro_FR799563.1_i000_001333	132	466	334	1.01212	0.704641
GCA_001483515.1-Pro_JTAI01000036.1_i000_002272	125	489	364	1.10303	0.729459
GCA_001593465.1-Pro_JIBM01000083.1_i000_001120	125	489	364	1.10303	0.729459
GCA_001593475.1-Pro_JIBN01000124.1_i000_001631	125	489	364	1.10303	0.729459
GCA_002223825.1-Pro_LN877948.1_i000_000431	125	489	364	1.10303	0.729459
GCA_017918225.1-Pro_CM030554.1_i000_001901	96	421	325	0.984848	0.725446
GCA_021556725.1-Ani_CM038615.1_i000_005935	123	459	336	1.01818	0.591549
GCA_000524195.1-Ani_APAU02000027.1_i000_006954	125	461	336	1.01818	0.589474
NICO001.0722.00001.C001_01534	84	396	312	0.945455	0.617822
GCA_017916305.1-Pro_CM030590.1_i000_001925	97	422	325	0.984848	0.720621
GCA_003543875.1-Pro_CM010679.1_i000_003654	6	340	334	1.01212	0.932961
GCA_902702955.1-Ani_CACRXO010000064.1_i000_006673	261	549	288	0.872727	0.515206
GCA_000442575.2-Pro_ATMG01007233.1_i000_009668	95	420	325	0.984848	0.764706
GCA_900604375.1-Ani_UXSR01005617.1_i000_008966	1392	1726	334	1.01212	0.181719
GCA_002926015.1-Pla_KZ648585.1_i000_024686	123	462	339	1.02727	0.577513
GCA_017916305.1-Pro_CM030585.1_i000_001114	133	465	332	1.00606	0.700422
GCA_001644535.1-Fun_KV441657.1_i000_012011	117	457	340	1.0303	0.59754
GCA_013396525.1-Ani_VWYX01004174.1_i000_014050	1	70	69	0.209091	0.261364
GCA_013396525.1-Ani_VWYX01004174.1_i000_014050	78	264	186	0.563636	0.704545
GCA_003185045.1-Pla_CM009906.1_i000_002790	214	465	251	0.760606	0.538627
GCA_001636815.1-Fun_AZHD01000008.1_i000_008710	126	456	330	1	0.548173
GCA_019828565.1-Pro_JAHDYR010000005.1_i000_001427	123	464	341	1.03333	0.667319
GCA_000442575.2-Pro_ATMG01008881.1_i000_008020	95	407	312	0.945455	0.757282
GCA_903995115.1-Pro_LR877167.1_i000_009333	95	407	312	0.945455	0.757282
GCA_006461475.1-Ani_SUNJ01000903.1_i000_000701	123	455	332	1.00606	0.568493
GCA_014338405.1-Ani_JTDE01005187.1_i000_008359	89	419	330	1	0.613383
GCA_003795295.1-Fun_LKEB01000028.1_i000_005512	130	459	329	0.99697	0.527244
GCA_019202805.1-Pla_CM032910.1_i000_046477	191	520	329	0.99697	0.583333
GCA_000002725.2-Pro_FR796411.1_i000_001950	253	577	324	0.981818	0.538206
GCA_916722125.1-Pro_OU755549.1_i000_001984	253	577	324	0.981818	0.538206
GCA_020736525.1-Fun_JAHBOE010000002.1_i000_005695	128	433	305	0.924242	0.514334
GCA_003177105.1-Pro_PRFA01000021.1_i000_005473	133	465	332	1.00606	0.690229
GCA_000188675.2-Pro_ADWP02026287.1_i000_010673	133	465	332	1.00606	0.690229
GCA_000496795.1-Pro_AYLP01000094.1_i000_005920	133	465	332	1.00606	0.690229
GCA_002219105.2-Pro_MBSY01000747.1_i000_012972	133	465	332	1.00606	0.690229
GCA_003719455.1-Pro_MKKV01000118.1_i000_006471	133	465	332	1.00606	0.690229
GCA_015033625.1-Pro_CM026612.1_i000_011005	133	465	332	1.00606	0.690229
GCA_000210295.1-Pro_FN554971.1_i000_004430	124	464	340	1.0303	0.703934
GCA_020379485.1-Pla_JAGKQM010000756.1_i000_090767	132	449	317	0.960606	0.701327
GCA_000751015.1-Pla_LK032588.1_i000_037115	132	443	311	0.942424	0.698876
GCA_019096155.1-Fun_JAHCVI010000005.1_i000_009890	128	437	309	0.936364	0.524618
GCA_000005005.6-Pla_CM007647.1_i000_002812	339	590	251	0.760606	0.424704
GCA_000002445.1-Pro_CP000071.1_i000_003839	124	465	341	1.03333	0.706004
GCA_001457755.2-Pro_CZPT02000691.1_i000_004863	124	465	341	1.03333	0.706004
GCA_018994105.1-Fun_JAFKAI010000157.1_i000_000038	1	267	266	0.806061	0.844444
GCA_000764305.3-Ani_JQDR03009694.1_i000_004779	112	432	320	0.969697	0.626223
GCA_001593445.1-Pro_JIBK01000023.1_i000_001845	126	464	338	1.02424	0.671968
GCA_000474925.1-Fun_KI440845.1_i000_004388	127	463	336	1.01818	0.565657
GCA_000961545.1-Fun_AXCR01000010.1_i000_007604	127	463	336	1.01818	0.565657
GCA_017916325.1-Pro_CM030410.1_i000_001826	96	421	325	0.984848	0.725446
GCA_900622495.1-Ani_UYWX01020434.1_i000_007999	1599	1932	333	1.00909	0.163797
GCA_000820605.1-Fun_AWTV01000004.1_i000_001181	127	465	338	1.02424	0.569024
GCA_000002845.2-Pro_FR798984.1_i000_001004	133	465	332	1.00606	0.704883
GCA_900537975.1-Pro_LS997609.1_i000_001097	133	465	332	1.00606	0.704883
GCA_002763495.2-Ani_JXXN02001935.1_i000_005341	479	810	331	1.00303	0.352503
GCA_003730215.1-Pro_RHLC01000033.1_i000_005670	96	422	326	0.987879	0.402469
GCA_015252655.1-Ani_JTDF01000650.1_i000_001330	124	433	309	0.936364	0.705479
GCA_000755165.1-Pro_CP009379.1_i000_000985	133	465	332	1.00606	0.704883
GCA_001299535.1-Pro_LJSK01000061.1_i000_002768	134	466	332	1.00606	0.700422
GCA_017916335.1-Pro_CM030441.1_i000_001062	134	466	332	1.00606	0.700422
GCA_017918215.1-Pro_CM030477.1_i000_001024	133	466	333	1.00909	0.702532
GCA_000813385.1-Fun_KN714668.1_i000_000765	126	459	333	1.00909	0.564407
GCA_000186865.1-Pro_GL833130.1_i000_005500	142	458	316	0.957576	0.640974
GCA_001299535.1-Pro_LJSK01000048.1_i000_002378	96	417	321	0.972727	0.755294
GCA_020726465.1-Fun_JAGIZQ010000008.1_i000_011465	133	449	316	0.957576	0.519737
GCA_000818155.1-Fun_CM003100.1_i000_002996	127	457	330	1	0.559322
GCA_000410735.1-Fun_KE148157.1_i000_005722	127	453	326	0.987879	0.555366
GCA_017918225.1-Pro_CM030549.1_i000_001083	134	466	332	1.00606	0.700422
GCA_011766145.1-Pla_BLLF01000353.1_i000_005333	89	387	298	0.90303	0.615702
GCA_001750085.1-Pro_KV784353.1_i000_000095	1	276	275	0.833333	0.818452
GCA_021556665.1-Fun_JAKFGG010000094.1_i000_010287	127	464	337	1.02121	0.655642
GCA_017916325.1-Pro_CM030405.1_i000_001023	134	466	332	1.00606	0.700422
GCA_018857305.1-Fun_JABCKQ010017470.1_i000_006967	72	357	285	0.863636	0.603814
GCA_000143105.2-Fun_GL629735.1_i000_000964	131	457	326	0.987879	0.547899
GCA_017918235.1-Pro_JAFJZO010000041.1_i000_007868	134	466	332	1.00606	0.700422
GCA_009887335.1-Ani_SGJC01008747.1_i000_007381	102	415	313	0.948485	0.752404
GCA_000277445.1-Pro_AJWJ01000038.1_i000_001568	118	453	335	1.01515	0.622677
GCA_015033655.1-Pro_CM026650.1_i000_010148	133	465	332	1.00606	0.690229
GCA_003177095.1-Pro_PRFC01000122.1_i000_003160	133	465	332	1.00606	0.690229
GCA_002276285.1-Fun_NLAX01000004.1_i000_004128	123	439	316	0.957576	0.522314
GCA_002895965.2-Ani_PIJE02010130.1_i000_032502	1	289	288	0.872727	0.538318
GCA_003730175.1-Pro_RHLD01000037.1_i000_005958	96	418	322	0.975758	0.404523
GCA_013400675.1-Ani_VYZR01003190.1_i000_000154	1	67	66	0.2	0.249057
GCA_013400675.1-Ani_VYZR01003190.1_i000_000154	85	265	180	0.545455	0.679245
GCA_008508345.1-Ani_QNGE01001779.1_i000_005684	117	432	315	0.954545	0.719178
GCA_013358655.1-Pro_JABDHM010000016.1_i000_002656	167	499	332	1.00606	0.64466
GCA_001692735.1-Fun_KV745360.1_i000_011363	128	461	333	1.00909	0.564407
GCA_001460835.1-Pro_CYKH01001851.1_i000_013933	94	414	320	0.969697	0.756501
GCA_002087225.1-Pro_NBCO01000025.1_i000_004228	132	465	333	1.00909	0.683778
GCA_000300495.1-Pro_AHKC01019303.1_i000_009028	133	466	333	1.00909	0.688017
GCA_001875675.1-Fun_MKPU01000064.1_i000_003071	119	452	333	1.00909	0.731868
GCA_000691245.1-Pro_JMRU01001530.1_i000_009480	130	465	335	1.01515	0.696466
GCA_014338405.1-Ani_JTDE01016553.1_i000_010566	115	442	327	0.990909	0.718681
GCA_014858505.1-Pla_CM026417.1_i000_022364	117	432	315	0.954545	0.552632
GCA_001692895.1-Fun_KV748222.1_i000_010754	133	448	315	0.954545	0.534805
GCA_003719475.1-Pro_MKGL01000210.1_i000_005779	94	419	325	0.984848	0.742009
GCA_013368445.1-Fun_JAACJO010000019.1_i000_009691	140	469	329	0.99697	0.272126
GCA_905116865.2-Ani_CAJHNH020001733.1_i000_009794	1	266	265	0.80303	0.660848
GCA_020746835.1-Fun_JAGPNK010000006.1_i000_012390	131	455	324	0.981818	0.546374
GCA_022059095.1-Pro_JAJSEB010000045.1_i000_006660	127	465	338	1.02424	0.694045
GCA_001293395.1-Pro_LGTL01000026.1_i000_008488	94	414	320	0.969697	0.752941
GCA_000696135.1-Fun_JMSE01001045.1_i000_007124	149	418	269	0.815152	0.550102
GCA_003795315.1-Fun_LKEA01000049.1_i000_008749	130	459	329	0.99697	0.558574
GCA_002966975.2-Pla_PJQY01000397.1_i000_010551	4	297	293	0.887879	0.719902
GCA_910592015.1-Fun_CAJVPK010000106.1_i000_002065	110	423	313	0.948485	0.658947
GCA_900617795.1-Ani_CAAALY010036928.1_i000_011840	114	404	290	0.878788	0.717822
GCA_021028975.1-Ani_CM037615.1_i000_003187	108	406	298	0.90303	0.730392
GCA_009733575.1-Fun_ML769473.1_i000_012487	125	467	342	1.03636	0.628676
GCA_000691245.1-Pro_JMRU01000306.1_i000_004674	92	417	325	0.984848	0.755814
GCA_000691945.2-Pro_LN871598.1_i000_002278	118	442	324	0.981818	0.72809
GCA_003795275.1-Fun_LJZO01000018.1_i000_004760	124	459	335	1.01515	0.530903
GCA_021066465.1-Fun_JAJKFY010000221.1_i000_005012	132	462	330	1	0.647059
GCA_910592345.1-Fun_CAJVPI010000232.1_i000_002815	147	503	356	1.07879	0.518195
GCA_013423425.1-Fun_BLZH01000004.1_i000_002856	134	464	330	1	0.647059
GCA_000221225.1-Fun_GL988032.1_i000_000624	125	449	324	0.981818	0.556701
GCA_000613005.1-Ani_HG805811.1_i000_000139	81	430	349	1.05758	0.727083
GCA_000507165.2-Ani_KZ498004.1_i000_011644	129	433	304	0.921212	0.516129
GCA_019425475.1-Pro_NLFJ01000389.1_i000_003999	94	405	311	0.942424	0.723256
GCA_021307395.1-Pro_SOPI01000403.1_i000_009727	94	405	311	0.942424	0.723256
GCA_000827895.1-Ani_JWZT01004662.1_i000_011746	1	291	290	0.878788	0.983051
GCA_002087225.1-Pro_NBCO01000018.1_i000_002377	94	422	328	0.993939	0.745455
GCA_001643675.2-Pro_LSRY02000049.1_i000_013256	106	441	335	1.01515	0.655577
MELA004.0722.00001.C001_00314	94	411	317	0.960606	0.769417
GCA_003719485.1-Pro_MKKU01000960.1_i000_008896	94	420	326	0.987879	0.739229
GCA_003177095.1-Pro_PRFC01000059.1_i000_018972	133	465	332	1.00606	0.690229
GCA_000442495.1-Pro_ATMH01009196.1_i000_009168	141	466	325	0.984848	0.685654
GCA_003719475.1-Pro_MKGL01000071.1_i000_002926	128	466	338	1.02424	0.698347
GCA_008508345.1-Ani_QNGE01001009.1_i000_003868	123	457	334	1.01212	0.581882
GCA_008360955.1-Ani_LUCM01003720.1_i000_003894	45	375	330	1	0.662651
GCA_000442495.1-Pro_ATMH01002882.1_i000_002876	96	411	315	0.954545	0.730858
GCA_003719485.1-Pro_MKKU01000330.1_i000_005532	129	466	337	1.02121	0.691992
GCA_022059095.1-Pro_JAJSEB010000007.1_i000_000590	95	423	328	0.993939	0.750572
GCA_000701025.1-Ani_KL367479.1_i000_001298	136	454	318	0.963636	0.424
GCA_000171015.2-Fun_ABDG02000025.1_i000_004828	134	465	331	1.00303	0.64902
GCA_020647795.1-Fun_CP084938.1_i000_008532	134	465	331	1.00303	0.64902
GCA_003177095.1-Pro_PRFC01000204.1_i000_008572	94	419	325	0.984848	0.748848
GCA_015033655.1-Pro_CM026663.1_i000_012602	94	419	325	0.984848	0.748848
GCA_008692325.1-Fun_NMPR01000178.1_i000_003108	130	406	276	0.836364	0.674817
GCA_000182805.2-Fun_CABT02000046.1_i000_001543	132	457	325	0.984848	0.629845
GCA_006368765.1-Ani_SKCS01000391.1_i000_005375	119	429	310	0.939394	0.717593
GCA_021461655.1-Ani_CM038284.1_i000_003659	119	429	310	0.939394	0.717593
GCA_000300495.1-Pro_AHKC01012153.1_i000_005674	94	419	325	0.984848	0.748848
GCA_000982615.1-Pro_HF955210.1_i000_005503	140	465	325	0.984848	0.690021
GCA_000188675.2-Pro_ADWP02017096.1_i000_006888	94	418	324	0.981818	0.746544
GCA_000496795.1-Pro_AYLP01000023.1_i000_002526	94	418	324	0.981818	0.746544
GCA_002219105.2-Pro_MBSY01000090.1_i000_001490	94	418	324	0.981818	0.746544
GCA_003177105.1-Pro_PRFA01000026.1_i000_006819	94	418	324	0.981818	0.746544
GCA_003719455.1-Pro_MKKV01000057.1_i000_004419	94	418	324	0.981818	0.746544
GCA_015033625.1-Pro_CM026593.1_i000_005916	94	418	324	0.981818	0.746544
GCA_003177095.1-Pro_PRFC01000159.1_i000_005614	94	417	323	0.978788	0.74424
GCA_017788925.1-Fun_JACEFK010000002.1_i000_000017	127	442	315	0.954545	0.711061
GCA_000165365.1-Pro_AAGK01000001.1_i000_000718	124	453	329	0.99697	0.5875
GCA_000982615.1-Pro_HF955201.1_i000_001907	96	419	323	0.978788	0.76
GCA_001457755.2-Pro_CZPT02000860.1_i000_004723	94	406	312	0.945455	0.730679
GCA_003543875.1-Pro_CM010680.1_i000_003951	94	406	312	0.945455	0.725581
GCA_003072535.2-Pro_CP056069.1_i000_000625	87	424	337	1.02121	0.646833
GCA_001235845.1-Pro_LFNC01000057.1_i000_000831	92	419	327	0.990909	0.774882
GCA_000265015.1-Fun_JH687735.1_i000_002107	126	229	103	0.312121	0.162975
GCA_000265015.1-Fun_JH687735.1_i000_002107	242	490	248	0.751515	0.392405
GCA_002894205.1-Fun_MTYH01000060.1_i000_008709	134	465	331	1.00303	0.64902
CANI002.0722.00001.C001_01969	95	426	331	1.00303	0.747178
GCA_000582765.1-Pro_HF955104.1_i000_005789	97	419	322	0.975758	0.754098
GCA_000209065.1-Pro_CH473489.1_i000_004568	156	480	324	0.981818	0.653226
GCA_013358655.1-Pro_JABDHM010000029.1_i000_006004	156	480	324	0.981818	0.653226
GCA_001481775.2-Fun_JPDN02000006.1_i000_009366	134	462	328	0.993939	0.566494
GCA_000701005.1-Ani_KL363183.1_i000_000446	136	465	329	0.99697	0.451303
GCA_000442575.2-Pro_ATMG01006551.1_i000_010349	140	466	326	0.987879	0.686316
GCA_903995115.1-Pro_LR877173.1_i000_010278	140	466	326	0.987879	0.686316
GCA_003025105.1-Fun_KZ679258.1_i000_002930	132	462	330	1	0.647059
GCA_020647865.1-Fun_CP084944.1_i000_002751	132	462	330	1	0.647059
GCA_000740895.1-Pro_AP011946.1_i000_000714	121	459	338	1.02424	0.587826
GCA_014904985.1-Fun_MU128917.1_i000_001719	135	416	281	0.851515	0.535238
GCA_000210295.1-Pro_FN554972.1_i000_005229	168	480	312	0.945455	0.619048
GCA_003615045.1-Fun_ML014127.1_i000_001160	122	461	339	1.02727	0.672619
GCA_002911725.1-Pro_NCKW01017255.1_i000_022693	123	382	259	0.784848	0.67801
GCA_000499545.1-Pro_HG673815.1_i000_001252	151	487	336	1.01818	0.622222
GCA_014529505.1-Pro_JABXOJ010000013.1_i000_000541	125	483	358	1.08485	0.729124
GCA_000002445.1-Pro_CM000207.1_i000_004669	168	479	311	0.942424	0.620758
GCA_900618015.1-Ani_UZAK01034133.1_i000_010657	51	367	316	0.957576	0.856369
GCA_021029035.1-Pro_JAFCAH010000043.1_i000_008266	105	458	353	1.0697	0.639493
GCA_000003225.1-Pro_CR940347.1_i000_000480	123	451	328	0.993939	0.589928
GCA_900618445.1-Ani_UYSG01010926.1_i000_007315	117	432	315	0.954545	0.720824
GCA_902177915.1-Ani_CABIJS010000077.1_i000_002637	117	432	315	0.954545	0.720824
GCA_000342415.1-Pro_ACOU01000002.1_i000_002049	128	454	326	0.987879	0.63301
CANI011.0722.00001.C001_00041	83	401	318	0.963636	0.636
GCA_001531365.1-Pla_CM009741.1_i000_014359	20	315	295	0.893939	0.699052
GCA_000442495.1-Pro_ATMH01001635.1_i000_001632	1	275	274	0.830303	0.944828
GCA_000442495.1-Pro_ATMH01008172.1_i000_008149	1	275	274	0.830303	0.944828
GCA_000372725.1-Pro_KB866422.1_i000_023546	116	390	274	0.830303	0.702564
GCA_003025115.1-Fun_KZ680209.1_i000_002484	136	464	328	0.993939	0.641879
GCA_900617985.1-Ani_UYRR01030973.1_i000_009829	110	219	109	0.330303	0.199634
GCA_900617985.1-Ani_UYRR01030973.1_i000_009829	209	474	265	0.80303	0.485348
GCA_000389695.3-Fun_APWK03000116.1_i000_000881	124	470	346	1.04848	0.599653
GCA_000091205.1-Pro_AP006499.2_i000_003358	121	460	339	1.02727	0.611913
GCA_003958945.1-Ani_QMKO01002935.1_i000_008860	130	444	314	0.951515	0.702461
GCA_003072545.2-Pro_CP056065.1_i000_000594	123	457	334	1.01212	0.58087
GCA_003958945.1-Ani_QMKO01002801.1_i000_008532	136	468	332	1.00606	0.539837
MEAE001.0722.00001.C001_00773	85	406	321	0.972727	0.651116
GCA_000968615.1-Fun_LAEV01000037.1_i000_004273	125	469	344	1.04242	0.592083
GCA_000582765.1-Pro_HF955102.1_i000_005720	135	465	330	1	0.693277
GCA_000978885.1-Fun_LBBL01000010.1_i000_000299	124	470	346	1.04848	0.599653
GCA_900618015.1-Ani_UZAK01032657.1_i000_007958	136	470	334	1.01212	0.537842
GCA_000149815.1-Fun_DS016981.1_i000_010412	135	443	308	0.933333	0.533795
GCA_000760515.2-Fun_JMKJ01000014.1_i000_000175	124	450	326	0.987879	0.663951
GCA_003635345.1-Fun_QVQW01000037.1_i000_005039	122	432	310	0.939394	0.535406
GCA_002095265.1-Pro_MBFZ01000024.1_i000_002761	116	428	312	0.945455	0.710706
GCA_017552425.1-Pla_JAEQKX010000776.1_i000_035000	71	396	325	0.984848	0.530179
GCA_020379485.1-Pla_CM035447.1_i000_007332	153	457	304	0.921212	0.659436
GCA_013390005.1-Ani_WEIV01029094.1_i000_012264	56	188	132	0.4	0.261905
GCA_013390005.1-Ani_WEIV01029094.1_i000_012264	204	357	153	0.463636	0.303571
CAKO001.0722.00001.C001_01606	88	381	293	0.887879	0.767016
GCA_000003085.2-Pro_AABL01000416.1_i000_005732	116	391	275	0.833333	0.699746
GCA_905250025.1-Ani_CAJNOJ010000153.1_i000_025643	169	442	273	0.827273	0.616253
GCA_900618425.1-Ani_UZAN01056734.1_i000_014104	112	431	319	0.966667	0.738426
GCA_000732125.1-Fun_JOWA01000165.1_i000_007814	130	464	334	1.01212	0.647287
GCA_021461655.1-Ani_CM038289.1_i000_007393	132	465	333	1.00909	0.551325
GCA_001447665.1-Ani_JYDP01000005.1_i000_001024	129	464	335	1.01515	0.29884
GCA_003012105.1-Fun_PXOA01000224.1_i000_003962	133	465	332	1.00606	0.56176
GCA_006368765.1-Ani_SKCS01000076.1_i000_009013	131	465	334	1.01212	0.55298
GCA_020647635.1-Fun_CP071108.1_i000_004205	83	406	323	0.978788	0.649899
GCA_019279435.1-Pla_JAAALK010000079.1_i000_040488	149	409	260	0.787879	0.27957
MECO002.0722.00001.C001_02058	94	404	310	0.939394	0.765432
GCA_019828565.1-Pro_JAHDYR010000020.1_i000_004357	94	428	334	1.01212	0.684426
GCA_001447645.1-Ani_JYDV01000091.1_i000_007525	123	457	334	1.01212	0.297153
CANI015.0722.00001.C001_01583	83	395	312	0.945455	0.712329
GCA_000733215.1-Pla_KL662128.1_i000_003949	133	432	299	0.906061	0.602823
GCA_000321355.1-Pro_DF157100.1_i000_001653	118	425	307	0.930303	0.71729
GCA_000165395.2-Pro_CM031753.1_i000_001193	118	431	313	0.948485	0.712984
MEPA006.0722.00001.C001_02151	94	405	311	0.942424	0.76601
GCA_014805555.1-Fun_SBIQ01000017.1_i000_000455	89	410	321	0.972727	0.781022
GCA_000769265.1-Fun_JPKY01000024.1_i000_003902	137	466	329	0.99697	0.630268
GCA_000769155.2-Pro_JROU02000047.1_i000_007131	152	483	331	1.00303	0.607339
GCA_020647705.1-Fun_CP071116.1_i000_004120	132	463	331	1.00303	0.617537
GCA_918797485.1-Pro_CAKKNE010000002.1_i000_003522	133	496	363	1.1	0.726
GCA_000170995.2-Fun_ABDF02000005.1_i000_008617	132	466	334	1.01212	0.654902
CAPR004.0722.00001.C001_00284	96	428	332	1.00606	0.739421
GCA_000167675.2-Fun_GL985081.1_i000_007918	133	459	326	0.987879	0.636719
GCA_000513815.1-Fun_KI911163.1_i000_008212	133	459	326	0.987879	0.636719
GCA_001875675.1-Fun_MKPU01000178.1_i000_001272	114	430	316	0.957576	0.728111
GCA_001278495.1-Fun_LGSR01000022.1_i000_002788	134	467	333	1.00909	0.634286
GCA_000223845.4-Pro_KK211457.1_i000_001012	116	433	317	0.960606	0.7254
GCA_004014815.1-Fun_RYZI01000426.1_i000_007304	128	292	164	0.49697	0.308271
GCA_004014815.1-Fun_RYZI01000426.1_i000_007304	295	480	185	0.560606	0.347744
GCA_020184695.1-Pro_JAANOX010000258.1_i000_009850	120	445	325	0.984848	0.704989
GCA_020186115.1-Pro_WSYJ01000092.1_i000_004350	120	445	325	0.984848	0.704989
GCA_015039365.1-Fun_WION01000002.1_i000_005292	138	413	275	0.833333	0.548902
GCA_001050175.1-Fun_LFMI01000831.1_i000_008963	133	462	329	0.99697	0.552941
GCA_900624965.1-Ani_UYYB01022778.1_i000_006867	12	252	240	0.727273	0.948617
GCA_010108815.1-Ani_QWKW01006511.1_i000_003838	60	403	343	1.03939	0.826506
MESP046.0722.00001.C001_01593	87	373	286	0.866667	0.764706
GCA_900618445.1-Ani_UYSG01001658.1_i000_004372	110	440	330	1	0.649606
GCA_900617975.1-Ani_UZAE01001155.1_i000_002368	98	426	328	0.993939	0.764569
GCA_902177915.1-Ani_CABIJS010000111.1_i000_003837	126	461	335	1.01515	0.579585
GCA_002276285.1-Fun_NLAX01001623.1_i000_004487	130	467	337	1.02121	0.65692
MESP045.0722.00001.C001_01111	88	368	280	0.848485	0.758808
GCA_903853725.1-Fun_CAINUL010000001.1_i000_001368	119	437	318	0.963636	0.657025
GCA_013995675.1-Pro_VWRR01000002.1_i000_002740	123	463	340	1.0303	0.610413
GCA_007182795.1-Fun_VFLP01000065.1_i000_009274	128	456	328	0.993939	0.646943
GCA_000739165.1-Fun_KN042416.1_i000_000983	151	439	288	0.872727	0.578313
MEMA003.0722.00001.C001_01577	87	368	281	0.851515	0.761518
GCA_020002365.1-Fun_JAINEY010000005.1_i000_006893	136	458	322	0.975758	0.569912
GCA_001466705.1-Fun_LATX01000627.1_i000_001658	128	449	321	0.972727	0.597765
GCA_001447755.1-Ani_JYDO01000183.1_i000_003455	123	457	334	1.01212	0.297948
GCA_001447445.1-Ani_JYDU01000090.1_i000_010513	171	503	332	1.00606	0.289956
GCA_008360955.1-Ani_LUCM01005583.1_i000_005751	115	422	307	0.930303	0.713953
GCA_002894145.1-Fun_MTYI01000004.1_i000_008575	195	525	330	1	0.577933
GCA_001447675.1-Ani_JYDR01000103.1_i000_007651	123	457	334	1.01212	0.305302
GCA_001447725.1-Ani_JYDS01000166.1_i000_006482	123	457	334	1.01212	0.304745
GCA_000699445.3-Ani_CM039142.1_i000_000034	156	477	321	0.972727	0.511146
GCA_000499605.1-Pro_HG718948.1_i000_000547	161	487	326	0.987879	0.587387
GCA_001447575.1-Ani_JYDT01000131.1_i000_009713	123	458	335	1.01515	0.304545
GCA_013389885.1-Ani_VWPV01018471.1_i000_006457	121	360	239	0.724242	0.663889
GCA_000002425.2-Pla_CM009340.1_i000_029607	126	377	251	0.760606	0.445035
GCA_000002425.2-Pla_CM009340.1_i000_029607	373	440	67	0.20303	0.118794
GCA_022496225.1-Fun_WTXE01000054.1_i000_009680	130	431	301	0.912121	0.574427
GCA_021029045.1-Pro_JAFCAI010000003.1_i000_007658	134	391	257	0.778788	0.523422
GCA_022160365.1-Fun_MU273481.1_i000_001584	139	442	303	0.918182	0.576046
GCA_900617975.1-Ani_UZAE01003656.1_i000_004751	113	427	314	0.951515	0.723502
GCA_000988865.1-Fun_JOKZ01000301.1_i000_008131	135	463	328	0.993939	0.643137
GCA_020631695.1-Fun_CM036090.1_i000_004971	134	464	330	1	0.642023
GCA_001606155.1-Pro_LODT01000001.1_i000_009989	118	462	344	1.04242	0.548644
GCA_015849335.1-Fun_JAAAIC010002731.1_i000_005211	1	256	255	0.772727	0.812102
GCA_000499725.1-Pro_HG710781.1_i000_001993	129	471	342	1.03636	0.651429
GCA_000732775.1-Fun_KL660883.1_i000_009768	130	455	325	0.984848	0.517516
GCA_000825725.1-Fun_CDGI01000023.1_i000_001569	119	360	241	0.730303	0.639257
GCA_905116865.2-Ani_CAJHNH020001913.1_i000_010486	118	359	241	0.730303	0.671309
GCA_002838845.1-Fun_NQLC01000171.1_i000_003185	135	459	324	0.981818	0.635294
GCA_003025095.1-Fun_KZ679679.1_i000_005746	135	459	324	0.981818	0.635294
GCA_011066345.1-Fun_QLNT01000014.1_i000_003207	134	459	325	0.984848	0.637255
GCA_002022785.1-Fun_LVVK01000023.1_i000_005565	136	460	324	0.981818	0.631579
GCA_002763495.2-Ani_JXXN02001140.1_i000_003706	98	401	303	0.918182	0.728365
GCA_019565615.1-Fun_CP075865.1_i000_003099	135	463	328	0.993939	0.643137
GCA_000699945.1-Ani_JMFT01216671.1_i000_011303	111	350	239	0.724242	0.682857
GCA_020045945.2-Fun_CM034695.1_i000_002455	135	467	332	1.00606	0.65098
GCA_019973975.1-Ani_BMAO01027851.1_i000_049524	86	406	320	0.969697	0.786241
CANI006.0722.00001.C001_00516	86	406	320	0.969697	0.568384
GCA_000730325.1-Fun_KL648754.1_i000_011278	132	455	323	0.978788	0.510269
GCA_000732565.1-Fun_KL651591.1_i000_008983	132	455	323	0.978788	0.510269
GCA_000732765.1-Fun_KL657467.1_i000_003071	132	455	323	0.978788	0.510269
GCA_009194965.1-Fun_VSMA01000002.1_i000_008025	126	426	300	0.909091	0.505902
GCA_910592205.1-Fun_CAJVPJ010002438.1_i000_008428	112	451	339	1.02727	0.605357
GCA_020310465.1-Fun_JAHSQE010000001.1_i000_000259	140	442	302	0.915152	0.54025
GCA_020746835.1-Fun_JAGPNK010000004.1_i000_010172	130	457	327	0.990909	0.638672
GCA_001447595.1-Ani_JYDH01000135.1_i000_008972	123	456	333	1.00909	0.315043
GCA_016097925.1-Fun_JAAAIQ010001148.1_i000_000852	1	253	252	0.763636	0.965517
GCA_002148645.1-Ani_LVZM01004660.1_i000_002718	93	430	337	1.02121	0.689162
GCA_009194965.1-Fun_VSMA01000001.1_i000_001429	82	382	300	0.909091	0.549451
GCA_016771965.1-Pla_CM028693.1_i000_030087	127	436	309	0.936364	0.705479
GCA_001235845.1-Pro_LFNC01000426.1_i000_004431	145	476	331	1.00303	0.69392
GCA_001447745.1-Ani_JYDM01000148.1_i000_002698	155	488	333	1.00909	0.306348
GCA_010093515.1-Fun_MU001677.1_i000_003852	118	456	338	1.02424	0.563333
GCA_902085965.1-Fun_CABFNS010000823.1_i000_010787	132	465	333	1.00909	0.530255
GCA_001662595.1-Fun_KV456757.1_i000_008058	142	446	304	0.921212	0.62423
MESP053.0722.00001.C001_01041	94	399	305	0.924242	0.7625
GCA_006381635.2-Pla_VEPZ02001449.1_i000_064197	131	446	315	0.954545	0.606936
CAME002.0722.00001.C001_01585	68	358	290	0.878788	0.805556
METH001.0722.00001.C001_01189	87	369	282	0.854545	0.762162
GCA_000981445.1-Pro_LK391707.1_i000_000432	117	432	315	0.954545	0.71754
GCA_001879275.1-Fun_KV875099.1_i000_007642	126	421	295	0.893939	0.513043
GCA_013398395.1-Ani_VZSK01000670.1_i000_013216	54	304	250	0.757576	0.822368
GCA_000499425.1-Pro_HG673481.1_i000_006192	160	490	330	1	0.604396
MESU001.0722.00002.C001_01574	93	400	307	0.930303	0.763682
MESP088.0722.00001.C001_01135	87	369	282	0.854545	0.762162
GCA_001447505.1-Ani_JYDN01000114.1_i000_007441	157	490	333	1.00909	0.307763
GCA_900332095.2-Pla_OOIL02006685.1_i000_042057	115	431	316	0.957576	0.681034
GCA_001447655.1-Ani_JYDQ01000151.1_i000_007748	123	456	333	1.00909	0.297587
GCA_902006505.2-Fun_CABFNO020001538.1_i000_013685	132	463	331	1.00303	0.5313
MESP014.0722.00001.C001_00694	94	400	306	0.927273	0.761194
GCA_000149305.1-Fun_CH476739.1_i000_006246	120	426	306	0.927273	0.655246
GCA_902077795.2-Fun_CABFNQ020000754.1_i000_016766	133	465	332	1.00606	0.528662
GCA_905237085.1-Pro_CAJNNV010026698.1_i000_036425	1	213	212	0.642424	0.990654
GCA_905237095.1-Pro_CAJNNW010036238.1_i000_046558	1	213	212	0.642424	0.990654
GCA_001447425.1-Ani_JYDJ01000142.1_i000_006047	166	499	333	1.00909	0.303832
GCA_001447455.1-Ani_JYDL01000144.1_i000_002208	117	451	334	1.01212	0.459422
GCA_006461475.1-Ani_SUNJ01002279.1_i000_001845	114	431	317	0.960606	0.71236
GCA_001447435.1-Ani_JYDK01000141.1_i000_007781	117	449	332	1.00606	0.294587
GCA_021432605.1-Fun_MU271148.1_i000_006510	126	415	289	0.875758	0.5
GCA_018856295.1-Fun_JAFLHD010008894.1_i000_004897	122	440	318	0.963636	0.615087
GCA_018902385.1-Fun_JABSSW010000003.1_i000_000908	86	237	151	0.457576	0.331868
GCA_018902385.1-Fun_JABSSW010000003.1_i000_000908	232	403	171	0.518182	0.375824
MESU001.0722.00001.C001_01177	93	400	307	0.930303	0.763682
GCA_002897235.1-Pro_BDSA01000002.1_i000_002203	117	424	307	0.930303	0.699317
GCA_012550715.1-Fun_JAANYQ010000002.1_i000_001469	120	446	326	0.987879	0.658586
GCA_900618405.1-Ani_UYSL01027347.1_i000_022019	110	358	248	0.751515	0.690808
GCA_013399695.1-Ani_VXAU01005792.1_i000_012543	54	189	135	0.409091	0.294118
GCA_013399695.1-Ani_VXAU01005792.1_i000_012543	196	363	167	0.506061	0.363834
GCA_003260385.1-Pla_NQVE01000098.1_i000_005558	114	425	311	0.942424	0.726636
GCA_001447585.1-Ani_JYDI01000172.1_i000_008161	117	447	330	1	0.314286
GCA_008636045.1-Pro_SNRW01010248.1_i000_027640	75	416	341	1.03333	0.539557
GCA_003676055.1-Ani_QUSF01003367.1_i000_017523	62	194	132	0.4	0.236984
GCA_003676055.1-Ani_QUSF01003367.1_i000_017523	205	259	54	0.163636	0.0969479
GCA_003676055.1-Ani_QUSF01003367.1_i000_017523	284	385	101	0.306061	0.181329
GCA_003676055.1-Ani_QUSF01003367.1_i000_017523	508	555	47	0.142424	0.0843806
MEFO001.0722.00002.C001_02061	94	400	306	0.927273	0.761194
MEFO001.0722.00001.C001_00329	94	400	306	0.927273	0.761194
GCA_905338385.1-Ani_CAJPEV010002676.1_i000_009854	130	438	308	0.933333	0.623482
GCA_000430065.1-Fun_ATCN01000010.1_i000_000034	78	384	306	0.927273	0.796875
GCA_902141235.2-Fun_CABFOC020000039.1_i000_009378	133	467	334	1.01212	0.532695
GCA_001447565.1-Ani_JYDW01000125.1_i000_001190	117	447	330	1	0.316092
GCA_001651475.1-Pla_CM004363.1_i000_022967	118	439	321	0.972727	0.699346
GCA_905221635.1-Pro_CAJNDV010035552.1_i000_028795	121	255	134	0.406061	0.156359
GCA_905221635.1-Pro_CAJNDV010035552.1_i000_028795	604	814	210	0.636364	0.245041
GCA_000208865.2-Pro_FR823393.1_i000_006587	142	514	372	1.12727	0.683824
GCA_019202795.1-Pla_CM032917.1_i000_022957	89	413	324	0.981818	0.72973
GCA_021029035.1-Pro_JAFCAH010000001.1_i000_000298	89	357	268	0.812121	0.576344
GCA_000006565.2-Pro_CM002047.1_i000_007666	142	483	341	1.03333	0.636194
GCA_000150015.2-Pro_KI544497.1_i000_002283	142	483	341	1.03333	0.636194
GCA_000224865.2-Pro_KN044615.1_i000_001564	142	483	341	1.03333	0.636194
GCA_000325525.2-Pro_KN003119.1_i000_002643	142	483	341	1.03333	0.636194
GCA_013099955.1-Pro_CM023093.1_i000_007694	142	483	341	1.03333	0.636194
GCA_000250965.2-Pro_KQ976326.1_i000_007585	142	483	341	1.03333	0.636194
GCA_013400395.1-Ani_WBNN01012465.1_i000_004090	55	276	221	0.669697	0.479393
GCA_013400395.1-Ani_WBNN01012465.1_i000_004090	279	377	98	0.29697	0.212581
GCA_000002825.1-Pro_DS113281.1_i000_049623	122	453	331	1.00303	0.581722
GCA_004325035.1-Fun_PIXR01000531.1_i000_001450	92	419	327	0.990909	0.778571
GCA_002563875.1-Pro_CM008346.1_i000_000572	139	484	345	1.04545	0.64486
GCA_910591605.1-Ani_CAJVCH010478535.1_i000_030827	1	197	196	0.593939	0.994924
GCA_902705455.1-Pla_CACSHJ010000096.1_i000_023325	89	410	321	0.972727	0.746512
GCA_904420315.1-Pla_LR881470.1_i000_019220	118	440	322	0.975758	0.701525
GCA_014805705.1-Fun_SBJP01000179.1_i000_001061	90	395	305	0.924242	0.772152
GCA_015502465.1-Fun_JAAAUP010000158.1_i000_002542	1	253	252	0.763636	0.812903
GCA_004325045.1-Fun_PITJ01000859.1_i000_002293	92	419	327	0.990909	0.778571
GCA_015852435.1-Fun_JAAAIJ010003532.1_i000_007121	1	181	180	0.545455	0.994475
GCA_000613005.1-Ani_HG805869.1_i000_002111	120	392	272	0.824242	0.676617
GCA_004325065.1-Fun_PITI01000495.1_i000_001859	92	419	327	0.990909	0.778571
GCA_004325075.1-Fun_PITK01000638.1_i000_002871	92	419	327	0.990909	0.778571
GCA_009771035.1-Pla_CM020004.1_i000_010657	126	457	331	1.00303	0.719565
GCA_019202805.1-Pla_CM032904.1_i000_022285	89	409	320	0.969697	0.715884
GCA_000165425.1-Pro_CT868130.1_i000_017310	117	442	325	0.984848	0.625
MESP007.0722.00001.C001_01915	80	382	302	0.915152	0.788512
GCA_000797535.1-Ani_KN538392.1_i000_005599	167	522	355	1.07576	0.518248
GCA_000447185.1-Fun_KE647051.1_i000_000416	84	403	319	0.966667	0.787654
GCA_000018645.1-Pro_CP000882.1_i000_000309	102	405	303	0.918182	0.748148
METE004.0722.00001.C001_00228	84	356	272	0.824242	0.764045
GCA_000732775.1-Fun_KL659360.1_i000_000885	143	471	328	0.993939	0.618868
GCA_000223845.4-Pro_KK211460.1_i000_001437	123	454	331	1.00303	0.656746
GCA_018360755.1-Fun_SRQW01001066.1_i000_000314	122	470	348	1.05455	0.731092
GCA_018360855.1-Fun_SRRF01000745.1_i000_007353	122	470	348	1.05455	0.731092
GCA_002954075.1-Fun_CP025763.1_i000_003453	129	369	240	0.727273	0.564706
GCA_019669845.1-Fun_MU251271.1_i000_008298	134	465	331	1.00303	0.64902
GCA_009299455.1-Fun_VIGI01000012.1_i000_008249	142	445	303	0.918182	0.612121
GCA_018360865.1-Fun_SRRG01001065.1_i000_000321	122	457	335	1.01515	0.715812
GCA_018342105.1-Ani_JAFIRS010000060.1_i000_002151	116	349	233	0.706061	0.423636
GCA_018342105.1-Ani_JAFIRS010000060.1_i000_002151	348	424	76	0.230303	0.138182
GCA_000337935.2-Ani_AKCR02000303.1_i000_013596	106	323	217	0.657576	0.470716
GCA_000337935.2-Ani_AKCR02000303.1_i000_013596	330	438	108	0.327273	0.234273
GCA_000732565.1-Fun_KL650463.1_i000_001366	145	472	327	0.990909	0.570681
MEME001.0722.00001.C001_02227	46	338	292	0.884848	0.853801
GCA_001839685.1-Pro_MLAK01000726.1_i000_011271	128	457	329	0.99697	0.611524
GCA_000730325.1-Fun_KL647752.1_i000_001535	145	472	327	0.990909	0.570681
GCA_000182985.1-Fun_ACOL01000064.1_i000_001271	83	405	322	0.975758	0.793103
GCA_000988165.1-Fun_JPQZ01000019.1_i000_000871	83	405	322	0.975758	0.793103
GCA_004919615.1-Fun_SMUP01000067.1_i000_002093	83	405	322	0.975758	0.793103
GCA_015852385.1-Fun_JAAAIE010000340.1_i000_006073	1	251	250	0.757576	0.798722
GCA_000280035.2-Fun_CP003521.1_i000_000499	91	412	321	0.972727	0.77724
GCA_000767015.2-Ani_ASGP02000001.1_i000_001104	161	475	314	0.951515	0.601533
MEMI001.0722.00001.C001_02085	74	375	301	0.912121	0.798408
GCA_000383075.1-Fun_KB909498.1_i000_003593	80	403	323	0.978788	0.797531
GCA_000165395.2-Pro_AAXT02000005.1_i000_003385	121	455	334	1.01212	0.586995
MEOL001.0722.00001.C001_01467	94	406	312	0.945455	0.764706
GCA_000183805.3-Ani_JH712318.1_i000_009992	164	412	248	0.751515	0.601942
GCA_012274485.2-Pla_MU105901.1_i000_022780	135	448	313	0.948485	0.695556
GCA_000238015.2-Fun_JH413860.1_i000_002510	141	379	238	0.721212	0.477912
GCA_000238015.2-Fun_JH413860.1_i000_002510	376	441	65	0.19697	0.130522
GCA_000224805.2-Pro_KN039986.1_i000_001207	139	434	295	0.893939	0.679724
GCA_000256725.2-Pro_KQ983273.1_i000_002598	139	434	295	0.893939	0.679724
GCA_015679545.1-Fun_JAAAUZ010000549.1_i000_006188	1	247	246	0.745455	0.836735
MESM001.0722.00001.C001_01482	80	385	305	0.924242	0.788114
MESM001.0722.00002.C001_01022	80	385	305	0.924242	0.788114
MESM001.0722.00003.C001_01242	80	385	305	0.924242	0.788114
GCA_002095265.1-Pro_MBFZ01000215.1_i000_002913	120	459	339	1.02727	0.562189
GCA_015179025.1-Fun_WHUX01000038.1_i000_007254	128	378	250	0.757576	0.641026
GCA_000733215.1-Pla_KL662175.1_i000_006254	126	351	225	0.681818	0.479744
GCA_000733215.1-Pla_KL662175.1_i000_006254	350	436	86	0.260606	0.183369
GCA_014220965.1-Ani_LOND01006034.1_i000_007910	126	447	321	0.972727	0.57016
GCA_002284615.2-Pla_MU069898.1_i000_010437	132	420	288	0.872727	0.619355
GCA_015502575.1-Fun_JAAAUR010000358.1_i000_006899	1	246	245	0.742424	0.830508
GCA_020497125.1-Ani_CM035647.1_i000_018292	29	360	331	1.00303	0.71645
GCA_015501075.1-Fun_JADNYJ010000055.1_i000_012450	136	442	306	0.927273	0.552347
GCA_015832245.1-Fun_SBJO01000046.1_i000_000936	83	404	321	0.972727	0.792593
GCA_006381635.2-Pla_VEPZ02001331.1_i000_057350	1	206	205	0.621212	0.57423
GCA_022376445.1-Fun_JACBKP010000092.1_i000_017022	131	429	298	0.90303	0.56979
GCA_000981445.1-Pro_LK391707.1_i000_000889	120	455	335	1.01515	0.543831
GCA_020142125.1-Ani_CM034710.1_i000_014069	44	357	313	0.948485	0.627255
MESP079.0722.00001.C001_01247	80	386	306	0.927273	0.790698
GCA_002897235.1-Pro_BDSA01000002.1_i000_001756	120	455	335	1.01515	0.530903
GCA_021525005.1-Fun_JAKEYE010000011.1_i000_001631	127	440	313	0.948485	0.581784
GCA_014108255.1-Ani_JACAGC010000022.1_i000_009904	40	369	329	0.99697	0.659319
MEFE001.0722.00001.C001_01213	82	359	277	0.839394	0.771588
GCA_003942145.1-Ani_QXTE01000511.1_i000_019023	37	365	328	0.993939	0.658635
GCA_018859375.1-Ani_JAHGAV010000356.1_i000_015382	21	368	347	1.05152	0.698189
GCA_000091225.2-Fun_AL590444.1_i000_000587	90	412	322	0.975758	0.779661
GCA_010078445.1-Ani_VULE01000234.1_i000_000279	54	270	216	0.654545	0.459574
GCA_010078445.1-Ani_VULE01000234.1_i000_000279	294	386	92	0.278788	0.195745
GCA_000281125.4-Ani_AKHW03006584.1_i000_022793	42	368	326	0.987879	0.63301
GCA_002738545.1-Ani_NTJE010242034.1_i000_008916	4	300	296	0.89697	0.787234
GCA_000230795.1-Ani_CM001271.1_i000_015844	45	370	325	0.984848	0.651303
GCA_002880755.3-Ani_CM009257.2_i000_016640	45	370	325	0.984848	0.651303
GCA_002880775.3-Ani_CM009281.2_i000_016494	45	370	325	0.984848	0.651303
GCF_000001405.40-Hum_NC_000019.10_i000_017570	45	370	325	0.984848	0.651303
GCA_014533835.1-Ani_WJEC01000714.1_i000_004395	54	370	316	0.957576	0.622047
GCA_901343595.1-Ani_CABDUW010001168.1_i000_020195	54	370	316	0.957576	0.622047
GCA_010411085.1-Ani_CM021195.1_i000_002605	40	369	329	0.99697	0.659319
GCA_014049915.1-Ani_JABVXQ010000014.1_i000_005849	40	369	329	0.99697	0.659319
GCA_014176215.1-Ani_JACASE010000014.1_i000_005742	40	369	329	0.99697	0.659319
GCA_014108415.1-Ani_JACASF010000021.1_i000_011568	40	369	329	0.99697	0.659319
GCA_017524585.1-Ani_CM029832.1_i000_013567	40	369	329	0.99697	0.659319
GCA_000325575.1-Ani_KB030432.1_i000_002876	40	369	329	0.99697	0.659319
GCA_900661375.1-Ani_CAAGRJ010021716.1_i000_012758	40	369	329	0.99697	0.659319
GCA_905146905.1-Ani_CAJHUB010000775.1_i000_024972	40	369	329	0.99697	0.659319
GCA_016881025.1-Ani_JAESOR010004409.1_i000_020150	43	367	324	0.981818	0.649299
GCA_021218885.1-Ani_MU269954.1_i000_007797	43	367	324	0.981818	0.649299
GCA_020004445.1-Ani_JAATJV010454215.1_i000_022987	43	367	324	0.981818	0.649299
GCA_003521335.2-Ani_QWLN02007227.1_i000_007232	41	364	323	0.978788	0.647295
GCA_008782695.1-Ani_CM018502.1_i000_012826	44	365	321	0.972727	0.643287
GCA_008787405.2-Ani_CM018479.1_i000_006849	44	365	321	0.972727	0.643287
GCA_000002265.1-Ani_CM000231.2_i000_000626	40	369	329	0.99697	0.659319
GCA_000002165.1-Ani_CM000215.2_i000_011144	43	370	327	0.990909	0.655311
GCA_019455555.1-Ani_JAGFMF010011562.1_i000_004604	41	369	328	0.993939	0.618868
GCA_000516915.1-Ani_AZIM01000507.1_i000_003505	116	404	288	0.872727	0.576
GCA_000002425.2-Pla_CM009320.1_i000_008168	154	485	331	1.00303	0.556303
GCA_005125345.1-Ani_RWIC01001494.1_i000_018354	3	313	310	0.939394	0.717593
GCA_021904315.1-Pla_CM038908.1_i000_002771	92	406	314	0.951515	0.58473
GCA_001078035.1-Fun_LFTZ01000004.1_i000_000496	90	412	322	0.975758	0.779661
GCA_007646595.3-Ani_VBQZ03000414.1_i000_020364	3	313	310	0.939394	0.696629
GCA_014108245.1-Ani_JACAGB010000184.1_i000_006443	40	369	329	0.99697	0.659319
GCA_000743615.1-Ani_KN121407.1_i000_002127	74	402	328	0.993939	0.615385
GCA_905332335.1-Ani_CAJOBX010013891.1_i000_018787	3	313	310	0.939394	0.702948
GCA_021028975.1-Ani_CM037628.1_i000_026131	45	366	321	0.972727	0.643287
GCA_021525775.1-Fun_JAKELK010000003.1_i000_009119	130	439	309	0.936364	0.619238
CAME003.0722.00001.C001_01119	75	358	283	0.857576	0.786111
GCA_000277815.3-Fun_CP002716.1_i000_000517	91	412	321	0.972727	0.77724
GCA_018342045.1-Fun_JAGEXW010000004.1_i000_000676	91	412	321	0.972727	0.77724
MEOR003.0722.00001.C001_01864	46	339	293	0.887879	0.856725
GCA_000146465.1-Fun_CP001945.1_i000_000523	90	410	320	0.969697	0.776699
GCA_910592245.1-Fun_CAJVQB010027124.1_i000_025001	100	174	74	0.224242	0.162637
GCA_910592245.1-Fun_CAJVQB010027124.1_i000_025001	171	403	232	0.70303	0.50989
GCA_000192795.1-Fun_GL877426.1_i000_001463	94	394	300	0.909091	0.753769
MESP023.0722.00001.C001_01570	93	403	310	0.939394	0.765432
GCA_000002825.1-Pro_DS113312.1_i000_047741	118	455	337	1.02121	0.700624
GCA_900618395.1-Ani_UZAI01019276.1_i000_022159	156	461	305	0.924242	0.501645
GCA_020921065.1-Pla_CM037157.1_i000_020178	49	355	306	0.927273	0.60355
GCA_020921065.1-Pla_CM037157.1_i000_020178	348	450	102	0.309091	0.201183
GCA_020921065.1-Pla_CM037157.1_i000_020178	439	485	46	0.139394	0.0907298
GCA_905397895.1-Ani_CAJPWZ010001066.1_i000_021242	114	295	181	0.548485	0.359127
GCA_905397895.1-Ani_CAJPWZ010001066.1_i000_021242	294	427	133	0.40303	0.263889
GCA_910592055.1-Fun_CAJVPT010002334.1_i000_001922	127	193	66	0.2	0.129921
GCA_910592055.1-Fun_CAJVPT010002334.1_i000_001922	190	431	241	0.730303	0.474409
GCA_016256075.1-Fun_SDVU01000239.1_i000_000818	73	386	313	0.948485	0.806701
GCA_014871385.1-Pla_CM026423.1_i000_008592	46	379	333	1.00909	0.685185
GCA_020499125.1-Fun_JAIBQH010000033.1_i000_005576	129	439	310	0.939394	0.618762
GCA_000797535.1-Ani_KN538377.1_i000_001633	120	456	336	1.01818	0.644914
GCA_020184695.1-Pro_JAANOX010000034.1_i000_001491	125	456	331	1.00303	0.645224
GCA_020186115.1-Pro_WSYJ01000001.1_i000_000173	125	456	331	1.00303	0.645224
GCA_015502485.1-Fun_JAAAUO010001309.1_i000_002024	1	241	240	0.727273	0.872727
GCA_013368315.1-Fun_JAACJM010000230.1_i000_016134	127	372	245	0.742424	0.469349
GCA_013368315.1-Fun_JAACJM010000230.1_i000_016134	370	435	65	0.19697	0.124521
GCA_020004485.1-Ani_JAATJU010025451.1_i000_018084	43	368	325	0.984848	0.251548
GCA_018397855.1-Fun_JAGFBS010000010.1_i000_000809	127	283	156	0.472727	0.29434
GCA_018397855.1-Fun_JAGFBS010000010.1_i000_000809	281	431	150	0.454545	0.283019
MEHO001.0722.00001.C001_00051	47	356	309	0.936364	0.844262
GCA_021442195.1-Pla_CM038211.1_i000_023057	43	375	332	1.00606	0.687371
GCA_021904315.1-Pla_CM038924.1_i000_023791	43	375	332	1.00606	0.687371
GCA_016906535.1-Fun_CP059658.1_i000_000475	267	585	318	0.963636	0.389229
GCA_014871845.1-Pla_CM026438.1_i000_015853	43	375	332	1.00606	0.68595
GCA_014362265.1-Pla_BJWL01000007.1_i000_010432	124	359	235	0.712121	0.428832
GCA_000334495.1-Ani_KB320547.1_i000_003932	76	398	322	0.975758	0.630137
GCA_000004195.4-Ani_CM004449.2_i000_017887	40	370	330	1	0.662651
GCA_001270105.1-Ani_LHQP01026721.1_i000_034868	123	195	72	0.218182	0.159292
GCA_001270105.1-Ani_LHQP01026721.1_i000_034868	191	427	236	0.715152	0.522124
GCA_019973955.1-Ani_BMAV01024545.1_i000_044375	37	373	336	1.01818	0.689938
GCA_015342795.1-Ani_CM027196.1_i000_021656	38	373	335	1.01515	0.687885
GCA_018991925.1-Ani_JAHLQT010021643.1_i000_010869	487	799	312	0.945455	0.342105
GCA_008932095.1-Pla_CM018510.1_i000_012789	131	375	244	0.739394	0.576832
GCA_000286095.1-Pro_CP003681.1_i000_000285	94	390	296	0.89697	0.758974
MESP004.0722.00001.C001_00258	47	335	288	0.872727	0.857143
GCA_001642395.1-Fun_LTDL01000040.1_i000_001155	67	412	345	1.04545	0.831325
CAME001.0722.00001.C001_00225	74	364	290	0.878788	0.79235
CAME001.0722.00002.C001_00227	74	364	290	0.878788	0.79235
GCA_900617995.1-Ani_UZAL01039559.1_i000_017343	147	487	340	1.0303	0.564784
GCA_019973975.1-Ani_BMAO01036591.1_i000_065011	38	373	335	1.01515	0.687885
GCA_000223135.1-Ani_JH001168.1_i000_016439	3	313	310	0.939394	0.702948
GCA_019343175.1-Ani_CM033279.1_i000_013228	124	460	336	1.01818	0.48415
MEHO003.0722.00001.C001_04149	47	335	288	0.872727	0.857143
GCA_001663975.1-Ani_CM004478.1_i000_029797	60	370	310	0.939394	0.62249
GCA_000611955.2-Ani_KK113697.1_i000_004381	38	373	335	1.01515	0.686475
GCA_003032435.1-Pla_KZ772714.1_i000_008337	43	374	331	1.00303	0.6853
GCA_009936355.2-Pla_AP019867.1_i000_004283	43	374	331	1.00303	0.6853
GCA_002104905.1-Fun_MCFE01000045.1_i000_009908	14	358	344	1.04242	0.742981
GCA_001839685.1-Pro_MLAK01000545.1_i000_004488	122	447	325	0.984848	0.700431
GCA_008692225.1-Fun_VICG01000012.1_i000_009715	140	345	205	0.621212	0.385338
GCA_008692225.1-Fun_VICG01000012.1_i000_009715	343	443	100	0.30303	0.18797
GCA_000316135.1-Fun_JH993798.1_i000_000014	20	347	327	0.990909	0.931624
GCA_019623705.1-Fun_WSTJ01000001.1_i000_000042	1	258	257	0.778788	0.683511
GCA_002148645.1-Ani_LVZM01002395.1_i000_001390	141	453	312	0.945455	0.447633
GCA_003086715.1-Fun_MBFS01003796.1_i000_007023	1	229	228	0.690909	0.987013
GCA_900659725.1-Ani_CAACVG010007067.1_i000_006589	88	316	228	0.690909	0.716981
GCA_013235015.1-Ani_BGPR01005340.1_i000_099040	38	374	336	1.01818	0.755056
GCA_014871385.1-Pla_CM026425.1_i000_012983	42	375	333	1.00909	0.688017
GCA_015852375.1-Fun_JAAAIF010000039.1_i000_006608	1	231	230	0.69697	0.851852
GCA_004786185.1-Ani_CM015718.1_i000_007677	53	384	331	1.00303	0.651575
GCA_019447015.1-Ani_CM033475.1_i000_013341	48	363	315	0.954545	0.633803
GCA_015852435.1-Fun_JAAAIJ010001805.1_i000_003564	1	227	226	0.684848	0.840149
GCA_019512145.1-Ani_CM033646.1_i000_012206	39	363	324	0.981818	0.650602
GCA_016098085.1-Fun_JAAAIX010000014.1_i000_001814	1	238	237	0.718182	0.871324
GCA_905219585.1-Fun_CAJMWS010000316.1_i000_003944	126	373	247	0.748485	0.464286
GCA_905219585.1-Fun_CAJMWS010000316.1_i000_003944	369	433	64	0.193939	0.120301
GCA_021604985.1-Pla_BQKI01000018.1_i000_026443	151	406	255	0.772727	0.516194
GCA_013401335.1-Ani_VYZX01018503.1_i000_006875	53	297	244	0.739394	0.821549
GCA_003615035.1-Fun_ML009500.1_i000_001234	138	479	341	1.03333	0.637383
GCA_001641455.1-Pla_LVLJ01001475.1_i000_008891	90	412	322	0.975758	0.618042
GCA_018994095.1-Fun_JAEMWZ010000091.1_i000_018506	121	460	339	1.02727	0.526398
MESP010.0722.00001.C001_01723	91	408	317	0.960606	0.773171
GCA_021605095.1-Ani_BPLR01013209.1_i000_050327	38	373	335	1.01515	0.696466
GCA_000743665.3-Fun_JMRO03000017.1_i000_000767	155	221	66	0.2	0.130693
GCA_000743665.3-Fun_JMRO03000017.1_i000_000767	218	464	246	0.745455	0.487129
GCA_021605075.1-Ani_BPLQ01011868.1_i000_040928	38	373	335	1.01515	0.687885
GCA_006381635.2-Pla_VEPZ02001109.1_i000_042008	58	309	251	0.760606	0.749254
GCA_902651935.1-Pla_CACRSJ010000110.1_i000_023447	89	409	320	0.969697	0.774818
GCA_004026145.2-Ani_CP034976.1_i000_010176	47	379	332	1.00606	0.66004
GCA_000209065.1-Pro_CH473844.1_i000_000043	1	267	266	0.806061	0.939929
GCA_003711565.2-Ani_CM011078.1_i000_012948	52	383	331	1.00303	0.65286
GCA_014773175.1-Ani_VXCM01002143.1_i000_013247	79	411	332	1.00606	0.620561
MEMA006.0722.00001.C001_03253	48	335	287	0.869697	0.854167
GCA_017589495.1-Ani_CM030058.1_i000_015340	55	384	329	0.99697	0.642578
GCA_000311805.2-Ani_KB016369.1_i000_000365	40	377	337	1.02121	0.654369
MEEV001.0722.00001.C001_02268	47	327	280	0.848485	0.856269
GCA_001663975.1-Ani_CM004479.1_i000_031518	72	363	291	0.881818	0.5369
MEMA006.0722.00003.C001_03162	47	335	288	0.872727	0.857143
GCA_019776745.2-Pla_CM034147.1_i000_004946	512	842	330	1	0.347003
GCA_020310875.1-Pla_CM035422.1_i000_016588	43	375	332	1.00606	0.687371
GCA_014180765.2-Pla_MUAA02000041.1_i000_007383	2	311	309	0.936364	0.73747
GCA_001642395.1-Fun_LTDL01000021.1_i000_002027	106	407	301	0.912121	0.734146
GCA_000803125.3-Ani_CM016635.2_i000_007382	106	387	281	0.851515	0.539347
GCA_006937295.1-Pla_VIBQ01000014.1_i000_023131	133	360	227	0.687879	0.141609
MEFL001.0722.00001.C001_01011	47	334	287	0.869697	0.854167
GCA_000151145.1-Fun_DS995701.1_i000_007978	136	451	315	0.954545	0.531197
GCA_011752425.2-Ani_CACVKT020005076.1_i000_027620	38	375	337	1.02121	0.679435
GCA_019857665.1-Ani_CM034091.1_i000_008065	53	362	309	0.936364	0.620482
GCA_000250985.1-Fun_JH605027.1_i000_002008	103	415	312	0.945455	0.748201
GCA_001005745.2-Ani_JARO02000468.1_i000_001918	55	387	332	1.00606	0.649706
GCA_000143415.2-Pla_GL377593.1_i000_015465	5	337	332	1.00606	0.749436
GCA_000143415.2-Pla_GL377603.1_i000_018788	5	337	332	1.00606	0.749436
GCA_902810595.1-Ani_LR778280.1_i000_031557	3	333	330	1	0.68323
GCA_000180735.1-Ani_CAAE01014543.1_i000_010915	52	383	331	1.00303	0.628083
GCA_905397895.1-Ani_CAJPWZ010000964.1_i000_018950	38	375	337	1.02121	0.679435
GCA_900618805.1-Ani_UYJE01010245.1_i000_058383	38	375	337	1.02121	0.679435
GCA_013634535.1-Ani_JACDTQ010002604.1_i000_008241	44	363	319	0.966667	0.641851
GCA_003427395.1-Pla_BFEA01000824.1_i000_031094	53	380	327	0.990909	0.668712
GCA_008632915.2-Pla_AP019301.1_i000_014784	144	337	193	0.584848	0.243995
GCA_008632915.2-Pla_AP019301.1_i000_014784	337	436	99	0.3	0.125158
GCA_001642415.1-Fun_LTDK01000181.1_i000_000280	103	415	312	0.945455	0.748201
GCA_003073045.1-Ani_CM009758.1_i000_000922	38	365	327	0.990909	0.667347
GCA_013400895.1-Ani_VZTW01015422.1_i000_002776	1	249	248	0.751515	0.837838
GCA_016745375.1-Ani_WIOS01000021.1_i000_010430	7	335	328	0.993939	0.713043
GCA_003845795.1-Ani_CM011687.1_i000_013444	52	384	332	1.00606	0.653543
GCA_003711585.2-Ani_CM011661.2_i000_012382	52	384	332	1.00606	0.653543
GCA_008124465.1-Pla_CM017872.1_i000_000912	45	376	331	1.00303	0.683884
GCA_000209225.1-Ani_DS469781.1_i000_007949	36	371	335	1.01515	0.683673
GCA_002837095.1-Pla_PGOL01003331.1_i000_037948	1	248	247	0.748485	0.703704
GCA_000803265.1-Fun_JOKQ01000004.1_i000_000702	90	412	322	0.975758	0.779661
GCA_004324935.1-Fun_PITG01000004.1_i000_000698	90	412	322	0.975758	0.779661
GCA_004324945.1-Fun_PITF01000005.1_i000_000695	90	412	322	0.975758	0.779661
GCA_004325055.1-Fun_PITH01000006.1_i000_000694	90	412	322	0.975758	0.779661
GCA_902459845.2-Pro_CABPSV020000014.1_i000_000185	120	458	338	1.02424	0.581756
GCA_910591915.1-Fun_CAJVQA010017081.1_i000_014436	112	188	76	0.230303	0.151093
GCA_910591915.1-Fun_CAJVQA010017081.1_i000_014436	184	410	226	0.684848	0.449304
GCA_014461125.1-Fun_JACAZG010000001.1_i000_000600	879	1204	325	0.984848	0.246773
GCA_012432095.1-Ani_CM022800.1_i000_015924	54	383	329	0.99697	0.646365
GCA_003186165.1-Ani_CP026243.1_i000_000834	53	384	331	1.00303	0.651575
GCA_006346445.1-Ani_VEVO01000002.1_i000_001996	53	384	331	1.00303	0.651575
GCA_014170095.1-Ani_WKFB01000117.1_i000_004826	52	383	331	1.00303	0.65286
GCA_000190615.1-Fun_GL870880.1_i000_001910	62	415	353	1.0697	0.846523
METH002.0722.00001.C001_01214	48	334	286	0.866667	0.85119
GCA_004786185.1-Ani_CM015718.1_i000_007678	2718	3044	326	0.987879	0.102807
GCA_019176455.1-Ani_CM032862.1_i000_011573	2796	3123	327	0.990909	0.100615
MEST002.0722.00001.C001_01434	91	407	316	0.957576	0.772616
GCA_002920065.1-Fun_PKSL01000028.1_i000_003648	207	363	156	0.472727	0.267581
GCA_002920065.1-Fun_PKSL01000028.1_i000_003648	381	528	147	0.445455	0.252144
GCA_014805555.1-Fun_SBIQ01000039.1_i000_000850	106	427	321	0.972727	0.504717
GCA_900002335.2-Pro_LK022886.2_i000_002141	120	456	336	1.01818	0.684318
GCA_900095555.1-Pro_LT608175.1_i000_001784	120	456	336	1.01818	0.684318
GCA_900095605.1-Pro_LT608161.1_i000_001872	120	456	336	1.01818	0.684318
GCA_019974015.1-Ani_BMAW01053855.1_i000_030364	37	373	336	1.01818	0.689938
GCA_900088575.1-Pro_FLQW01000692.1_i000_001243	120	449	329	0.99697	0.510078
GCA_001879085.1-Pla_MJEQ01002470.1_i000_026697	66	397	331	1.00303	0.655446
GCA_900095565.1-Pro_LT608203.1_i000_001890	120	456	336	1.01818	0.684318
GCA_900095625.1-Pro_LT608189.1_i000_001886	120	456	336	1.01818	0.684318
GCA_013397655.1-Ani_VYZF01004093.1_i000_012789	58	184	126	0.381818	0.243714
GCA_013397655.1-Ani_VYZF01004093.1_i000_012789	208	421	213	0.645455	0.411992
GCA_000524515.1-Pro_KI965397.1_i000_001769	120	456	336	1.01818	0.684318
GCA_903994235.1-Pro_LR865414.1_i000_002222	120	456	336	1.01818	0.684318
GCA_021821965.1-Fun_JACCJH010000006.1_i000_000704	113	434	321	0.972727	0.736239
GCA_019721115.1-Ani_CM033897.1_i000_007655	55	382	327	0.990909	0.641176
GCA_012411365.1-Ani_CM022757.1_i000_005950	54	387	333	1.00909	0.658103
GCA_903994225.1-Pro_LR865371.1_i000_002127	120	457	337	1.02121	0.686354
GCA_903632075.3-Ani_CAHIKZ030001009.1_i000_016809	3	329	326	0.987879	0.719647
GCA_003999625.1-Ani_CM012452.1_i000_014133	80	411	331	1.00303	0.618692
GCA_002914805.1-Pla_JXTB01000141.1_i000_016067	45	377	332	1.00606	0.687371
GCA_003546025.1-Pla_QPKB01000001.1_i000_002590	126	458	332	1.00606	0.718615
GCA_905332335.1-Ani_CAJOBX010000390.1_i000_001242	42	363	321	0.972727	0.644578
GCA_019176425.1-Ani_CM032884.1_i000_011624	77	407	330	1	0.619137
GCA_903994265.1-Pro_LR865430.1_i000_002249	120	457	337	1.02121	0.686354
GCA_910591915.1-Fun_CAJVQA010004890.1_i000_007349	112	355	243	0.736364	0.483101
GCA_910591915.1-Fun_CAJVQA010004890.1_i000_007349	370	452	82	0.248485	0.163022
GCA_002914845.1-Pla_JXTC01000021.1_i000_005163	45	377	332	1.00606	0.653543
GCA_903994205.1-Pro_LR865387.1_i000_002037	120	457	337	1.02121	0.686354
GCA_910592135.1-Fun_CAJVPZ010002597.1_i000_003125	57	130	73	0.221212	0.0975936
GCA_910592135.1-Fun_CAJVPZ010002597.1_i000_003125	126	356	230	0.69697	0.307487
GCA_900090045.1-Pro_LT594630.1_i000_002264	120	453	333	1.00909	0.511521
GCA_000708835.1-Pla_DF237719.1_i000_002304	51	378	327	0.990909	0.67284
GCA_000147415.1-Pla_GL433838.1_i000_002196	1044	1295	251	0.760606	0.188438
GCA_006348945.1-Ani_SRLO01000049.1_i000_008679	52	384	332	1.00606	0.653543
MEBA002.0722.00001.C001_02230	47	334	287	0.869697	0.854167
MEBU001.0722.00001.C001_01657	45	335	290	0.878788	0.860534
MEAR003.0722.00001.C001_01503	103	424	321	0.972727	0.755294
GCA_001270105.1-Ani_LHQP01023319.1_i000_031640	36	359	323	0.978788	0.665979
GCA_020169535.1-Pla_CM034995.1_i000_027052	44	374	330	1	0.68323
GCA_020169555.1-Pla_CM035019.1_i000_026200	44	374	330	1	0.68323
GCA_020169575.1-Pla_CM035007.1_i000_026169	44	374	330	1	0.68323
GCA_020169585.1-Pla_CM034983.1_i000_026217	44	374	330	1	0.68323
MEBA002.0722.00003.C001_00528	47	334	287	0.869697	0.854167
GCA_000375325.1-Pla_KB870810.1_i000_018745	7	261	254	0.769697	0.927007
GCA_018258275.1-Pla_CM031113.1_i000_043381	62	392	330	1	0.66
GCA_900005855.1-Pro_CVMV01000059.1_i000_004936	120	452	332	1.00606	0.598198
GCA_003550305.1-Fun_QKYT01000080.1_i000_019090	26	357	331	1.00303	0.704255
GCA_010015445.1-Ani_CM020915.1_i000_007676	58	390	332	1.00606	0.645914
GCA_004354835.1-Ani_CM014940.1_i000_005799	58	390	332	1.00606	0.645914
GCA_001742945.1-Pla_DF973129.1_i000_002158	45	376	331	1.00303	0.737194
GCA_006381635.2-Pla_VEPZ02000209.1_i000_006464	45	377	332	1.00606	0.684536
GCA_008692095.1-Ani_CM018458.1_i000_016358	168	410	242	0.733333	0.167243
GCA_000696525.1-Pla_KK914893.1_i000_020502	45	377	332	1.00606	0.684536
GCA_011823955.1-Ani_JAAKFY010000006.1_i000_009741	109	454	345	1.04545	0.614973
GCA_014851425.1-Pla_CM026267.1_i000_024922	14	345	331	1.00303	0.730684
GCA_001270105.1-Ani_LHQP01001574.1_i000_002227	55	384	329	0.99697	0.691176
GCA_007224835.1-Ani_SRMA01025987.1_i000_010482	48	359	311	0.942424	0.641237
GCA_014282145.1-Pla_CM024948.1_i000_044549	47	378	331	1.00303	0.68107
GCA_000512255.2-Pla_CM008455.1_i000_000650	44	375	331	1.00303	0.6853
GCA_002271885.2-Pla_CM008443.1_i000_000536	44	375	331	1.00303	0.6853
GCA_016984155.1-Ani_JAAWVP010001524.1_i000_002096	66	393	327	0.990909	0.630058
GCA_013400515.1-Ani_VZTN01031880.1_i000_011140	5	316	311	0.942424	0.773632
GCA_000146465.1-Fun_CP001950.1_i000_001506	100	435	335	1.01515	0.682281
GCA_000151645.1-Fun_FN430061.1_i000_001922	139	278	139	0.421212	0.270955
GCA_000151645.1-Fun_FN430061.1_i000_001922	275	430	155	0.469697	0.302144
GCA_011799765.1-Pla_JAANDH010000587.1_i000_017026	73	405	332	1.00606	0.648438
GCA_009078355.1-Ani_CM018541.1_i000_000357	2761	3086	325	0.984848	0.101057
GCA_000441895.2-Ani_KE525351.1_i000_016602	61	394	333	1.00909	0.649123
GCA_000003085.2-Pro_AABL01000242.1_i000_004050	77	413	336	1.01818	0.665347
GCA_000738915.1-Fun_AKIJ01000002.1_i000_000586	85	405	320	0.969697	0.786241
GCA_006013705.1-Pla_RXGB01026140.1_i000_024601	2	311	309	0.936364	0.73747
GCA_000091225.2-Fun_AL590451.2_i000_001649	102	430	328	0.993939	0.666667
GCA_000709005.1-Pro_KL446949.1_i000_002818	120	456	336	1.01818	0.684318
GCA_900681995.1-Pro_LR215065.1_i000_001957	120	456	336	1.01818	0.684318
GCA_013397815.1-Ani_VZTH01019439.1_i000_013180	46	363	317	0.960606	0.634
GCA_000219495.2-Pla_CM001223.2_i000_037559	45	376	331	1.00303	0.683884
GCA_003473485.2-Pla_CM010654.1_i000_034513	45	376	331	1.00303	0.683884
GCA_014065215.1-Fun_JACCEH010000346.1_i000_006872	138	278	140	0.424242	0.27027
GCA_014065215.1-Fun_JACCEH010000346.1_i000_006872	276	434	158	0.478788	0.305019
GCA_011745845.1-Pla_VYZY01002554.1_i000_012135	120	450	330	1	0.59034
GCA_008369825.1-Ani_CM017916.1_i000_022950	53	382	329	0.99697	0.647638
GCA_015679645.1-Fun_JAAAVC010003458.1_i000_006953	1	180	179	0.542424	0.994444
GCA_000505035.1-Pro_KI635795.1_i000_004571	120	454	334	1.01212	0.632576
GCA_001659605.2-Pla_CM004398.2_i000_021406	45	376	331	1.00303	0.682474
GCA_000250695.1-Fun_JH604633.1_i000_000512	85	405	320	0.969697	0.786241
GCA_000004515.5-Pla_CM000852.4_i000_048682	47	378	331	1.00303	0.68107
GCA_000722935.2-Pla_KN642099.1_i000_003549	47	378	331	1.00303	0.68107
GCA_004193775.2-Pla_CM014375.1_i000_050859	47	378	331	1.00303	0.68107
GCA_012273815.2-Pla_CM022577.2_i000_052416	47	378	331	1.00303	0.68107
GCA_014282035.1-Pla_CM024851.1_i000_041600	47	378	331	1.00303	0.68107
GCA_014282085.1-Pla_CM024911.1_i000_026129	47	378	331	1.00303	0.68107
GCA_014282095.1-Pla_CM024931.1_i000_053668	47	378	331	1.00303	0.68107
GCA_014282145.1-Pla_CM024951.1_i000_052810	47	378	331	1.00303	0.68107
GCA_014282345.1-Pla_CM024986.1_i000_052897	47	378	331	1.00303	0.68107
GCA_020497155.1-Pla_CM035725.1_i000_053471	47	378	331	1.00303	0.68107
GCA_900090005.1-Pro_LT594497.1_i000_001784	120	447	327	0.990909	0.491729
GCA_011745865.1-Pla_VYZZ01001890.1_i000_009644	151	481	330	1	0.559322
GCA_014282035.1-Pla_CM024848.1_i000_032836	47	378	331	1.00303	0.683884
GCA_014282095.1-Pla_CM024928.1_i000_045155	47	378	331	1.00303	0.683884
GCA_000004515.5-Pla_CM000849.3_i000_041195	47	378	331	1.00303	0.68107
GCA_000722935.2-Pla_KN664134.1_i000_038289	47	378	331	1.00303	0.68107
GCA_004193775.2-Pla_CM014372.1_i000_042866	47	378	331	1.00303	0.68107
GCA_012273815.2-Pla_CM022574.2_i000_044321	47	378	331	1.00303	0.68107
GCA_014282085.1-Pla_CM024908.1_i000_017950	47	378	331	1.00303	0.68107
GCA_014282345.1-Pla_CM024983.1_i000_044383	47	378	331	1.00303	0.68107
GCA_900002395.1-Pro_LK934637.1_i000_002232	121	455	334	1.01212	0.609489
GCA_004320505.1-Pla_AP015044.1_i000_029900	46	377	331	1.00303	0.682474
GCA_016808095.1-Pla_CM028992.1_i000_020230	46	377	331	1.00303	0.682474
GCA_013397825.1-Ani_VZRK01001847.1_i000_003631	5	256	251	0.760606	0.980469
GCA_003952965.2-Pla_CM025855.1_i000_022719	42	373	331	1.00303	0.68815
GCA_019097595.1-Ani_CM032594.1_i000_000123	2724	3049	325	0.984848	0.102233
GCA_010458925.1-Pla_CM021228.1_i000_005963	67	396	329	0.99697	0.589606
GCA_000326865.1-Ani_KB095959.1_i000_003880	41	371	330	1	0.666667
GCA_020497155.1-Pla_CM035722.1_i000_044868	78	409	331	1.00303	0.640232
GCA_900002385.2-Pro_LM993663.2_i000_002658	121	456	335	1.01515	0.611314
GCA_900002375.2-Pro_LK023124.2_i000_002048	120	454	334	1.01212	0.669339
GCA_900044335.1-Pro_LT160029.1_i000_002019	120	454	334	1.01212	0.669339
GCA_900088445.1-Pro_LT614635.1_i000_001901	120	454	334	1.01212	0.669339
GCA_900095545.1-Pro_LT608145.1_i000_001901	120	454	334	1.01212	0.669339
GCA_900095585.1-Pro_LT608273.1_i000_001904	120	454	334	1.01212	0.669339
GCA_900095635.1-Pro_LT608257.1_i000_001894	120	454	334	1.01212	0.669339
GCA_927797965.1-Ani_OV696694.1_i000_014879	49	362	313	0.948485	0.628514
GCA_000401715.2-Pro_KE124615.1_i000_003348	120	441	321	0.972727	0.724605
GCA_014851425.1-Pla_CM026266.1_i000_020849	47	378	331	1.00303	0.68107
GCA_013339905.1-Ani_CM023503.1_i000_007536	76	408	332	1.00606	0.62406
GCA_001675575.1-Ani_LZPO01055082.1_i000_011060	126	394	268	0.812121	0.59292
GCA_907169785.1-Ani_CAJRST010038888.1_i000_018158	53	384	331	1.00303	0.651575
MESI002.0722.00001.C001_00351	47	335	288	0.872727	0.857143
MELA002.0722.00001.C001_00219	47	334	287	0.869697	0.854167
GCA_000583005.2-Pla_ASHM01031468.1_i000_032221	5	309	304	0.921212	0.921212
GCA_910591825.1-Fun_CAJVPQ010000149.1_i000_001221	26	360	334	1.01212	0.71828
GCA_003549995.1-Fun_QKKE01000403.1_i000_013513	3	333	330	1	0.75
GCA_001601855.1-Pro_CM003852.1_i000_002546	120	458	338	1.02424	0.571912
GCA_013397635.1-Ani_VYZG01004753.1_i000_011515	1	245	244	0.739394	0.972112
GCA_910591765.1-Fun_CAJVPS010000778.1_i000_003856	25	388	363	1.1	0.711765
GCA_000499845.1-Pla_CM002290.1_i000_006639	47	379	332	1.00606	0.684536
GCA_001078035.1-Fun_LFTZ01000013.1_i000_001418	102	430	328	0.993939	0.666667
GCA_000439145.3-Fun_AUPC02000029.1_i000_012581	69	399	330	1	0.652174
GCA_000597685.1-Fun_JEMT01024014.1_i000_015283	69	399	330	1	0.652174
GCA_001593125.1-Fun_LLXH01000434.1_i000_009683	69	399	330	1	0.652174
GCA_001593155.1-Fun_LLXL01000260.1_i000_005886	69	399	330	1	0.652174
GCA_001593205.1-Fun_LLXJ01000573.1_i000_009943	69	399	330	1	0.652174
GCA_002897155.2-Fun_BDIQ02000033.1_i000_012795	69	399	330	1	0.652174
GCA_903189765.1-Fun_CAEVNM010000002.1_i000_002479	69	399	330	1	0.652174
GCA_903231485.1-Fun_CAFBRS010000318.1_i000_012562	69	399	330	1	0.652174
GCA_903470525.1-Fun_CAGKOT010000032.1_i000_013828	69	399	330	1	0.652174
GCA_903470595.1-Fun_CAGKPD010000009.1_i000_004309	69	399	330	1	0.652174
GCA_910592225.1-Fun_CAJVPR010000541.1_i000_007140	69	399	330	1	0.652174
GCA_000612305.1-Pla_KK198760.1_i000_024455	45	377	332	1.00606	0.684536
GCA_000521155.1-Pro_KI927918.1_i000_002140	120	431	311	0.942424	0.719907
GCA_903189815.1-Fun_CAEVNS010000074.1_i000_021213	69	399	330	1	0.652174
GCA_016984135.1-Ani_JAAWVN010012555.1_i000_002478	4	315	311	0.942424	0.706818
GCA_900088565.1-Pro_FLQU01000288.1_i000_002060	120	442	322	0.975758	0.534884
GCA_012923435.1-Pla_JAATIP010000285.1_i000_005555	46	372	326	0.987879	0.692144
GCA_013030025.1-Pla_JAATIQ010000013.1_i000_004483	46	372	326	0.987879	0.692144
GCA_016835505.1-Ani_CM029072.1_i000_015838	644	960	316	0.957576	0.290441
GCA_013358835.1-Ani_JABSTQ010010752.1_i000_020321	39	374	335	1.01515	0.784543
GCA_900088555.1-Pro_FLQV01000356.1_i000_001871	120	445	325	0.984848	0.538972
GCA_000521055.1-Pro_KI926441.1_i000_003279	120	448	328	0.993939	0.624762
GCA_000521095.1-Pro_KI927387.1_i000_005075	120	449	329	0.99697	0.61039
GCA_001718145.1-Ani_LJIJ01000126.1_i000_004623	58	390	332	1.00606	0.654832
GCA_003426265.1-Fun_NQIL01000003.1_i000_005399	128	284	156	0.472727	0.318367
GCA_003426265.1-Fun_NQIL01000003.1_i000_005399	281	439	158	0.478788	0.322449
GCA_000521075.1-Pro_KI926053.1_i000_003417	120	450	330	1	0.587189
GCA_004120215.1-Ani_QBIY01011444.1_i000_007952	2770	3094	324	0.981818	0.100527
GCA_900090035.2-Pro_LT594590.1_i000_001927	120	449	329	0.99697	0.543802
GCA_002271895.2-Pla_CM008431.1_i000_000605	44	375	331	1.00303	0.6853
GCA_003958685.2-Pla_CP039349.1_i000_018684	46	377	331	1.00303	0.682474
GCA_003203555.1-Fun_BEXD01000491.1_i000_004786	87	398	311	0.942424	0.614625
GCA_015698045.1-Fun_BLAL01000036.1_i000_005416	87	398	311	0.942424	0.614625
GCA_020875875.1-Pla_CM037026.1_i000_019606	46	377	331	1.00303	0.638996
GCA_903819665.1-Fun_CAIJEO010000006.1_i000_005060	97	408	311	0.942424	0.638604
GCA_001659605.2-Pla_CM004399.2_i000_023075	46	376	330	1	0.680412
GCA_000149795.1-Pro_DS016117.1_i000_002908	120	453	333	1.00909	0.595707
GCA_910591835.1-Fun_CAJVPV010010037.1_i000_009791	58	385	327	0.990909	0.661943
GCA_900097025.1-Pro_LT969574.1_i000_003017	120	456	336	1.01818	0.568528
GCA_000401695.2-Pro_KE123835.1_i000_003127	120	454	334	1.01212	0.618519
GCA_000723685.1-Pro_HG810772.1_i000_003360	120	454	334	1.01212	0.56229
GCA_003958685.2-Pla_CP039354.1_i000_034795	88	418	330	1	0.626186
GCA_014805685.1-Ani_CM025888.1_i000_003227	2756	3086	330	1	0.10274
MESI002.0722.00003.C001_00310	47	335	288	0.872727	0.857143
GCA_000521115.1-Pro_KI927522.1_i000_003217	120	439	319	0.966667	0.564602
GCA_007990455.1-Pla_CM017638.1_i000_011585	14	345	331	1.00303	0.730684
GCA_001974805.1-Pla_AWWV01010603.1_i000_013700	43	374	331	1.00303	0.686722
GCA_900240055.1-Pro_LT969448.1_i000_002779	120	459	339	1.02727	0.547658
GCA_003434825.1-Pla_CM010629.1_i000_007321	143	421	278	0.842424	0.65566
GCA_910591945.1-Fun_CAJVPL010000472.1_i000_004247	58	388	330	1	0.64833
GCA_001661175.1-Pla_LSRQ01006666.1_i000_020368	47	376	329	0.99697	0.678351
GCA_013467485.1-Pla_JABEZX010355876.1_i000_026017	45	376	331	1.00303	0.837975
GCA_002157705.1-Pro_BDQF01000010.1_i000_002077	121	463	342	1.03636	0.625229
GCA_900095595.1-Pro_LT963424.1_i000_003093	120	454	334	1.01212	0.560403
GCA_001593145.1-Fun_LLXI01000303.1_i000_006948	69	399	330	1	0.652174
GCA_903189775.1-Fun_CAEVNN010000860.1_i000_031578	69	399	330	1	0.652174
GCA_900090025.2-Pro_LT594513.1_i000_001788	120	439	319	0.966667	0.524671
GCA_900088485.1-Pro_FLRD01000079.1_i000_002479	120	438	318	0.963636	0.52562
GCA_900088545.1-Pro_FLRE01000104.1_i000_002471	120	438	318	0.963636	0.52562
MEMA006.0722.00002.C001_03262	48	334	286	0.866667	0.853731
GCA_000521035.1-Pro_KI925567.1_i000_003228	120	457	337	1.02121	0.625232
GCA_900005765.1-Pro_LN835304.1_i000_001880	120	455	335	1.01515	0.561139
GCA_007990325.1-Pla_CM017690.1_i000_012218	46	377	331	1.00303	0.682474
GCA_007990345.1-Pla_CM017664.1_i000_006153	46	377	331	1.00303	0.682474
GCA_007990485.1-Pla_CM017612.1_i000_012285	46	377	331	1.00303	0.682474
GCA_003615045.1-Fun_ML014196.1_i000_003528	114	492	378	1.14545	0.64726
GCA_000165425.1-Pro_CT868008.1_i000_005186	116	432	316	0.957576	0.694505
GCA_905397895.1-Ani_CAJPWZ010002369.1_i000_049281	126	353	227	0.687879	0.464213
GCA_905397895.1-Ani_CAJPWZ010002369.1_i000_049281	353	428	75	0.227273	0.153374
GCA_000611955.2-Ani_KK116973.1_i000_012887	1	285	284	0.860606	0.809117
GCA_008761655.1-Pla_CM018204.1_i000_011294	57	388	331	1.00303	0.667339
GCA_000695605.1-Pla_KK784875.1_i000_002072	14	345	331	1.00303	0.730684
GCA_002928715.1-Pla_KZ669006.1_i000_034180	59	390	331	1.00303	0.664659
GCA_003731715.1-Ani_RJVU01062584.1_i000_018877	2855	3178	323	0.978788	0.0976716
GCA_013677255.1-Pla_CM025223.1_i000_008320	45	376	331	1.00303	0.782506
GCA_008009225.1-Pla_CM017768.1_i000_017642	61	392	331	1.00303	0.662
GCA_000002765.3-Pro_LN999945.1_i000_003043	120	456	336	1.01818	0.565657
GCA_000149665.2-Pro_CH671954.1_i000_003143	120	456	336	1.01818	0.565657
GCA_000787975.1-Pla_KN447304.1_i000_029836	46	377	331	1.00303	0.682474
GCA_012898025.1-Pro_QFXU01000005.1_i000_004898	120	457	337	1.02121	0.56734
GCA_020496765.1-Pla_CM035624.1_i000_015247	46	377	331	1.00303	0.682474
GCA_000150435.3-Pro_KE123623.1_i000_003331	120	458	338	1.02424	0.556837
GCA_019845555.1-Pla_CM034083.1_i000_017059	51	377	326	0.987879	0.672165
GCA_000493195.1-Pla_KI536726.1_i000_012519	47	378	331	1.00303	0.68107
GCA_022201065.1-Pla_CM039173.1_i000_013306	47	378	331	1.00303	0.68107
GCA_013511315.1-Pla_CM025262.1_i000_007697	45	376	331	1.00303	0.683884
GCA_001974825.1-Pla_AWUE01023765.1_i000_034133	43	374	331	1.00303	0.686722
GCA_000186055.2-Pro_GG665024.1_i000_003837	120	456	336	1.01818	0.565657
GCA_001602025.1-Pro_CM003866.1_i000_002627	120	454	334	1.01212	0.536977
GCA_021653875.1-Fun_JAKFRD010000104.1_i000_000999	92	404	312	0.945455	0.77037
GCA_008692095.1-Ani_CM018440.1_i000_004294	2784	3109	325	0.984848	0.0985147
GCA_018107945.1-Pla_JACEIK010000799.1_i000_016621	44	374	330	1	0.68323
GCA_002762385.1-Pla_NKXS01001789.1_i000_010370	46	377	331	1.00303	0.6853
GCA_014362265.1-Pla_BJWL01000013.1_i000_019889	107	438	331	1.00303	0.607339
GCA_000003745.2-Pla_FN597015.1_i000_000739	84	415	331	1.00303	0.632887
GCA_004329165.1-Pla_CM014732.1_i000_012835	46	377	331	1.00303	0.682474
GCA_900097035.1-Pro_LT969560.1_i000_002641	120	460	340	1.0303	0.580205
GCA_003704355.1-Fun_QWIL01002179.1_i000_013020	1	257	256	0.775758	0.615385
GCA_013487665.1-Pla_CM025184.1_i000_008280	30	361	331	1.00303	0.705757
GCA_022201045.1-Pla_CM039164.1_i000_013045	79	410	331	1.00303	0.638996
GCA_000150455.3-Pro_KE123501.1_i000_003250	120	457	337	1.02121	0.555189
GCA_003024255.1-Pla_CM009666.1_i000_013656	45	376	331	1.00303	0.6853
GCA_000151685.2-Pla_EQ973961.1_i000_015237	363	692	329	0.99697	0.425065
GCA_902713445.1-Pla_CACTIH010003893.1_i000_038700	44	376	332	1.00606	0.68595
GCA_900059795.1-Pla_HG974438.1_i000_005305	67	396	329	0.99697	0.650198
GCA_002897195.1-Pla_BDQV01000004.1_i000_002190	89	420	331	1.00303	0.626894
GCA_013467465.1-Pla_CM025158.1_i000_008035	45	376	331	1.00303	0.683884
GCA_013467475.1-Pla_CM025171.1_i000_008061	45	376	331	1.00303	0.683884
GCA_013677235.1-Pla_CM025197.1_i000_008878	45	376	331	1.00303	0.683884
GCA_013677275.1-Pla_CM025249.1_i000_008495	45	376	331	1.00303	0.683884
GCA_013677245.1-Pla_CM025210.1_i000_008528	45	376	331	1.00303	0.683884
GCA_000327365.1-Pla_CM001744.1_i000_012320	46	377	331	1.00303	0.682474
GCA_007990455.1-Pla_CM017650.1_i000_009137	46	377	331	1.00303	0.682474
GCA_002891405.2-Ani_NEVH01002996.1_i000_001959	44	385	341	1.03333	0.690283
GCA_900097015.1-Pro_LT969420.1_i000_002760	120	441	321	0.972727	0.523654
GCA_007990325.1-Pla_CM017702.1_i000_009582	46	377	331	1.00303	0.682474
GCA_008761655.1-Pla_CM018216.1_i000_008911	46	377	331	1.00303	0.682474
GCA_016984175.1-Ani_JAAWVO010073909.1_i000_013735	57	387	330	1	0.643275
GCA_013339745.1-Ani_CM023474.1_i000_013053	40	372	332	1.00606	0.678937
GCA_018320845.1-Ani_CM031320.1_i000_000593	65	394	329	0.99697	0.632692
GCA_000403535.1-Pla_CM001880.1_i000_006518	46	377	331	1.00303	0.682474
GCA_004153795.2-Pla_SDRB02012896.1_i000_027566	159	366	207	0.627273	0.420732
GCA_004153795.2-Pla_SDRB02012896.1_i000_027566	363	452	89	0.269697	0.180894
GCA_014858505.1-Pla_CM026417.1_i000_021357	3	309	306	0.927273	0.732057
GCA_000521015.1-Pro_KI925184.1_i000_005761	120	460	340	1.0303	0.607143
GCA_000002435.2-Pro_CM018793.1_i000_004076	118	460	342	1.03636	0.557912
GCA_016628065.1-Fun_JABBWA010000244.1_i000_008782	114	338	224	0.678788	0.444444
GCA_016628065.1-Fun_JABBWA010000244.1_i000_008782	345	418	73	0.221212	0.144841
GCA_000498715.1-Pro_AHGT01000054.1_i000_003609	118	460	342	1.03636	0.554295
GCA_013621035.1-Ani_QNUK01000065.1_i000_019042	2716	3042	326	0.987879	0.104187
GCA_020796205.1-Pla_JAEACU010000380.1_i000_023886	49	381	332	1.00606	0.678937
GCA_003710015.1-Ani_REGN01001524.1_i000_011117	66	398	332	1.00606	0.639692
GCA_013677265.1-Pla_CM025236.1_i000_007276	45	376	331	1.00303	0.683884
GCA_007990345.1-Pla_CM017676.1_i000_040785	46	377	331	1.00303	0.682474
GCA_019648995.1-Ani_BLXT01005682.1_i000_051492	5	367	362	1.09697	0.711198
GCA_910592015.1-Fun_CAJVPK010000036.1_i000_000990	59	388	329	0.99697	0.670061
GCA_007210705.1-Ani_CM017379.1_i000_007515	125	219	94	0.284848	0.203024
GCA_007210705.1-Ani_CM017379.1_i000_007515	216	391	175	0.530303	0.37797
GCA_001411555.2-Pla_CM023853.1_i000_030253	45	376	331	1.00303	0.683884
GCA_000510995.2-Pla_KQ131592.1_i000_000671	43	376	333	1.00909	0.680982
GCA_001411555.2-Pla_CM023845.1_i000_011454	46	377	331	1.00303	0.682474
GCA_018689175.1-Pla_CM031845.1_i000_010633	46	377	331	1.00303	0.682474
GCA_018687715.1-Pla_CM031813.1_i000_011409	46	377	331	1.00303	0.682474
GCA_018688675.1-Pla_CM031829.1_i000_011254	46	377	331	1.00303	0.682474
GCA_016808215.1-Pla_CM029000.1_i000_011289	46	377	331	1.00303	0.682474
GCA_000002975.1-Pro_AJ010592.2_i000_000194	93	389	296	0.89697	0.751269
GCA_000511025.2-Pla_CM002326.2_i000_014781	46	375	329	0.99697	0.672802
GCA_000002775.3-Pla_CM009303.1_i000_032315	46	377	331	1.00303	0.68107
GCA_905332325.1-Ani_CAJOBW010002841.1_i000_013102	1	234	233	0.706061	0.913725
GCA_008638375.1-Pla_CM018044.1_i000_034090	47	376	329	0.99697	0.574171
GCA_000331365.3-Pla_AMZH03016647.1_i000_042055	55	385	330	1	0.829146
GCA_000818735.3-Pla_JTFG03008954.1_i000_043488	55	385	330	1	0.829146
GCA_014282245.1-Pla_CM024964.1_i000_027237	452	780	328	0.993939	0.368954
GCA_002104945.1-Fun_MCFH01000028.1_i000_004676	74	406	332	1.00606	0.657426
GCA_000956335.1-Pro_KQ001671.1_i000_002628	122	449	327	0.990909	0.622857
GCA_014065205.1-Fun_JACCEG010000238.1_i000_004110	141	280	139	0.421212	0.26938
GCA_014065205.1-Fun_JACCEG010000238.1_i000_004110	276	430	154	0.466667	0.29845
GCA_005239225.1-Pla_RCHU01000113.1_i000_004280	46	377	331	1.00303	0.68107
GCA_000448345.1-Ani_KE691399.1_i000_021733	39	315	276	0.836364	0.87619
GCA_001884805.1-Pla_MKKS01014170.1_i000_042633	68	398	330	1	0.80292
GCA_009746105.1-Pla_CM019271.1_i000_014008	93	424	331	1.00303	0.62218
GCA_013676235.1-Pla_CM025505.1_i000_021227	46	376	330	1	0.690377
GCA_015852605.2-Pla_CM027583.2_i000_024444	46	377	331	1.00303	0.68107
GCA_002870075.2-Pla_CM022518.1_i000_000327	48	379	331	1.00303	0.679671
GCA_003547095.1-Fun_PQFF01000210.1_i000_009883	58	390	332	1.00606	0.668008
GCA_018804465.1-Pla_CM031995.1_i000_012412	46	377	331	1.00303	0.68107
GCA_016808215.1-Pla_CM029009.1_i000_028451	46	377	331	1.00303	0.682474
GCA_018687715.1-Pla_CM031822.1_i000_028833	46	377	331	1.00303	0.682474
GCA_018688675.1-Pla_CM031838.1_i000_028582	46	377	331	1.00303	0.682474
GCA_018689175.1-Pla_CM031854.1_i000_027229	46	377	331	1.00303	0.682474
GCA_004153795.2-Pla_SDRB02005865.1_i000_010531	51	381	330	1	0.674847
GCA_000471905.1-Pla_KI397501.1_i000_025870	44	375	331	1.00303	0.6853
GCA_019923975.1-Fun_JAHFWY010000001.1_i000_000394	162	413	251	0.760606	0.503006
GCA_910591965.1-Fun_CAJVPY010007023.1_i000_011404	55	390	335	1.01515	0.409535
GCA_905116865.2-Ani_CAJHNH020000249.1_i000_001952	40	369	329	0.99697	0.647638
GCA_000327345.1-Ani_KB104817.1_i000_005851	5	254	249	0.754545	0.968872
GCA_006381635.2-Pla_VEPZ02000843.1_i000_019926	46	376	330	1	0.622642
GCA_000327385.1-Ani_KB203683.1_i000_022293	35	371	336	1.01818	0.681542
GCA_910592325.1-Fun_CAJVPM010012491.1_i000_006498	38	391	353	1.0697	0.729339
GCA_000002415.2-Pro_CM000450.1_i000_002159	122	461	339	1.02727	0.605357
GCA_000209065.1-Pro_CH473405.1_i000_008476	132	387	255	0.772727	0.658915
GCA_000320645.2-Pro_KQ234864.1_i000_005415	122	461	339	1.02727	0.597884
GCA_014925825.1-Fun_JACGCK010000061.1_i000_014260	116	364	248	0.751515	0.661333
GCA_000320625.2-Pro_KQ234279.1_i000_002666	122	461	339	1.02727	0.593695
GCA_001972305.1-Pla_BDDD01001859.1_i000_022220	46	377	331	1.00303	0.682474
GCA_910592245.1-Fun_CAJVQB010035210.1_i000_028042	54	392	338	1.02424	0.688391
GCA_002870075.2-Pla_CM022525.1_i000_033588	30	377	347	1.05152	0.715464
GCA_000524495.1-Pro_KI965479.1_i000_004165	122	461	339	1.02727	0.619744
GCA_000340665.1-Pla_CM003609.1_i000_012222	14	345	331	1.00303	0.730684
GCA_020424065.1-Pla_CM035471.1_i000_022202	46	377	331	1.00303	0.682474
GCA_004170445.1-Pla_CM014332.1_i000_053248	46	377	331	1.00303	0.522082
GCA_019671135.1-Fun_JAHRHY010000008.1_i000_011916	81	415	334	1.01212	0.630189
GCA_001444175.2-Ani_KQ563500.1_i000_010851	56	394	338	1.02424	0.661448
GCA_002201585.1-Pla_MTKT01003224.1_i000_015634	55	386	331	1.00303	0.67004
GCA_000697945.4-Ani_ML762988.1_i000_002812	47	390	343	1.03939	0.691532
GCA_902860255.1-Pla_LR794331.1_i000_038851	30	377	347	1.05152	0.715464
GCA_009809945.1-Fun_WTPW01000165.1_i000_004310	30	392	362	1.09697	0.72837
GCA_001444175.2-Ani_KQ565356.1_i000_013520	57	395	338	1.02424	0.661448
GCA_903114435.1-Pla_CAEKKB010000005.1_i000_017984	71	402	331	1.00303	0.663327
GCA_007990485.1-Pla_CM017624.1_i000_009703	46	377	331	1.00303	0.682474
GCA_903112645.1-Pla_CAEKDK010000005.1_i000_018098	71	401	330	1	0.647059
GCA_001865875.1-Pla_CM007371.1_i000_017421	46	377	331	1.00303	0.682474
GCA_000346465.2-Pla_CM007655.1_i000_015860	70	400	330	1	0.64833
GCA_003024255.1-Pla_CM009682.1_i000_032336	45	376	331	1.00303	0.6853
GCA_001865875.1-Pla_CM007363.1_i000_005079	46	377	331	1.00303	0.682474
GCA_902713445.1-Pla_LR743779.1_i000_005120	47	377	330	1	0.680412
GCA_002174775.1-Pla_MVGT01003557.1_i000_002124	46	377	331	1.00303	0.682474
GCA_018804465.1-Pla_CM031994.1_i000_011039	85	409	324	0.981818	0.625483
GCA_000511025.2-Pla_CM002326.2_i000_014783	15	318	303	0.918182	0.940994
GCA_003370565.1-Pla_QJKJ01000393.1_i000_001998	81	411	330	1	0.635838
MESP002.0722.00001.C001_03294	47	334	287	0.869697	0.854167
GCA_019924185.1-Fun_JAHFXE010006537.1_i000_020473	130	362	232	0.70303	0.640884
MEZI001.0722.00001.C001_02510	54	342	288	0.872727	0.837209
GCA_004170445.1-Pla_CM014330.1_i000_042452	14	346	332	1.00606	0.732892
GCA_002920205.1-Fun_PKSM01000055.1_i000_004503	155	462	307	0.930303	0.526587
GCA_910592215.1-Fun_CAJVPN010001198.1_i000_007233	4	332	328	0.993939	0.745455
GCA_000182665.1-Pro_ACVC01000192.1_i000_001409	120	459	339	1.02727	0.554828
GCA_002104895.1-Fun_MCFG01000082.1_i000_012025	75	401	326	0.987879	0.648111
GCA_905331525.1-Ani_CAJNZF010000980.1_i000_028153	6	244	238	0.721212	0.898113
GCA_003713155.1-Pla_CP030988.1_i000_040108	46	377	331	1.00303	0.682474
GCA_003713155.1-Pla_CP030998.1_i000_043279	46	377	331	1.00303	0.682474
GCA_004320505.1-Pla_AP015037.1_i000_011977	46	377	331	1.00303	0.682474
GCA_014362265.1-Pla_BJWL01000029.1_i000_041062	191	521	330	1	0.524642
GCA_000002775.3-Pla_CM009291.1_i000_006739	47	378	331	1.00303	0.68107
GCA_005239225.1-Pla_RCHU01000554.1_i000_022408	47	378	331	1.00303	0.68107
GCA_015852605.2-Pla_CM027571.2_i000_005089	47	378	331	1.00303	0.68107
GCA_009739505.2-Ani_CM019182.2_i000_011267	41	347	306	0.927273	0.628337
GCA_021962125.1-Ani_JAGDYQ010000217.1_i000_009440	6	365	359	1.08788	0.713718
GCA_900257145.2-Pro_LT990240.1_i000_002777	120	458	338	1.02424	0.577778
GCA_000250695.1-Fun_JH604637.1_i000_001974	106	412	306	0.927273	0.73913
GCA_910592255.1-Fun_CAJVPO010001772.1_i000_008680	54	383	329	0.99697	0.670061
GCA_001190045.1-Pla_CM003373.1_i000_007696	66	397	331	1.00303	0.655446
GCA_003713155.1-Pla_CP030990.1_i000_053200	46	377	331	1.00303	0.682474
GCA_004170445.1-Pla_CM014322.1_i000_052195	46	377	331	1.00303	0.682474
GCA_013340265.1-Ani_BLKM01000254.1_i000_001433	44	385	341	1.03333	0.690283
GCA_003704095.1-Ani_RCHS01004153.1_i000_020541	36	370	334	1.01212	0.759091
GCA_000738915.1-Fun_AKIJ01000004.1_i000_001646	106	412	306	0.927273	0.73913
GCA_000499425.1-Pro_HG671351.1_i000_004092	2	276	274	0.830303	0.796512
GCA_002127325.2-Pla_CM007897.2_i000_030494	46	377	331	1.00303	0.682474
GCA_020080835.1-Ani_CM034664.1_i000_010726	40	339	299	0.906061	0.611452
GCA_001638985.2-Fun_KV440997.1_i000_013614	15	347	332	1.00606	0.744395
GCA_017552425.1-Pla_CM029800.1_i000_004674	47	377	330	1	0.679012
GCA_900093555.2-Pro_LT635620.2_i000_002431	122	461	339	1.02727	0.587522
GCA_914969965.1-Pro_CAJZCX010000007.1_i000_002750	122	461	339	1.02727	0.593695
GCA_018127125.1-Pla_CM030799.1_i000_033940	221	551	330	1	0.500759
GCA_000320685.2-Pro_KQ235387.1_i000_002936	122	461	339	1.02727	0.590592
GCA_900093535.1-Pro_LT615264.1_i000_002265	122	461	339	1.02727	0.589565
GCA_000006355.3-Pro_AM910991.2_i000_002117	122	459	337	1.02121	0.609403
GCA_002140095.1-Pro_NETL01000026.1_i000_001225	122	459	337	1.02121	0.609403
GCA_900004885.2-Pro_CWHQ02000002.1_i000_002144	122	459	337	1.02121	0.609403
GCA_900005025.2-Pro_CWHR02000001.1_i000_004961	122	459	337	1.02121	0.609403
GCA_000320665.2-Pro_KQ235046.1_i000_002761	122	461	339	1.02727	0.588542
GCA_900093545.1-Pro_LT615247.1_i000_002335	122	461	339	1.02727	0.585492
GCA_009078335.1-Pla_CM018573.1_i000_003087	47	378	331	1.00303	0.68107
GCA_013401445.1-Pla_CM023889.1_i000_025684	46	377	331	1.00303	0.682474
GCA_019649035.1-Ani_BMAT01006598.1_i000_031979	41	366	325	0.984848	0.638507
GCA_015679605.1-Fun_JAAAVE010000027.1_i000_005057	220	399	179	0.542424	0.0880906
GCA_015679605.1-Fun_JAAAVE010000027.1_i000_005057	398	528	130	0.393939	0.0639764
GCA_004170445.1-Pla_CM014320.1_i000_038476	61	392	331	1.00303	0.662
GCA_004115385.1-Pla_CM014050.1_i000_003440	47	377	330	1	0.680412
GCA_008932095.1-Pla_CM018506.1_i000_002196	47	377	330	1	0.680412
GCA_000211455.3-Ani_ADMH02001525.1_i000_004468	62	396	334	1.01212	0.651072
GCA_018804465.1-Pla_CM031970.1_i000_031626	47	377	330	1	0.550918
GCA_015731905.1-Pla_CM027660.1_i000_003247	47	378	331	1.00303	0.6341
GCA_004837865.1-Pla_CM017190.1_i000_005944	72	402	330	1	0.647059
GCA_018446385.1-Pla_CM031508.1_i000_004013	45	376	331	1.00303	0.682474
GCA_018446385.1-Pla_CM031509.1_i000_005710	45	376	331	1.00303	0.682474
GCA_000498735.1-Pro_AHHH01000086.1_i000_003554	118	461	343	1.03939	0.567881
GCA_011800145.1-Ani_JAAMPH010000181.1_i000_014520	98	349	251	0.760606	0.524008
GCA_000182405.1-Pro_ACGJ01000646.1_i000_004000	119	462	343	1.03939	0.567881
GCA_003573695.1-Pla_CM010721.1_i000_026476	45	377	332	1.00606	0.683128
GCA_918697745.1-Ani_CAKKLH010000043.1_i000_002685	46	378	332	1.00606	0.66004
GCA_000504015.1-Pla_KI631803.1_i000_019716	45	377	332	1.00606	0.687371
GCA_014058105.1-Pla_JACGCM010000665.1_i000_013011	86	415	329	0.99697	0.627863
GCA_902729315.2-Pla_LR746277.1_i000_018300	45	377	332	1.00606	0.684536
GCA_002837095.1-Pla_PGOL01001822.1_i000_025655	4	296	292	0.884848	0.724566
GCA_905319865.3-Ani_CAJNRD030001119.1_i000_005746	39	360	321	0.972727	0.699346
GCA_014905375.1-Pla_BMAC01001133.1_i000_027342	17	343	326	0.987879	0.726058
GCA_905250045.1-Ani_CAJNOG010000264.1_i000_022738	1	240	239	0.724242	0.971545
GCA_003550325.1-Fun_QKWP01000184.1_i000_005831	55	392	337	1.02121	0.678068
GCA_016808095.1-Pla_CM028986.1_i000_005583	4	301	297	0.9	0.726161
GCA_015852415.1-Fun_JAAAIH010000572.1_i000_009735	83	417	334	1.01212	0.629002
GCA_015679495.1-Fun_JAAAUW010001594.1_i000_007490	83	417	334	1.01212	0.629002
GCA_015847195.1-Fun_JAAAHV010000333.1_i000_005323	90	425	335	1.01515	0.618081
GCA_013202065.2-Ani_JAAOIC020000049.1_i000_006058	45	330	285	0.863636	0.563241
GCA_004768795.1-Fun_SKBN01000083.1_i000_010398	130	284	154	0.466667	0.314286
GCA_004768795.1-Fun_SKBN01000083.1_i000_010398	280	439	159	0.481818	0.32449
GCA_001651415.1-Fun_KV442040.1_i000_007259	83	417	334	1.01212	0.629002
GCA_001651415.1-Fun_KV442265.1_i000_014807	83	417	334	1.01212	0.629002
GCA_020744185.1-Fun_JAGSXK010000014.1_i000_003290	83	417	334	1.01212	0.629002
GCA_000763605.2-Pla_JRKL02012448.1_i000_028146	46	377	331	1.00303	0.682474
GCA_004379255.2-Pla_CM031474.1_i000_007469	71	396	325	0.984848	0.64741
GCA_001594075.1-Ani_KQ980838.1_i000_015215	39	378	339	1.02727	0.693252
GCA_001194135.1-Ani_KQ419180.1_i000_014569	37	360	323	0.978788	0.660532
GCA_000499845.1-Pla_CM002295.1_i000_019823	54	388	334	1.01212	0.734066
GCA_002113885.2-Ani_NEDP02004182.1_i000_010386	20	375	355	1.07576	0.721545
GCA_004193795.1-Ani_QDEB01115462.1_i000_013032	44	348	304	0.921212	0.612903
GCA_015679425.1-Fun_JAAAUV010001485.1_i000_002559	83	417	334	1.01212	0.629002
GCA_003546025.1-Pla_QPKB01000004.1_i000_011486	104	434	330	1	0.573913
GCA_002906115.4-Pla_PKMF03022086.1_i000_077409	62	393	331	1.00303	0.660679
GCA_021653875.1-Fun_JAKFRD010000099.1_i000_000085	107	413	306	0.927273	0.737349
GCA_903819115.1-Fun_CAIJCR010000001.1_i000_000403	1	265	264	0.8	0.765217
GCA_902829235.1-Ani_CADEPI010000281.1_i000_012163	61	357	296	0.89697	0.586139
GCA_001680005.1-Pro_CP016247.1_i000_002484	122	463	341	1.03333	0.677932
GCA_020921065.1-Pla_CM037153.1_i000_008494	95	426	331	1.00303	0.61985
GCA_001543975.1-Pro_JXTI01000106.1_i000_003308	119	462	343	1.03939	0.571667
GCA_013358455.1-Pla_JABWDY010008420.1_i000_006241	133	184	51	0.154545	0.0922242
GCA_013358455.1-Pla_JABWDY010008420.1_i000_006241	166	419	253	0.766667	0.457505
GCA_004379255.2-Pla_CM031475.1_i000_010402	119	443	324	0.981818	0.590164
GCA_000346465.2-Pla_CM007656.1_i000_019913	46	377	331	1.00303	0.682474
GCA_902201215.1-Pla_LR694011.1_i000_019291	46	377	331	1.00303	0.682474
GCA_006547085.1-Pla_VIEB01000970.1_i000_037069	47	377	330	1	0.680412
GCA_003991915.1-Ani_RQTK01000003.1_i000_000225	5	367	362	1.09697	0.711198
GCA_022539455.1-Pla_CM039729.1_i000_016830	46	377	331	1.00303	0.682474
GCA_002966975.2-Pla_PJQY01001326.1_i000_018455	133	444	311	0.942424	0.685022
GCA_002571385.1-Ani_LSMT01000128.1_i000_008709	36	369	333	1.00909	0.685185
GCA_001605985.2-Pla_KZ502877.1_i000_016620	46	377	331	1.00303	0.67551
GCA_002786265.1-Pla_KZ451980.1_i000_012065	47	377	330	1	0.680412
GCA_018804465.1-Pla_CM031971.1_i000_033638	47	377	330	1	0.558376
GCA_000147415.1-Pla_GL433843.1_i000_004379	122	216	94	0.284848	0.229268
GCA_000147415.1-Pla_GL433843.1_i000_004379	214	384	170	0.515152	0.414634
GCA_002966975.2-Pla_PJQY01002118.1_i000_025710	91	421	330	1	0.622642
GCA_905250105.1-Ani_CAJNOC010002357.1_i000_012733	63	388	325	0.984848	0.627413
GCA_003573695.1-Pla_CM010724.1_i000_036385	44	377	333	1.00909	0.685185
GCA_015502485.1-Fun_JAAAUO010000306.1_i000_007821	80	417	337	1.02121	0.634652
GCA_016946835.1-Fun_JACVTC010000095.1_i000_027187	71	401	330	1	0.657371
GCA_008632915.2-Pla_AP019302.1_i000_016988	106	434	328	0.993939	0.604052
GCA_019973975.1-Ani_BMAO01015866.1_i000_027907	247	507	260	0.787879	0.428336
GCA_009771035.1-Pla_CM020020.1_i000_034354	46	377	331	1.00303	0.682474
GCA_014466175.1-Ani_CM025350.1_i000_014554	39	381	342	1.03636	0.699387
GCA_001272555.1-Ani_KQ434842.1_i000_004380	36	379	343	1.03939	0.702869
GCA_003018175.1-Ani_PYGN01001178.1_i000_020953	42	385	343	1.03939	0.694332
GCA_019925795.1-Pla_CM034308.1_i000_013458	64	395	331	1.00303	0.658052
GCA_003427395.1-Pla_BFEA01000297.1_i000_019306	64	157	93	0.281818	0.164311
GCA_003427395.1-Pla_BFEA01000297.1_i000_019306	151	340	189	0.572727	0.333922
GCA_903112645.1-Pla_CAEKDK010000006.1_i000_022729	193	522	329	0.99697	0.521395
GCA_903114435.1-Pla_CAEKKB010000006.1_i000_022563	193	522	329	0.99697	0.521395
GCA_000280035.2-Fun_CP003528.1_i000_001430	101	434	333	1.00909	0.682377
GCA_008636045.1-Pro_SNRW01009411.1_i000_026428	1	267	266	0.806061	0.542857
GCA_021029045.1-Pro_JAFCAI010000029.1_i000_006686	144	444	300	0.909091	0.580271
GCA_000311805.2-Ani_KB017491.1_i000_015004	138	387	249	0.754545	0.625628
GCA_010261695.1-Pla_CM021005.1_i000_016150	114	444	330	1	0.596745
GCA_002249905.1-Ani_NNAY01003528.1_i000_013038	43	383	340	1.0303	0.692464
GCA_014905175.1-Ani_CM026522.1_i000_003479	46	379	333	1.00909	0.679592
GCA_019049445.1-Ani_JAHFVI010000010.1_i000_004786	42	379	337	1.02121	0.689162
GCA_022085475.1-Pla_JAIUZE010045862.1_i000_015659	45	376	331	1.00303	0.676892
GCA_000230445.1-Ani_JH204767.1_i000_021653	167	443	276	0.836364	0.469388
GCA_015342445.1-Pla_JACEFO010001619.1_i000_015611	14	344	330	1	0.726872
GCA_000328365.1-Ani_KB307920.1_i000_020472	37	371	334	1.01212	0.684426
GCA_015499975.1-Fun_JAAAUD010000397.1_i000_006864	129	304	175	0.530303	0.37234
GCA_015499975.1-Fun_JAAAUD010000397.1_i000_006864	301	427	126	0.381818	0.268085
GCA_001045655.1-Ani_LBMM01005167.1_i000_007825	32	379	347	1.05152	0.709611
GCA_020424065.1-Pla_CM035465.1_i000_001630	367	695	328	0.993939	0.407453
GCA_903813345.1-Ani_CAIIXF010000016.1_i000_025297	40	375	335	1.01515	0.671343
GCA_001531365.1-Pla_CM009744.1_i000_017672	113	439	326	0.987879	0.575972
GCA_003344405.1-Ani_NOWV01000290.1_i000_006163	46	382	336	1.01818	0.680162
GCA_000696155.1-Ani_KK852665.1_i000_005112	44	386	342	1.03636	0.692308
GCA_008636185.1-Pla_VXIU01000072.1_i000_012003	26	376	350	1.06061	0.715746
GCA_002211085.2-Pla_CM008052.2_i000_024836	45	375	330	1	0.680412
GCA_003046395.2-Pla_CM009704.2_i000_048978	45	375	330	1	0.680412
GCA_003046395.2-Pla_CM009705.2_i000_051580	45	375	330	1	0.680412
GCA_003061485.1-Pla_CM009755.1_i000_024442	45	375	330	1	0.680412
GCA_019426215.1-Pla_CM033394.1_i000_010153	85	416	331	1.00303	0.6341
GCA_018691285.1-Pla_CM031884.1_i000_006722	44	378	334	1.01212	0.690083
GCA_001633215.2-Pla_KV780740.1_i000_022300	55	384	329	0.99697	0.664646
GCA_016808335.1-Pla_CM029050.1_i000_069449	55	384	329	0.99697	0.664646
GCA_007726485.1-Pla_CM017443.1_i000_021061	45	375	330	1	0.680412
GCA_007726485.1-Pla_CM017443.1_i000_021463	45	375	330	1	0.680412
GCA_005286985.1-Pla_CM016558.1_i000_027399	45	375	330	1	0.680412
GCA_000204515.1-Ani_GL888742.1_i000_012975	39	378	339	1.02727	0.693252
GCA_017607455.1-Ani_JAANHZ010000809.1_i000_006738	39	378	339	1.02727	0.693252
GCA_013368555.1-Fun_JAACJN010000015.1_i000_003525	136	454	318	0.963636	0.579235
GCA_902201215.1-Pla_LR694010.1_i000_015291	46	377	331	1.00303	0.682474
GCA_001678115.1-Fun_LVWM01000089.1_i000_006136	134	342	208	0.630303	0.608187
GCA_016808335.1-Pla_CM029049.1_i000_030076	45	375	330	1	0.680412
GCA_000264995.1-Fun_JH687541.1_i000_004103	90	418	328	0.993939	0.614232
GCA_002994745.2-Pla_CM009583.1_i000_008596	47	377	330	1	0.679012
GCA_900624975.1-Ani_UYYA01004026.1_i000_007285	186	428	242	0.733333	0.514894
GCA_001742945.1-Pla_DF973249.1_i000_011610	46	330	284	0.860606	0.860606
GCA_907166875.3-Ani_CAJRHG030000007.1_i000_011368	47	380	333	1.00909	0.671371
GCA_000263155.2-Pla_CM003532.1_i000_019934	45	375	330	1	0.680412
GCA_005286985.1-Pla_CM016556.1_i000_022237	45	375	330	1	0.680412
GCA_000277815.3-Fun_CP002722.1_i000_001496	101	431	330	1	0.674847
GCA_004115005.2-Pla_CM032138.1_i000_006268	106	439	333	1.00909	0.60989
GCA_001594045.1-Ani_KQ976507.1_i000_006649	39	378	339	1.02727	0.693252
GCA_014466185.1-Ani_CM025400.1_i000_012207	39	381	342	1.03636	0.699387
GCA_018342045.1-Fun_JAGEXW010000001.1_i000_000052	101	431	330	1	0.674847
GCA_019722365.1-Pla_JADFUC010000345.1_i000_002686	49	381	332	1.00606	0.680328
GCA_019364655.1-Ani_JAGXCG010010411.1_i000_010567	36	370	334	1.01212	0.687243
GCA_011766145.1-Pla_BLLF01001341.1_i000_013179	8	282	274	0.830303	0.671569
GCA_015502505.1-Fun_JAAAUQ010000499.1_i000_008440	83	416	333	1.00909	0.627119
GCA_014466195.1-Ani_CM025375.1_i000_013484	36	381	345	1.04545	0.705521
GCA_001594065.1-Ani_KQ976750.1_i000_000387	50	389	339	1.02727	0.678
GCA_002284615.2-Pla_MU069807.1_i000_009193	52	378	326	0.987879	0.649402
GCA_017607545.1-Ani_JAANIC010003681.1_i000_004729	40	377	337	1.02121	0.641905
GCA_017607565.1-Ani_JAANIB010003379.1_i000_002106	40	377	337	1.02121	0.641905
GCA_001632505.1-Ani_LRGB01000024.1_i000_000798	53	349	296	0.89697	0.583826
GCA_020536995.1-Ani_CM035916.1_i000_024919	38	376	338	1.02424	0.681452
GCA_016758935.1-Fun_JAEPRE010000071.1_i000_008587	53	382	329	0.99697	0.667343
GCA_000002335.3-Ani_CM000284.3_i000_013184	47	346	299	0.906061	0.602823
GCA_016858145.1-Pla_JAEHOE010000012.1_i000_004123	56	377	321	0.972727	0.657787
GCA_000263155.2-Pla_CM003534.1_i000_024491	10	327	317	0.960606	0.686147
GCA_015499985.1-Fun_JAAAUF010000384.1_i000_006625	82	417	335	1.01515	0.630885
GCA_000005005.6-Pla_CM007648.1_i000_006698	45	375	330	1	0.680412
GCA_003185045.1-Pla_CM009907.1_i000_006494	45	375	330	1	0.680412
GCA_009761285.1-Ani_VYZN01000053.1_i000_012974	41	389	348	1.05455	0.705882
GCA_016748015.1-Fun_JAAOMT010000258.1_i000_009958	62	390	328	0.993939	0.645669
GCA_018691285.1-Pla_CM031898.1_i000_027634	45	378	333	1.00909	0.688017
GCA_006247105.1-Pro_CM016928.1_i000_003952	90	448	358	1.08485	0.629174
GCA_904845875.1-Pla_CAJGYO010000011.1_i000_043452	46	375	329	0.99697	0.678351
GCA_001185155.1-Pla_LFYR01001099.1_i000_011732	46	377	331	1.00303	0.683884
GCA_015680625.1-Fun_JAAAXW010000004.1_i000_008068	79	417	338	1.02424	0.636535
GCA_013398475.1-Ani_VZSO01008122.1_i000_012049	1	263	262	0.793939	0.929078
GCA_016413895.1-Pla_CM028158.1_i000_018031	45	378	333	1.00909	0.688017
GCA_004115005.2-Pla_CM032152.1_i000_025381	45	379	334	1.01212	0.656189
GCA_022160315.1-Fun_MU275167.1_i000_002183	91	419	328	0.993939	0.609665
GCA_900005825.1-Ani_CVRI01000056.1_i000_014972	57	354	297	0.9	0.588119
GCA_016097865.1-Fun_JAAAIN010004334.1_i000_012425	2	291	289	0.875758	0.711823
GCA_013841245.2-Ani_CM034064.1_i000_002058	10	340	330	1	0.734967
GCA_011392965.1-Ani_WNWW01000274.1_i000_003284	37	379	342	1.03636	0.699387
GCA_000147195.1-Ani_GL446678.1_i000_002760	37	379	342	1.03636	0.699387
GCA_002081605.1-Ani_MNPL01002959.1_i000_002558	74	411	337	1.02121	0.634652
GCA_903986555.1-Ani_CAJDYZ010007215.1_i000_004083	37	379	342	1.03636	0.699387
GCA_019279435.1-Pla_JAAALK010000285.1_i000_011682	46	374	328	0.993939	0.677686
GCA_001443705.1-Ani_LJIG01009468.1_i000_003921	45	368	323	0.978788	0.643426
GCA_002083735.1-Fun_KV921607.1_i000_010739	13	340	327	0.990909	0.728285
GCA_013841205.1-Ani_JACDQY010000091.1_i000_009444	36	378	342	1.03636	0.70082
GCA_000005505.4-Pla_CM000880.3_i000_007335	93	421	328	0.993939	0.616541
GCA_000005425.2-Pla_AP008210.2_i000_012375	45	374	329	0.99697	0.679752
GCA_001433935.1-Pla_AP014960.1_i000_018383	45	374	329	0.99697	0.679752
GCA_004007595.1-Pla_CM012944.1_i000_014059	45	374	329	0.99697	0.679752
GCA_002083745.1-Fun_KV922187.1_i000_011082	13	343	330	1	0.734967
GCA_002708625.1-Fun_KZ303862.1_i000_009278	13	343	330	1	0.734967
GCA_009797565.1-Pla_CM020524.1_i000_015064	45	374	329	0.99697	0.67418
GCA_900617915.1-Ani_UYRT01081163.1_i000_014335	16	334	318	0.963636	0.643725
GCA_910592345.1-Fun_CAJVPI010000099.1_i000_001516	61	380	319	0.966667	0.630435
GCA_003335185.2-Ani_QKKF02028090.1_i000_013817	42	374	332	1.00606	0.677551
GCA_000765035.1-Fun_CCBP010000183.1_i000_006495	101	426	325	0.984848	0.595238
GCA_009363875.1-Pla_SZYD01000412.1_i000_042188	183	513	330	1	0.530547
GCA_011823955.1-Ani_JAAKFY010000021.1_i000_000717	53	380	327	0.990909	0.643701
GCA_000149285.1-Pla_CM000140.1_i000_010321	114	397	283	0.857576	0.539048
GCA_009363875.1-Pla_CM018698.1_i000_022881	192	522	330	1	0.522979
GCA_001263275.1-Ani_KQ414748.1_i000_009533	37	379	342	1.03636	0.699387
GCA_000375325.1-Pla_KB870806.1_i000_004773	45	375	330	1	0.681818
GCA_000149865.1-Fun_DS022307.1_i000_002835	75	403	328	0.993939	0.648221
GCA_013399895.1-Ani_VXBA01004484.1_i000_010219	101	280	179	0.542424	0.404977
GCA_013399895.1-Ani_VXBA01004484.1_i000_010219	286	354	68	0.206061	0.153846
GCA_001594055.1-Ani_KQ982701.1_i000_008863	41	378	337	1.02121	0.689162
GCA_000203795.1-Fun_GL882887.1_i000_005525	11	361	350	1.06061	0.75431
GCA_900000135.1-Fun_CCYT01000011.1_i000_005265	61	389	328	0.993939	0.66129
GCA_000825725.1-Fun_CDGI01000865.1_i000_017069	60	390	330	1	0.663984
GCA_003325435.1-Fun_PJQL01002870.1_i000_013563	58	388	330	1	0.666667
GCA_904845875.1-Pla_CAJGYO010000012.1_i000_046061	45	374	329	0.99697	0.679752
GCA_900618515.1-Ani_UZAO01051776.1_i000_003984	166	435	269	0.815152	0.482944
GCA_022376465.1-Fun_JACDTU010000008.1_i000_011659	98	425	327	0.990909	0.60221
GCA_000825725.1-Fun_CDGI01000241.1_i000_008893	58	385	327	0.990909	0.660606
GCA_011762625.1-Fun_JAANIL010000846.1_i000_009026	58	385	327	0.990909	0.660606
GCA_011762635.1-Fun_JAANIK010000540.1_i000_007108	58	385	327	0.990909	0.660606
GCA_011763475.1-Fun_JAANIM010000860.1_i000_009040	58	385	327	0.990909	0.660606
GCA_011763565.1-Fun_JAANIN010000600.1_i000_008060	58	385	327	0.990909	0.660606
GCA_011764045.1-Fun_JAANQQ010000604.1_i000_007544	58	385	327	0.990909	0.660606
GCA_017607525.1-Ani_JAANIA010001783.1_i000_002370	40	377	337	1.02121	0.641905
GCA_013115865.1-Pro_JABANO010023718.1_i000_018988	2	240	238	0.721212	0.838028
GCA_015143295.1-Pla_CM026554.1_i000_006943	147	477	330	1	0.66
GCA_001876935.1-Pla_CM007383.1_i000_006714	48	379	331	1.00303	0.678279
GCA_902439185.1-Ani_CABPRJ010002377.1_i000_015114	44	390	346	1.04848	0.69899
GCA_910592205.1-Fun_CAJVPJ010000122.1_i000_001585	61	392	331	1.00303	0.65415
GCA_000149285.1-Pla_CM000141.1_i000_014978	149	471	322	0.975758	0.518519
GCA_003546025.1-Pla_QPKB01000001.1_i000_002591	127	427	300	0.909091	0.699301
GCA_016098045.1-Fun_JAAAIW010001212.1_i000_001073	93	425	332	1.00606	0.614815
GCA_011800145.1-Ani_JAAMPH010000037.1_i000_004911	135	373	238	0.721212	0.505308
GCA_015502465.1-Fun_JAAAUP010000466.1_i000_007596	87	420	333	1.00909	0.62243
GCA_002754855.1-Ani_MRZV01000269.1_i000_014220	40	371	331	1.00303	0.672764
GCA_002738545.1-Ani_NTJE010011556.1_i000_000660	37	277	240	0.727273	0.541761
GCA_000441915.1-Pla_KE528602.1_i000_004878	47	376	329	0.99697	0.682573
GCA_001646965.1-Fun_LVCJ01000060.1_i000_009088	130	355	225	0.681818	0.46875
GCA_001646965.1-Fun_LVCJ01000060.1_i000_009088	354	429	75	0.227273	0.15625
GCA_005223365.2-Pla_SPHZ02000006.1_i000_019885	45	374	329	0.99697	0.679752
GCA_016771965.1-Pla_CM028696.1_i000_048155	45	376	331	1.00303	0.682474
GCA_020379485.1-Pla_CM035459.1_i000_060049	45	376	331	1.00303	0.682474
GCA_015847235.1-Fun_JAAAHU010000164.1_i000_002538	83	416	333	1.00909	0.62594
GCA_016098025.1-Fun_JAAAIU010001650.1_i000_003171	83	419	336	1.01818	0.630394
GCA_000004655.2-Pla_CM000129.1_i000_016132	66	389	323	0.978788	0.600372
GCA_016098015.1-Fun_JAAAIT010002348.1_i000_004337	6	337	331	1.00303	0.727473
GCA_020796205.1-Pla_CM036899.1_i000_018746	70	367	297	0.9	0.794118
GCA_000003195.3-Pla_CM000765.3_i000_022854	43	374	331	1.00303	0.683884
GCA_015952705.1-Pla_CM027685.1_i000_023400	43	374	331	1.00303	0.683884
GCA_013339725.1-Ani_CM023468.1_i000_023812	40	375	335	1.01515	0.680894
GCA_004794785.1-Ani_SJOL01001134.1_i000_000585	58	384	326	0.987879	0.616257
GCA_015502445.1-Fun_JAAAUN010000134.1_i000_001771	88	421	333	1.00909	0.62594
GCA_007844105.2-Pla_CM017577.2_i000_025474	112	442	330	1	0.587189
GCA_000469725.3-Ani_LN902842.1_i000_004092	108	436	328	0.993939	0.556876
GCA_004114815.1-Pla_SDOW01000492.1_i000_035358	46	372	326	0.987879	0.672165
GCA_009835225.1-Ani_VUJU01003344.1_i000_013999	43	377	334	1.01212	0.330366
GCA_015502475.1-Fun_JAAAUL010001214.1_i000_001285	88	421	333	1.00909	0.62594
GCA_016098085.1-Fun_JAAAIX010000204.1_i000_003660	88	421	333	1.00909	0.62594
GCA_001483705.1-Ani_KQ766043.1_i000_009207	37	377	340	1.0303	0.584192
GCA_002245835.2-Pla_LHPG02000004.1_i000_006347	79	380	301	0.912121	0.611789
GCA_007844105.2-Pla_CM017577.2_i000_025905	50	381	331	1.00303	0.676892
GCA_018290095.1-Ani_CM031379.1_i000_004997	60	354	294	0.890909	0.582178
GCA_014282415.2-Ani_JABDTM020025416.1_i000_009496	985	1321	336	1.01818	0.234146
GCA_000188695.1-Pro_GL832968.1_i000_006016	53	388	335	1.01515	0.666004
GCA_001594115.1-Ani_KQ981655.1_i000_006943	39	378	339	1.02727	0.693252
GCA_015883425.1-Ani_JADDUC010000013.1_i000_001663	2	237	235	0.712121	0.673352
GCA_905330805.1-Ani_CAJNWK010000880.1_i000_027990	112	296	184	0.557576	0.418182
GCA_905330805.1-Ani_CAJNWK010000880.1_i000_027990	292	418	126	0.381818	0.286364
GCA_021235465.1-Fun_JAJSME010000001.1_i000_000985	57	391	334	1.01212	0.670683
GCA_900332095.2-Pla_OOIL02003369.1_i000_029521	46	377	331	1.00303	0.682474
GCA_905338385.1-Ani_CAJPEV010000132.1_i000_001386	48	392	344	1.04242	0.681188
GCA_011009095.1-Ani_VTPC01090285.1_i000_022314	49	382	333	1.00909	0.672727
GCA_003260385.1-Pla_NQVE01000027.1_i000_006931	46	377	331	1.00303	0.682474
GCA_900332095.2-Pla_OOIL02004817.1_i000_034938	46	377	331	1.00303	0.682474
GCA_016758965.1-Fun_JAEPRB010000288.1_i000_010791	66	397	331	1.00303	0.660679
GCA_003675905.2-Ani_NCKV01000645.1_i000_001944	52	382	330	1	0.658683
GCA_003604175.2-Ani_CM030371.1_i000_009764	58	384	326	0.987879	0.616257
GCA_910592015.1-Fun_CAJVPK010000018.1_i000_000547	123	334	211	0.639394	0.457701
GCA_910592015.1-Fun_CAJVPK010000018.1_i000_000547	332	418	86	0.260606	0.186551
GCA_000186025.2-Pro_GG664563.1_i000_000655	120	402	282	0.854545	0.701493
GCA_002082055.1-Ani_MTYJ01000314.1_i000_017580	38	370	332	1.00606	0.680328
GCA_016618385.1-Ani_JABFOP010000473.1_i000_010424	40	382	342	1.03636	0.563427
GCA_000344655.2-Fun_KE504133.1_i000_003475	93	421	328	0.993939	0.609665
GCA_002006685.1-Fun_LYON01000010.1_i000_000164	78	417	339	1.02727	0.650672
GCA_020617195.1-Fun_JAFDOU010000922.1_i000_007356	78	417	339	1.02727	0.650672
GCA_020617715.1-Fun_JAFDOV010000642.1_i000_003779	78	417	339	1.02727	0.650672
GCA_020617725.1-Fun_JAFDOT010000808.1_i000_006320	78	417	339	1.02727	0.650672
GCA_021556665.1-Fun_JAKFGG010000029.1_i000_005707	78	417	339	1.02727	0.650672
GCA_021556675.1-Fun_JAKFGI010000027.1_i000_005227	78	417	339	1.02727	0.650672
GCA_016758985.1-Fun_JAEPRD010000059.1_i000_006340	56	380	324	0.981818	0.658537
GCA_000414095.2-Pla_KE344869.1_i000_013955	83	413	330	1	0.604396
GCA_015502575.1-Fun_JAAAUR010000815.1_i000_010620	82	414	332	1.00606	0.62406
GCA_015679695.1-Fun_JAAAVD010001172.1_i000_000903	82	414	332	1.00606	0.62406
GCA_008360955.1-Ani_LUCM01008496.1_i000_008484	59	387	328	0.993939	0.623574
GCA_002738505.1-Pla_KZ305019.1_i000_001085	113	442	329	0.99697	0.594937
GCA_902806795.1-Ani_CADCXV010000795.1_i000_007527	43	342	299	0.906061	0.68894
MEHA001.0722.00001.C001_00559	46	315	269	0.815152	0.853968
GCA_002092935.1-Fun_KZ084135.1_i000_010101	101	423	322	0.975758	0.589744
GCA_015849295.1-Fun_JAAAHW010003494.1_i000_004330	94	430	336	1.01818	0.660118
GCA_020341155.1-Ani_JAHMML010000015.1_i000_002566	36	379	343	1.03939	0.702869
GCA_004794745.1-Ani_QBLH01003515.1_i000_007650	37	378	341	1.03333	0.697342
GCA_011951285.1-Fun_JAANRG010000100.1_i000_001859	64	390	326	0.987879	0.658586
GCA_902206195.3-Pla_CABITT030000002.1_i000_004517	46	378	332	1.00606	0.683128
GCA_012274485.2-Pla_MU105696.1_i000_012162	45	376	331	1.00303	0.682474
GCA_011763645.1-Fun_JAASGZ010000009.1_i000_000202	64	390	326	0.987879	0.657258
GCA_011763975.1-Fun_JAANJF010000867.1_i000_006182	64	390	326	0.987879	0.657258
GCA_011763995.1-Fun_JAANJE010000207.1_i000_001270	64	390	326	0.987879	0.657258
GCA_011764025.1-Fun_JAANQT010000650.1_i000_005372	64	390	326	0.987879	0.657258
GCA_011764055.1-Fun_JAANQS010000030.1_i000_000506	64	390	326	0.987879	0.657258
GCA_011764125.1-Fun_JAANQV010000106.1_i000_000569	64	390	326	0.987879	0.657258
GCA_011764145.1-Fun_JAANQZ010000307.1_i000_002077	64	390	326	0.987879	0.657258
GCA_011764185.1-Fun_JAANRA010000001.1_i000_000018	64	390	326	0.987879	0.657258
GCA_011764225.1-Fun_JAANRQ010001799.1_i000_005163	64	390	326	0.987879	0.657258
GCA_011764265.1-Fun_JAANRE010000145.1_i000_000457	64	390	326	0.987879	0.657258
GCA_011800955.1-Fun_JAANRM010000009.1_i000_000217	64	390	326	0.987879	0.657258
GCA_011800985.1-Fun_JAANRL010000034.1_i000_000583	64	390	326	0.987879	0.657258
GCA_011801035.1-Fun_JAANRN010000088.1_i000_001467	64	390	326	0.987879	0.657258
GCA_011801055.1-Fun_JAANRO010000041.1_i000_000845	64	390	326	0.987879	0.657258
GCA_011801305.1-Fun_JAANRS010000053.1_i000_000930	64	390	326	0.987879	0.657258
GCA_011801335.1-Fun_JAANRP010000008.1_i000_000170	64	390	326	0.987879	0.657258
GCA_011801385.1-Fun_JAANRR010000663.1_i000_005495	64	390	326	0.987879	0.657258
GCA_011801495.1-Fun_JAANRV010000019.1_i000_000358	64	390	326	0.987879	0.657258
GCA_011801505.1-Fun_JAANRU010000057.1_i000_001063	64	390	326	0.987879	0.657258
GCA_011801555.1-Fun_JAANRX010000056.1_i000_000949	64	390	326	0.987879	0.657258
GCA_011801575.1-Fun_JAANRW010000010.1_i000_000224	64	390	326	0.987879	0.657258
GCA_011801605.1-Fun_JAANRT010000051.1_i000_000884	64	390	326	0.987879	0.657258
GCA_011801645.1-Fun_JAANRB010000052.1_i000_000825	64	390	326	0.987879	0.657258
GCA_011801675.1-Fun_JAANQW010000016.1_i000_000260	64	390	326	0.987879	0.657258
GCA_011801705.1-Fun_JAANQY010000443.1_i000_004111	64	390	326	0.987879	0.657258
GCA_011801725.1-Fun_JAANQX010000003.1_i000_000060	64	390	326	0.987879	0.657258
GCA_011801785.1-Fun_JAANQR010000025.1_i000_000395	64	390	326	0.987879	0.657258
GCA_011801815.1-Fun_JAANQU010000019.1_i000_000303	64	390	326	0.987879	0.657258
GCA_011950945.1-Fun_JAANRD010000022.1_i000_000449	64	390	326	0.987879	0.657258
GCA_011950985.1-Fun_JAANRF010000024.1_i000_000509	64	390	326	0.987879	0.657258
GCA_011951295.1-Fun_JAANRC010000683.1_i000_005577	64	390	326	0.987879	0.657258
GCA_011952045.1-Fun_JAANRH010000686.1_i000_005645	64	390	326	0.987879	0.657258
GCA_011952115.1-Fun_JAANRI010000578.1_i000_004549	64	390	326	0.987879	0.657258
GCA_011952145.1-Fun_JAANRJ010000004.1_i000_000092	64	390	326	0.987879	0.657258
GCA_011952175.1-Fun_JAANRK010000002.1_i000_000048	64	390	326	0.987879	0.657258
GCA_902806795.1-Ani_CADCXV010001394.1_i000_015682	113	302	189	0.572727	0.383367
GCA_902806795.1-Ani_CADCXV010001394.1_i000_015682	301	418	117	0.354545	0.237323
GCA_000149305.1-Fun_CH476745.1_i000_002642	59	389	330	1	0.666667
GCA_011763585.1-Fun_JAANIP010000114.1_i000_001214	59	389	330	1	0.666667
GCA_011763695.1-Fun_JAANIQ010000136.1_i000_001531	59	389	330	1	0.666667
GCA_011763715.1-Fun_JAANIR010000056.1_i000_000767	59	389	330	1	0.666667
GCA_011763735.1-Fun_JAANIS010000174.1_i000_001174	59	389	330	1	0.666667
GCA_011763755.1-Fun_JAANIW010000229.1_i000_002983	59	389	330	1	0.666667
GCA_011763775.1-Fun_JAANIT010000005.1_i000_000107	59	389	330	1	0.666667
GCA_011763795.1-Fun_JAANIV010000048.1_i000_000904	59	389	330	1	0.666667
GCA_011763815.1-Fun_JAANIU010000619.1_i000_004920	59	389	330	1	0.666667
GCA_011763835.1-Fun_JAANIX010000056.1_i000_001029	59	389	330	1	0.666667
GCA_011763875.1-Fun_JAANIZ010000605.1_i000_004887	59	389	330	1	0.666667
GCA_011763895.1-Fun_JAANIY010000188.1_i000_002195	59	389	330	1	0.666667
GCA_011763915.1-Fun_JAANJB010000235.1_i000_002813	59	389	330	1	0.666667
GCA_011763935.1-Fun_JAANJC010000002.1_i000_000048	64	390	326	0.987879	0.657258
GCA_011763955.1-Fun_JAANJD010000002.1_i000_000046	64	390	326	0.987879	0.657258
GCA_016771965.1-Pla_CM028690.1_i000_020252	46	377	331	1.00303	0.68107
GCA_011763855.1-Fun_JAANJA010000243.1_i000_003074	60	389	329	0.99697	0.664646
GCA_002220415.3-Pla_CM022211.1_i000_003685	46	372	326	0.987879	0.672165
GCA_002220415.3-Pla_CM022213.1_i000_012958	46	372	326	0.987879	0.672165
GCA_005549215.1-Pla_SSTE01020484.1_i000_033743	44	378	334	1.01212	0.690083
GCA_005549225.1-Pla_SSTD01008475.1_i000_015970	44	378	334	1.01212	0.690083
GCA_002105155.1-Fun_MCFF01000045.1_i000_007942	28	363	335	1.01515	0.695021
GCA_015852335.1-Fun_JAAAID010001695.1_i000_008296	78	408	330	1	0.627376
GCA_900231445.1-Pla_LT934112.1_i000_007350	77	403	326	0.987879	0.631783
GCA_015849335.1-Fun_JAAAIC010001061.1_i000_000396	84	414	330	1	0.620301
GCA_000004255.1-Pla_GL348714.1_i000_005959	42	371	329	0.99697	0.685417
GCA_000488995.1-Fun_AWSO01000024.1_i000_000978	94	423	329	0.99697	0.613806
GCA_002763495.2-Ani_JXXN02002880.1_i000_006883	59	383	324	0.981818	0.61597
GCA_016097885.1-Fun_JAAAIO010000160.1_i000_002332	92	426	334	1.01212	0.617375
GCA_015847225.1-Fun_JAAAHT010000503.1_i000_003783	70	405	335	1.01515	0.639313
GCA_003990785.1-Fun_RBNK01003938.1_i000_006187	74	404	330	1	0.620301
GCA_905250015.1-Ani_CAJNOM010000060.1_i000_012215	41	356	315	0.954545	0.628743
GCA_905250015.1-Ani_CAJNOM010000062.1_i000_012518	41	356	315	0.954545	0.628743
GCA_905250115.1-Ani_CAJNOI010000056.1_i000_013762	41	356	315	0.954545	0.628743
GCA_000143185.1-Fun_GL377302.1_i000_000880	94	422	328	0.993939	0.604052
GCA_000286095.1-Pro_CP003682.1_i000_000406	121	398	277	0.839394	0.69598
GCA_000258705.1-Pla_AGSI01000009.1_i000_005256	57	381	324	0.981818	0.657201
GCA_001990785.1-Ani_KV892841.1_i000_003967	58	384	326	0.987879	0.670782
GCA_000150275.1-Ani_DS985242.1_i000_008893	46	379	333	1.00909	0.678208
GCA_015852425.1-Fun_JAAAIG010000501.1_i000_008112	85	418	333	1.00909	0.62594
GCA_015679535.1-Fun_JAAAUX010000067.1_i000_009789	74	410	336	1.01818	0.641221
GCA_003260655.2-Pla_QGKV02001507.1_i000_054504	45	376	331	1.00303	0.682474
GCA_003260675.2-Pla_QGKX02000004.1_i000_047373	46	376	330	1	0.680412
GCA_016758905.1-Fun_JAEPQZ010000001.1_i000_000192	61	389	328	0.993939	0.658635
GCA_900231445.1-Pla_LT934111.1_i000_003563	148	473	325	0.984848	0.553663
GCA_000611835.1-Ani_KK107921.1_i000_015755	102	183	81	0.245455	0.200495
GCA_000611835.1-Ani_KK107921.1_i000_015755	180	374	194	0.587879	0.480198
GCA_012274485.2-Pla_MU106574.1_i000_037257	45	376	331	1.00303	0.682474
GCA_016097935.1-Fun_JAAAIP010000129.1_i000_001180	92	426	334	1.01212	0.617375
GCA_000230815.1-Ani_CM001294.1_i000_014426	38	369	331	1.00303	0.729075
GCA_000147175.1-Ani_GL439579.1_i000_008053	36	379	343	1.03939	0.701431
GCA_000262585.1-Ani_JH668624.1_i000_010173	46	380	334	1.01212	0.673387
GCA_019059645.1-Ani_JAFELL010000934.1_i000_007712	53	373	320	0.969697	0.643863
GCA_017639395.1-Pla_CM029879.1_i000_005213	46	377	331	1.00303	0.68107
GCA_003260695.2-Pla_QGKY02000246.1_i000_043372	81	412	331	1.00303	0.635317
GCA_905250065.1-Ani_CAJNON010000156.1_i000_017058	39	356	317	0.960606	0.632735
GCA_905332035.1-Ani_CAJOAY010003422.1_i000_030970	39	356	317	0.960606	0.632735
GCA_001691785.2-Fun_JNHV02000011.1_i000_000730	82	412	330	1	0.625
GCA_016771965.1-Pla_CM028703.1_i000_086890	46	377	331	1.00303	0.68107
GCA_000524195.1-Ani_APAU02000089.1_i000_003450	73	401	328	0.993939	0.592058
GCA_015500005.1-Fun_JAAAUG010001177.1_i000_000873	79	411	332	1.00606	0.627599
GCA_015529795.1-Fun_JAAAUH010001148.1_i000_000761	80	412	332	1.00606	0.626415
GCA_902728155.2-Pla_CACVBM020001373.1_i000_034441	45	376	331	1.00303	0.676892
GCA_015499975.1-Fun_JAAAUD010001046.1_i000_000295	95	430	335	1.01515	0.611314
GCA_021556725.1-Ani_CM038614.1_i000_003771	108	436	328	0.993939	0.556876
GCA_020379485.1-Pla_CM035456.1_i000_043067	46	377	331	1.00303	0.68107
GCA_015039365.1-Fun_WION01000002.1_i000_005528	86	415	329	0.99697	0.619586
MEMA004.0722.00001.C001_00140	45	315	270	0.818182	0.857143
GCA_900618445.1-Ani_UYSG01011121.1_i000_008655	72	400	328	0.993939	0.588869
GCA_902177915.1-Ani_CABIJS010000016.1_i000_000749	82	410	328	0.993939	0.578483
GCA_017311265.1-Fun_JABTEF010000005.1_i000_002770	68	399	331	1.00303	0.65286
GCA_015252655.1-Ani_JTDF01002701.1_i000_003992	62	387	325	0.984848	0.610902
GCA_008508345.1-Ani_QNGE01001031.1_i000_003916	62	387	325	0.984848	0.610902
GCA_019924255.1-Fun_JAHFXK010001947.1_i000_006707	1	210	209	0.633333	0.765568
GCA_003614735.1-Fun_KZ992524.1_i000_001911	37	372	335	1.01515	0.685072
GCA_015679515.1-Fun_JAAAVA010000148.1_i000_002737	95	430	335	1.01515	0.613553
GCA_905216605.1-Pla_LR999452.1_i000_004321	45	376	331	1.00303	0.682474
GCA_004307905.1-Fun_ML145087.1_i000_002281	96	423	327	0.990909	0.565744
GCA_004307915.1-Fun_ML144183.1_i000_011792	96	423	327	0.990909	0.565744
GCA_016771965.1-Pla_CM028700.1_i000_069276	45	376	331	1.00303	0.682474
GCA_001691755.2-Fun_JNHY02000003.1_i000_002612	83	412	329	0.99697	0.621928
GCA_000004075.3-Pla_CM002926.2_i000_016236	44	378	334	1.01212	0.690083
GCA_020004485.1-Ani_JAATJU010024516.1_i000_016243	1	214	213	0.645455	0.986111
GCA_905071925.1-Ani_CAJHJT010000034.1_i000_013566	16	388	372	1.12727	0.739563
GCA_019297735.1-Ani_CM033248.1_i000_014800	19	324	305	0.924242	0.699541
GCA_015832365.1-Ani_JACWZX010000141.1_i000_001763	46	382	336	1.01818	0.72885
GCA_016097925.1-Fun_JAAAIQ010000096.1_i000_011770	405	738	333	1.00909	0.390387
GCA_022117675.1-Ani_JACEFF010000475.1_i000_010852	46	382	336	1.01818	0.722581
GCA_003434825.1-Pla_CM010628.1_i000_002461	46	377	331	1.00303	0.68107
GCA_900412535.3-Pla_LS974617.2_i000_003106	49	380	331	1.00303	0.676892
GCA_000827215.1-Fun_KN837076.1_i000_000262	85	413	328	0.993939	0.627151
GCA_000347455.1-Pla_KD251540.1_i000_020757	457	779	322	0.975758	0.359777
GCA_900231445.1-Pla_LT934114.1_i000_013595	56	382	326	0.987879	0.825316
GCA_015852435.1-Fun_JAAAIJ010000303.1_i000_006387	73	409	336	1.01818	0.642447
GCA_015852495.1-Fun_JAAAIK010000013.1_i000_001422	73	409	336	1.01818	0.642447
GCA_020379485.1-Pla_CM035446.1_i000_002548	69	400	331	1.00303	0.650295
GCA_905332015.1-Ani_CAJOAZ010008441.1_i000_039931	2	295	293	0.887879	0.667426
GCA_013397565.1-Ani_VZRJ01011332.1_i000_010858	55	236	181	0.548485	0.39693
GCA_013397565.1-Ani_VZRJ01011332.1_i000_010858	247	371	124	0.375758	0.27193
GCA_006783055.1-Ani_VCRD01007018.1_i000_021244	100	342	242	0.733333	0.707602
GCA_015852385.1-Fun_JAAAIE010001009.1_i000_000143	76	408	332	1.00606	0.634799
GCA_015679615.1-Ani_JACKWZ010000028.1_i000_003051	46	368	322	0.975758	0.647887
GCA_014338405.1-Ani_JTDE01022163.1_i000_012448	62	387	325	0.984848	0.610902
GCA_004307925.1-Fun_ML143396.1_i000_003814	96	423	327	0.990909	0.60221
GCA_013368495.1-Ani_LUCH01001308.1_i000_003171	62	385	323	0.978788	0.607143
GCA_900618015.1-Ani_UZAK01039108.1_i000_016235	60	366	306	0.927273	0.824798
GCA_000313525.1-Fun_HE797112.1_i000_005896	98	421	323	0.978788	0.60149
GCA_002220415.3-Pla_CM022230.1_i000_098174	46	373	327	0.990909	0.686975
GCA_000275845.1-Fun_JH719404.1_i000_004480	96	423	327	0.990909	0.565744
GCA_015849275.1-Fun_JAAAIA010000064.1_i000_007378	75	415	340	1.0303	0.637899
GCA_019202805.1-Pla_CM032906.1_i000_031030	45	376	331	1.00303	0.682474
GCA_018342105.1-Ani_JAFIRS010000880.1_i000_014909	19	390	371	1.12424	0.747984
GCA_004000445.1-Ani_RSAL01000003.1_i000_000579	48	370	322	0.975758	0.645291
GCA_017311285.1-Fun_JABTEG010000001.1_i000_000269	68	400	332	1.00606	0.656126
GCA_015178975.1-Fun_WHVD01000003.1_i000_007872	84	412	328	0.993939	0.616541
GCA_013368085.1-Ani_JABVZW010000323.1_i000_002297	46	381	335	1.01515	0.682281
GCA_001895945.1-Fun_MNAD01000413.1_i000_010105	98	423	325	0.984848	0.597426
GCA_000320605.2-Fun_KB445792.1_i000_001384	94	420	326	0.987879	0.605948
GCA_022264815.1-Fun_JADCUA010000001.1_i000_000497	93	422	329	0.99697	0.612663
GCA_020921065.1-Pla_CM037153.1_i000_007818	21	353	332	1.00606	0.790476
GCA_004369045.1-Fun_ML213504.1_i000_001920	96	422	326	0.987879	0.602588
GCA_000002865.1-Pro_CH991543.1_i000_008766	48	384	336	1.01818	0.685714
GCA_015679545.1-Fun_JAAAUZ010000002.1_i000_000055	78	411	333	1.00909	0.62949
GCA_019973155.1-Fun_BPQB01000001.1_i000_001033	97	425	328	0.993939	0.604052
GCA_004104545.1-Ani_SAUD01010417.1_i000_008491	58	378	320	0.969697	0.822622
GCA_000499385.1-Pro_HG722743.1_i000_001243	148	461	313	0.948485	0.608949
GCA_019202795.1-Pla_CM032919.1_i000_031007	46	376	330	1	0.680412
GCA_014904975.1-Fun_MU127806.1_i000_007270	93	422	329	0.99697	0.616105
GCA_002245815.2-Pla_LHPF02000006.1_i000_007837	51	377	326	0.987879	0.284468
GCA_900618395.1-Ani_UZAI01017338.1_i000_016896	60	387	327	0.990909	0.619318
GCA_016098105.1-Fun_JAAAIY010000245.1_i000_003542	66	399	333	1.00909	0.639155
GCA_000005245.1-Ani_CH940647.1_i000_012679	51	353	302	0.915152	0.600398
GCA_016098135.1-Fun_JAAAIZ010000237.1_i000_003315	66	399	333	1.00909	0.639155
GCA_019677385.1-Fun_WSLO01000037.1_i000_000665	133	378	245	0.742424	0.0841346
GCA_000005135.1-Ani_CH954178.1_i000_010247	47	385	338	1.02424	0.674651
GCA_000005975.1-Ani_CM000159.2_i000_009573	47	385	338	1.02424	0.674651
GCA_900622495.1-Ani_UYWX01000006.1_i000_000091	72	401	329	0.99697	0.593863
GCA_015679585.1-Fun_JAAAVF010000024.1_i000_004806	70	405	335	1.01515	0.642994
GCA_904063045.1-Ani_CAJFCJ010000007.1_i000_006327	37	358	321	0.972727	0.663223
GCA_003073045.1-Ani_CM009762.1_i000_010178	665	738	73	0.221212	0.068609
GCA_003073045.1-Ani_CM009762.1_i000_010178	730	944	214	0.648485	0.201128
GCA_003947045.1-Fun_NIZV01000036.1_i000_010172	138	309	171	0.518182	0.338614
GCA_003947045.1-Fun_NIZV01000036.1_i000_010172	320	454	134	0.406061	0.265347
GCA_005406025.1-Ani_BGZK01000061.1_i000_009209	12	313	301	0.912121	0.69515
GCA_000300595.1-Fun_JH930469.1_i000_002420	98	428	330	1	0.606618
GCA_020891255.1-Fun_BQFW01000008.1_i000_006580	82	416	334	1.01212	0.630189
GCA_016098005.1-Fun_JAAAIS010000120.1_i000_001168	75	409	334	1.01212	0.638623
GCA_015679405.1-Fun_JAAAUU010000032.1_i000_006068	75	409	334	1.01212	0.638623
GCA_021223785.1-Ani_JAJJHP010001087.1_i000_003564	53	353	300	0.909091	0.596421
GCA_021223965.1-Ani_JAJJHZ010003326.1_i000_008104	25	403	378	1.14545	0.725528
GCA_016808335.1-Pla_CM029050.1_i000_069450	45	372	327	0.990909	0.674227
GCA_900617975.1-Ani_UZAE01012716.1_i000_009603	72	400	328	0.993939	0.588869
GCA_004379715.1-Fun_ML213591.1_i000_001508	104	431	327	0.990909	0.601103
GCA_905368565.1-Ani_CAJPIZ010008922.1_i000_011246	58	392	334	1.01212	0.65748
GCA_015679485.1-Fun_JAAAUY010001037.1_i000_000281	74	409	335	1.01515	0.640535
GCA_015852375.1-Fun_JAAAIF010000708.1_i000_009747	53	409	356	1.07879	0.680688
GCA_021223725.1-Ani_JAJJHN010003778.1_i000_007604	70	407	337	1.02121	0.644359
GCA_003813185.1-Fun_ML122044.1_i000_001467	96	423	327	0.990909	0.605556
GCA_003813205.1-Fun_ML122250.1_i000_000025	96	423	327	0.990909	0.605556
GCA_000182895.1-Fun_AACS02000005.1_i000_006610	112	438	326	0.987879	0.587387
GCA_001187945.1-Ani_JRES01001072.1_i000_008281	47	387	340	1.0303	0.677291
GCA_002156985.1-Ani_KZ149829.1_i000_004581	46	371	325	0.984848	0.653924
GCA_021223825.1-Ani_JAJJHQ010011965.1_i000_010928	50	385	335	1.01515	0.668663
GCA_021223805.1-Ani_JAJJHR010000120.1_i000_000572	69	407	338	1.02424	0.646272
GCA_002135145.1-Ani_MUJZ01056654.1_i000_011895	44	376	332	1.00606	0.669355
GCA_013400255.1-Ani_VXBS01005705.1_i000_007053	56	288	232	0.70303	0.496788
GCA_013400255.1-Ani_VXBS01005705.1_i000_007053	307	376	69	0.209091	0.147752
GCA_021223765.1-Ani_JAJJHM010013123.1_i000_009947	48	385	337	1.02121	0.672655
GCA_021223845.1-Ani_JAJJHU010004954.1_i000_004468	46	385	339	1.02727	0.676647
GCA_009176605.1-Ani_SEYY01012740.1_i000_007458	59	383	324	0.981818	0.644135
GCA_009176605.1-Ani_SEYY01022761.1_i000_012909	59	383	324	0.981818	0.644135
GCA_000004655.2-Pla_CM000132.1_i000_023625	45	375	330	1	0.681818
GCA_000005425.2-Pla_AP008213.2_i000_018057	45	375	330	1	0.681818
GCA_000149285.1-Pla_CM000144.1_i000_022061	45	375	330	1	0.681818
GCA_001433935.1-Pla_AP014963.1_i000_027056	45	375	330	1	0.681818
GCA_004007595.1-Pla_CM012947.1_i000_020788	45	375	330	1	0.681818
GCA_009797565.1-Pla_CM020527.1_i000_022046	45	375	330	1	0.681818
GCA_005959815.1-Ani_QOCX01006883.1_i000_011675	47	387	340	1.0303	0.677291
GCA_016772295.1-Fun_JAAGWA010000005.1_i000_006905	142	468	326	0.987879	0.557265
GCA_000005215.1-Ani_CH480815.1_i000_013659	35	385	350	1.06061	0.698603
GCA_004369055.1-Fun_ML210989.1_i000_002090	96	420	324	0.981818	0.6
GCA_000018645.1-Pro_CP000881.1_i000_000127	116	412	296	0.89697	0.716707
GCA_008802855.1-Ani_VVIM01000008.1_i000_012434	46	349	303	0.918182	0.61336
GCA_014839865.1-Fun_JABAYA010000138.1_i000_001545	54	385	331	1.00303	0.68107
GCA_015039355.1-Fun_MU134298.1_i000_001269	88	415	327	0.990909	0.613508
GCA_001584585.1-Pla_LSYV01000002.1_i000_000189	48	380	332	1.00606	0.677551
GCA_003367725.1-Fun_KZ857388.1_i000_004659	96	420	324	0.981818	0.6
GCA_020884735.1-Fun_BPWL01000002.1_i000_001700	89	416	327	0.990909	0.61236
GCA_003324165.2-Pro_PYSW02000005.1_i000_002127	268	513	245	0.742424	0.380435
GCA_902825445.1-Ani_CADEBC010000483.1_i000_005618	46	368	322	0.975758	0.649194
GCA_902825455.1-Ani_CADEBD010000364.1_i000_013696	46	368	322	0.975758	0.649194
GCA_019924895.1-Fun_JAHFYM010000631.1_i000_015261	1	258	257	0.778788	0.769461
GCA_000478725.1-Pla_KI517881.1_i000_024509	44	376	332	1.00606	0.68595
GCA_000300555.1-Fun_JH971389.1_i000_004403	45	373	328	0.993939	0.673511
GCA_002261195.1-Fun_MVBO01000011.1_i000_000532	62	395	333	1.00909	0.664671
GCA_021223985.1-Ani_JAJJIA010003653.1_i000_008444	53	381	328	0.993939	0.652087
GCA_000699445.3-Ani_CM039143.1_i000_004273	60	387	327	0.990909	0.619318
GCA_905115235.1-Ani_LR899010.1_i000_004463	47	386	339	1.02727	0.678
GCA_905249995.1-Ani_CAJNOK010020167.1_i000_029025	31	343	312	0.945455	0.644628
GCA_905250885.1-Ani_CAJNOQ010008414.1_i000_023495	31	343	312	0.945455	0.644628
GCA_905332065.1-Ani_CAJOBC010008415.1_i000_023494	31	343	312	0.945455	0.644628
GCA_905332075.1-Ani_CAJOBA010041758.1_i000_029793	31	343	312	0.945455	0.644628
GCA_907164705.1-Ani_CAJQZP010001037.1_i000_015734	47	384	337	1.02121	0.676707
GCA_000005925.1-Ani_CH964101.1_i000_007345	51	388	337	1.02121	0.668651
GCA_014872705.1-Fun_CM026496.1_i000_004576	105	431	326	0.987879	0.59707
GCA_015502455.1-Fun_JAAAUM010000518.1_i000_008210	78	410	332	1.00606	0.628788
GCA_020796205.1-Pla_CM036896.1_i000_013081	53	383	330	1	0.663984
GCA_000259055.1-Ani_CM000363.1_i000_007796	32	385	353	1.0697	0.704591
GCA_000754195.3-Ani_CM002912.1_i000_007290	32	385	353	1.0697	0.704591
GCA_006381635.2-Pla_VEPZ02000981.1_i000_030936	131	225	94	0.284848	0.182171
GCA_006381635.2-Pla_VEPZ02000981.1_i000_030936	220	359	139	0.421212	0.26938
GCA_003675995.1-Ani_NCKU01000359.1_i000_002223	44	374	330	1	0.415617
GCA_003024255.1-Pla_CM009669.1_i000_017501	134	354	220	0.666667	0.485651
GCA_021223945.1-Ani_JAJJHW010002585.1_i000_005526	54	363	309	0.936364	0.614314
GCA_020887355.1-Pla_AP025003.1_i000_010048	50	380	330	1	0.669371
GCA_015484465.1-Fun_MU155148.1_i000_002663	105	430	325	0.984848	0.593066
GCA_900199415.2-Ani_FZQP02006033.1_i000_012550	45	372	327	0.990909	0.751724
GCA_000194455.1-Pro_CP002173.1_i000_000285	90	392	302	0.915152	0.768448
GCA_001563735.1-Fun_KQ962369.1_i000_006390	47	373	326	0.987879	0.668033
GCA_001632365.1-Fun_KV427605.1_i000_000444	93	416	323	0.978788	0.604869
GCA_000827195.1-Fun_KN838542.1_i000_001872	86	411	325	0.984848	0.617871
GCA_015849305.1-Fun_JAAAHY010000961.1_i000_010445	84	416	332	1.00606	0.626415
GCA_022376455.1-Fun_JACBKO010000034.1_i000_007095	90	418	328	0.993939	0.616541
GCA_905250035.1-Ani_CAJNOE010000200.1_i000_019681	39	341	302	0.915152	0.88563
GCA_002554575.1-Fun_KZ301978.1_i000_002196	88	416	328	0.993939	0.614232
GCA_001632425.1-Fun_KV425615.1_i000_010204	98	424	326	0.987879	0.602588
GCA_001913855.2-Fun_MLYV02001242.1_i000_012313	93	418	325	0.984848	0.607477
GCA_004802665.1-Fun_SGPJ01000015.1_i000_001470	93	418	325	0.984848	0.607477
GCA_019968985.1-Pro_JAHYSF010000267.1_i000_001110	1	253	252	0.763636	0.992126
GCA_002920065.1-Fun_PKSL01000393.1_i000_014660	195	448	253	0.766667	0.516327
GCA_021224005.1-Ani_JAJJHY010008789.1_i000_010927	71	407	336	1.01818	0.642447
GCA_000723665.1-Fun_CBTN010000036.1_i000_007242	60	390	330	1	0.666667
GCA_000697665.1-Fun_KL197709.1_i000_000814	101	428	327	0.990909	0.598901
GCA_000271585.1-Fun_JH711785.1_i000_003633	98	423	325	0.984848	0.597426
GCA_001683735.1-Fun_LUGG01000003.1_i000_003681	91	419	328	0.993939	0.616541
GCA_002760635.1-Fun_AYKW01000001.1_i000_000554	85	408	323	0.978788	0.569665
GCA_022376435.1-Fun_JABYQE010000039.1_i000_006874	90	417	327	0.990909	0.615819
GCA_000005175.1-Ani_CH933809.1_i000_003528	53	386	333	1.00909	0.662028
GCA_000005155.1-Ani_CH916366.1_i000_014675	53	381	328	0.993939	0.652087
GCA_900618005.1-Ani_UYRS01019220.1_i000_009454	72	402	330	1	0.638298
GCA_003614675.1-Fun_ML003383.1_i000_006423	129	266	137	0.415152	0.284823
GCA_003614675.1-Fun_ML003383.1_i000_006423	263	416	153	0.463636	0.318087
GCA_001298345.1-Ani_KQ459302.1_i000_004333	47	348	301	0.912121	0.603206
GCA_002895965.2-Ani_PIJE02013034.1_i000_033649	54	372	318	0.963636	0.828125
GCA_021223865.1-Ani_JAJJHT010001359.1_i000_000690	48	390	342	1.03636	0.657692
GCA_018127085.1-Fun_CM030726.1_i000_001434	64	398	334	1.01212	0.661386
GCA_002117355.1-Fun_KZ110602.1_i000_008751	94	421	327	0.990909	0.610075
GCA_021223745.1-Ani_JAJJHO010006587.1_i000_009112	48	385	337	1.02121	0.671315
GCA_001654015.2-Ani_LSRL02000075.1_i000_008010	53	379	326	0.987879	0.648111
GCA_905332045.1-Ani_CAJOBB010004522.1_i000_034045	39	336	297	0.9	0.881306
GCA_905338395.1-Ani_CAJPEW010000029.1_i000_000402	58	386	328	0.993939	0.643137
GCA_000005115.1-Ani_CH902618.1_i000_011003	48	385	337	1.02121	0.672655
GCA_000697705.1-Fun_KL198117.1_i000_014952	91	422	331	1.00303	0.61183
GCA_900618415.1-Ani_UZAM01012679.1_i000_009376	35	368	333	1.00909	0.659406
GCA_905250055.1-Ani_CAJNOF010000011.1_i000_008912	46	361	315	0.954545	0.62253
GCA_905250075.1-Ani_CAJNOP010000211.1_i000_037723	46	361	315	0.954545	0.62253
GCA_905331515.1-Ani_CAJNZC010000365.1_i000_023256	46	361	315	0.954545	0.62253
GCA_905332295.1-Ani_CAJOBT010005201.1_i000_023075	46	361	315	0.954545	0.62253
GCA_905332315.1-Ani_CAJOBV010005810.1_i000_028037	46	361	315	0.954545	0.62253
GCA_905332325.1-Ani_CAJOBW010004704.1_i000_017702	46	361	315	0.954545	0.62253
GCA_022160335.1-Fun_MU274903.1_i000_002434	98	427	329	0.99697	0.607011
GCA_013368075.1-Ani_JABVZV010001312.1_i000_007769	45	387	342	1.03636	0.692308
GCA_021605115.1-Pla_BMAR01000001.1_i000_001948	65	381	316	0.957576	0.642276
GCA_001687445.1-Fun_KV722333.1_i000_000828	95	422	327	0.990909	0.607807
GCA_905250075.1-Ani_CAJNOP010000212.1_i000_037770	46	361	315	0.954545	0.62253
GCA_000235995.2-Ani_KZ248694.1_i000_009321	46	376	330	1	0.666667
GCA_916720795.1-Ani_CAKASE010000083.1_i000_016053	46	376	330	1	0.666667
GCA_001683725.1-Fun_LUGH01000071.1_i000_010020	54	384	330	1	0.672098
GCA_003789085.1-Ani_QCYY01001067.1_i000_000453	54	384	330	1	0.653465
GCA_000143455.1-Pla_GL378361.1_i000_008577	61	381	320	0.969697	0.651731
GCA_004000155.1-Fun_RCSS01000356.1_i000_001513	83	400	317	0.960606	0.7925
GCA_006368765.1-Ani_SKCS01000061.1_i000_008566	61	388	327	0.990909	0.621673
GCA_002287475.2-Fun_CM008253.1_i000_003424	91	420	329	0.99697	0.612663
GCA_001466705.1-Fun_LATX01002123.1_i000_013397	94	420	326	0.987879	0.611632
GCA_016098025.1-Fun_JAAAIU010002580.1_i000_005758	119	329	210	0.636364	0.638298
GCA_002895965.2-Ani_PIJE02013249.1_i000_033714	54	372	318	0.963636	0.828125
GCA_905329745.1-Ani_CAJNSZ010000184.1_i000_021147	47	366	319	0.966667	0.630435
GCA_905330535.1-Ani_CAJNVN010000129.1_i000_018650	47	366	319	0.966667	0.630435
GCA_905330805.1-Ani_CAJNWK010000405.1_i000_023635	47	366	319	0.966667	0.630435
GCA_905332165.1-Ani_CAJOBK010000799.1_i000_008741	47	366	319	0.966667	0.630435
GCA_905332175.1-Ani_CAJOBL010006457.1_i000_023786	47	366	319	0.966667	0.630435
GCA_905332225.1-Ani_CAJOBN010003184.1_i000_014175	47	366	319	0.966667	0.630435
GCA_000733195.1-Pla_KL978098.1_i000_020102	145	355	210	0.636364	0.434783
GCA_015502565.1-Fun_JAAAUS010000054.1_i000_007006	81	417	336	1.01818	0.625698
GCA_020736565.1-Fun_JAHBOF010000004.1_i000_016971	103	427	324	0.981818	0.596685
GCA_016098155.1-Fun_JAAAJB010000435.1_i000_005962	81	417	336	1.01818	0.625698
GCA_018282005.1-Fun_JABCKV010000096.1_i000_005017	103	432	329	0.99697	0.640078
GCA_015680655.1-Fun_JAABKD010000001.1_i000_000070	84	416	332	1.00606	0.626415
GCA_016758895.1-Fun_JAEPRA010000010.1_i000_009112	59	384	325	0.984848	0.656566
GCA_905216605.1-Pla_LR999458.1_i000_020840	36	363	327	0.990909	0.700214
GCA_005298045.1-Fun_SWBT01000221.1_i000_011074	106	434	328	0.993939	0.596364
GCA_016834605.1-Pla_JAEHOC010000001.1_i000_000832	49	378	329	0.99697	0.67418
GCA_015679485.1-Fun_JAAAUY010001141.1_i000_000812	1	197	196	0.593939	0.816667
GCA_021223895.1-Ani_JAJJHX010004525.1_i000_004603	66	407	341	1.03333	0.652008
GCA_015679415.1-Fun_JAAAUT010000013.1_i000_001439	83	415	332	1.00606	0.627599
GCA_014461135.1-Fun_JACAZF010000006.1_i000_006790	86	414	328	0.993939	0.617702
GCA_021605075.1-Ani_BPLQ01011019.1_i000_038085	125	457	332	1.00606	0.594982
GCA_016618255.1-Pla_VFSX01000280.1_i000_014340	267	598	331	1.00303	0.464236
GCA_000945115.1-Fun_LK023331.1_i000_006269	59	386	327	0.990909	0.665988
GCA_021029095.1-Fun_JAJOHG010000017.1_i000_003816	94	425	331	1.00303	0.612963
GCA_007990485.1-Pla_CM017617.1_i000_042113	124	211	87	0.263636	0.174
GCA_007990485.1-Pla_CM017617.1_i000_042113	208	392	184	0.557576	0.368
GCA_015849285.1-Fun_JAAAHZ010000247.1_i000_003954	83	415	332	1.00606	0.627599
GCA_021223935.1-Ani_JAJJHV010000096.1_i000_000123	47	385	338	1.02424	0.674651
GCA_015849325.1-Fun_JAAAIB010000073.1_i000_008970	82	415	333	1.00909	0.630682
GCA_015847185.1-Fun_JAAAHX010000141.1_i000_001509	82	415	333	1.00909	0.630682
GCA_019968955.1-Pro_JAHYSE010000227.1_i000_001297	1	253	252	0.763636	0.992126
GCA_007844105.2-Pla_CM017575.2_i000_021667	117	260	143	0.433333	0.266791
GCA_007844105.2-Pla_CM017575.2_i000_021667	257	410	153	0.463636	0.285448
GCA_019632295.1-Fun_WSTZ01000102.1_i000_000261	83	411	328	0.993939	0.604052
GCA_001605315.2-Fun_LUEZ02000049.1_i000_010374	146	471	325	0.984848	0.550847
GCA_001477535.1-Fun_LFWA01000016.1_i000_001384	65	399	334	1.01212	0.660079
GCA_018924745.1-Fun_CM032182.1_i000_002942	97	425	328	0.993939	0.610801
GCA_902702955.1-Ani_CACRXO010000011.1_i000_001739	36	355	319	0.966667	0.613462
GCA_016920775.1-Ani_JAFDOW010001343.1_i000_004394	42	380	338	1.02424	0.685598
GCA_014925785.1-Fun_WIQG01000010.1_i000_001169	43	372	329	0.99697	0.667343
GCA_016771965.1-Pla_CM028693.1_i000_033165	4	226	222	0.672727	0.765517
GCA_019788775.1-Fun_JAIFTL010000102.1_i000_000269	82	415	333	1.00909	0.630682
GCA_013841245.2-Ani_CM034062.1_i000_001201	127	346	219	0.663636	0.480263
GCA_013841245.2-Ani_CM034062.1_i000_001201	351	423	72	0.218182	0.157895
GCA_015179125.1-Fun_WHVA01000085.1_i000_019279	87	415	328	0.993939	0.614232
GCA_000383075.1-Fun_KB908973.1_i000_001989	100	424	324	0.981818	0.601113
GCA_008636005.1-Pla_BKCP01006737.1_i000_019301	246	561	315	0.954545	0.485362
GCA_002895965.2-Ani_PIJE02000500.1_i000_013799	3	294	291	0.881818	0.718519
GCA_013235015.1-Ani_BGPR01007109.1_i000_109662	193	521	328	0.993939	0.606285
GCA_910592005.1-Fun_CAJVPP010007868.1_i000_013400	8	349	341	1.03333	0.751101
GCA_015832375.1-Fun_JADOXO010000069.1_i000_009498	94	421	327	0.990909	0.610075
GCA_003851025.1-Fun_BFAD01000002.1_i000_002247	95	423	328	0.993939	0.610801
GCA_000827485.1-Fun_KN818229.1_i000_003642	79	407	328	0.993939	0.627151
GCA_003076615.3-Ani_NJHN03000117.1_i000_007851	202	497	295	0.893939	0.478896
GCA_004325055.1-Fun_PITH01000022.1_i000_001562	106	433	327	0.990909	0.682672
GCA_014904855.1-Fun_MU117999.1_i000_005109	93	418	325	0.984848	0.607477
GCA_015584075.1-Fun_MU150231.1_i000_001176	92	420	328	0.993939	0.61194
GCA_921882275.1-Ani_OV170222.1_i000_002074	45	368	323	0.978788	0.648594
GCA_016098035.1-Fun_JAAAIV010000094.1_i000_010246	70	411	341	1.03333	0.647059
GCA_000803265.1-Fun_JOKQ01000011.1_i000_001592	105	433	328	0.993939	0.68476
GCA_004324935.1-Fun_PITG01000014.1_i000_001579	105	433	328	0.993939	0.68476
GCA_004355085.1-Fun_ML170156.1_i000_000625	81	407	326	0.987879	0.62572
GCA_007026445.1-Fun_VDMD01000002.1_i000_005804	93	422	329	0.99697	0.607011
GCA_019650235.1-Pla_BNCP01000083.1_i000_012857	61	379	318	0.963636	0.650307
GCA_019650255.1-Pla_BNCQ01000081.1_i000_012830	61	379	318	0.963636	0.650307
GCA_004324945.1-Fun_PITF01000017.1_i000_001573	106	433	327	0.990909	0.682672
GCA_000002595.3-Pla_CM008971.1_i000_010118	51	379	328	0.993939	0.672131
GCA_019633455.1-Fun_WSUA01000099.1_i000_012858	73	401	328	0.993939	0.615385
GCA_002938355.1-Fun_NHTK01006035.1_i000_011019	97	425	328	0.993939	0.610801
GCA_009746105.1-Pla_QEFC01004011.1_i000_022342	102	212	110	0.333333	0.232068
GCA_009746105.1-Pla_QEFC01004011.1_i000_022342	204	377	173	0.524242	0.364979
GCA_013397635.1-Ani_VYZG01003806.1_i000_011113	83	193	110	0.333333	0.257009
GCA_013397635.1-Ani_VYZG01003806.1_i000_011113	190	345	155	0.469697	0.36215
GCA_001632345.1-Fun_KV429040.1_i000_002688	93	437	344	1.04242	0.620939
GCA_014462675.1-Fun_JACAZH010000011.1_i000_013614	94	423	329	0.99697	0.604779
GCA_902702965.1-Ani_CACRXP010000097.1_i000_007053	70	386	316	0.957576	0.276465
GCA_003112345.1-Pla_PKPP01000776.1_i000_010297	36	368	332	1.00606	0.836272
GCA_018991925.1-Ani_JAHLQT010017232.1_i000_008962	48	378	330	1	0.668016
GCA_001638945.1-Fun_AMYB01000008.1_i000_010042	16	346	330	1	0.728477
GCA_015680635.1-Fun_JAABOA010001013.1_i000_004232	26	364	338	1.02424	0.699793
GCA_000346045.2-Ani_KB632204.1_i000_007456	65	350	285	0.863636	0.57
GCA_000355655.1-Ani_KB741014.1_i000_007980	65	350	285	0.863636	0.57
GCA_020466585.1-Ani_JAFETG010000005.1_i000_008820	65	350	285	0.863636	0.57
GCA_020466635.1-Ani_JAFETF010000005.1_i000_009394	65	350	285	0.863636	0.57
GCA_905250095.1-Ani_CAJNOR010003159.1_i000_033228	34	364	330	1	0.663984
GCA_900412535.3-Pla_LS974624.2_i000_036984	922	1130	208	0.630303	0.17479
GCA_022496185.1-Fun_WTXG01000002.1_i000_003582	88	418	330	1	0.635838
GCA_001949185.1-Ani_BDGG01000001.1_i000_000730	40	373	333	1.00909	0.663347
GCA_019202805.1-Pla_CM032912.1_i000_052730	115	468	353	1.0697	0.614983
GCA_905250025.1-Ani_CAJNOJ010000145.1_i000_024896	43	367	324	0.981818	0.645418
GCA_000230595.3-Fun_AFBI03000003.1_i000_001981	84	244	160	0.484848	0.327869
GCA_000230595.3-Fun_AFBI03000003.1_i000_001981	241	487	246	0.745455	0.504098
GCA_002286715.1-Fun_NSJX01000001.1_i000_000387	91	419	328	0.993939	0.613084
GCA_910592285.1-Fun_CAJVQC010041822.1_i000_016740	67	142	75	0.227273	0.154321
GCA_910592285.1-Fun_CAJVQC010041822.1_i000_016740	140	348	208	0.630303	0.427984
GCA_014058105.1-Pla_JACGCM010000067.1_i000_025369	249	474	225	0.681818	0.469729
GCA_000143565.1-Fun_DS547094.1_i000_014896	49	372	323	0.978788	0.664609
GCA_002290385.1-Ani_KZ288344.1_i000_007291	36	386	350	1.06061	0.705645
GCA_010203745.1-Fun_JAAECE010000004.1_i000_007471	64	371	307	0.930303	0.61523
GCA_014461115.1-Fun_JACAZE010000006.1_i000_004968	85	417	332	1.00606	0.614815
GCA_021613535.1-Ani_CP075497.1_i000_030991	42	365	323	0.978788	0.644711
GCA_004369085.1-Fun_ML210150.1_i000_001607	112	436	324	0.981818	0.582734
GCA_015956445.1-Fun_WIUZ02000011.1_i000_002375	94	407	313	0.948485	0.583955
GCA_000828355.1-Ani_JXLN01009656.1_i000_003006	41	372	331	1.00303	0.67551
GCA_014595675.1-Ani_WVUK01000046.1_i000_003137	41	372	331	1.00303	0.67551
GCA_905368565.1-Ani_CAJPIZ010055577.1_i000_022886	1	161	160	0.484848	0.993789
GCA_016758945.1-Fun_JAEPRC010000309.1_i000_006089	62	389	327	0.990909	0.655311
GCA_905250025.1-Ani_CAJNOJ010000145.1_i000_024889	34	372	338	1.02424	0.685598
GCA_905250125.1-Ani_CAJNOL010000068.1_i000_004713	46	367	321	0.972727	0.634387
GCA_905250005.1-Ani_CAJNOH010000067.1_i000_006122	46	367	321	0.972727	0.634387
GCA_905250125.1-Ani_CAJNOL010000074.1_i000_005047	46	367	321	0.972727	0.634387
GCA_905251635.1-Ani_CAJNOT010000032.1_i000_001774	46	367	321	0.972727	0.634387
GCA_905332095.1-Ani_CAJOBD010001189.1_i000_013683	46	367	321	0.972727	0.634387
GCA_905250875.1-Ani_CAJNOO010000074.1_i000_003193	46	367	321	0.972727	0.634387
GCA_905252715.1-Ani_CAJNOU010000015.1_i000_000853	46	367	321	0.972727	0.634387
GCA_905332085.1-Ani_CAJOAX010005829.1_i000_026930	46	367	321	0.972727	0.634387
GCA_905332105.1-Ani_CAJOBE010000865.1_i000_008662	46	367	321	0.972727	0.634387
GCA_000182565.2-Fun_KQ257468.1_i000_008261	49	376	327	0.990909	0.67284
GCA_001929475.1-Fun_LXFE01000603.1_i000_000850	56	394	338	1.02424	0.666667
GCA_021821965.1-Fun_JACCJH010000018.1_i000_001572	98	436	338	1.02424	0.708595
GCA_006247105.1-Pro_CM016926.1_i000_002321	112	455	343	1.03939	0.713098
GCA_910591915.1-Fun_CAJVQA010017087.1_i000_014440	57	322	265	0.80303	0.512573
GCA_910591915.1-Fun_CAJVQA010017087.1_i000_014440	335	418	83	0.251515	0.160542
GCA_013368445.1-Fun_JAACJO010000001.1_i000_000540	95	420	325	0.984848	0.604089
GCA_000739165.1-Fun_KN042423.1_i000_008294	68	410	342	1.03636	0.651429
GCA_015679645.1-Fun_JAAAVC010001455.1_i000_002360	68	410	342	1.03636	0.651429
GCA_019096205.1-Ani_CM032504.1_i000_006088	50	382	332	1.00606	0.665331
GCA_000950595.1-Fun_DF836314.1_i000_009313	67	395	328	0.993939	0.652087
GCA_905116875.3-Ani_CAJHNJ030000004.1_i000_001698	50	382	332	1.00606	0.665331
GCA_003073295.1-Fun_KZ803304.1_i000_005181	88	418	330	1	0.623819
GCA_015501605.1-Fun_JADNRZ010000001.1_i000_000765	95	424	329	0.99697	0.614953
GCA_001298355.1-Ani_KQ461175.1_i000_013511	47	385	338	1.02424	0.65
GCA_905261645.1-Ani_CAJNOV010009087.1_i000_019335	5	358	353	1.0697	0.697628
GCA_905273325.1-Ani_CAJNOW010000082.1_i000_001280	5	358	353	1.0697	0.697628
GCA_905319835.1-Ani_CAJNRE010000077.1_i000_001214	5	358	353	1.0697	0.697628
GCA_905321285.1-Ani_CAJNRF010000075.1_i000_001387	5	358	353	1.0697	0.697628
GCA_905321535.1-Ani_CAJNRG010013426.1_i000_028102	5	358	353	1.0697	0.697628
GCA_905332115.1-Ani_CAJOBH010000395.1_i000_002310	5	358	353	1.0697	0.697628
GCA_905332125.1-Ani_CAJOBJ010000245.1_i000_001477	5	358	353	1.0697	0.697628
GCA_905332135.1-Ani_CAJOBI010000527.1_i000_002767	5	358	353	1.0697	0.697628
GCA_905332145.1-Ani_CAJOBF010001246.1_i000_012125	5	358	353	1.0697	0.697628
GCA_905332155.1-Ani_CAJOBG010000971.1_i000_008357	5	358	353	1.0697	0.697628
GCA_000344685.1-Fun_KB469297.1_i000_002123	55	378	323	0.978788	0.649899
GCA_014188975.1-Fun_JACGCI010000007.1_i000_022068	108	435	327	0.990909	0.59132
GCA_013368325.1-Fun_JAACJK010000109.1_i000_011102	108	435	327	0.990909	0.59132
GCA_011763605.1-Fun_JAANIO010000147.1_i000_000797	19	365	346	1.04848	0.729958
GCA_014905635.1-Pla_JABVCE010000015.1_i000_002226	333	642	309	0.936364	0.123108
GCA_000938895.1-Fun_LN734054.1_i000_012747	69	393	324	0.981818	0.645418
GCA_002926015.1-Pla_KZ650123.1_i000_034002	119	328	209	0.633333	0.637195
GCA_015500155.1-Fun_JAAAUE010003163.1_i000_004980	351	684	333	1.00909	0.41625
GCA_905331015.1-Ani_CAJNXB010003641.1_i000_021018	6	362	356	1.07879	0.703557
GCA_905331295.1-Ani_CAJNYD010001075.1_i000_009402	6	362	356	1.07879	0.703557
GCA_905331475.1-Ani_CAJNYU010001540.1_i000_012996	6	362	356	1.07879	0.703557
GCA_905331485.1-Ani_CAJNYT010004795.1_i000_027697	6	362	356	1.07879	0.703557
GCA_905331495.1-Ani_CAJNYV010003694.1_i000_020669	6	362	356	1.07879	0.703557
GCA_905332235.1-Ani_CAJOBO010001521.1_i000_019091	6	362	356	1.07879	0.703557
GCA_905332245.1-Ani_CAJOBP010000868.1_i000_008249	6	362	356	1.07879	0.703557
GCA_905332265.1-Ani_CAJOBQ010001591.1_i000_021014	6	362	356	1.07879	0.703557
GCA_905332275.1-Ani_CAJOBR010000584.1_i000_006520	6	362	356	1.07879	0.703557
GCA_905332285.1-Ani_CAJOBS010001599.1_i000_019977	6	362	356	1.07879	0.703557
GCA_002600585.1-Pro_MIGC01005091.1_i000_008793	142	396	254	0.769697	0.641414
GCA_015679595.1-Fun_JAAAVB010000396.1_i000_007304	58	411	353	1.0697	0.671103
GCA_000430065.1-Fun_ATCN01001017.1_i000_002017	104	434	330	1	0.56314
GCA_015584085.1-Fun_MU151076.1_i000_003132	106	431	325	0.984848	0.595238
GCA_001630475.1-Fun_KV419405.1_i000_005244	89	403	314	0.951515	0.562724
GCA_001632355.1-Fun_KV428239.1_i000_011175	89	403	314	0.951515	0.562724
GCA_015342405.1-Fun_JACYCF010000009.1_i000_011311	128	319	191	0.578788	0.358349
GCA_015342405.1-Fun_JACYCF010000009.1_i000_011311	316	430	114	0.345455	0.213884
GCA_003325415.1-Fun_PJQM01004203.1_i000_010008	3	305	302	0.915152	0.729469
GCA_905332375.1-Ani_CAJOBZ010000003.1_i000_002061	46	371	325	0.984848	0.653924
GCA_007859695.1-Pla_CP031034.1_i000_000075	47	368	321	0.972727	0.663223
GCA_000005195.1-Ani_CH479191.1_i000_006724	48	385	337	1.02121	0.672655
GCA_019202795.1-Pla_CM032925.1_i000_052433	36	368	332	1.00606	0.704883
GCA_022160305.1-Fun_MU277187.1_i000_000431	89	417	328	0.993939	0.617702
GCA_014925795.1-Fun_WIQF01000003.1_i000_008738	47	375	328	0.993939	0.665314
GCA_015832365.1-Ani_JACWZX010000789.1_i000_017154	128	302	174	0.527273	0.400922
GCA_015832365.1-Ani_JACWZX010000789.1_i000_017154	306	430	124	0.375758	0.285714
GCA_014905825.1-Fun_JACGCN010000002.1_i000_005926	97	424	327	0.990909	0.606679
GCA_019364655.1-Ani_JAGXCG010013462.1_i000_037857	1	207	206	0.624242	0.834008
GCA_015501595.1-Fun_JADNRX010000919.1_i000_026763	82	409	327	0.990909	0.632495
GCA_015179015.1-Fun_WHUW01000002.1_i000_006475	64	392	328	0.993939	0.643137
GCA_016097525.1-Fun_JADAKD010000014.1_i000_006793	1	242	241	0.730303	0.65847
GCA_000827315.1-Fun_KN832972.1_i000_001555	45	368	323	0.978788	0.664609
GCA_000004255.1-Pla_GL348720.1_i000_029155	29	361	332	1.00606	0.72967
GCA_000827185.1-Fun_KN839835.1_i000_000585	97	425	328	0.993939	0.604052
GCA_019924195.1-Fun_JAHFXF010000062.1_i000_015771	1	248	247	0.748485	0.764706
GCA_009746105.1-Pla_CM019267.1_i000_007620	51	362	311	0.942424	0.845109
GCA_000218685.1-Fun_GL945431.1_i000_003591	101	426	325	0.984848	0.597426
GCA_000218725.1-Fun_GL945477.1_i000_003479	101	426	325	0.984848	0.597426
GCA_000611835.1-Ani_KK107519.1_i000_013508	35	377	342	1.03636	0.699387
GCA_003672135.1-Ani_CM010864.1_i000_009032	35	377	342	1.03636	0.699387
GCA_001632445.1-Fun_KV424669.1_i000_013928	42	372	330	1	0.680412
GCA_000785585.1-Fun_JSEJ01000042.1_i000_006822	127	455	328	0.993939	0.713043
GCA_004369125.1-Fun_ML178835.1_i000_008744	104	409	305	0.924242	0.556569
GCA_004802705.1-Fun_SGPL01000028.1_i000_004227	71	397	326	0.987879	0.62572
GCA_002966975.2-Pla_PJQY01002919.1_i000_032049	46	369	323	0.978788	0.677149
GCA_015501055.1-Fun_JADNYV010000017.1_i000_005120	82	409	327	0.990909	0.632495
GCA_018127125.1-Pla_CM030800.1_i000_035064	40	373	333	1.00909	0.34224
GCA_001286725.1-Fun_CYGV01001733.1_i000_010022	85	416	331	1.00303	0.615242
GCA_022160275.1-Fun_MU275842.1_i000_001257	90	419	329	0.99697	0.617261
GCA_011763645.1-Fun_JAASGZ010006418.1_i000_018526	51	381	330	1	0.774648
GCA_000190615.1-Fun_GL870876.1_i000_000092	87	403	316	0.957576	0.782178
GCA_000250985.1-Fun_JH605024.1_i000_001139	87	403	316	0.957576	0.782178
GCA_001642415.1-Fun_LTDK01000147.1_i000_001851	88	403	315	0.954545	0.779703
GCA_014461125.1-Fun_JACAZG010000001.1_i000_000724	86	414	328	0.993939	0.609665
GCA_905250025.1-Ani_CAJNOJ010000185.1_i000_028308	44	371	327	0.990909	0.64881
GCA_905250095.1-Ani_CAJNOR010000288.1_i000_006364	43	367	324	0.981818	0.642857
GCA_000695385.1-Fun_KK764652.1_i000_001550	90	421	331	1.00303	0.609576
GCA_905219625.1-Fun_CAJMWX010001036.1_i000_003639	87	416	329	0.99697	0.611524
GCA_016808335.1-Pla_CM029039.1_i000_009636	13	219	206	0.624242	0.656051
GCA_000264905.1-Fun_JH687383.1_i000_004750	102	429	327	0.990909	0.60221
GCA_011114355.1-Pla_CM022090.1_i000_010183	44	373	329	0.99697	0.681159
GCA_017499595.2-Fun_CM039001.1_i000_004891	99	426	327	0.990909	0.604436
GCA_015039465.1-Fun_MU130533.1_i000_013740	91	418	327	0.990909	0.608939
GCA_000182405.1-Pro_ACGJ01002928.1_i000_000155	122	458	336	1.01818	0.669323
GCA_000498735.1-Pro_AHHH01000005.1_i000_000422	122	458	336	1.01818	0.669323
GCA_019202805.1-Pla_CM032900.1_i000_004650	45	376	331	1.00303	0.682474
GCA_001651475.1-Pla_CM004359.1_i000_004838	45	376	331	1.00303	0.682474
GCA_019202795.1-Pla_CM032913.1_i000_004772	45	376	331	1.00303	0.682474
GCA_902651935.1-Pla_CACRSJ010000104.1_i000_004993	45	376	331	1.00303	0.682474
GCA_902705455.1-Pla_CACSHJ010000087.1_i000_004874	45	376	331	1.00303	0.682474
GCA_904420315.1-Pla_LR881466.1_i000_004046	45	376	331	1.00303	0.682474
GCA_010799875.2-Ani_VXIV02001534.1_i000_014934	45	381	336	1.01818	0.678788
GCA_013400195.1-Ani_VXBL01005102.1_i000_007068	5	216	211	0.639394	0.50358
GCA_013400195.1-Ani_VXBL01005102.1_i000_007068	260	331	71	0.215152	0.169451
GCA_015484515.1-Fun_MU154537.1_i000_004120	94	417	323	0.978788	0.602612
GCA_905219635.1-Fun_CAJMWY010000060.1_i000_000269	87	416	329	0.99697	0.573171
GCA_012979565.1-Fun_SJDA01000003.1_i000_006060	94	417	323	0.978788	0.602612
GCA_012980525.1-Fun_SJKE01000003.1_i000_005382	94	417	323	0.978788	0.602612
GCA_002105135.1-Fun_MCGN01000008.1_i000_009943	59	385	326	0.987879	0.663951
GCA_002966975.2-Pla_PJQY01000153.1_i000_004607	134	289	155	0.469697	0.303327
GCA_002966975.2-Pla_PJQY01000153.1_i000_004607	288	417	129	0.390909	0.252446
GCA_002938375.1-Fun_NHYD01003440.1_i000_015050	108	435	327	0.990909	0.594545
GCA_006535965.1-Fun_QEAR01000027.1_i000_004001	48	376	328	0.993939	0.674897
GCA_001630335.1-Fun_KV417525.1_i000_010043	94	422	328	0.993939	0.607407
GCA_022264855.1-Fun_JABYQU010000035.1_i000_006943	43	373	330	1	0.673469
GCA_000401635.1-Fun_KE123897.1_i000_000244	60	389	329	0.99697	0.660643
GCA_016097525.1-Fun_JADAKD010000001.1_i000_000668	1	209	208	0.630303	0.8125
GCA_001543975.1-Pro_JXTI01000005.1_i000_000311	122	458	336	1.01818	0.669323
GCA_017911155.1-Fun_JAEFCI010009751.1_i000_006179	241	535	294	0.890909	0.498305
GCA_000697645.1-Fun_KL142368.1_i000_001749	107	432	325	0.984848	0.591985
GCA_000151265.1-Pla_GG663738.1_i000_006911	48	383	335	1.01515	0.674044
GCA_000767015.2-Ani_ASGP02000003.1_i000_008680	42	375	333	1.00909	0.672727
GCA_020809275.1-Ani_SDOV01000007.1_i000_002701	42	375	333	1.00909	0.672727
GCA_019616945.1-Fun_WSTK01000054.1_i000_009146	139	468	329	0.99697	0.555743
GCA_014462655.1-Fun_JACAZI010000009.1_i000_011829	98	423	325	0.984848	0.6238
GCA_000350255.1-Fun_CAOJ01001134.1_i000_000859	82	412	330	1	0.616822
GCA_000832345.2-Fun_LN679102.1_i000_004453	82	412	330	1	0.616822
GCA_905219545.1-Fun_CAJMWQ010000981.1_i000_004212	82	412	330	1	0.616822
GCA_020746845.1-Fun_JAGPNJ010000001.1_i000_000637	86	416	330	1	0.613383
GCA_004679265.1-Fun_SEKV01000009.1_i000_010618	93	426	333	1.00909	0.62949
GCA_014925845.1-Fun_JACGCL010000002.1_i000_005877	99	425	326	0.987879	0.603704
GCA_021605075.1-Ani_BPLQ01002810.1_i000_009614	1	236	235	0.712121	0.951417
GCA_000150825.1-Fun_DS985216.1_i000_007554	186	442	256	0.775758	0.52459
GCA_002158475.1-Pla_KZ155771.1_i000_000273	57	394	337	1.02121	0.667327
GCA_000214015.2-Pla_CAID01000004.2_i000_001952	57	394	337	1.02121	0.667327
GCA_905219585.1-Fun_CAJMWS010000310.1_i000_003369	85	415	330	1	0.613383
GCA_015342415.1-Fun_JACYCE010000056.1_i000_000484	85	416	331	1.00303	0.615242
GCA_015342435.1-Fun_JACYCD010000049.1_i000_000483	85	416	331	1.00303	0.615242
GCA_016906535.1-Fun_CP059661.1_i000_003835	85	416	331	1.00303	0.615242
GCA_003942215.1-Fun_RSCD01000016.1_i000_002937	141	364	223	0.675758	0.39539
GCA_003942215.1-Fun_RSCD01000016.1_i000_002937	374	451	77	0.233333	0.136525
GCA_015341985.1-Fun_JACYCC010000037.1_i000_000526	85	416	331	1.00303	0.615242
GCA_905219565.1-Fun_CAJMWR010004313.1_i000_008317	85	416	331	1.00303	0.615242
GCA_015529505.1-Fun_JAAAUI010000015.1_i000_001567	86	419	333	1.00909	0.621269
GCA_015529515.1-Fun_JAAAUJ010000097.1_i000_009663	86	419	333	1.00909	0.621269
GCA_015342405.1-Fun_JACYCF010000001.1_i000_000643	47	375	328	0.993939	0.65996
GCA_004126415.1-Fun_SDEE01000001.1_i000_000099	100	425	325	0.984848	0.600739
GCA_000497125.2-Pro_AUWU02000036.1_i000_008656	97	432	335	1.01515	0.686475
GCA_000497125.2-Pro_CM035319.1_i000_003383	97	432	335	1.01515	0.686475
GCA_905219575.1-Fun_CAJMWT010001717.1_i000_002708	85	416	331	1.00303	0.615242
GCA_905397405.1-Ani_CAJPVJ010012461.1_i000_013598	61	343	282	0.854545	0.822157
GCA_004369175.1-Fun_QPFP01000007.1_i000_020013	42	365	323	0.978788	0.670124
GCA_000827395.1-Fun_KN825062.1_i000_005934	97	427	330	1	0.605505
GCA_006783055.1-Ani_VCRD01003710.1_i000_016659	54	387	333	1.00909	0.660714
GCA_019616325.1-Fun_WSTG01001775.1_i000_009581	80	409	329	0.99697	0.617261
GCA_000832265.1-Fun_KN840469.1_i000_003738	93	420	327	0.990909	0.614662
GCA_009905375.1-Pla_WRXP01001143.1_i000_000533	3	331	328	0.993939	0.752294
GCA_018127125.1-Pla_CM030799.1_i000_034267	35	365	330	1	0.887097
GCA_905332275.1-Ani_CAJOBR010005265.1_i000_024542	1	204	203	0.615152	0.922727
GCA_900536885.1-Fun_UWZB01000024.1_i000_001967	84	413	329	0.99697	0.624288
GCA_905232135.1-Fun_CAJNJQ010003406.1_i000_007236	85	416	331	1.00303	0.615242
GCA_004794745.1-Ani_QBLH01002416.1_i000_010026	6	308	302	0.915152	0.669623
GCA_000385875.2-Fun_KK365226.1_i000_002721	84	401	317	0.960606	0.790524
GCA_014898675.1-Fun_JACXVL010000027.1_i000_009177	100	427	327	0.990909	0.6
GCA_000934385.1-Fun_KN880439.1_i000_001517	86	411	325	0.984848	0.6238
GCA_015679605.1-Fun_JAAAVE010000431.1_i000_007071	70	405	335	1.01515	0.646718
GCA_018858115.1-Fun_JABCKT010000015.1_i000_001052	122	350	228	0.690909	0.465306
GCA_018858115.1-Fun_JABCKT010000015.1_i000_001052	350	413	63	0.190909	0.128571
GCA_019974015.1-Ani_BMAW01009945.1_i000_005530	128	447	319	0.966667	0.710468
GCA_016835505.1-Ani_CM029061.1_i000_006834	183	399	216	0.654545	0.366723
GCA_016835505.1-Ani_CM029061.1_i000_006834	414	467	53	0.160606	0.089983
GCA_001078535.1-Pro_CAIX01000086.1_i000_005828	63	395	332	1.00606	0.662675
GCA_019616915.1-Fun_WSTI01011645.1_i000_012018	84	415	331	1.00303	0.616387
GCA_001691835.3-Fun_JNHZ02000001.1_i000_000221	92	417	325	0.984848	0.608614
GCA_016628075.1-Fun_JABBWC010000003.1_i000_008445	96	423	327	0.990909	0.604436
GCA_021018615.1-Fun_JAEVFL010000004.1_i000_005234	99	423	324	0.981818	0.570423
GCA_000498715.1-Pro_AHGT01000013.1_i000_001416	124	461	337	1.02121	0.676707
GCA_000092065.1-Pla_CP000584.1_i000_001890	3	310	307	0.930303	0.78117
GCA_019677325.2-Fun_CM033830.1_i000_008886	94	417	323	0.978788	0.580935
GCA_905219615.1-Fun_CAJMWW010000280.1_i000_006079	85	416	331	1.00303	0.615242
GCA_000695815.1-Ani_KK846943.1_i000_011486	7	216	209	0.633333	0.5199
GCA_000695815.1-Ani_KK846943.1_i000_011486	252	321	69	0.209091	0.171642
GCA_000271605.1-Fun_JH717974.1_i000_007108	33	359	326	0.987879	0.677755
GCA_014898675.1-Fun_JACXVL010000053.1_i000_016298	100	427	327	0.990909	0.6
GCA_018855915.1-Fun_JABCKO010015849.1_i000_006388	116	445	329	0.99697	0.5875
GCA_016097715.1-Fun_JAAZWU010000146.1_i000_002016	56	384	328	0.993939	0.676289
GCA_016097735.1-Fun_JAAZWV010000189.1_i000_002334	56	384	328	0.993939	0.676289
GCA_016097755.1-Fun_JAAZWW010000207.1_i000_003120	56	384	328	0.993939	0.676289
GCA_905332135.1-Ani_CAJOBI010030581.1_i000_024819	1	204	203	0.615152	0.890351
GCA_015500155.1-Fun_JAAAUE010003121.1_i000_004878	1	190	189	0.572727	0.811159
GCA_015679645.1-Fun_JAAAVC010000074.1_i000_010389	1	190	189	0.572727	0.811159
GCA_006386115.1-Pro_VFIW01000004.1_i000_010835	85	420	335	1.01515	0.635674
GCA_015529785.1-Fun_JAAAUK010002242.1_i000_004353	1	188	187	0.566667	0.809524
GCA_014904835.1-Fun_MU120898.1_i000_000608	97	426	329	0.99697	0.604779
GCA_001020605.1-Fun_KQ086034.1_i000_010627	87	412	325	0.984848	0.614367
GCA_900618505.1-Ani_UZAH01029990.1_i000_017341	126	350	224	0.678788	0.479657
GCA_900618505.1-Ani_UZAH01029990.1_i000_017341	348	425	77	0.233333	0.164882
GCA_014904945.1-Fun_MU127426.1_i000_005188	99	427	328	0.993939	0.601835
GCA_000002435.2-Pro_CM018789.1_i000_000326	120	459	339	1.02727	0.680723
GCA_013399305.1-Ani_VXAI01000727.1_i000_012461	54	270	216	0.654545	0.460554
GCA_013399305.1-Ani_VXAI01000727.1_i000_012461	307	374	67	0.20303	0.142857
GCA_004369135.1-Fun_ML179035.1_i000_000628	93	420	327	0.990909	0.613508
GCA_015501065.1-Fun_JADNYI010000002.1_i000_006566	101	423	322	0.975758	0.596296
GCA_016098165.1-Fun_JAAAJA010000819.1_i000_009206	88	419	331	1.00303	0.617537
GCA_905219655.1-Fun_CAJMXA010002472.1_i000_004602	85	415	330	1	0.614525
GCA_003144195.1-Fun_KZ819375.1_i000_003563	90	420	330	1	0.576923
GCA_004332605.1-Fun_RWJN01000120.1_i000_000897	455	778	323	0.978788	0.359288
GCA_015039315.1-Fun_WIDE01000151.1_i000_003292	89	419	330	1	0.597826
GCA_016758765.1-Fun_JABBWL010000001.1_i000_000128	71	382	311	0.942424	0.660297
GCA_021015755.1-Fun_JABWDW010000001.1_i000_000411	92	418	326	0.987879	0.611632
GCA_001566745.1-Fun_KQ964437.1_i000_001693	55	392	337	1.02121	0.676707
GCA_022496195.1-Fun_WTXC01000062.1_i000_010324	91	419	328	0.993939	0.616541
GCA_021029105.1-Fun_JAEVFJ010000003.1_i000_005918	133	458	325	0.984848	0.565217
GCA_021442195.1-Pla_CM038197.1_i000_006630	123	195	72	0.218182	0.140351
GCA_021442195.1-Pla_CM038197.1_i000_006630	188	345	157	0.475758	0.306043
GCA_000182665.1-Pro_ACVC01000031.1_i000_004645	136	471	335	1.01515	0.663366
GCA_018127125.1-Pla_CM030789.1_i000_004478	15	323	308	0.933333	0.933333
GCA_013053245.1-Fun_JAACJL010000016.1_i000_006619	105	431	326	0.987879	0.59707
GCA_015484485.1-Fun_MU156557.1_i000_009184	105	431	326	0.987879	0.59707
GCA_009835185.1-Pro_VJMH01005730.1_i000_015673	53	385	332	1.00606	0.677551
GCA_900708865.1-Pro_CAADRA010005751.1_i000_012619	53	385	332	1.00606	0.677551
GCA_900079185.1-Fun_LT554468.1_i000_007182	83	414	331	1.00303	0.637765
GCA_000182985.1-Fun_ACOL01000182.1_i000_000747	98	400	302	0.915152	0.753117
GCA_000988165.1-Fun_JPQZ01000118.1_i000_000325	98	400	302	0.915152	0.753117
GCA_004919615.1-Fun_SMUP01000076.1_i000_001359	98	400	302	0.915152	0.753117
GCA_905219645.1-Fun_CAJMWZ010003131.1_i000_003772	85	419	334	1.01212	0.617375
GCA_902713445.1-Pla_CACTIH010009500.1_i000_054373	1	181	180	0.545455	0.994475
GCA_019924465.1-Fun_JAHFXQ010007493.1_i000_020853	1	239	238	0.721212	0.741433
GCA_019924535.1-Fun_JAHFXS010000667.1_i000_006454	1	239	238	0.721212	0.741433
GCA_000147195.1-Ani_GL450376.1_i000_009063	1	182	181	0.548485	0.989071
GCA_900000165.1-Fun_CCYA01000269.1_i000_005190	92	420	328	0.993939	0.573427
GCA_003713155.1-Pla_CP031000.1_i000_056578	46	357	311	0.942424	0.501613
GCA_019677335.1-Fun_WSLM01000406.1_i000_004074	120	449	329	0.99697	0.574171
GCA_015499995.1-Fun_JADNRV010000001.1_i000_000259	3	313	310	0.939394	0.734597
GCA_001447595.1-Ani_JYDH01000010.1_i000_001838	332	662	330	1	0.414573
GCA_003097735.1-Ani_NHOQ01000204.1_i000_001644	157	228	71	0.215152	0.137331
GCA_003097735.1-Ani_NHOQ01000204.1_i000_001644	244	428	184	0.557576	0.355899
GCA_015039395.1-Fun_MU132141.1_i000_001582	25	357	332	1.00606	0.693111
GCA_019924535.1-Fun_JAHFXS010000682.1_i000_006535	1	239	238	0.721212	0.741433
GCA_019112545.1-Fun_MU250535.1_i000_007123	91	419	328	0.993939	0.617702
GCA_000524645.1-Fun_JATN01000308.1_i000_001096	45	376	331	1.00303	0.664659
GCA_021014945.1-Fun_MU266327.1_i000_000243	97	423	326	0.987879	0.601476
GCA_001658105.1-Fun_KV448147.1_i000_002031	92	419	327	0.990909	0.608939
GCA_002148645.1-Ani_LVZM01008355.1_i000_004304	35	367	332	1.00606	0.664
GCA_000827465.1-Fun_KN822989.1_i000_005946	85	414	329	0.99697	0.613806
GCA_015832245.1-Fun_SBJO01000006.1_i000_000188	100	401	301	0.912121	0.748756
GCA_014773135.1-Ani_JABEBT010000050.1_i000_007117	43	380	337	1.02121	0.650579
GCA_000715385.1-Fun_AZST01000042.1_i000_001864	85	415	330	1	0.613383
GCA_905219595.1-Fun_CAJMWU010006726.1_i000_008838	85	415	330	1	0.613383
GCA_905219605.1-Fun_CAJMWV010003117.1_i000_004962	85	415	330	1	0.613383
GCA_004679275.1-Fun_SEOQ01000132.1_i000_001700	79	402	323	0.978788	0.625969
GCA_000757645.3-Ani_AZBU02000002.1_i000_006670	46	380	334	1.01212	0.661386
GCA_000827475.1-Fun_KN819325.1_i000_001859	98	427	329	0.99697	0.60367
GCA_001447655.1-Ani_JYDQ01000030.1_i000_002879	138	469	331	1.00303	0.548922
GCA_019633465.1-Fun_WSTY01007969.1_i000_013532	86	415	329	0.99697	0.721491
GCA_019924465.1-Fun_JAHFXQ010000445.1_i000_004940	1	244	243	0.736364	0.759375
GCA_016584305.1-Ani_JACEEZ010017225.1_i000_012391	48	371	323	0.978788	0.65121
GCA_019616345.1-Fun_WSTH01003175.1_i000_013758	84	414	330	1	0.723684
GCA_001447435.1-Ani_JYDK01000036.1_i000_003296	339	669	330	1	0.410959
GCA_019364595.1-Fun_JAHRGV010000022.1_i000_002922	97	424	327	0.990909	0.60221
GCA_019616345.1-Fun_WSTH01002672.1_i000_012628	84	414	330	1	0.723684
GCA_011800875.2-Fun_JRHT02000038.1_i000_013198	97	424	327	0.990909	0.604436
GCA_002105175.1-Fun_MCGE01000004.1_i000_009901	57	407	350	1.06061	0.686275
GCA_013400335.1-Ani_VZZY01006200.1_i000_003285	54	278	224	0.678788	0.474576
GCA_013400335.1-Ani_VZZY01006200.1_i000_003285	317	385	68	0.206061	0.144068
GCA_000827495.1-Fun_KN817518.1_i000_000605	105	429	324	0.981818	0.591241
GCA_002938385.1-Fun_NHYE01005657.1_i000_015634	103	435	332	1.00606	0.605839
GCA_019623705.1-Fun_WSTJ01001913.1_i000_012427	85	414	329	0.99697	0.670061
GCA_014904895.1-Fun_MU125221.1_i000_018411	95	421	326	0.987879	0.604824
GCA_903994135.1-Ani_CAJEWN010000013.1_i000_003814	42	380	338	1.02424	0.82439
GCA_900157425.1-Fun_FUEG01000003.1_i000_014278	88	415	327	0.990909	0.620493
GCA_000313135.1-Pro_KB007805.1_i000_000698	53	379	326	0.987879	0.665306
GCA_019616325.1-Fun_WSTG01003053.1_i000_012525	82	411	329	0.99697	0.614953
GCA_021527775.1-Fun_JAKEYF010000028.1_i000_008682	99	417	318	0.963636	0.6
GCA_021527035.1-Fun_JAKELG010000016.1_i000_002634	91	414	323	0.978788	0.610586
GCA_000827355.1-Fun_KN831771.1_i000_003583	95	422	327	0.990909	0.608939
GCA_009078325.1-Fun_SSOP01000067.1_i000_007862	86	414	328	0.993939	0.609665
GCA_000002975.1-Pro_AF083031.2_i000_000447	115	416	301	0.912121	0.720096
GCA_015178925.1-Fun_WHVC01000002.1_i000_004324	90	418	328	0.993939	0.638132
GCA_002003045.1-Fun_BDGU01000627.1_i000_009721	92	416	324	0.981818	0.285714
GCA_001447745.1-Ani_JYDM01000001.1_i000_004990	314	644	330	1	0.424165
GCA_001447455.1-Ani_JYDL01000003.1_i000_008152	332	662	330	1	0.414573
GCA_019787685.1-Fun_JAHNUO010000002.1_i000_001295	96	424	328	0.993939	0.607407
GCA_003573695.1-Pla_CM010718.1_i000_015946	128	343	215	0.651515	0.625
GCA_001447565.1-Ani_JYDW01000001.1_i000_004291	347	677	330	1	0.406905
GCA_000827265.1-Fun_KN834749.1_i000_000092	41	370	329	0.99697	0.679752
GCA_006348945.1-Ani_SRLO01000285.1_i000_026908	50	265	215	0.651515	0.595568
GCA_001447425.1-Ani_JYDJ01000015.1_i000_001203	334	664	330	1	0.413534
GCA_001447585.1-Ani_JYDI01000001.1_i000_000055	344	674	330	1	0.408416
GCA_001447725.1-Ani_JYDS01000012.1_i000_001254	321	653	332	1.00606	0.422392
GCA_001447575.1-Ani_JYDT01000001.1_i000_000099	322	653	331	1.00303	0.42112
GCA_001447665.1-Ani_JYDP01000012.1_i000_001919	355	698	343	1.03939	0.412756
GCA_000697685.1-Fun_KL198007.1_i000_004975	46	368	322	0.975758	0.661191
GCA_021527785.1-Pro_JAJATU010003778.1_i000_009148	49	383	334	1.01212	0.681633
GCA_021524915.1-Fun_JAKELL010000041.1_i000_008241	93	415	322	0.975758	0.607547
GCA_001447675.1-Ani_JYDR01000002.1_i000_000477	333	664	331	1.00303	0.415307
GCA_020142125.1-Ani_CM034701.1_i000_001484	126	274	148	0.448485	0.272059
GCA_020142125.1-Ani_CM034701.1_i000_001484	302	444	142	0.430303	0.261029
GCA_000827255.1-Fun_KN835136.1_i000_000967	97	424	327	0.990909	0.604436
GCA_000520115.1-Pro_KI913962.1_i000_006366	58	389	331	1.00303	0.668687
GCA_003546525.1-Pro_QUSY01000077.1_i000_001852	58	389	331	1.00303	0.668687
GCA_022496205.1-Fun_WTXD01000019.1_i000_003658	97	424	327	0.990909	0.608939
GCA_900617995.1-Ani_UZAL01028575.1_i000_007694	60	342	282	0.854545	0.822157
GCA_001447645.1-Ani_JYDV01000002.1_i000_000343	353	685	332	1.00606	0.405868
GCA_021527665.1-Pro_JAJNMJ010005134.1_i000_012647	48	383	335	1.01515	0.683673
GCA_021527805.1-Pro_JAJNMK010000827.1_i000_008891	48	383	335	1.01515	0.683673
GCA_016097945.1-Fun_JAAAIR010000287.1_i000_004267	2	262	260	0.787879	0.682415
GCA_021527685.1-Pro_JAJGMV010000187.1_i000_017241	51	383	332	1.00606	0.677551
GCA_001447755.1-Ani_JYDO01000074.1_i000_010340	311	652	341	1.03333	0.434395
GCA_001447505.1-Ani_JYDN01000055.1_i000_005000	391	720	329	0.99697	0.384795
GCA_009835175.1-Pro_VJMJ01000087.1_i000_002642	51	383	332	1.00606	0.677551
GCA_021527745.1-Pro_JAJNML010006782.1_i000_020562	51	383	332	1.00606	0.677551
GCA_000313545.1-Fun_CAFZ01000056.1_i000_008583	90	420	330	1	0.622642
GCA_910890315.1-Fun_CAJVGD010000006.1_i000_003432	90	420	330	1	0.622642
GCA_015039435.1-Fun_MU130753.1_i000_001300	99	425	326	0.987879	0.601476
GCA_903994135.1-Ani_CAJEWN010000123.1_i000_017270	43	380	337	1.02121	0.666008
GCA_015501075.1-Fun_JADNYJ010000001.1_i000_000370	91	419	328	0.993939	0.616541
GCA_018856295.1-Fun_JAFLHD010008879.1_i000_004079	88	415	327	0.990909	0.605556
GCA_019828595.1-Pro_JAHQRK010000002.1_i000_007772	49	384	335	1.01515	0.683673
GCA_010077935.1-Ani_VUKX01003200.1_i000_003276	35	250	215	0.651515	0.86
GCA_000478725.1-Pla_KI517683.1_i000_019398	6	333	327	0.990909	0.729911
GCA_001447445.1-Ani_JYDU01000030.1_i000_005963	374	705	331	1.00303	0.394517
GCA_003203535.1-Pla_BDRX01000148.1_i000_011892	49	382	333	1.00909	0.659406
GCA_000209185.1-Ani_DS231841.1_i000_016781	59	358	299	0.906061	0.590909
GCA_019632305.1-Fun_WSTW01000721.1_i000_007904	84	414	330	1	0.606618
GCA_014466165.1-Fun_JACETU010000003.1_i000_005099	158	479	321	0.972727	0.536789
GCA_016584345.1-Fun_JABCPV010000024.1_i000_007016	95	423	328	0.993939	0.606285
GCA_019202805.1-Pla_CM032907.1_i000_036435	40	370	330	1	0.699153
GCA_010078485.1-Ani_VULA01002610.1_i000_004036	53	268	215	0.651515	0.802239
GCA_016800925.1-Fun_JABCPU010000002.1_i000_006076	94	421	327	0.990909	0.607807
GCA_019202805.1-Pla_CM032907.1_i000_036429	39	371	332	1.00606	0.701903
GCA_014839935.1-Fun_QTSX01006703.1_i000_004268	1	207	206	0.624242	0.735714
GCA_015501585.1-Fun_JADNRY010000022.1_i000_008630	95	422	327	0.990909	0.587074
GCA_001882365.1-Fun_LVVM01000339.1_i000_000800	586	893	307	0.930303	0.301868
GCA_013401275.1-Ani_VYZV01019405.1_i000_005295	53	268	215	0.651515	0.802239
GCA_015852605.2-Pla_CM027586.2_i000_027573	128	340	212	0.642424	0.614493
GCA_000827335.1-Fun_KN831947.1_i000_002673	97	428	331	1.00303	0.608456
GCA_019633425.1-Fun_WSUB01000101.1_i000_000563	82	411	329	0.99697	0.613806
GCA_019633485.1-Fun_WSUC01000130.1_i000_001872	82	411	329	0.99697	0.613806
GCA_013389825.1-Ani_VWPW01030274.1_i000_012447	53	268	215	0.651515	0.802239
GCA_905330665.1-Ani_HG994585.1_i000_007328	109	325	216	0.654545	0.664615
GCA_000223135.1-Ani_JH000069.1_i000_002697	1	217	216	0.654545	0.699029
GCA_000143365.1-Fun_CH408033.1_i000_004015	133	207	74	0.224242	0.128028
GCA_000143365.1-Fun_CH408033.1_i000_004015	198	423	225	0.681818	0.389273
GCA_019924255.1-Fun_JAHFXK010000070.1_i000_016752	1	238	237	0.718182	0.757188
GCA_903994135.1-Ani_CAJEWN010000174.1_i000_020988	43	380	337	1.02121	0.666008
GCA_018127125.1-Pla_CM030799.1_i000_034241	51	385	334	1.01212	0.816626
GCA_016906575.1-Fun_CP059613.1_i000_004537	139	469	330	1	0.557432
GCA_016906575.1-Fun_CP059629.1_i000_019377	139	469	330	1	0.557432
GCA_016906555.1-Fun_CP059645.1_i000_004422	139	469	330	1	0.557432
GCA_016647625.1-Fun_JABBWH010000004.1_i000_011223	94	421	327	0.990909	0.607807
GCA_019044685.2-Pla_JAGTXX020000014.1_i000_007730	50	382	332	1.00606	0.653543
GCA_000341285.1-Pro_KB454534.1_i000_005118	21	346	325	0.984848	0.700431
GCA_902705455.1-Pla_CACSHJ010000089.1_i000_016324	30	359	329	0.99697	0.701493
GCA_016695475.1-Fun_MU172920.1_i000_001939	94	421	327	0.990909	0.607807
GCA_014220965.1-Ani_LOND01002773.1_i000_005095	140	462	322	0.975758	0.567901
GCA_019202795.1-Pla_CM032920.1_i000_036136	42	371	329	0.99697	0.69556
GCA_022496215.1-Fun_WTXF01000046.1_i000_008940	89	416	327	0.990909	0.616981
GCA_010458925.1-Pla_CM021226.1_i000_000348	138	194	56	0.169697	0.16092
GCA_010458925.1-Pla_CM021226.1_i000_000348	168	347	179	0.542424	0.514368
GCA_019633595.1-Fun_WSUI01000077.1_i000_011711	83	410	327	0.990909	0.321534
GCA_015178965.1-Fun_WHVB01000003.1_i000_005784	90	418	328	0.993939	0.618868
GCA_001481415.2-Fun_LNZH02000215.1_i000_000446	73	398	325	0.984848	0.627413
GCA_016758785.1-Fun_JABBWO010000003.1_i000_006071	94	421	327	0.990909	0.607807
GCA_016767475.1-Fun_MU179299.1_i000_001788	46	375	329	0.99697	0.670061
GCA_000701005.1-Ani_KL363197.1_i000_003224	43	373	330	1	0.653465
GCA_000701025.1-Ani_KL367612.1_i000_011625	43	373	330	1	0.653465
GCA_018282025.1-Fun_JABCKI010006025.1_i000_009966	103	433	330	1	0.601093
GCA_019973975.1-Ani_BMAO01019030.1_i000_033751	28	345	317	0.960606	0.916185
GCA_013398875.1-Ani_VYZK01001106.1_i000_012770	54	268	214	0.648485	0.798507
GCA_016628065.1-Fun_JABBWA010000002.1_i000_007033	44	369	325	0.984848	0.668724
GCA_012980535.1-Fun_SJKF01000003.1_i000_005370	125	447	322	0.975758	0.568905
GCA_016758765.1-Fun_JABBWL010000001.1_i000_000371	92	421	329	0.99697	0.611524
GCA_020921065.1-Pla_CM037157.1_i000_020180	60	392	332	1.00606	0.83
GCA_001632435.1-Fun_KV423947.1_i000_004214	42	370	328	0.993939	0.676289
GCA_016758775.1-Fun_JABBWN010000015.1_i000_003704	97	425	328	0.993939	0.605166
GCA_000764305.3-Ani_JQDR03001316.1_i000_000501	55	389	334	1.01212	0.661386
GCA_000827275.1-Fun_KN833686.1_i000_000554	97	428	331	1.00303	0.608456
GCA_002786265.1-Pla_KZ451951.1_i000_008718	54	274	220	0.666667	0.794224
GCA_022160365.1-Fun_MU273512.1_i000_003500	91	418	327	0.990909	0.611215
GCA_003144115.1-Fun_KZ819301.1_i000_005393	79	410	331	1.00303	0.594255
GCA_019202925.1-Pla_JAHPZM010000001.1_i000_000381	50	382	332	1.00606	0.653543
GCA_016628085.1-Fun_JABBWB010000083.1_i000_014916	97	424	327	0.990909	0.604436
GCA_016695465.1-Fun_MU177896.1_i000_002354	94	422	328	0.993939	0.608534
GCA_009176605.1-Ani_SEYY01013742.1_i000_007714	103	288	185	0.560606	0.371486
GCA_009176605.1-Ani_SEYY01013742.1_i000_007714	286	404	118	0.357576	0.236948
GCA_016628565.1-Fun_JABBWD010000009.1_i000_014394	97	424	327	0.990909	0.604436
GCA_009746105.1-Pla_CM019271.1_i000_014213	35	364	329	0.99697	0.884409
GCA_016647635.1-Fun_JABBWG010000008.1_i000_014837	94	421	327	0.990909	0.607807
GCA_019649035.1-Ani_BMAT01000236.1_i000_001278	123	357	234	0.709091	0.427007
GCA_019649035.1-Ani_BMAT01000236.1_i000_001278	352	425	73	0.221212	0.133212
GCA_905231915.1-Pro_CAJNJA010091941.1_i000_033972	8	217	209	0.633333	0.819608
GCA_018858115.1-Fun_JABCKT010006433.1_i000_008618	92	420	328	0.993939	0.61194
GCA_004679275.1-Fun_SEOQ01000906.1_i000_011227	128	350	222	0.672727	0.393617
GCA_019633495.1-Fun_WSUD01000476.1_i000_003792	4	316	312	0.945455	0.345898
GCA_900618425.1-Ani_UZAN01001631.1_i000_000485	38	302	264	0.8	0.854369
GCA_000797535.1-Ani_KN538395.1_i000_006095	325	653	328	0.993939	0.416773
GCA_001029375.1-Pro_BBXB01000381.1_i000_012955	699	1030	331	1.00303	0.202446
GCA_000699005.1-Ani_KL214726.1_i000_000149	94	312	218	0.660606	0.440404
GCA_000385595.1-Fun_KB916411.1_i000_006492	99	441	342	1.03636	0.563427
GCA_019973955.1-Ani_BMAV01028207.1_i000_051317	64	380	316	0.957576	0.825065
GCA_000613005.1-Ani_HG805949.1_i000_003612	370	699	329	0.99697	0.291667
GCA_019202805.1-Pla_CM032907.1_i000_036421	39	371	332	1.00606	0.701903
GCA_015178925.1-Fun_WHVC01000008.1_i000_012278	57	349	292	0.884848	0.680653
GCA_006381635.2-Pla_VEPZ02000431.1_i000_011434	108	296	188	0.569697	0.184314
GCA_006381635.2-Pla_VEPZ02000431.1_i000_011434	325	446	121	0.366667	0.118627
GCA_022496225.1-Fun_WTXE01000013.1_i000_002208	90	418	328	0.993939	0.622391
GCA_021525775.1-Fun_JAKELK010000013.1_i000_003129	93	413	320	0.969697	0.608365
GCA_007210705.1-Ani_CM017377.1_i000_005661	60	390	330	1	0.643275
GCA_002287525.1-Ani_LIAE01007728.1_i000_011513	38	375	337	1.02121	0.678068
GCA_004681135.1-Fun_SFCI01000284.1_i000_005775	95	424	329	0.99697	0.630268
GCA_000520075.1-Pro_KI913162.1_i000_013333	59	390	331	1.00303	0.665996
GCA_002197585.2-Pro_MZMZ02002061.1_i000_004022	59	390	331	1.00303	0.665996
GCA_003546545.1-Pro_QUTB01004490.1_i000_004909	59	390	331	1.00303	0.665996
GCA_022117675.1-Ani_JACEFF010000511.1_i000_014381	1	201	200	0.606061	0.677966
GCA_002738545.1-Ani_NTJE010111337.1_i000_005455	111	325	214	0.648485	0.656442
GCA_001974825.1-Pla_AWUE01021140.1_i000_029993	6	332	326	0.987879	0.770686
GCA_003614725.1-Fun_ML005449.1_i000_003732	9	335	326	0.987879	0.740909
GCA_000442015.1-Fun_KE560431.1_i000_000294	10	335	325	0.984848	0.738636
GCA_900604375.1-Ani_UXSR01000372.1_i000_002330	78	348	270	0.818182	0.459184
GCA_003203535.1-Pla_BDRX01000021.1_i000_003664	127	286	159	0.481818	0.331942
GCA_003203535.1-Pla_BDRX01000021.1_i000_003664	295	414	119	0.360606	0.248434
GCA_021399455.1-Fun_JAJTUO010000005.1_i000_015146	88	415	327	0.990909	0.607807
GCA_016647785.1-Fun_JABBWK010000003.1_i000_009074	97	424	327	0.990909	0.604436
GCA_006381635.2-Pla_VEPZ02001342.1_i000_058321	119	326	207	0.627273	0.633028
GCA_000006295.1-Ani_DS235860.1_i000_001442	95	353	258	0.781818	0.552463
GCA_003546565.1-Pro_QUSZ01007044.1_i000_010014	59	390	331	1.00303	0.665996
GCA_003546585.1-Pro_QUTD01011700.1_i000_013789	59	390	331	1.00303	0.665996
GCA_003546605.1-Pro_QUTA01001869.1_i000_001161	59	390	331	1.00303	0.665996
GCA_003546625.1-Pro_QUTC01008450.1_i000_011538	59	390	331	1.00303	0.665996
GCA_003546765.1-Pro_QUTG01007137.1_i000_013199	59	390	331	1.00303	0.665996
GCA_003546785.1-Pro_QUTF01002875.1_i000_000926	59	390	331	1.00303	0.665996
GCA_003546805.1-Pro_QUTE01009019.1_i000_005120	59	390	331	1.00303	0.665996
GCA_003546825.1-Pro_QUTH01001263.1_i000_001654	59	390	331	1.00303	0.665996
GCA_000349005.2-Fun_AFWA02000012.1_i000_000752	67	399	332	1.00606	0.656126
GCA_018296085.1-Fun_JACKQM010011832.1_i000_013426	94	422	328	0.993939	0.610801
GCA_018296165.1-Fun_JACKQL010012037.1_i000_011317	94	422	328	0.993939	0.610801
GCA_900618395.1-Ani_UZAI01018017.1_i000_019163	17	239	222	0.672727	0.925
GCA_020091625.1-Fun_JAGYZC010000003.1_i000_005997	94	422	328	0.993939	0.593128
GCA_003573695.1-Pla_PUWZ01001678.1_i000_042927	1	218	217	0.657576	0.9819
GCA_016647645.1-Fun_JABBWF010000008.1_i000_015214	97	424	327	0.990909	0.604436
GCA_016758755.1-Fun_JABBWM010000003.1_i000_007471	97	424	327	0.990909	0.604436
GCA_016647745.1-Fun_JABBWE010000043.1_i000_009912	97	424	327	0.990909	0.604436
GCA_016647685.1-Fun_JABBWJ010000025.1_i000_007192	97	424	327	0.990909	0.604436
GCA_000934395.1-Fun_KN881724.1_i000_004807	58	385	327	0.990909	0.657948
GCA_000320585.2-Fun_KI925456.1_i000_003921	43	368	325	0.984848	0.672878
GCA_004119915.2-Ani_CM014091.1_i000_016203	53	380	327	0.990909	0.64881
GCA_905216605.1-Pla_LR999453.1_i000_008365	39	368	329	0.99697	0.709052
GCA_001276565.1-Ani_KQ435840.1_i000_010064	104	327	223	0.675758	0.471459
GCA_015657495.1-Fun_MU157825.1_i000_001198	102	427	325	0.984848	0.59633
GCA_002111425.1-Fun_KZ107832.1_i000_009904	97	440	343	1.03939	0.566942
GCA_008931885.1-Fun_VCHE01000163.1_i000_003340	97	440	343	1.03939	0.566942
GCA_012971845.1-Fun_QCYV01000285.1_i000_012331	97	440	343	1.03939	0.566942
GCA_001029375.1-Pro_BBXB01000006.1_i000_000856	741	1072	331	1.00303	0.201461
GCA_905216605.1-Pla_LR999453.1_i000_008241	32	369	337	1.02121	0.717021
GCA_021525025.1-Fun_JAKELI010000010.1_i000_000262	96	412	316	0.957576	0.601905
GCA_005966545.1-Pro_SPLM01000108.1_i000_000598	86	421	335	1.01515	0.63447
GCA_900537275.1-Ani_UYRX01000122.1_i000_002860	37	371	334	1.01212	0.677485
GCA_003788615.2-Fun_ML121529.1_i000_001395	99	429	330	1	0.550918
GCA_001633215.2-Pla_KV770768.1_i000_003216	8	327	319	0.966667	0.921965
GCA_900537255.1-Ani_UPTC01000756.1_i000_004639	38	371	333	1.00909	0.675456
GCA_018857265.1-Fun_JABAJZ010013610.1_i000_008824	97	423	326	0.987879	0.610487
GCA_003990745.1-Fun_RBNI01007879.1_i000_007151	69	418	349	1.05758	0.772124
GCA_004369065.1-Fun_ML208261.1_i000_001691	51	375	324	0.981818	0.661224
GCA_003990765.1-Fun_RBNJ01000078.1_i000_000136	70	418	348	1.05455	0.768212
GCA_019202795.1-Pla_CM032920.1_i000_036147	39	371	332	1.00606	0.701903
GCA_021525015.1-Fun_JAKELH010000001.1_i000_000028	108	421	313	0.948485	0.583955
GCA_000512085.1-Pro_ASPP01008386.1_i000_011433	1	228	227	0.687879	0.598945
MEPA005.0722.00001.C001_01604	3	243	240	0.727273	0.967742
GCA_000004825.1-Pro_GL290984.1_i000_001155	75	410	335	1.01515	0.656863
NASP007.0722.00001.C001_03544	24	301	277	0.839394	0.917219
GCA_900617915.1-Ani_UYRT01083638.1_i000_016333	6	326	320	0.969697	0.711111
GCA_020921065.1-Pla_CM037153.1_i000_008873	58	392	334	1.01212	0.835
GCA_020744175.1-Fun_JAGTJP010000031.1_i000_007225	87	414	327	0.990909	0.61236
GCA_013396875.1-Ani_VZRF01006670.1_i000_005415	1	228	227	0.687879	0.707165
GCA_003025155.1-Fun_KZ679130.1_i000_004540	132	214	82	0.248485	0.179039
GCA_003025155.1-Fun_KZ679130.1_i000_004540	210	409	199	0.60303	0.434498
GCA_021525005.1-Fun_JAKEYE010000012.1_i000_002253	40	353	313	0.948485	0.671674
GCA_006535955.1-Fun_QEAN01000008.1_i000_000406	72	403	331	1.00303	0.6341
GCA_006536045.1-Fun_QEAM01000073.1_i000_002558	76	407	331	1.00303	0.629278
GCA_001006355.1-Fun_LAQI01000195.1_i000_003400	86	440	354	1.07273	0.584158
GCA_001975905.1-Fun_MSZU01000075.1_i000_001332	86	440	354	1.07273	0.584158
GCA_000827415.1-Fun_KN824278.1_i000_001089	92	423	331	1.00303	0.61985
GCA_000183805.3-Ani_JH712708.1_i000_012894	38	372	334	1.01212	0.677485
GCA_015476405.1-Fun_CM027205.1_i000_009032	91	413	322	0.975758	0.292461
GCA_000265015.1-Fun_JH687735.1_i000_001893	48	378	330	1	0.666667
GCA_017607575.1-Fun_JABAJY010007606.1_i000_007205	612	938	326	0.987879	0.309005
GCA_009761265.1-Ani_VOSG01000238.1_i000_005840	38	367	329	0.99697	0.668699
GCA_000292625.1-Fun_JH795876.1_i000_009117	56	385	329	0.99697	0.658
GCA_015179025.1-Fun_WHUX01000002.1_i000_004188	50	380	330	1	0.6
GCA_020379485.1-Pla_CM035457.1_i000_049480	89	145	56	0.169697	0.123348
GCA_020379485.1-Pla_CM035457.1_i000_049480	141	357	216	0.654545	0.475771
GCA_001625215.1-Pla_CM004284.1_i000_025182	9	342	333	1.00909	0.731868
GCA_018857285.1-Fun_JABAKA010008023.1_i000_004303	94	422	328	0.993939	0.610801
GCA_019632285.1-Fun_WSTV01000310.1_i000_005102	84	413	329	0.99697	0.611524
GCA_004802725.1-Fun_SGPM01000004.1_i000_005989	101	425	324	0.981818	0.598891
GCA_001477545.1-Fun_LFVZ01000011.1_i000_000540	67	399	332	1.00606	0.656126
GCA_900080155.1-Fun_LT558118.1_i000_001401	136	462	326	0.987879	0.54063
GCA_900519155.1-Fun_ULHB01000048.1_i000_002865	136	462	326	0.987879	0.54063
GCA_002104935.1-Fun_MCGT01000004.1_i000_007324	50	384	334	1.01212	0.685832
GCA_001883845.1-Fun_MNUE01000004.1_i000_006274	99	440	341	1.03333	0.562706
GCA_001268165.1-Fun_CVQI01035050.1_i000_017636	87	363	276	0.836364	0.416918
GCA_001268165.1-Fun_CVQI01035050.1_i000_017636	364	482	118	0.357576	0.178248
GCA_900617995.1-Ani_UZAL01030401.1_i000_009935	18	239	221	0.669697	0.920833
GCA_000286035.1-Fun_CAGI01000188.1_i000_000925	136	462	326	0.987879	0.537068
GCA_900519145.1-Fun_ULHA01000001.1_i000_000488	136	462	326	0.987879	0.537068
GCA_012274485.2-Pla_MU112966.1_i000_049472	40	372	332	1.00606	0.687371
GCA_900618515.1-Ani_UZAO01071653.1_i000_012244	112	343	231	0.7	0.66763
GCA_916381525.1-Ani_CAKAEH010001276.1_i000_004039	38	371	333	1.00909	0.675456
GCA_900537205.1-Ani_UYRW01003173.1_i000_007834	38	371	333	1.00909	0.675456
GCA_019632265.1-Fun_WSTU01000210.1_i000_003301	84	413	329	0.99697	0.611524
GCA_003086735.1-Fun_MBFR01000221.1_i000_004254	52	357	305	0.924242	0.618661
GCA_020379485.1-Pla_CM035447.1_i000_007481	149	208	59	0.178788	0.11501
GCA_020379485.1-Pla_CM035447.1_i000_007481	204	426	222	0.672727	0.432749
GCA_000507405.3-Fun_KI669495.1_i000_001587	123	452	329	0.99697	0.576182
GCA_010015785.1-Fun_ML978715.1_i000_003373	98	439	341	1.03333	0.555375
GCA_019202795.1-Pla_CM032920.1_i000_036142	39	371	332	1.00606	0.701903
GCA_019202795.1-Pla_CM032920.1_i000_036145	39	371	332	1.00606	0.701903
GCA_002215745.1-Fun_NKHX01000022.1_i000_002808	98	434	336	1.01818	0.608696
GCA_002215755.1-Fun_NKHW01000065.1_i000_005730	98	434	336	1.01818	0.608696
GCA_002220045.1-Fun_NKHY01000065.1_i000_005887	98	434	336	1.01818	0.608696
GCA_002215705.1-Fun_AMKS01000010.1_i000_000847	98	434	336	1.01818	0.608696
GCA_000751015.1-Pla_LK051726.1_i000_061020	13	332	319	0.966667	0.759524
GCA_019632275.1-Fun_WSTT01000012.1_i000_001164	84	413	329	0.99697	0.611524
GCA_000310025.1-Pro_FN648498.1_i000_015900	100	432	332	1.00606	0.620561
GCA_002222385.1-Fun_AMKN01000033.1_i000_002754	112	448	336	1.01818	0.59364
GCA_002215835.1-Fun_AMKP01000006.1_i000_006204	112	448	336	1.01818	0.59364
GCA_002222475.1-Fun_AMKO01000009.1_i000_006832	112	448	336	1.01818	0.59364
GCA_002234625.1-Fun_AMKQ01000010.1_i000_000639	112	448	336	1.01818	0.59364
GCA_002222155.1-Fun_APKL01000080.1_i000_006556	112	448	336	1.01818	0.59364
GCA_000827205.1-Fun_KN832554.1_i000_000881	95	418	323	0.978788	0.606004
GCA_004918325.1-Fun_SPNW01000011.1_i000_000308	105	432	327	0.990909	0.584973
GCA_002215855.1-Fun_AMKX01000077.1_i000_006375	98	434	336	1.01818	0.608696
GCA_002217545.1-Fun_APKM01000091.1_i000_006704	98	434	336	1.01818	0.608696
GCA_002220035.1-Fun_AMKW01000094.1_i000_006889	98	434	336	1.01818	0.608696
GCA_000149245.3-Fun_CP003821.1_i000_001440	98	434	336	1.01818	0.608696
GCA_002215765.1-Fun_AMLA01000088.1_i000_006419	98	434	336	1.01818	0.608696
GCA_002215775.1-Fun_AMLG01000037.1_i000_003142	98	434	336	1.01818	0.608696
GCA_002215825.1-Fun_AMLK01000019.1_i000_000960	98	434	336	1.01818	0.608696
GCA_002216725.1-Fun_CP022322.1_i000_001440	98	434	336	1.01818	0.608696
GCA_002220445.1-Fun_AMLJ01000068.1_i000_005858	98	434	336	1.01818	0.608696
GCA_002221985.1-Fun_APKI01000054.1_i000_005758	98	434	336	1.01818	0.608696
GCA_002222015.1-Fun_APKO01000086.1_i000_006596	98	434	336	1.01818	0.608696
GCA_002222025.1-Fun_APKS01000087.1_i000_006561	98	434	336	1.01818	0.608696
GCA_002222095.1-Fun_APKP01000086.1_i000_006729	98	434	336	1.01818	0.608696
GCA_002222115.1-Fun_APKR01000077.1_i000_006464	98	434	336	1.01818	0.608696
GCA_002222135.1-Fun_APKK01000071.1_i000_006249	98	434	336	1.01818	0.608696
GCA_002222145.1-Fun_APKQ01000063.1_i000_006084	98	434	336	1.01818	0.608696
GCA_002222165.1-Fun_APKT01000066.1_i000_006158	98	434	336	1.01818	0.608696
GCA_002222215.1-Fun_APKH01000051.1_i000_005681	98	434	336	1.01818	0.608696
GCA_002222225.1-Fun_AMLE01000204.1_i000_000706	98	434	336	1.01818	0.608696
GCA_002222245.1-Fun_APKJ01000064.1_i000_005899	98	434	336	1.01818	0.608696
GCA_002222255.1-Fun_AMLH01000123.1_i000_000516	98	434	336	1.01818	0.608696
GCA_002222295.1-Fun_AMLB01000113.1_i000_000372	98	434	336	1.01818	0.608696
GCA_002222315.1-Fun_AMKY01000012.1_i000_000724	98	434	336	1.01818	0.608696
GCA_002222325.1-Fun_AMKT01000025.1_i000_001464	98	434	336	1.01818	0.608696
GCA_002222375.1-Fun_AMLI01000006.1_i000_006375	98	434	336	1.01818	0.608696
GCA_002222395.1-Fun_AMLD01000099.1_i000_006882	98	434	336	1.01818	0.608696
GCA_002222405.1-Fun_AMLC01000026.1_i000_002680	98	434	336	1.01818	0.608696
GCA_002222455.1-Fun_AMKZ01000089.1_i000_006405	98	434	336	1.01818	0.608696
GCA_002224005.1-Fun_AMLF01000007.1_i000_006433	98	434	336	1.01818	0.608696
GCA_002222335.1-Fun_AMKU01000008.1_i000_006445	98	434	336	1.01818	0.608696
GCA_002215885.1-Fun_AMKM01000010.1_i000_000699	98	434	336	1.01818	0.608696
GCA_001630345.1-Fun_KV417361.1_i000_011845	45	373	328	0.993939	0.672131
GCA_900242705.1-Fun_OEYX01000115.1_i000_007195	136	462	326	0.987879	0.539735
GCA_000302655.1-Fun_AHHD01000233.1_i000_005100	101	441	340	1.0303	0.566667
GCA_020744275.1-Fun_JAGTJR010000043.1_i000_009911	101	441	340	1.0303	0.566667
GCA_002222465.1-Fun_AMKV01000006.1_i000_006201	98	434	336	1.01818	0.608696
GCA_000091045.1-Fun_AE017342.1_i000_001396	101	435	334	1.01212	0.603978
GCA_000149385.1-Fun_CM000041.1_i000_000845	101	435	334	1.01212	0.603978
GCA_009428295.1-Fun_RDSH01000069.1_i000_006661	157	493	336	1.01818	0.526646
GCA_019627755.1-Fun_WSTS01000002.1_i000_003683	85	415	330	1	0.627376
GCA_001645055.2-Fun_LWDG02000511.1_i000_005821	157	493	336	1.01818	0.526646
GCA_019616975.1-Fun_WSTL01000333.1_i000_004192	85	415	330	1	0.696203
GCA_001645015.2-Fun_LWDF02000192.1_i000_002875	157	493	336	1.01818	0.526646
GCA_019633535.1-Fun_WSUE01000024.1_i000_005914	80	409	329	0.99697	0.617261
GCA_900618355.1-Ani_UZAD01000183.1_i000_001831	38	371	333	1.00909	0.675456
GCA_000447185.1-Fun_KE647071.1_i000_000551	3	294	291	0.881818	0.986441
GCA_019627735.1-Fun_WSTP01000215.1_i000_004290	85	415	330	1	0.627376
GCA_000002995.5-Ani_CAAKNF010000195.1_i000_007407	38	371	333	1.00909	0.675456
GCA_904066235.2-Ani_CAJFCV020000001.1_i000_001555	40	375	335	1.01515	0.44021
GCA_904067135.1-Ani_CAJFDI010000001.1_i000_001555	40	375	335	1.01515	0.44021
GCA_016834595.1-Pla_JAEHOD010000038.1_i000_010315	50	320	270	0.818182	0.421875
GCA_019155685.1-Pro_JAGDFL010000010.1_i000_000139	95	430	335	1.01515	0.623836
GCA_010194725.1-Pro_WXXK01003404.1_i000_015773	93	408	315	0.954545	0.730858
CANA006.0722.00001.C001_00254	1	249	248	0.751515	0.995984
GCA_905071775.1-Fun_CAJHJJ010002745.1_i000_003592	140	477	337	1.02121	0.605027
GCA_020875895.1-Ani_JNEY01000006.1_i000_003766	40	376	336	1.01818	0.678788
GCA_019623675.1-Fun_WSTN01000441.1_i000_008464	85	415	330	1	0.696203
GCA_015179035.1-Fun_WHUY01000026.1_i000_004211	98	427	329	0.99697	0.551089
GCA_002286715.1-Fun_NSJX01000001.1_i000_000659	46	267	221	0.669697	0.809524
GCA_008629635.1-Fun_NQVO01000014.1_i000_003402	105	436	331	1.00303	0.597473
GCA_000507425.3-Fun_KV700221.1_i000_005479	123	452	329	0.99697	0.576182
GCA_009428365.1-Fun_RDSJ01002307.1_i000_003727	157	493	336	1.01818	0.526646
GCA_009428345.1-Fun_RDSI01000852.1_i000_008800	157	493	336	1.01818	0.526646
GCA_001040885.1-Ani_LN609528.1_i000_001507	70	404	334	1.01212	0.637405
GCA_002352805.1-Ani_KZ349016.1_i000_012424	134	362	228	0.690909	0.629834
GCA_019627745.1-Fun_WSTR01000358.1_i000_007572	85	415	330	1	0.696203
GCA_000836335.1-Fun_KN847983.1_i000_004140	100	435	335	1.01515	0.605787
GCA_001645045.2-Fun_LWDE02000141.1_i000_001579	140	477	337	1.02121	0.546191
GCA_009428265.1-Fun_RDSE01000117.1_i000_000710	140	477	337	1.02121	0.546191
GCA_905071705.1-Fun_CAJHJC010007634.1_i000_009124	140	477	337	1.02121	0.546191
GCA_905071725.1-Fun_CAJHJD010002512.1_i000_003733	140	477	337	1.02121	0.546191
GCA_905071765.1-Fun_CAJHJB010000556.1_i000_008404	140	477	337	1.02121	0.546191
GCA_905071785.1-Fun_CAJHJI010002236.1_i000_003490	140	477	337	1.02121	0.546191
GCA_001645005.2-Fun_LWDD02000682.1_i000_008503	142	479	337	1.02121	0.544426
GCA_009428275.1-Fun_RDSF01000474.1_i000_006979	142	479	337	1.02121	0.544426
GCA_009428285.1-Fun_RDSG01000030.1_i000_004851	142	479	337	1.02121	0.544426
GCA_905068135.1-Fun_CAJHJA010003014.1_i000_004360	142	479	337	1.02121	0.544426
GCA_905071715.1-Fun_CAJHJH010001462.1_i000_002565	142	479	337	1.02121	0.544426
GCA_905071735.1-Fun_CAJHJE010003002.1_i000_004275	142	479	337	1.02121	0.544426
GCA_905071745.1-Fun_CAJHJG010003188.1_i000_004442	142	479	337	1.02121	0.544426
GCA_905071755.1-Fun_CAJHJF010002924.1_i000_004506	142	479	337	1.02121	0.544426
GCA_905072865.1-Fun_CAJHJV010003851.1_i000_005719	142	479	337	1.02121	0.544426
GCA_003260675.2-Pla_QGKX02000996.1_i000_003015	45	364	319	0.966667	0.690476
CAMI002.0722.00001.C001_00386	1	296	295	0.893939	0.986622
GCA_015501535.1-Fun_JADNRW010000010.1_i000_001106	97	416	319	0.966667	0.599624
SASP011.0722.00001.C001_01479	26	118	92	0.278788	0.333333
SASP011.0722.00001.C001_01479	108	276	168	0.509091	0.608696
GCA_019968985.1-Pro_JAHYSF010000461.1_i000_002563	1	195	194	0.587879	0.989796
GCA_019968955.1-Pro_JAHYSE010000488.1_i000_003456	1	195	194	0.587879	0.989796
GCA_019627725.1-Fun_WSTQ01000142.1_i000_001954	85	415	330	1	0.627376
GCA_019633565.1-Fun_WSUH01000148.1_i000_001896	85	415	330	1	0.627376
GCA_019623665.1-Fun_WSTM01000346.1_i000_007277	85	415	330	1	0.627376
GCA_000180755.1-Ani_ADBV01002657.1_i000_006334	38	371	333	1.00909	0.675456
GCA_900622535.1-Ani_UYWW01001087.1_i000_003277	38	371	333	1.00909	0.675456
GCA_000512585.2-Fun_KV700382.1_i000_009077	113	446	333	1.00909	0.591474
GCA_004918905.1-Fun_SPRC01000006.1_i000_003079	96	420	324	0.981818	0.592322
GCA_009650685.1-Fun_CM018866.1_i000_002207	100	435	335	1.01515	0.605787
GCA_000855695.1-Fun_KN848899.1_i000_004081	100	435	335	1.01515	0.605787
GCA_900618415.1-Ani_UZAM01007789.1_i000_003507	126	347	221	0.669697	0.636888
GCA_000005005.6-Pla_CM000784.4_i000_032688	29	183	154	0.466667	0.498382
GCA_000005005.6-Pla_CM000784.4_i000_032688	197	306	109	0.330303	0.352751
GCA_000263375.1-Fun_JH668235.1_i000_003349	43	367	324	0.981818	0.65587
GCA_000835755.1-Fun_KN848865.1_i000_003979	100	435	335	1.01515	0.605787
GCA_022376545.1-Fun_WTXJ01000025.1_i000_004870	88	415	327	0.990909	0.616981
GCA_019633555.1-Fun_WSUG01000014.1_i000_002164	80	409	329	0.99697	0.590664
GCA_000512565.2-Fun_KI894030.1_i000_003340	120	455	335	1.01515	0.584642
GCA_000293215.1-Fun_JH977535.1_i000_000232	90	423	333	1.00909	0.614391
GCA_000299215.2-Fun_JH925092.1_i000_003423	90	423	333	1.00909	0.614391
GCA_003260635.2-Pla_QGKW02001911.1_i000_008632	45	364	319	0.966667	0.693478
GCA_900242695.1-Fun_OHJM01000027.1_i000_004852	140	462	322	0.975758	0.533113
GCA_902206195.3-Pla_CABITT030000001.1_i000_001864	1	309	308	0.933333	0.745763
GCA_002271895.2-Pla_CM008431.1_i000_000608	3	299	296	0.89697	0.8
GCA_002104995.1-Fun_MCFD01000001.1_i000_000466	37	365	328	0.993939	0.68476
GCA_006535985.1-Fun_QEAO01000003.1_i000_000854	67	397	330	1	0.642023
GCA_000709325.1-Ani_KL447386.1_i000_003592	2	272	270	0.818182	0.745856
GCA_019202795.1-Pla_CM032920.1_i000_036122	40	370	330	1	0.709677
GCA_003260635.2-Pla_QGKW02001660.1_i000_006827	1	177	176	0.533333	0.715447
GCA_000271625.1-Fun_JH711577.1_i000_005497	103	424	321	0.972727	0.588991
GCA_004918025.1-Fun_SPRV01000005.1_i000_002654	96	420	324	0.981818	0.592322
GCA_004918155.1-Fun_SPRG01000010.1_i000_004219	96	420	324	0.981818	0.592322
GCA_004918605.1-Fun_SPRK01000005.1_i000_002491	96	420	324	0.981818	0.592322
GCA_004918635.1-Fun_SPRD01000001.1_i000_000075	96	420	324	0.981818	0.592322
GCA_004918645.1-Fun_SPRE01000001.1_i000_000076	96	420	324	0.981818	0.592322
GCA_004918725.1-Fun_SPRT01000004.1_i000_001970	96	420	324	0.981818	0.592322
GCA_004918795.1-Fun_SPRH01000004.1_i000_001962	96	420	324	0.981818	0.592322
GCA_004918805.1-Fun_SPRR01000001.1_i000_000076	96	420	324	0.981818	0.592322
GCA_004918985.1-Fun_SPRS01000001.1_i000_000076	96	420	324	0.981818	0.592322
GCA_004917925.1-Fun_SPRI01000003.1_i000_001263	99	423	324	0.981818	0.589091
GCA_004917935.1-Fun_SPRJ01000007.1_i000_003396	99	423	324	0.981818	0.589091
GCA_004917965.1-Fun_SPRO01000003.1_i000_001272	99	423	324	0.981818	0.589091
GCA_004917975.1-Fun_SPRM01000006.1_i000_003099	99	423	324	0.981818	0.589091
GCA_004918005.1-Fun_SPRU01000006.1_i000_002985	99	423	324	0.981818	0.589091
GCA_004918075.1-Fun_SPRL01000008.1_i000_003879	99	423	324	0.981818	0.589091
GCA_004918485.1-Fun_SPRQ01000004.1_i000_002137	99	423	324	0.981818	0.589091
GCA_004918525.1-Fun_SPRF01000009.1_i000_003995	99	423	324	0.981818	0.589091
GCA_004918665.1-Fun_SPRB01000007.1_i000_003356	99	423	324	0.981818	0.589091
GCA_004918835.1-Fun_SPRW01000004.1_i000_002028	99	423	324	0.981818	0.589091
GCA_004918915.1-Fun_SPRN01000008.1_i000_003762	99	423	324	0.981818	0.589091
GCA_004918925.1-Fun_SPRP01000002.1_i000_000352	99	423	324	0.981818	0.589091
GCA_004918995.1-Fun_SPRY01000003.1_i000_001318	99	423	324	0.981818	0.589091
GCA_004919005.1-Fun_SPRX01000008.1_i000_003669	99	423	324	0.981818	0.589091
HASP051.0722.00001.C001_03622	32	130	98	0.29697	0.3391
HASP051.0722.00001.C001_03622	120	287	167	0.506061	0.577855
GCA_000090985.2-Pla_CP001575.1_i000_005744	63	393	330	1	0.64833
GCA_004918515.1-Fun_SPRA01000005.1_i000_002697	96	420	324	0.981818	0.592322
GCA_000315625.1-Pro_JH992970.1_i000_002151	45	378	333	1.00909	0.675456
GCA_000722935.2-Pla_KN643869.1_i000_005429	104	334	230	0.69697	0.46371
GCA_000722935.2-Pla_KN643869.1_i000_005429	335	405	70	0.212121	0.141129
GCA_000492115.1-Pro_AUPL01001560.1_i000_001534	1	205	204	0.618182	0.976077
GCA_012274485.2-Pla_MU106159.1_i000_030267	39	371	332	1.00606	0.687371
GCA_002705745.1-Fun_KZ303501.1_i000_003626	4	327	323	0.978788	0.747685
GCA_017301755.1-Fun_CP054542.1_i000_002280	71	399	328	0.993939	0.648221
GCA_001625215.1-Pla_CM004286.1_i000_030707	103	314	211	0.639394	0.403442
GCA_001625215.1-Pla_CM004286.1_i000_030707	313	415	102	0.309091	0.195029
GCA_015852395.1-Fun_JAAAII010002613.1_i000_010785	83	294	211	0.639394	0.410506
GCA_015852395.1-Fun_JAAAII010002613.1_i000_010785	293	400	107	0.324242	0.208171
GCA_000185945.1-Fun_CP000286.1_i000_000030	100	435	335	1.01515	0.605787
GCA_000835745.1-Fun_KN848659.1_i000_002777	100	435	335	1.01515	0.605787
GCA_000836355.1-Fun_KN847928.1_i000_003087	100	435	335	1.01515	0.605787
GCA_000875815.1-Fun_KN849060.1_i000_003198	100	435	335	1.01515	0.605787
GCA_000935105.1-Fun_KN905586.1_i000_000833	100	435	335	1.01515	0.605787
GCA_000835765.1-Fun_KN848832.1_i000_000837	100	438	338	1.02424	0.611212
GCA_000835815.1-Fun_KN848527.1_i000_002305	100	438	338	1.02424	0.611212
GCA_000836315.1-Fun_KN848136.1_i000_002158	100	438	338	1.02424	0.611212
GCA_000836375.1-Fun_KN847907.1_i000_004622	100	438	338	1.02424	0.611212
GCA_000836455.1-Fun_KN848958.1_i000_003077	100	438	338	1.02424	0.611212
GCA_000875795.1-Fun_KN848514.1_i000_005066	100	438	338	1.02424	0.611212
GCA_002954075.1-Fun_CP025761.1_i000_002326	100	438	338	1.02424	0.611212
GCA_019924875.1-Fun_JAHFYK010008765.1_i000_022703	85	298	213	0.645455	0.714765
HADA001.0722.00001.C001_01114	32	126	94	0.284848	0.316498
HADA001.0722.00001.C001_01114	120	294	174	0.527273	0.585859
GCA_002269645.1-Ani_NIVC01003258.1_i000_042538	56	387	331	1.00303	0.618692
GCA_002269645.1-Ani_NIVC01000027.1_i000_001401	56	387	331	1.00303	0.618692
GCA_001574975.1-Fun_KQ965734.1_i000_001705	29	375	346	1.04848	0.690619
NAHA001.0722.00001.C001_00860	28	132	104	0.315152	0.352542
NAHA001.0722.00001.C001_00860	123	294	171	0.518182	0.579661
GCA_011503125.2-Fun_WWBZ02000016.1_i000_005720	99	441	342	1.03636	0.564356
GCA_905338385.1-Ani_CAJPEV010004180.1_i000_011860	132	346	214	0.648485	0.618497
GCA_002269645.1-Ani_NIVC01001310.1_i000_025309	56	387	331	1.00303	0.604015
HASP048.0722.00001.C001_01526	28	120	92	0.278788	0.33213
HASP048.0722.00001.C001_01526	112	277	165	0.5	0.595668
GCA_000751015.1-Pla_LK033282.1_i000_046848	78	396	318	0.963636	0.643725
GCA_000512605.2-Fun_KI894008.1_i000_001876	114	451	337	1.02121	0.592267
GCA_019155715.1-Pro_JAGDFM010000003.1_i000_007345	89	421	332	1.00606	0.626415
GCA_015179045.1-Fun_WHUZ01000013.1_i000_003049	97	426	329	0.99697	0.547421
GCA_019924485.1-Fun_JAHFXR010008447.1_i000_021371	1	226	225	0.681818	0.735294
GCA_000751015.1-Pla_LK032160.1_i000_017236	69	388	319	0.966667	0.656379
GCA_905332015.1-Ani_CAJOAZ010003579.1_i000_030426	14	274	260	0.787879	0.62201
SAJA001.0722.00001.C001_01768	26	121	95	0.287879	0.344203
SAJA001.0722.00001.C001_01768	111	276	165	0.5	0.597826
GCA_000507465.3-Fun_KV700055.1_i000_007911	117	453	336	1.01818	0.589474
GCA_000507485.3-Fun_KI669556.1_i000_007445	117	453	336	1.01818	0.589474
GCA_000507885.2-Fun_KI669465.1_i000_006641	117	453	336	1.01818	0.589474
GCA_014188975.1-Fun_JACGCI010000077.1_i000_022935	118	254	136	0.412121	0.283333
GCA_014188975.1-Fun_JACGCI010000077.1_i000_022935	252	400	148	0.448485	0.308333
GCA_009733575.1-Fun_ML769388.1_i000_002462	49	372	323	0.978788	0.661885
GCA_000875855.1-Fun_KN848931.1_i000_004779	100	438	338	1.02424	0.611212
GCA_900323505.1-Fun_OOIN01000002.1_i000_001327	125	452	327	0.990909	0.54958
GCA_000230445.1-Ani_JH171628.1_i000_014940	1	203	202	0.612121	0.660131
GCA_003709365.1-Pla_QOKY01000206.1_i000_005505	15	339	324	0.981818	0.3361
GCA_001712635.2-Pro_MBAC02007296.1_i000_016628	93	426	333	1.00909	0.621269
GCA_000512255.2-Pla_CM008459.1_i000_015536	119	246	127	0.384848	0.276688
GCA_000512255.2-Pla_CM008459.1_i000_015536	261	411	150	0.454545	0.326797
GCA_007182795.1-Fun_VFLP01000001.1_i000_000234	88	434	346	1.04848	0.565359
GCA_016865095.1-Pro_RCMR01000007.1_i000_000620	92	427	335	1.01515	0.625
GCA_016880175.1-Pro_RCMS01000004.1_i000_000318	92	427	335	1.01515	0.625
GCA_016880985.1-Pro_QOKR01000001.1_i000_000060	92	427	335	1.01515	0.625
GCA_010194725.1-Pro_WXXK01002579.1_i000_011886	79	413	334	1.01212	0.639847
GCA_019845555.1-Pla_CM034081.1_i000_013084	16	217	201	0.609091	0.926267
NASP006.0722.00001.C001_01814	33	132	99	0.3	0.336735
NASP006.0722.00001.C001_01814	125	291	166	0.50303	0.564626
GCA_020800215.1-Pro_JAICDV010000005.1_i000_005842	78	414	336	1.01818	0.643678
GCA_020800235.1-Pro_JAICDX010000004.1_i000_005223	78	414	336	1.01818	0.643678
GCA_002215365.1-Pro_NBNE01000056.1_i000_001298	74	408	334	1.01212	0.646035
GCA_003369665.1-Fun_PDLM01000001.1_i000_000929	122	462	340	1.0303	0.53125
GCA_000478725.1-Pla_KI517609.1_i000_017524	25	356	331	1.00303	0.722707
GCA_014300015.1-Ani_CM025010.1_i000_003699	52	156	104	0.315152	0.219409
GCA_014300015.1-Ani_CM025010.1_i000_003699	155	343	188	0.569697	0.396624
GCA_001712635.2-Pro_MBAC02008046.1_i000_018273	65	426	361	1.09394	0.673507
GCA_022376445.1-Fun_JACBKP010000001.1_i000_000497	93	402	309	0.936364	0.574349
GCA_000743755.1-Pro_JPUL02000132.1_i000_002993	40	360	320	0.969697	0.388821
GCA_018873745.1-Pro_JAENGY010000003.1_i000_009098	89	424	335	1.01515	0.628518
GCA_000497045.1-Fun_KI545851.1_i000_000380	120	450	330	1	0.56701
GCA_021491655.1-Pro_CP090811.1_i000_005998	81	416	335	1.01515	0.639313
GCA_003369635.1-Fun_PDLN01000001.1_i000_000293	123	463	340	1.0303	0.532081
GCA_016695485.1-Fun_MU172282.1_i000_003623	9	318	309	0.936364	0.715278
GCA_003426235.1-Fun_NQIM01000070.1_i000_010810	121	452	331	1.00303	0.719565
GCA_016864775.1-Pro_RCMO01000018.1_i000_001572	92	427	335	1.01515	0.625
GCA_016864795.1-Pro_RCMN01000008.1_i000_000728	92	427	335	1.01515	0.625
GCA_016865085.1-Pro_RCMU01000019.1_i000_008082	92	427	335	1.01515	0.625
GCA_016906365.1-Pro_RCMQ01000011.1_i000_001073	92	427	335	1.01515	0.625
GCA_018873755.1-Pro_JAENGZ010000002.1_i000_006084	92	427	335	1.01515	0.625
GCA_004325045.1-Fun_PITJ01000191.1_i000_000830	83	444	361	1.09394	0.433894
GCA_004918235.1-Fun_SPOE01000016.1_i000_000905	116	440	324	0.981818	0.570423
GCA_000400465.1-Fun_KE007227.1_i000_001160	109	433	324	0.981818	0.57754
GCA_004918755.1-Fun_SPOI01000182.1_i000_001218	112	436	324	0.981818	0.574468
GCA_004917865.1-Fun_SPOD01000017.1_i000_000948	112	436	324	0.981818	0.574468
GCA_004918415.1-Fun_SPOL01000015.1_i000_000750	112	436	324	0.981818	0.574468
GCA_000003515.2-Fun_CH476616.1_i000_003272	48	385	337	1.02121	0.598579
GCA_000224885.2-Pro_KL998082.1_i000_000783	2	242	240	0.727273	0.816327
GCA_000224905.2-Pro_KN000238.1_i000_001827	2	242	240	0.727273	0.816327
GCA_000256705.2-Pro_ML130728.1_i000_005147	2	242	240	0.727273	0.816327
GCA_004918305.1-Fun_SPOM01000017.1_i000_001004	116	440	324	0.981818	0.570423
GCA_004918335.1-Fun_SPNZ01000007.1_i000_003310	116	440	324	0.981818	0.570423
GCA_004918405.1-Fun_SPOO01000017.1_i000_001005	116	440	324	0.981818	0.570423
GCA_004918655.1-Fun_SPOP01000017.1_i000_001009	116	440	324	0.981818	0.570423
GCA_004918735.1-Fun_SPON01000017.1_i000_001004	116	440	324	0.981818	0.570423
GCA_004918745.1-Fun_SPOJ01000014.1_i000_000674	116	440	324	0.981818	0.570423
GCA_004918885.1-Fun_SPNY01000017.1_i000_001003	116	440	324	0.981818	0.570423
GCA_004917845.1-Fun_SPOB01000014.1_i000_000744	116	440	324	0.981818	0.570423
GCA_004917895.1-Fun_SPOH01000016.1_i000_000906	116	440	324	0.981818	0.570423
GCA_004918015.1-Fun_SPOC01000014.1_i000_000695	116	440	324	0.981818	0.570423
GCA_004918345.1-Fun_SPOA01000014.1_i000_000746	116	440	324	0.981818	0.570423
GCA_004918445.1-Fun_SPOG01000013.1_i000_000585	116	440	324	0.981818	0.570423
GCA_004918455.1-Fun_SPOF01000016.1_i000_000934	116	440	324	0.981818	0.570423
GCA_004918065.1-Fun_SPOQ01000015.1_i000_000796	116	440	324	0.981818	0.570423
GCA_004918315.1-Fun_SPNX01000015.1_i000_000771	116	440	324	0.981818	0.570423
GCA_004918625.1-Fun_SPOK01000016.1_i000_000876	116	440	324	0.981818	0.570423
GCA_004918895.1-Fun_SPOR01000014.1_i000_000684	116	440	324	0.981818	0.570423
GCA_000333075.3-Pro_AOFI03000009.1_i000_011278	95	431	336	1.01818	0.630394
GCA_000785725.3-Pro_JPWU03000007.1_i000_008496	95	431	336	1.01818	0.630394
GCA_000785735.3-Pro_JPWV03000017.1_i000_002241	95	431	336	1.01818	0.630394
GCA_001707905.2-Pro_MAYM02000342.1_i000_007353	95	431	336	1.01818	0.630394
GCA_001712715.2-Pro_MBDN02000009.1_i000_009500	95	431	336	1.01818	0.630394
GCA_000365505.1-Pro_ANIZ01002880.1_i000_016380	36	368	332	1.00606	0.696017
GCA_000509525.1-Pro_KI695036.1_i000_015764	36	368	332	1.00606	0.696017
GCA_004325065.1-Fun_PITI01000321.1_i000_001404	83	444	361	1.09394	0.433894
GCA_000224845.2-Pro_KN044600.1_i000_007842	29	270	241	0.730303	0.74613
GCA_013389825.1-Ani_VWPW01016790.1_i000_006906	1	232	231	0.7	0.643454
GCA_902829315.1-Ani_CADEPM010000006.1_i000_009365	51	385	334	1.01212	0.65748
GCA_001483015.1-Pro_LNFO01001429.1_i000_004084	86	418	332	1.00606	0.629981
GCA_000497125.2-Pro_CM035319.1_i000_003496	99	421	322	0.975758	0.763033
GCA_000816705.1-Ani_KN716153.1_i000_000473	36	377	341	1.03333	0.662136
GCA_001712645.2-Pro_MBAD02002145.1_i000_004615	96	431	335	1.01515	0.628518
GCA_001712705.2-Pro_MBDO02000013.1_i000_001217	96	431	335	1.01515	0.628518
GCA_002307695.1-Fun_KZ293645.1_i000_002307	92	413	321	0.972727	0.611429
GCA_000509465.1-Pro_KI688317.1_i000_015941	86	418	332	1.00606	0.629981
GCA_000509485.1-Pro_KI675081.1_i000_015842	86	418	332	1.00606	0.629981
GCA_000509505.1-Pro_KI681774.1_i000_015624	86	418	332	1.00606	0.629981
GCA_000247585.2-Pro_KI669613.1_i000_017874	86	418	332	1.00606	0.629981
GCA_000365525.1-Pro_ANJA01003037.1_i000_016331	86	418	332	1.00606	0.629981
GCA_000365545.1-Pro_ANIX01003266.1_i000_016223	86	418	332	1.00606	0.629981
GCA_000367145.1-Pro_ANIY01003431.1_i000_016214	86	418	332	1.00606	0.629981
NAPA001.0722.00001.C001_00436	28	131	103	0.312121	0.353952
NAPA001.0722.00001.C001_00436	120	289	169	0.512121	0.580756
GCA_000149755.2-Pro_JH159151.1_i000_001658	97	432	335	1.01515	0.619224
GCA_900618365.1-Ani_UYYF01000082.1_i000_000876	11	372	361	1.09394	0.730769
GCA_001692735.1-Fun_KV744870.1_i000_003404	66	403	337	1.02121	0.579038
GCA_004325035.1-Fun_PIXR01001817.1_i000_002995	84	443	359	1.08788	0.434625
GCA_000224905.2-Pro_KN000265.1_i000_006652	1	210	209	0.633333	0.985849
GCA_001243155.1-Fun_LM651872.1_i000_007545	114	456	342	1.03636	0.636872
NASA002.0722.00001.C001_00875	31	135	104	0.315152	0.353741
NASA002.0722.00001.C001_00875	125	292	167	0.506061	0.568027
GCA_003144295.1-Fun_KZ819634.1_i000_000276	152	446	294	0.890909	0.482759
GCA_009982845.1-Fun_JAADKB010000001.1_i000_000977	97	438	341	1.03333	0.562706
GCA_015178925.1-Fun_WHVC01000082.1_i000_012589	51	177	126	0.381818	0.272138
GCA_015178925.1-Fun_WHVC01000082.1_i000_012589	189	384	195	0.590909	0.421166
GCA_000281045.1-Pro_JH767148.1_i000_006378	55	387	332	1.00606	0.677551
GCA_000142945.1-Pro_DS028121.1_i000_014147	87	421	334	1.01212	0.63138
GCA_019677355.1-Fun_WSLN01000294.1_i000_003048	81	360	279	0.845455	0.601293
GCA_018127125.1-Pla_CM030799.1_i000_034236	1	277	276	0.836364	0.8625
GCA_000002985.3-Ani_BX284601.5_i000_000804	33	384	351	1.06364	0.696429
GCA_000507365.1-Ani_KI668993.1_i000_017090	41	375	334	1.01212	0.673387
GCA_004014815.1-Fun_RYZI01000511.1_i000_008457	96	441	345	1.04545	0.556452
GCA_001482985.1-Pro_LNFP01000126.1_i000_002481	86	418	332	1.00606	0.629981
GCA_001268165.1-Fun_CVQI01005446.1_i000_003638	121	330	209	0.633333	0.17563
GCA_002003505.1-Fun_BDMC01000033.1_i000_009544	96	441	345	1.04545	0.555556
GCA_900002365.1-Fun_LK056664.1_i000_004179	118	455	337	1.02121	0.557947
GCA_904845305.1-Ani_CAJGYM010000001.1_i000_000475	39	377	338	1.02424	0.681452
CAMA001.0722.00001.C001_00703	1	311	310	0.939394	0.925373
GCA_011057905.1-Fun_WUBL01000003.1_i000_005809	89	434	345	1.04545	0.561889
GCA_001632375.1-Fun_KV425882.1_i000_000309	88	418	330	1	0.617978
GCA_009746105.1-Pla_CM019272.1_i000_015480	15	347	332	1.00606	0.666667
GCA_900625125.1-Ani_UYYG01001159.1_i000_002180	38	373	335	1.01515	0.675403
HALO001.0722.00001.C001_03448	28	130	102	0.309091	0.350515
HALO001.0722.00001.C001_03448	121	287	166	0.50303	0.570447
GCA_013368315.1-Fun_JAACJM010000012.1_i000_003135	91	427	336	1.01818	0.619926
GCA_001642005.1-Ani_LWCA01000051.1_i000_004799	46	378	332	1.00606	0.669355
GCA_900343105.1-Fun_OUUZ01000001.1_i000_002913	92	434	342	1.03636	0.5625
GCA_000226115.1-Fun_CP003010.1_i000_003569	92	434	342	1.03636	0.5625
NAGR001.0722.00001.C001_00182	32	135	103	0.312121	0.353952
NAGR001.0722.00001.C001_00182	122	290	168	0.509091	0.57732
GCA_002754855.1-Ani_MRZV01001178.1_i000_002480	119	286	167	0.506061	0.345041
GCA_002754855.1-Ani_MRZV01001178.1_i000_002480	307	437	130	0.393939	0.268595
GCA_022432375.1-Fun_JAJKKK010000056.1_i000_009502	90	435	345	1.04545	0.560065
GCA_001275005.1-Pro_JWZX01001013.1_i000_002535	64	390	326	0.987879	0.663951
GCA_905250045.1-Ani_CAJNOG010000195.1_i000_019237	14	293	279	0.845455	0.713555
GCA_015342445.1-Pla_JACEFO010002050.1_i000_038736	3	293	290	0.878788	0.801105
GCA_002307675.1-Fun_KZ293421.1_i000_006064	88	410	322	0.975758	0.633858
GCA_003144235.1-Fun_KZ819688.1_i000_000172	103	433	330	1	0.56701
GCA_000504015.1-Pla_KI631274.1_i000_016868	58	385	327	0.990909	0.667347
GCA_019448385.1-Pro_JAGTXO010000007.1_i000_000824	75	382	307	0.930303	0.623984
GCA_012295175.1-Pro_WSZM01000007.1_i000_000368	87	421	334	1.01212	0.63138
GCA_012552325.1-Pro_JAACNO010001556.1_i000_011375	87	421	334	1.01212	0.63138
GCA_001179505.1-Pro_CDMY01000270.1_i000_005119	71	398	327	0.990909	0.628846
GCA_000732125.1-Fun_JOWA01000107.1_i000_005196	76	422	346	1.04848	0.574751
GCA_003788565.2-Fun_ML119649.1_i000_001725	92	428	336	1.01818	0.562814
GCA_002081595.1-Pro_JNBR01001584.1_i000_003908	56	388	332	1.00606	0.673428
GCA_900323505.1-Fun_OOIN01000001.1_i000_000410	128	452	324	0.981818	0.544538
GCA_022376555.1-Fun_WTXH01000035.1_i000_006285	91	438	347	1.05152	0.630909
GCA_900617895.1-Ani_UZAF01000288.1_i000_000408	50	385	335	1.01515	0.664683
HALA003.0722.00001.C001_01621	32	130	98	0.29697	0.324503
HALA003.0722.00001.C001_01621	124	299	175	0.530303	0.57947
GCA_000190715.1-Pro_GL871204.1_i000_008387	99	433	334	1.01212	0.630189
NASP005.0722.00001.C001_01286	33	136	103	0.312121	0.34106
NASP005.0722.00001.C001_01286	134	300	166	0.50303	0.549669
GCA_900576705.1-Ani_UXUI01008308.1_i000_005874	23	374	351	1.06364	0.702
NAAE001.0722.00001.C001_02543	33	130	97	0.293939	0.324415
NAAE001.0722.00001.C001_02543	122	296	174	0.527273	0.58194
GCA_000787575.2-Pro_DF837582.1_i000_007224	80	413	333	1.00909	0.64786
GCA_002738505.1-Pla_KZ305019.1_i000_000903	29	321	292	0.884848	0.650334
HARO001.0722.00001.C001_00815	29	123	94	0.284848	0.329825
HARO001.0722.00001.C001_00815	117	284	167	0.506061	0.585965
GCA_900624975.1-Ani_UYYA01000001.1_i000_000015	41	380	339	1.02727	0.679359
GCA_003614675.1-Fun_ML002298.1_i000_001377	1	286	285	0.863636	0.861027
GCA_006013705.1-Pla_RXGB01001096.1_i000_005633	21	339	318	0.963636	0.706667
HASP026.0722.00001.C001_02021	26	122	96	0.290909	0.345324
HASP026.0722.00001.C001_02021	118	277	159	0.481818	0.571942
GCA_900000015.1-Pro_CCYD01000523.1_i000_005820	85	416	331	1.00303	0.629278
GCA_020080795.1-Fun_JAGHQM010000006.1_i000_007159	138	473	335	1.01515	0.498512
HALA002.0722.00001.C001_03187	32	126	94	0.284848	0.315436
HALA002.0722.00001.C001_03187	119	295	176	0.533333	0.590604
GCA_000403515.1-Fun_DF238795.1_i000_003083	130	461	331	1.00303	0.553512
NASP004.0722.00001.C001_00382	28	132	104	0.315152	0.357388
NASP004.0722.00001.C001_00382	122	289	167	0.506061	0.573883
GCA_900618345.1-Ani_UZAJ01006419.1_i000_006610	1	295	294	0.890909	0.715328
GCA_012184315.1-Fun_LDDX01000232.1_i000_004489	83	420	337	1.02121	0.578045
GCA_016618375.1-Pro_JADEVP010000019.1_i000_007469	82	418	336	1.01818	0.638783
HAMA001.0722.00001.C001_00856	34	128	94	0.284848	0.324138
HAMA001.0722.00001.C001_00856	122	289	167	0.506061	0.575862
GCA_000224885.2-Pro_KL998096.1_i000_004665	1	230	229	0.693939	0.870722
GCA_000402015.1-Ani_KE125413.1_i000_012324	35	376	341	1.03333	0.6875
GCA_000688135.1-Ani_JARK01001632.1_i000_034017	35	376	341	1.03333	0.6875
GCA_010093885.1-Fun_ML995512.1_i000_010795	46	385	339	1.02727	0.59894
GCA_918797485.1-Pro_CAKKNE010000002.1_i000_006140	59	395	336	1.01818	0.662722
GCA_000816745.1-Ani_KN730822.1_i000_009063	17	376	359	1.08788	0.72379
SASP032.0722.00001.C001_01414	28	130	102	0.309091	0.366906
SASP032.0722.00001.C001_01414	117	278	161	0.487879	0.579137
GCA_000151545.2-Pro_KK583226.1_i000_009598	55	386	331	1.00303	0.672764
GCA_000517465.1-Fun_AWNI01000008.1_i000_001773	123	452	329	0.99697	0.562393
GCA_000221225.1-Fun_GL988037.1_i000_000968	82	426	344	1.04242	0.566722
NAOC001.0722.00001.C001_03740	33	130	97	0.293939	0.337979
NAOC001.0722.00001.C001_03740	123	285	162	0.490909	0.56446
GCA_003336725.1-Ani_JOJR01000852.1_i000_019906	17	376	359	1.08788	0.72379
GCA_000226545.1-Fun_CU633867.1_i000_001138	76	425	349	1.05758	0.580699
GCA_004918105.1-Fun_QZBS01000687.1_i000_009045	120	459	339	1.02727	0.535545
GCA_004917145.1-Fun_QZAE01000935.1_i000_010311	120	459	339	1.02727	0.535545
GCA_009194965.1-Fun_VSMA01000021.1_i000_009954	87	428	341	1.03333	0.569282
GCA_004917225.1-Fun_QZAH01000974.1_i000_010254	120	459	339	1.02727	0.533858
GCA_004917305.1-Fun_QZAP01000215.1_i000_004153	120	459	339	1.02727	0.533858
GCA_012184305.1-Fun_LDUB01000081.1_i000_003713	15	327	312	0.945455	0.63286
GCA_003843895.1-Pro_QKXF01000081.1_i000_000731	81	416	335	1.01515	0.639313
GCA_003704535.1-Pro_QLLG01000204.1_i000_002288	81	416	335	1.01515	0.639313
GCA_000277445.1-Pro_AJWJ01000045.1_i000_001794	63	415	352	1.06667	0.695652
GCA_002105065.1-Fun_MCFC01000091.1_i000_007765	90	423	333	1.00909	0.612132
HAHU002.0722.00001.C001_01473	27	130	103	0.312121	0.371841
HAHU002.0722.00001.C001_01473	112	277	165	0.5	0.595668
GCA_004917165.1-Fun_QZAK01000457.1_i000_007781	120	459	339	1.02727	0.535545
GCA_013397755.1-Ani_VZTF01000341.1_i000_000495	1	233	232	0.70303	0.64986
GCA_003260655.2-Pla_QGKV02000297.1_i000_007827	42	160	118	0.357576	0.23092
GCA_003260655.2-Pla_QGKV02000297.1_i000_007827	150	400	250	0.757576	0.489237
GCA_020080175.1-Fun_JAGHQL010000047.1_i000_005361	107	440	333	1.00909	0.525237
HASP045.0722.00001.C001_00399	31	126	95	0.287879	0.336879
HASP045.0722.00001.C001_00399	116	282	166	0.50303	0.588652
GCA_000226095.1-Fun_CP003002.1_i000_001197	95	435	340	1.0303	0.555556
GCA_911649665.1-Fun_CAJVRL010000038.1_i000_002264	92	432	340	1.0303	0.559211
HASP035.0722.00001.C001_00202	28	122	94	0.284848	0.314381
HASP035.0722.00001.C001_00202	127	297	170	0.515152	0.568562
GCA_000224865.2-Pro_KN044642.1_i000_005990	1	194	193	0.584848	0.984694
GCA_000256725.2-Pro_KQ983279.1_i000_004317	1	194	193	0.584848	0.984694
GCA_018446385.1-Pla_CM031517.1_i000_036336	63	274	211	0.639394	0.764493
GCA_010093925.1-Fun_ML994620.1_i000_006185	65	402	337	1.02121	0.588133
GCA_009732905.1-Pro_QXFV01000060.1_i000_001848	95	430	335	1.01515	0.622677
GCA_009732945.1-Pro_QXFU01000060.1_i000_001918	95	430	335	1.01515	0.622677
GCA_009733145.1-Pro_QXFT01000088.1_i000_002729	95	430	335	1.01515	0.622677
GCA_002271885.2-Pla_CM008447.1_i000_013171	133	279	146	0.442424	0.286837
GCA_002271885.2-Pla_CM008447.1_i000_013171	295	435	140	0.424242	0.275049
GCA_003061485.1-Pla_CM009750.1_i000_007865	1	186	185	0.560606	0.860465
GCA_005498985.1-Fun_CM016669.1_i000_000589	125	455	330	1	0.547264
GCA_003704575.1-Fun_QWIN01001199.1_i000_001495	1	210	209	0.633333	0.567935
GCA_001720245.1-Fun_AWGL01000010.1_i000_000837	101	438	337	1.02121	0.608303
GCA_001720195.1-Fun_AWGK01000034.1_i000_004506	101	438	337	1.02121	0.608303
GCA_022376655.1-Fun_JAJJKE010000003.1_i000_005381	91	436	345	1.04545	0.561889
GCA_004917525.1-Fun_QZBG01001000.1_i000_010734	120	459	339	1.02727	0.536392
GCA_022376525.1-Fun_WTXL01000008.1_i000_011566	91	414	323	0.978788	0.612903
GCA_004768795.1-Fun_SKBN01000345.1_i000_006571	89	434	345	1.04545	0.560976
GCA_021399445.1-Fun_JAJTUQ010000004.1_i000_011047	92	434	342	1.03636	0.559738
GCA_900290415.1-Fun_LR026964.1_i000_001446	61	425	364	1.10303	0.605657
GCA_013368555.1-Fun_JAACJN010000005.1_i000_001431	93	443	350	1.06061	0.628366
GCA_003287315.1-Pro_MJFZ01000023.1_i000_008276	92	427	335	1.01515	0.625
GCA_016864635.1-Pro_RCME01000007.1_i000_000627	92	427	335	1.01515	0.625
GCA_016864655.1-Pro_NHQK01000086.1_i000_027639	92	427	335	1.01515	0.625
GCA_016864665.1-Pro_RCMF01000013.1_i000_001212	92	427	335	1.01515	0.625
GCA_016864695.1-Pro_RCMG01000012.1_i000_001180	92	427	335	1.01515	0.625
GCA_016864715.1-Pro_RCMK01000012.1_i000_001119	92	427	335	1.01515	0.625
GCA_016864735.1-Pro_RCMI01000010.1_i000_000894	92	427	335	1.01515	0.625
GCA_016864755.1-Pro_RCMH01000014.1_i000_001515	92	427	335	1.01515	0.625
GCA_016864815.1-Pro_RCML01000009.1_i000_000871	92	427	335	1.01515	0.625
GCA_016864835.1-Pro_RCMM01000007.1_i000_000699	92	427	335	1.01515	0.625
GCA_016864855.1-Pro_RCMP01000011.1_i000_001135	92	427	335	1.01515	0.625
GCA_016865055.1-Pro_RCMV01000004.1_i000_000306	92	427	335	1.01515	0.625
GCA_016865075.1-Pro_RCMT01000008.1_i000_025270	92	427	335	1.01515	0.625
GCA_017309695.1-Pro_RCMJ01000030.1_i000_003025	92	427	335	1.01515	0.625
GCA_003611215.1-Fun_MCBR01018864.1_i000_005187	92	436	344	1.04242	0.548644
MEAR001.0722.00001.C001_02894	36	297	261	0.790909	0.878788
GCA_000250965.2-Pro_KQ973610.1_i000_001223	1	235	234	0.709091	0.910506
GCA_900073065.1-Fun_FJOG01000017.1_i000_010792	87	432	345	1.04545	0.565574
GCA_002220235.1-Pla_FO082261.1_i000_007605	80	419	339	1.02727	0.633645
GCA_014066315.1-Fun_JACCJB010000015.1_i000_002540	97	433	336	1.01818	0.556291
GCA_000721755.1-Fun_KL584762.1_i000_006374	77	429	352	1.06667	0.581818
GCA_004917825.1-Fun_QZBZ01000377.1_i000_006742	120	459	339	1.02727	0.536392
GCA_004917205.1-Fun_QZAN01000175.1_i000_003137	120	459	339	1.02727	0.535545
GCA_004917705.1-Fun_QZBK01001681.1_i000_002933	120	459	339	1.02727	0.535545
GCA_004917555.1-Fun_QZBJ01000065.1_i000_008652	120	459	339	1.02727	0.535545
GCA_004917815.1-Fun_QZBQ01000455.1_i000_007866	120	459	339	1.02727	0.535545
GCA_004918215.1-Fun_QZBP01000905.1_i000_009923	120	459	339	1.02727	0.535545
GCA_004918275.1-Fun_QZBR01000148.1_i000_002551	120	459	339	1.02727	0.535545
GCA_004917185.1-Fun_QZAL01000391.1_i000_007102	120	459	339	1.02727	0.535545
GCA_004917445.1-Fun_QZBB01000198.1_i000_003771	120	459	339	1.02727	0.535545
GCA_004917135.1-Fun_QZAJ01000745.1_i000_009270	120	459	339	1.02727	0.535545
GCA_903819465.1-Fun_CAIJDR010000005.1_i000_004019	120	459	339	1.02727	0.533858
GCA_004917755.1-Fun_QZBO01000327.1_i000_006076	120	459	339	1.02727	0.533858
GCA_004918145.1-Fun_QZBV01000423.1_i000_007247	120	459	339	1.02727	0.533858
GCA_000224805.2-Pro_KN040001.1_i000_006577	1	235	234	0.709091	0.910506
GCA_004000055.1-Fun_SAEB01000007.1_i000_009534	90	419	329	0.99697	0.564322
GCA_004918505.1-Fun_QZCB01000847.1_i000_009784	120	459	339	1.02727	0.535545
GCA_004917595.1-Fun_QZAQ01002523.1_i000_005025	89	430	341	1.03333	0.593043
GCA_000149335.2-Fun_GG704915.1_i000_001724	95	430	335	1.01515	0.550082
GCA_000149895.1-Fun_DS028099.1_i000_001462	95	430	335	1.01515	0.550082
GCA_000150085.1-Fun_DS268200.1_i000_001366	95	430	335	1.01515	0.550082
GCA_004115165.2-Fun_RHJW02000005.1_i000_006247	95	430	335	1.01515	0.550082
GCA_911693285.1-Fun_CAJVRM010000049.1_i000_001990	92	432	340	1.0303	0.559211
GCA_000151335.1-Fun_ACFW01000001.1_i000_007220	96	430	334	1.01212	0.549342
GCA_003611235.1-Fun_MCBS01024610.1_i000_005323	92	436	344	1.04242	0.548644
GCA_000150055.1-Fun_DS268113.1_i000_001753	96	430	334	1.01212	0.549342
GCA_000170175.2-Fun_GL636491.1_i000_004741	96	430	334	1.01212	0.549342
GCA_018416015.1-Fun_CP075071.1_i000_007259	96	430	334	1.01212	0.549342
GCA_004918575.1-Fun_QZBY01000919.1_i000_010178	120	459	339	1.02727	0.536392
GCA_004917625.1-Fun_QZBC01000186.1_i000_002659	120	459	339	1.02727	0.536392
GCA_004917505.1-Fun_QZBF01000913.1_i000_010050	120	459	339	1.02727	0.535545
GCA_000747765.1-Fun_DF830068.1_i000_006379	123	452	329	0.99697	0.562393
GCA_900322835.1-Fun_OOIQ01000001.1_i000_000530	123	452	329	0.99697	0.562393
GCA_003611195.1-Fun_MCBQ01001246.1_i000_000489	92	436	344	1.04242	0.548644
GCA_000803305.1-Ani_JPKZ01000956.1_i000_004653	40	372	332	1.00606	0.673428
GCA_010093705.1-Fun_MU006090.1_i000_001785	64	433	369	1.11818	0.621212
GCA_004917685.1-Fun_QZBI01001960.1_i000_003633	89	430	341	1.03333	0.565506
GCA_004786125.1-Fun_PQXH01000097.1_i000_007415	97	436	339	1.02727	0.553018
NAVE001.0722.00001.C001_01936	28	130	102	0.309091	0.352941
NAVE001.0722.00001.C001_01936	120	287	167	0.506061	0.577855
GCA_003795275.1-Fun_LJZO01000016.1_i000_004409	87	430	343	1.03939	0.566942
GCA_004379285.1-Fun_PHWZ01000193.1_i000_006454	95	436	341	1.03333	0.556281
GCA_004918195.1-Fun_QZCA01000216.1_i000_003778	121	459	338	1.02424	0.53481
GCA_004917105.1-Fun_QZAF01000781.1_i000_009310	121	459	338	1.02424	0.533965
GCA_004917275.1-Fun_QZAO01000690.1_i000_008978	121	459	338	1.02424	0.533965
GCA_004917795.1-Fun_QZBL01000942.1_i000_010259	121	459	338	1.02424	0.533965
GCA_004917115.1-Fun_QZAI01002787.1_i000_006451	121	459	338	1.02424	0.533965
HASA003.0722.00001.C001_03693	32	132	100	0.30303	0.338983
HASA003.0722.00001.C001_03693	120	293	173	0.524242	0.586441
GCA_900622545.1-Ani_UYWY01020010.1_i000_008820	40	373	333	1.00909	0.651663
GCA_009732865.1-Fun_ML769333.1_i000_005439	91	436	345	1.04545	0.565574
GCA_003260675.2-Pla_QGKX02001290.1_i000_014382	1	206	205	0.621212	0.692568
GCA_000143535.4-Fun_CP009815.1_i000_008275	95	436	341	1.03333	0.556281
GCA_022432385.1-Fun_JAJJXC010000009.1_i000_013024	89	433	344	1.04242	0.569536
GCA_004917495.1-Fun_QZBE01000033.1_i000_005659	119	459	340	1.0303	0.537125
GCA_002865625.1-Fun_KZ613499.1_i000_011267	92	437	345	1.04545	0.564648
GCA_004917155.1-Fun_QZAG01002437.1_i000_004775	120	459	339	1.02727	0.535545
GCA_004917385.1-Fun_QZAV01000312.1_i000_005592	120	459	339	1.02727	0.536392
GCA_004917415.1-Fun_QZAX01001634.1_i000_002715	120	459	339	1.02727	0.536392
GCA_004918535.1-Fun_QZBU01002401.1_i000_006411	120	459	339	1.02727	0.535545
GCA_004918245.1-Fun_QZBX01000183.1_i000_003447	120	459	339	1.02727	0.536392
GCA_004917335.1-Fun_QZAR01000252.1_i000_004982	120	459	339	1.02727	0.536392
GCA_004917425.1-Fun_QZAZ01000420.1_i000_006679	120	459	339	1.02727	0.536392
GCA_004917745.1-Fun_QZBN01000401.1_i000_006336	120	459	339	1.02727	0.536392
GCA_015251385.1-Fun_JADGIM010000031.1_i000_006136	120	459	339	1.02727	0.536392
GCA_004917375.1-Fun_QZAT01000342.1_i000_006590	120	459	339	1.02727	0.535545
GCA_004917435.1-Fun_QZBA01000463.1_i000_008046	120	459	339	1.02727	0.535545
GCA_004917605.1-Fun_QZAU01000933.1_i000_010295	120	459	339	1.02727	0.535545
GCA_004917665.1-Fun_QZBH01000453.1_i000_007013	120	459	339	1.02727	0.535545
GCA_001678115.1-Fun_LVWM01000282.1_i000_002798	120	459	339	1.02727	0.535545
GCA_004786205.1-Fun_PQXM01000138.1_i000_003969	97	436	339	1.02727	0.553922
GCA_014898435.1-Fun_RCTB01000007.1_i000_005034	97	436	339	1.02727	0.553922
GCA_014898485.1-Fun_RCTC01000017.1_i000_009988	97	436	339	1.02727	0.553922
GCA_014898555.1-Fun_RCSY01000010.1_i000_003831	97	436	339	1.02727	0.553922
GCA_014898465.1-Fun_RCTA01000002.1_i000_001582	96	436	340	1.0303	0.554649
GCA_000827425.1-Fun_KN822008.1_i000_002120	96	414	318	0.963636	0.597744
GCA_004916875.1-Fun_PQXL01000167.1_i000_006005	96	436	340	1.0303	0.554649
GCA_004786245.1-Fun_PQXK01000157.1_i000_008045	97	436	339	1.02727	0.553018
GCA_000418435.1-Fun_KE374161.1_i000_000932	88	433	345	1.04545	0.57309
GCA_900519115.1-Fun_LR026992.1_i000_006342	88	433	345	1.04545	0.57309
GCA_905067625.1-Fun_LR898476.1_i000_005980	88	433	345	1.04545	0.57309
GCA_013461495.1-Fun_JABFCT010000028.1_i000_012162	97	436	339	1.02727	0.553018
GCA_014898295.1-Fun_RCSW01000004.1_i000_002296	97	436	339	1.02727	0.553018
GCA_004786275.1-Fun_PQXN01000227.1_i000_009261	97	436	339	1.02727	0.553018
GCA_000227075.1-Fun_FQ790287.1_i000_005885	95	436	341	1.03333	0.556281
GCA_000349525.1-Fun_KB707857.1_i000_004895	95	436	341	1.03333	0.556281
GCA_000711695.1-Fun_JMSN01000090.1_i000_005060	113	444	331	1.00303	0.548922
GCA_014898285.1-Fun_RCSV01000009.1_i000_007068	97	436	339	1.02727	0.553018
GCA_020169555.1-Pla_CM035018.1_i000_024009	27	346	319	0.966667	0.691974
GCA_020169575.1-Pla_CM035006.1_i000_023906	27	346	319	0.966667	0.691974
GCA_020169585.1-Pla_CM034982.1_i000_023857	27	346	319	0.966667	0.691974
GCA_009613015.1-Fun_VXCB01000133.1_i000_002391	122	465	343	1.03939	0.535937
GCA_001275765.2-Fun_LCTW02000403.1_i000_009528	129	469	340	1.0303	0.532081
HAPA001.0722.00001.C001_03962	30	132	102	0.309091	0.361702
HAPA001.0722.00001.C001_03962	115	282	167	0.506061	0.592199
GCA_004917485.1-Fun_QZBD01000738.1_i000_008986	120	459	339	1.02727	0.535545
GCA_014898425.1-Fun_RCSZ01000008.1_i000_006037	97	436	339	1.02727	0.553018
GCA_903819495.1-Fun_CAIJDT010000008.1_i000_006755	120	459	339	1.02727	0.535545
GCA_004917725.1-Fun_QZBM01000405.1_i000_005752	120	459	339	1.02727	0.535545
GCA_002276285.1-Fun_NLAX01000701.1_i000_006484	74	421	347	1.05152	0.577371
GCA_904066225.2-Ani_CAJFCW020000001.1_i000_001342	48	376	328	0.993939	0.432148
GCA_904067145.1-Ani_CAJFDH010000001.1_i000_001342	48	376	328	0.993939	0.432148
GCA_011745865.1-Pla_VYZZ01009625.1_i000_031194	119	246	127	0.384848	0.254509
GCA_011745865.1-Pla_VYZZ01009625.1_i000_031194	260	411	151	0.457576	0.302605
HARU002.0722.00001.C001_02349	23	117	94	0.284848	0.336918
HARU002.0722.00001.C001_02349	114	277	163	0.493939	0.584229
HASP058.0722.00001.C001_03473	33	127	94	0.284848	0.319728
HASP058.0722.00001.C001_03473	119	292	173	0.524242	0.588435
GCA_000151065.3-Fun_HF943549.1_i000_005177	89	433	344	1.04242	0.571429
GCA_004917255.1-Fun_QZAM01000338.1_i000_006300	89	430	341	1.03333	0.565506
GCA_004917355.1-Fun_QZAS01000050.1_i000_007441	89	430	341	1.03333	0.565506
GCA_004917615.1-Fun_QZAY01000459.1_i000_007492	89	430	341	1.03333	0.565506
GCA_000721785.1-Fun_KL585003.1_i000_010393	89	430	341	1.03333	0.56457
GCA_900237765.1-Fun_UNSH01000001.1_i000_003166	89	433	344	1.04242	0.571429
GCA_002865645.1-Fun_KZ613854.1_i000_012097	8	348	340	1.0303	0.651341
GCA_016771965.1-Pla_CM028699.1_i000_062925	42	160	118	0.357576	0.23092
GCA_016771965.1-Pla_CM028699.1_i000_062925	151	400	249	0.754545	0.48728
GCA_020921065.1-Pla_CM037157.1_i000_020183	14	342	328	0.993939	0.947977
GCA_002812745.2-Fun_NCSJ02000111.1_i000_000512	94	433	339	1.02727	0.554828
GCA_018691715.1-Pro_JAFJYM010000054.1_i000_013818	98	431	333	1.00909	0.616667
GCA_002317995.1-Fun_MVNX01000071.1_i000_006921	47	387	340	1.0303	0.580205
GCA_015679595.1-Fun_JAAAVB010001589.1_i000_002758	1	177	176	0.533333	0.789238
GCA_006912115.1-Fun_VCMJ01003489.1_i000_004402	94	436	342	1.03636	0.545455
GCA_019669835.1-Fun_MU251566.1_i000_007694	91	435	344	1.04242	0.56486
HASP002.0722.00001.C001_01099	28	122	94	0.284848	0.336918
HASP002.0722.00001.C001_01099	113	279	166	0.50303	0.594982
GCA_902602495.3-Pro_CACKRE030005206.1_i000_024746	113	448	335	1.01515	0.607985
GCA_012184295.1-Fun_LDUD01000118.1_i000_005602	88	416	328	0.993939	0.564544
GCA_000146945.2-Fun_CH476628.1_i000_008006	60	399	339	1.02727	0.588542
GCA_000271645.1-Fun_JH711542.1_i000_007381	45	378	333	1.00909	0.667335
GCA_009729455.1-Pro_QWGH01000006.1_i000_029640	95	430	335	1.01515	0.622677
GCA_009732925.1-Pro_QXFW01000265.1_i000_006325	95	430	335	1.01515	0.622677
GCA_009732985.1-Pro_QXGB01000185.1_i000_005353	95	430	335	1.01515	0.622677
GCA_009733005.1-Pro_QXFX01000267.1_i000_006590	95	430	335	1.01515	0.622677
GCA_009733025.1-Pro_QXGA01000057.1_i000_002102	95	430	335	1.01515	0.622677
GCA_009733045.1-Pro_QXGC01000153.1_i000_004431	95	430	335	1.01515	0.622677
GCA_009733065.1-Pro_QXFZ01000184.1_i000_005319	95	430	335	1.01515	0.622677
GCA_009733085.1-Pro_QXGD01000204.1_i000_006014	95	430	335	1.01515	0.622677
GCA_009733105.1-Pro_QXGE01000272.1_i000_006708	95	430	335	1.01515	0.622677
GCA_009194965.1-Fun_VSMA01000003.1_i000_013426	87	428	341	1.03333	0.569282
GCA_009733125.1-Pro_QXFY01000272.1_i000_006757	97	432	335	1.01515	0.62037
GCA_014871845.1-Pla_CM026436.1_i000_011531	46	291	245	0.742424	0.795455
GCA_000803305.1-Ani_JPKZ01002282.1_i000_011742	126	310	184	0.557576	0.4098
GCA_000803305.1-Ani_JPKZ01002282.1_i000_011742	307	422	115	0.348485	0.256125
GCA_019627685.1-Fun_WSTO01000057.1_i000_001001	85	417	332	1.00606	0.629981
GCA_013368375.1-Fun_JAACJP010000001.1_i000_000237	115	443	328	0.993939	0.578483
NAPE001.0722.00001.C001_02099	33	127	94	0.284848	0.314381
NAPE001.0722.00001.C001_02099	126	296	170	0.515152	0.568562
GCA_905337355.1-Fun_CAJPDT010000144.1_i000_010298	127	465	338	1.02424	0.531447
GCA_001857865.1-Fun_CP017826.1_i000_009547	97	436	339	1.02727	0.553018
GCA_012184355.1-Fun_LDUC01000151.1_i000_008130	89	421	332	1.00606	0.568493
GCA_014898535.1-Fun_RCSX01000004.1_i000_002540	96	436	340	1.0303	0.555556
HAAL003.0722.00001.C001_03419	33	130	97	0.293939	0.326599
HAAL003.0722.00001.C001_03419	122	295	173	0.524242	0.582492
HASP025.0722.00001.C001_01541	26	119	93	0.281818	0.333333
HASP025.0722.00001.C001_01541	104	277	173	0.524242	0.620072
GCA_011066875.1-Fun_JAABOE010000008.1_i000_010434	15	342	327	0.990909	0.646245
GCA_011066885.1-Fun_WIWS01000056.1_i000_008737	15	342	327	0.990909	0.646245
GCA_011066985.1-Fun_WIPG01000113.1_i000_001151	15	342	327	0.990909	0.646245
GCA_021399475.1-Fun_JAJTUR010000021.1_i000_006750	92	437	345	1.04545	0.564648
GCA_021399465.1-Fun_JAJTUS010000060.1_i000_013820	92	437	345	1.04545	0.564648
GCA_015852495.1-Fun_JAAAIK010002017.1_i000_003662	1	176	175	0.530303	0.821596
NASP001.0722.00001.C001_00083	28	130	102	0.309091	0.343434
NASP001.0722.00001.C001_00083	120	295	175	0.530303	0.589226
GCA_003357145.1-Fun_NPIC01000001.1_i000_002079	91	434	343	1.03939	0.561375
GCA_001500285.1-Fun_KQ947409.1_i000_003863	90	437	347	1.05152	0.567921
GCA_900162835.1-Fun_LT795054.1_i000_000808	125	455	330	1	0.552764
HALI005.0722.00001.C001_02583	32	110	78	0.236364	0.265306
HALI005.0722.00001.C001_02583	138	294	156	0.472727	0.530612
GCA_000230245.1-Fun_FQ311430.1_i000_000404	125	455	330	1	0.552764
GCA_004117975.1-Fun_SDIL01000084.1_i000_007426	115	448	333	1.00909	0.585237
GCA_015680905.1-Pla_CM027383.1_i000_030609	25	352	327	0.990909	0.720264
GCA_002276475.2-Fun_NCSK02000070.1_i000_007525	123	463	340	1.0303	0.534591
NAAI001.0722.00001.C001_03152	32	128	96	0.290909	0.33218
NAAI001.0722.00001.C001_03152	129	288	159	0.481818	0.550173
GCA_002946385.1-Fun_NJPR01000092.1_i000_010576	95	437	342	1.03636	0.561576
HASP053.0722.00001.C001_00272	31	125	94	0.284848	0.332155
HASP053.0722.00001.C001_00272	116	283	167	0.506061	0.590106
GCA_006381635.2-Pla_VEPZ02001419.1_i000_062088	20	242	222	0.672727	0.917355
GCA_021365295.1-Fun_JAJTIW010000015.1_i000_002830	91	434	343	1.03939	0.565074
GCA_011066745.1-Fun_JAABOH010000116.1_i000_001378	69	397	328	0.993939	0.58467
GCA_011067015.1-Fun_JAABLO010000091.1_i000_011683	69	397	328	0.993939	0.58467
HAPE003.0722.00001.C001_04419	28	124	96	0.290909	0.323232
HAPE003.0722.00001.C001_04419	120	292	172	0.521212	0.579125
GCA_004786145.1-Fun_PQXI01000038.1_i000_003685	97	436	339	1.02727	0.553018
GCA_022179045.1-Fun_BPPX01000024.1_i000_009726	75	417	342	1.03636	0.570952
NASP008.0722.00001.C001_00819	32	137	105	0.318182	0.355932
NASP008.0722.00001.C001_00819	124	294	170	0.515152	0.576271
GCA_011068445.1-Fun_JAAGKP010000056.1_i000_008403	90	419	329	0.99697	0.564322
GCA_004768765.1-Fun_SOZJ01000002.1_i000_003721	90	419	329	0.99697	0.564322
GCA_011066715.1-Fun_WIWQ01000031.1_i000_006279	90	419	329	0.99697	0.564322
GCA_011066735.1-Fun_JAABOI010000093.1_i000_011734	90	419	329	0.99697	0.564322
GCA_011066795.1-Fun_WIWR01000014.1_i000_002231	90	419	329	0.99697	0.564322
GCA_000225545.1-Fun_JH119005.1_i000_000723	85	419	334	1.01212	0.572899
GCA_011066905.1-Fun_WIWT01000044.1_i000_007437	91	419	328	0.993939	0.562607
GCA_011066925.1-Fun_WIPF01000001.1_i000_000014	91	419	328	0.993939	0.562607
GCA_000696135.1-Fun_JMSE01000014.1_i000_000176	87	430	343	1.03939	0.561375
GCA_017366145.1-Fun_JAFJYG010000019.1_i000_000932	92	435	343	1.03939	0.561375
GCA_020379485.1-Pla_CM035460.1_i000_064942	42	160	118	0.357576	0.230469
GCA_020379485.1-Pla_CM035460.1_i000_064942	150	401	251	0.760606	0.490234
GCA_007726485.1-Pla_CM017443.1_i000_021461	50	375	325	0.984848	0.607477
HAHA004.0722.00001.C001_01255	34	128	94	0.284848	0.314381
HAHA004.0722.00001.C001_01255	126	297	171	0.518182	0.571906
GCA_011066845.1-Fun_JAABOJ010000060.1_i000_009798	85	419	334	1.01212	0.572899
GCA_004802695.1-Fun_SGPK01000001.1_i000_000027	606	768	162	0.490909	0.151828
GCA_004802695.1-Fun_SGPK01000001.1_i000_000027	771	950	179	0.542424	0.16776
GCA_000441935.1-Fun_KE525480.1_i000_002019	86	417	331	1.00303	0.568729
GCA_021307315.1-Fun_JAJSPD010000037.1_i000_010204	87	431	344	1.04242	0.570481
GCA_000334475.1-Fun_DF196775.1_i000_002484	123	452	329	0.99697	0.562393
GCA_018855395.1-Fun_JABAJW010008958.1_i000_005477	666	979	313	0.948485	0.285845
GCA_008065275.1-Fun_QKWK01000002.1_i000_000996	92	422	330	1	0.612245
HABO001.0722.00001.C001_01527	33	125	92	0.278788	0.323944
HABO001.0722.00001.C001_01527	116	284	168	0.509091	0.591549
GCA_009835185.1-Pro_VJMH01005579.1_i000_014761	2	211	209	0.633333	0.985849
GCA_014898415.1-Fun_RCTD01000021.1_i000_008236	97	436	339	1.02727	0.552117
NASU002.0722.00001.C001_01525	31	124	93	0.281818	0.333333
NASU002.0722.00001.C001_01525	120	279	159	0.481818	0.569892
GCA_010015735.1-Fun_ML978067.1_i000_002269	64	407	343	1.03939	0.596522
GCA_003942205.1-Fun_RSCE01000006.1_i000_007497	108	471	363	1.1	0.654054
HASP049.0722.00001.C001_01973	34	128	94	0.284848	0.323024
HASP049.0722.00001.C001_01973	124	290	166	0.50303	0.570447
GCA_020746875.1-Fun_JAGTJL010000012.1_i000_002754	93	435	342	1.03636	0.559738
GCA_013054445.1-Fun_JAAMPI010000248.1_i000_007301	92	434	342	1.03636	0.5625
GCA_000149515.1-Ani_DS268926.1_i000_003644	50	386	336	1.01818	0.665347
GCA_004918165.1-Fun_QZBW01000418.1_i000_006789	120	459	339	1.02727	0.536392
GCA_001636715.1-Fun_AZGZ01000028.1_i000_003446	55	430	375	1.13636	0.609756
NASU001.0722.00001.C001_02346	30	131	101	0.306061	0.353147
NASU001.0722.00001.C001_02346	124	283	159	0.481818	0.555944
NASU001.0722.00002.C001_01324	30	131	101	0.306061	0.353147
NASU001.0722.00002.C001_01324	124	283	159	0.481818	0.555944
GCA_001625265.1-Fun_LFIV01000044.1_i000_008652	129	463	334	1.01212	0.517829
HASP014.0722.00001.C001_00299	27	126	99	0.3	0.349823
HASP014.0722.00001.C001_00299	120	283	163	0.493939	0.575972
HAMU001.0722.00001.C001_02249	26	119	93	0.281818	0.333333
HAMU001.0722.00001.C001_02249	105	277	172	0.521212	0.616487
HASP032.0722.00001.C001_02901	26	119	93	0.281818	0.333333
HASP032.0722.00001.C001_02901	105	277	172	0.521212	0.616487
GCA_010183535.1-Ani_CM021144.1_i000_000343	50	386	336	1.01818	0.665347
HALI003.0722.00001.C001_00900	27	120	93	0.281818	0.33574
HALI003.0722.00001.C001_00900	112	277	165	0.5	0.595668
GCA_002918395.1-Fun_PEDP01000009.1_i000_000142	86	429	343	1.03939	0.574539
GCA_003635345.1-Fun_QVQW01000070.1_i000_008103	117	460	343	1.03939	0.54531
GCA_021604985.1-Pla_BQKI01000001.1_i000_002388	8	287	279	0.845455	0.307269
GCA_003795315.1-Fun_LKEA01000002.1_i000_001045	84	428	344	1.04242	0.570481
GCA_021901655.1-Fun_CM038893.1_i000_008193	1	154	153	0.463636	0.962264
GCA_000743665.3-Fun_JMRO03000007.1_i000_003671	93	434	341	1.03333	0.559016
GCA_000417875.1-Fun_KE361633.1_i000_003622	146	475	329	0.99697	0.534959
GCA_900322975.1-Fun_OOIP01000014.1_i000_004890	146	475	329	0.99697	0.534959
GCA_003182015.1-Fun_PYWC01000033.1_i000_004550	121	430	309	0.936364	0.508224
GCA_013400115.1-Ani_VXBP01005116.1_i000_006860	52	356	304	0.921212	0.610442
GCA_002317995.1-Fun_MVNX01000013.1_i000_002204	94	435	341	1.03333	0.559016
GCA_001855235.1-Fun_KV842086.1_i000_008455	86	430	344	1.04242	0.562092
GCA_000503235.1-Fun_KI628568.1_i000_002561	97	436	339	1.02727	0.553018
GCA_000409485.1-Fun_KE145354.1_i000_001830	91	434	343	1.03939	0.565074
GCA_017357885.1-Fun_CP063405.1_i000_000870	97	436	339	1.02727	0.553018
HAXA001.0722.00001.C001_00226	33	127	94	0.284848	0.313333
HAXA001.0722.00001.C001_00226	131	292	161	0.487879	0.536667
GCA_001672515.1-Fun_CM004461.1_i000_011843	123	463	340	1.0303	0.527132
HASA005.0722.00001.C001_02472	27	120	93	0.281818	0.327465
HASA005.0722.00001.C001_02472	110	282	172	0.521212	0.605634
GCA_014805705.1-Fun_SBJP01000141.1_i000_000910	92	397	305	0.924242	0.766332
GCA_001879275.1-Fun_KV875093.1_i000_000800	87	428	341	1.03333	0.571189
GCA_004359215.2-Pro_CM033812.1_i000_005611	96	430	334	1.01212	0.620818
HATU001.0722.00001.C001_02105	32	127	95	0.287879	0.322034
HATU001.0722.00001.C001_02105	121	292	171	0.518182	0.579661
NABA001.0722.00001.C001_03080	32	133	101	0.306061	0.348276
NABA001.0722.00001.C001_03080	127	286	159	0.481818	0.548276
GCA_020169535.1-Pla_CM034994.1_i000_024753	26	345	319	0.966667	0.693478
GCA_011745845.1-Pla_VYZY01011444.1_i000_032812	119	246	127	0.384848	0.255533
GCA_011745845.1-Pla_VYZY01011444.1_i000_032812	260	411	151	0.457576	0.303823
HANO001.0722.00001.C001_01851	27	125	98	0.29697	0.353791
HANO001.0722.00001.C001_01851	112	277	165	0.5	0.595668
GCA_001625285.1-Fun_LFIW01001556.1_i000_002915	173	512	339	1.02727	0.488473
GCA_007821495.1-Fun_QGMH01000234.1_i000_008490	94	437	343	1.03939	0.561375
GCA_002102565.1-Fun_NBSH01000017.1_i000_002826	90	424	334	1.01212	0.615101
GCA_916048055.1-Pla_CAJZHL010000016.1_i000_004644	94	382	288	0.872727	0.57485
GCA_000313795.2-Fun_CACQ02001458.1_i000_003521	90	430	340	1.0303	0.555556
GCA_004920355.1-Fun_MWPZ01000007.1_i000_011413	90	430	340	1.0303	0.555556
GCA_000143925.2-Ani_GL379792.1_i000_002993	51	386	335	1.01515	0.663366
GCA_000143925.2-Ani_GL380135.1_i000_025242	51	386	335	1.01515	0.663366
SASP001.0722.00001.C001_02191	31	124	93	0.281818	0.313131
SASP001.0722.00001.C001_02191	129	296	167	0.506061	0.56229
GCA_011066695.1-Fun_WIRB01000007.1_i000_009913	89	419	330	1	0.566038
GCA_011066565.1-Fun_WIRA01000065.1_i000_009333	89	419	330	1	0.566038
GCA_007825325.1-Fun_QGMG01000518.1_i000_005653	131	469	338	1.02424	0.525661
GCA_003573695.1-Pla_CM010724.1_i000_038528	8	333	325	0.984848	0.735294
GCA_002865655.1-Fun_KZ613937.1_i000_000646	8	348	340	1.0303	0.651341
GCA_003610855.1-Fun_MCFK01003576.1_i000_002453	90	435	345	1.04545	0.574043
GCA_000981605.1-Fun_HF935702.1_i000_008210	95	424	329	0.99697	0.545605
GCA_014621435.1-Fun_JAANBA010000326.1_i000_008585	84	429	345	1.04545	0.577889
GCA_000004555.3-Ani_FR847112.2_i000_001290	51	386	335	1.01515	0.663366
GCA_902728155.2-Pla_CACVBM020001071.1_i000_015814	23	360	337	1.02121	0.721627
GCA_011066575.1-Fun_WIQW01000085.1_i000_011107	89	419	330	1	0.566038
GCA_011066585.1-Fun_WIQY01000048.1_i000_007941	89	419	330	1	0.566038
GCA_011066595.1-Fun_WIQZ01000094.1_i000_010999	89	419	330	1	0.566038
GCA_011066605.1-Fun_WIQX01000084.1_i000_011139	89	419	330	1	0.566038
HAPE002.0722.00001.C001_00097	36	129	93	0.281818	0.315254
HAPE002.0722.00001.C001_00097	121	294	173	0.524242	0.586441
GCA_020747065.1-Fun_JAGMVK010000008.1_i000_015936	93	435	342	1.03636	0.559738
GCA_016771965.1-Pla_CM028699.1_i000_062929	36	154	118	0.357576	0.327778
GCA_016771965.1-Pla_CM028699.1_i000_062929	145	359	214	0.648485	0.594444
GCA_001006365.1-Fun_LCUC01000331.1_i000_005460	87	429	342	1.03636	0.568106
GCA_002920065.1-Fun_PKSL01000171.1_i000_011398	1	154	153	0.463636	0.962264
GCA_003691605.1-Fun_CP033149.1_i000_000837	76	404	328	0.993939	0.602941
GCA_020726485.1-Fun_JAHEWH010000006.1_i000_015348	93	434	341	1.03333	0.561779
GCA_003019875.1-Fun_KZ679010.1_i000_004222	46	383	337	1.02121	0.597518
NAMA001.0722.00001.C001_00673	47	133	86	0.260606	0.267913
NAMA001.0722.00001.C001_00673	124	319	195	0.590909	0.607477
GCA_014065205.1-Fun_JACCEG010000002.1_i000_003204	121	431	310	0.939394	0.509868
GCA_010094025.1-Fun_ML991826.1_i000_008656	61	438	377	1.14242	0.620066
GCA_900074885.1-Fun_FJUW01000004.1_i000_005478	95	437	342	1.03636	0.557912
GCA_900074895.1-Fun_FJVC01000058.1_i000_006883	95	437	342	1.03636	0.557912
GCA_022376515.1-Fun_WTXI01000019.1_i000_004626	91	436	345	1.04545	0.628415
GCA_905066765.1-Fun_CAJHIA010000021.1_i000_006344	96	436	340	1.0303	0.553746
GCA_000827325.1-Fun_KN832875.1_i000_007072	45	386	341	1.03333	0.614414
HALI002.0722.00001.C001_02235	32	132	100	0.30303	0.334448
HALI002.0722.00001.C001_02235	119	297	178	0.539394	0.595318
GCA_019096155.1-Fun_JAHCVI010000001.1_i000_002268	132	468	336	1.01818	0.522551
GCA_000151505.1-Fun_ACYE01000083.1_i000_006482	62	405	343	1.03939	0.629358
GCA_003788595.2-Fun_ML120375.1_i000_005150	116	431	315	0.954545	0.517241
GCA_018855395.1-Fun_JABAJW010009276.1_i000_007791	159	390	231	0.7	0.497845
GCA_004786225.1-Fun_PQXJ01000308.1_i000_008458	97	436	339	1.02727	0.553018
GCA_002081575.1-Pro_JNBS01005268.1_i000_013151	28	353	325	0.984848	0.918079
GCA_014065215.1-Fun_JACCEH010000258.1_i000_005315	116	430	314	0.951515	0.516447
GCA_000209125.2-Pro_DS548389.1_i000_007191	30	362	332	1.00606	0.736142
GCA_000516985.1-Fun_KI912109.1_i000_001533	92	436	344	1.04242	0.569536
HASP061.0722.00001.C001_00946	6	95	89	0.269697	0.347656
HASP061.0722.00001.C001_00946	94	256	162	0.490909	0.632812
GCA_003112345.1-Pla_PKPP01002282.1_i000_021940	98	377	279	0.845455	0.738095
GCA_003112345.1-Pla_PKPP01006970.1_i000_042106	98	377	279	0.845455	0.738095
GCA_000208925.2-Pro_DS571303.1_i000_002548	28	365	337	1.02121	0.743929
GCA_000338855.1-Pro_KB444337.1_i000_002472	28	365	337	1.02121	0.743929
GCA_000344925.1-Pro_KB610214.1_i000_001490	28	365	337	1.02121	0.743929
GCA_000346345.1-Pro_KB638864.1_i000_007081	28	365	337	1.02121	0.743929
GCA_000365475.1-Pro_KB824335.1_i000_004847	28	365	337	1.02121	0.743929
GCA_001662325.1-Pro_BDEQ01000001.1_i000_005776	28	365	337	1.02121	0.743929
GCA_905337325.1-Fun_CAJPDR010000632.1_i000_009397	117	452	335	1.01515	0.538585
GCA_002204255.1-Fun_MZNU01000258.1_i000_003174	93	435	342	1.03636	0.557003
GCA_011058875.1-Fun_SWKT01000156.1_i000_003630	90	435	345	1.04545	0.572139
HASP044.0722.00001.C001_01610	31	125	94	0.284848	0.333333
HASP044.0722.00001.C001_01610	116	282	166	0.50303	0.588652
GCA_900074905.1-Fun_FJUX01000055.1_i000_008793	95	437	342	1.03636	0.557912
GCA_000187425.2-Fun_ADNJ02000012.1_i000_002839	74	419	345	1.04545	0.579832
GCA_000813385.1-Fun_KN714671.1_i000_001418	87	431	344	1.04242	0.567657
MECO001.0722.00001.C001_01837	6	77	71	0.215152	0.288618
MECO001.0722.00001.C001_01837	87	245	158	0.478788	0.642276
HASU001.0722.00001.C001_01600	27	122	95	0.287879	0.341727
HASU001.0722.00001.C001_01600	111	278	167	0.506061	0.600719
HASU001.0722.00002.C001_01598	27	122	95	0.287879	0.341727
HASU001.0722.00002.C001_01598	111	278	167	0.506061	0.600719
GCA_000151145.1-Fun_DS995706.1_i000_001723	63	405	342	1.03636	0.58864
GCA_003614145.1-Fun_KZ988116.1_i000_002441	33	357	324	0.981818	0.677824
GCA_020726505.1-Fun_JAHLEZ010000004.1_i000_015450	80	423	343	1.03939	0.572621
GCA_005350895.1-Fun_PJEX01000003.1_i000_000292	78	417	339	1.02727	0.595782
GCA_003795295.1-Fun_LKEB01000006.1_i000_001983	94	435	341	1.03333	0.559934
GCA_003942215.1-Fun_RSCD01000003.1_i000_006425	153	472	319	0.966667	0.538851
GCA_014066305.1-Fun_JACCJC010000017.1_i000_005062	128	465	337	1.02121	0.529874
GCA_903819115.1-Fun_CAIJCR010000004.1_i000_004202	120	459	339	1.02727	0.535545
GCA_001702395.2-Fun_MAVT02001095.1_i000_009547	88	430	342	1.03636	0.567164
GCA_000231115.1-Fun_JH370147.1_i000_001726	83	400	317	0.960606	0.790524
GCA_022453885.1-Ani_CP092620.1_i000_001113	49	384	335	1.01515	0.408039
GCA_010093515.1-Fun_MU001710.1_i000_010058	86	433	347	1.05152	0.552548
GCA_001027345.1-Fun_KQ087270.1_i000_007459	83	420	337	1.02121	0.617216
GCA_008065305.1-Fun_QKWL01000003.1_i000_004373	83	420	337	1.02121	0.617216
GCA_001619985.1-Fun_KV407454.1_i000_000548	98	439	341	1.03333	0.547352
GCA_000750935.1-Fun_JPKD01003300.1_i000_010137	119	456	337	1.02121	0.573129
GCA_004325075.1-Fun_PITK01000606.1_i000_002788	84	385	301	0.912121	0.781818
GCA_017365405.1-Fun_JAFJYH010000157.1_i000_009511	89	435	346	1.04848	0.566285
GCA_001600855.1-Fun_BCLC01000006.1_i000_003605	153	472	319	0.966667	0.538851
GCA_000798715.1-Fun_JNVN01000894.1_i000_002077	3	309	306	0.927273	0.638831
GCA_000143365.1-Fun_CH408030.1_i000_007971	91	433	342	1.03636	0.564356
GCA_020726465.1-Fun_JAGIZQ010000003.1_i000_005046	91	433	342	1.03636	0.563427
GCA_001263195.1-Fun_KQ412721.1_i000_008562	102	260	158	0.478788	0.282143
GCA_001263195.1-Fun_KQ412721.1_i000_008562	265	444	179	0.542424	0.319643
GCA_019669825.1-Fun_MU253869.1_i000_004320	93	436	343	1.03939	0.565074
GCA_021432625.1-Fun_MU270362.1_i000_008265	92	435	343	1.03939	0.561375
GCA_000334115.1-Fun_KB317705.1_i000_004320	89	418	329	0.99697	0.609259
GCA_006535975.1-Fun_QEAP01000093.1_i000_003603	63	393	330	1	0.657371
GCA_021365275.1-Fun_JAJTIY010000003.1_i000_010510	91	434	343	1.03939	0.566942
GCA_003290485.1-Fun_CP030252.1_i000_001550	76	404	328	0.993939	0.602941
GCA_007825345.1-Fun_QGMK01000198.1_i000_002207	129	468	339	1.02727	0.528861
GCA_001651435.1-Fun_LHPN01000013.1_i000_001965	62	405	343	1.03939	0.589347
GCA_000149035.1-Fun_GG697342.1_i000_003866	88	430	342	1.03636	0.559738
GCA_002573605.1-Fun_PDNA01000038.1_i000_006291	91	430	339	1.02727	0.553018
GCA_002818225.1-Fun_KZ454987.1_i000_000622	72	373	301	0.912121	0.572243
HAFO001.0722.00002.C001_00571	25	119	94	0.284848	0.34058
HAFO001.0722.00002.C001_00571	119	276	157	0.475758	0.568841
GCA_009733165.1-Ani_CM019155.1_i000_016526	114	322	208	0.630303	0.42623
HATI002.0722.00001.C001_00340	28	121	93	0.281818	0.333333
HATI002.0722.00001.C001_00340	112	279	167	0.506061	0.598566
GCA_000151425.1-Fun_GG700661.1_i000_000302	63	405	342	1.03636	0.587629
GCA_000616765.1-Fun_KK203767.1_i000_000302	63	405	342	1.03636	0.587629
GCA_000616805.1-Fun_KK207123.1_i000_000301	63	405	342	1.03636	0.587629
GCA_000616825.1-Fun_KK207687.1_i000_000300	63	405	342	1.03636	0.587629
GCA_000616845.1-Fun_KK208225.1_i000_000300	63	405	342	1.03636	0.587629
GCA_000616865.1-Fun_KK208718.1_i000_000295	63	405	342	1.03636	0.587629
GCA_000616905.1-Fun_KK209163.1_i000_000304	63	405	342	1.03636	0.587629
GCA_000616945.1-Fun_KK209731.1_i000_000304	63	405	342	1.03636	0.587629
GCA_000616965.1-Fun_KK210202.1_i000_000191	63	405	342	1.03636	0.587629
GCA_000616985.1-Fun_KK210552.1_i000_000337	63	405	342	1.03636	0.587629
GCA_000622995.1-Fun_AOLB01000061.1_i000_000301	63	405	342	1.03636	0.587629
GCA_000812105.1-Fun_JPGR01000068.1_i000_006417	63	405	342	1.03636	0.587629
GCA_001651445.1-Fun_LHPM01000016.1_i000_004998	63	405	342	1.03636	0.587629
GCA_001720155.1-Fun_AWGH01000025.1_i000_004055	114	447	333	1.00909	0.592527
GCA_000750795.1-Fun_JPJX01001773.1_i000_005225	89	427	338	1.02424	0.612319
GCA_000151645.1-Fun_FN430363.1_i000_006780	116	430	314	0.951515	0.516447
GCA_004918115.1-Fun_QZBT01000139.1_i000_001906	120	459	339	1.02727	0.535545
GCA_001662585.1-Fun_KV454732.1_i000_010033	120	456	336	1.01818	0.544571
GCA_000328475.2-Fun_CM003140.1_i000_000386	117	456	339	1.02727	0.565943
GCA_000750815.1-Fun_JPJZ01001561.1_i000_008805	89	427	338	1.02424	0.602496
GCA_020726445.1-Fun_JAGJXA010000003.1_i000_004036	95	436	341	1.03333	0.5456
GCA_001662645.1-Fun_KV459369.1_i000_001753	119	456	337	1.02121	0.546191
GCA_003070745.1-Fun_NESQ01000035.1_i000_007272	123	431	308	0.933333	0.505747
GCA_018258275.1-Pla_CM031112.1_i000_039019	27	340	313	0.948485	0.196979
GCA_001662605.1-Fun_KV458831.1_i000_005787	120	456	336	1.01818	0.544571
GCA_000257125.1-Pro_JH926792.1_i000_002775	15	365	350	1.06061	0.772627
GCA_021491975.1-Ani_CP090891.1_i000_001130	51	384	333	1.00909	0.405603
GCA_000818155.1-Fun_CM003099.1_i000_001745	87	431	344	1.04242	0.567657
GCA_007821475.1-Fun_QGMF01000320.1_i000_005222	94	437	343	1.03939	0.563218
GCA_000331365.3-Pla_AMZH03002417.1_i000_010573	1	153	152	0.460606	0.401055
GCA_010015675.1-Fun_ML977004.1_i000_010412	68	409	341	1.03333	0.601411
GCA_008694065.1-Fun_VYXO01000003.1_i000_005599	86	430	344	1.04242	0.565789
HASP041.0722.00001.C001_02904	27	120	93	0.281818	0.332143
HASP041.0722.00001.C001_02904	112	280	168	0.509091	0.6
GCA_002120305.1-Fun_KZ112637.1_i000_010643	26	369	343	1.03939	0.624772
GCA_007825375.1-Fun_QGML01000839.1_i000_004062	94	437	343	1.03939	0.563218
GCA_001720205.1-Fun_AWGJ01000010.1_i000_000962	112	445	333	1.00909	0.594643
GCA_001720235.1-Fun_MEKH01000009.1_i000_007750	119	452	333	1.00909	0.587302
GCA_014904845.1-Fun_MU119259.1_i000_009324	1	281	280	0.848485	0.611354
GCA_021432605.1-Fun_MU271150.1_i000_008210	88	428	340	1.0303	0.569514
GCA_013235015.1-Ani_BGPR01005086.1_i000_097143	123	338	215	0.651515	0.630499
HASP010.0722.00001.C001_00833	32	129	97	0.293939	0.324415
HASP010.0722.00001.C001_00833	126	297	171	0.518182	0.571906
GCA_000150975.2-Fun_DS989827.1_i000_001660	64	405	341	1.03333	0.585911
GCA_001191645.1-Fun_AJIL01000017.1_i000_003205	1	154	153	0.463636	0.962264
HARU004.0722.00001.C001_03707	28	123	95	0.287879	0.322034
HARU004.0722.00001.C001_03707	120	292	172	0.521212	0.583051
GCA_003016335.1-Fun_KZ678129.1_i000_002309	63	406	343	1.03939	0.606007
GCA_000591435.1-Fun_JELW01000009.1_i000_005734	63	407	344	1.04242	0.590051
GCA_002105095.1-Fun_MCFJ01000005.1_i000_009579	92	436	344	1.04242	0.56486
HASP022.0722.00001.C001_03088	27	122	95	0.287879	0.339286
HASP022.0722.00001.C001_03088	112	280	168	0.509091	0.6
GCA_000814965.1-Fun_AZNG01000007.1_i000_009854	74	419	345	1.04545	0.579832
GCA_013426205.1-Fun_CP058938.1_i000_010927	74	419	345	1.04545	0.579832
GCA_000739145.1-Fun_JNNZ01000014.1_i000_001637	74	419	345	1.04545	0.579832
GCA_000814975.1-Fun_AZNF01000011.1_i000_002416	74	419	345	1.04545	0.579832
GCA_022376275.1-Fun_JAJNOH010000003.1_i000_007325	87	433	346	1.04848	0.566285
GCA_002742825.1-Ani_CM008509.1_i000_001619	55	402	347	1.05152	0.413095
GCA_000184105.1-Fun_GL573181.1_i000_001126	162	499	337	1.02121	0.510606
GCA_001641265.1-Fun_KV441390.1_i000_002654	162	499	337	1.02121	0.510606
GCA_020736525.1-Fun_JAHBOE010000001.1_i000_001341	128	469	341	1.03333	0.531153
GCA_000426965.1-Fun_KE384720.1_i000_000909	74	419	345	1.04545	0.579832
GCA_001969505.1-Fun_LSSK01001527.1_i000_005151	81	413	332	1.00606	0.615955
GCA_002120335.1-Fun_KZ111278.1_i000_011015	90	433	343	1.03939	0.559543
GCA_000259595.1-Fun_AHIQ01000018.1_i000_000235	5	216	211	0.639394	0.976852
GCA_000814955.1-Fun_AZNH01000022.1_i000_004791	115	460	345	1.04545	0.542453
GCA_001651215.1-Pro_LXWW01000168.1_i000_003113	66	391	325	0.984848	0.435657
GCA_007821535.1-Fun_QGMI01000053.1_i000_001654	96	437	341	1.03333	0.556281
GCA_022432515.1-Fun_JAJKLA010000001.1_i000_000062	90	433	343	1.03939	0.559543
GCA_013305495.1-Fun_JABUBV010000007.1_i000_012378	109	450	341	1.03333	0.544728
GCA_000616785.1-Fun_KK204356.1_i000_001946	62	405	343	1.03939	0.589347
GCA_000622975.1-Fun_AOKY01000019.1_i000_000219	62	405	343	1.03939	0.589347
GCA_012182645.1-Fun_JAATJQ010000058.1_i000_006187	62	405	343	1.03939	0.589347
GCA_012182655.1-Fun_JAAQVJ010000062.1_i000_006372	62	405	343	1.03939	0.589347
GCA_019359935.1-Fun_JAADCK010000058.1_i000_006159	62	405	343	1.03939	0.589347
GCA_013399305.1-Ani_VXAI01002143.1_i000_004890	3	236	233	0.706061	0.529545
GCA_000151175.1-Fun_DS995747.1_i000_003270	62	405	343	1.03939	0.589347
GCA_000151455.1-Fun_GG698539.1_i000_000518	62	405	343	1.03939	0.589347
GCA_011745365.1-Fun_MU032348.1_i000_006908	94	434	340	1.0303	0.561056
GCA_014595645.1-Fun_JACTAD010000003.1_i000_008151	131	468	337	1.02121	0.525741
GCA_020379485.1-Pla_CM035451.1_i000_021582	43	375	332	1.00606	0.68595
GCA_000814945.1-Fun_AZNE01000017.1_i000_003263	74	419	345	1.04545	0.579832
CAME007.0722.00001.C001_01373	21	297	276	0.836364	0.929293
HASA006.0722.00002.C001_01596	30	127	97	0.293939	0.342756
HASA006.0722.00002.C001_01596	116	282	166	0.50303	0.586572
GCA_001653235.2-Fun_CM008059.1_i000_008624	117	456	339	1.02727	0.535545
GCA_000298775.1-Fun_JH921440.1_i000_005920	92	435	343	1.03939	0.557724
HAAL001.0722.00001.C001_02327	26	119	93	0.281818	0.332143
HAAL001.0722.00001.C001_02327	112	279	167	0.506061	0.596429
GCA_010015805.1-Fun_ML978133.1_i000_010164	67	401	334	1.01212	0.571918
GCA_000750805.1-Fun_JPJY01000093.1_i000_000584	90	426	336	1.01818	0.572402
GCA_001006345.1-Fun_LCWF01000067.1_i000_005535	87	429	342	1.03636	0.557912
GCA_013396695.1-Ani_VWZD01009476.1_i000_009867	1	161	160	0.484848	0.492308
GCA_013396695.1-Ani_VWZD01009476.1_i000_009867	159	229	70	0.212121	0.215385
GCA_002591395.1-Fun_NJES01000862.1_i000_007158	62	405	343	1.03939	0.60708
HARA001.0722.00001.C001_00921	31	117	86	0.260606	0.30605
HARA001.0722.00001.C001_00921	111	281	170	0.515152	0.604982
HAFO001.0722.00001.C001_00579	25	119	94	0.284848	0.34058
HAFO001.0722.00001.C001_00579	119	276	157	0.475758	0.568841
GCA_001662655.1-Fun_KV460236.1_i000_006586	89	426	337	1.02121	0.574106
GCA_000750895.1-Fun_JPKB01001043.1_i000_006271	89	426	337	1.02121	0.574106
GCA_003144125.1-Fun_KZ819188.1_i000_000220	145	458	313	0.948485	0.516502
GCA_000750995.1-Fun_JPKE01002398.1_i000_006488	117	455	338	1.02424	0.651252
GCA_905337345.1-Fun_CAJPDS010000087.1_i000_008672	94	430	336	1.01818	0.541063
GCA_015679495.1-Fun_JAAAUW010003870.1_i000_011150	1	172	171	0.518182	0.826087
GCA_003073865.1-Fun_KZ804255.1_i000_017059	93	435	342	1.03636	0.559738
GCA_000151125.2-Fun_ABSU01000014.1_i000_003436	66	405	339	1.02727	0.582474
GCA_000750875.1-Fun_JPKA01000047.1_i000_000257	99	436	337	1.02121	0.564489
GCA_000209065.1-Pro_CH473548.1_i000_002956	1	195	194	0.587879	0.92381
GCA_002271895.2-Pla_MCIT02002194.1_i000_033596	90	241	151	0.457576	0.321962
GCA_002271895.2-Pla_MCIT02002194.1_i000_033596	241	377	136	0.412121	0.289979
GCA_008704415.1-Fun_VXIS01000237.1_i000_004917	98	426	328	0.993939	0.542149
GCA_006783085.1-Fun_PUHP01000047.1_i000_001176	123	463	340	1.0303	0.527132
GCA_002120325.1-Fun_KZ112928.1_i000_000752	89	432	343	1.03939	0.560458
HATA001.0722.00001.C001_01488	26	125	99	0.3	0.353571
HATA001.0722.00001.C001_01488	111	280	169	0.512121	0.603571
GCA_003019895.1-Fun_KZ678419.1_i000_004353	95	435	340	1.0303	0.554649
GCA_001008285.1-Fun_LCZI01000301.1_i000_001678	93	433	340	1.0303	0.551053
GCA_022432525.1-Fun_JAJKLB010000008.1_i000_009499	89	432	343	1.03939	0.561375
GCA_903819455.1-Fun_CAIJDQ010000009.1_i000_003813	120	460	340	1.0303	0.536278
GCA_002572855.1-Fun_PDND01000065.1_i000_007483	94	434	340	1.0303	0.555556
GCA_000750925.1-Fun_JPKC01003610.1_i000_010962	117	454	337	1.02121	0.584055
HACE001.0722.00001.C001_00825	28	125	97	0.293939	0.352727
HACE001.0722.00001.C001_00825	119	275	156	0.472727	0.567273
GCA_004786265.1-Fun_PQXO01000357.1_i000_006736	98	436	338	1.02424	0.551387
GCA_002271895.2-Pla_CM008435.1_i000_014373	124	271	147	0.445455	0.295181
GCA_002271895.2-Pla_CM008435.1_i000_014373	269	406	137	0.415152	0.2751
HASA006.0722.00001.C001_01871	30	125	95	0.287879	0.335689
HASA006.0722.00001.C001_01871	115	282	167	0.506061	0.590106
GCA_017639395.1-Pla_CM029884.1_i000_025272	43	375	332	1.00606	0.68595
HAME001.0722.00001.C001_01769	27	109	82	0.248485	0.293907
HAME001.0722.00001.C001_01769	112	279	167	0.506061	0.598566
HAME001.0722.00002.C001_02390	27	109	82	0.248485	0.293907
HAME001.0722.00002.C001_02390	112	279	167	0.506061	0.598566
GCA_001662575.1-Fun_KV455065.1_i000_009035	117	455	338	1.02424	0.548701
GCA_015342445.1-Pla_JACEFO010000268.1_i000_003625	9	305	296	0.89697	0.819945
HASP042.0722.00001.C001_01083	27	120	93	0.281818	0.329787
HASP042.0722.00001.C001_01083	108	280	172	0.521212	0.609929
GCA_019321695.1-Fun_JAHWGW010000005.1_i000_005184	88	430	342	1.03636	0.567164
GCA_014621405.1-Fun_JAANBC010000252.1_i000_003584	120	456	336	1.01818	0.531646
GCA_001692915.1-Fun_KV751158.1_i000_014184	66	404	338	1.02424	0.57976
GCA_021399435.1-Fun_JAJTUP010000001.1_i000_000866	93	434	341	1.03333	0.560855
GCA_009299455.1-Fun_VIGI01000015.1_i000_009759	97	436	339	1.02727	0.553018
HAVO001.0722.00001.C001_01650	26	119	93	0.281818	0.332143
HAVO001.0722.00001.C001_01650	118	279	161	0.487879	0.575
GCA_900412535.3-Pla_LS974622.2_i000_027724	42	375	333	1.00909	0.688017
GCA_000180635.4-Ani_CM026579.1_i000_023444	48	384	336	1.01818	0.662722
GCA_000733195.1-Pla_CM002869.1_i000_001202	17	345	328	0.993939	0.735426
GCA_000149845.2-Fun_KE651168.1_i000_003800	48	348	300	0.909091	0.603622
GCA_014904905.1-Fun_MU122107.1_i000_003107	102	432	330	1	0.546358
GCA_016256075.1-Fun_SDVU01000236.1_i000_000807	178	556	378	1.14545	0.418605
GCA_020536535.1-Pro_JAHLWZ010000849.1_i000_012480	55	427	372	1.12727	0.677596
GCA_003711515.1-Fun_ML119058.1_i000_007130	82	428	346	1.04848	0.570957
GCA_904859935.1-Fun_CAJHEQ010000917.1_i000_005834	99	427	328	0.993939	0.3054
GCA_020102295.1-Fun_JACEFI010000009.1_i000_005490	63	407	344	1.04242	0.590051
GCA_011947485.2-Fun_JAATWK020000156.1_i000_003217	127	463	336	1.01818	0.524181
GCA_011075155.1-Fun_JAAJBS010000008.1_i000_008744	89	429	340	1.0303	0.559211
GCA_018906675.1-Fun_JAESDO010000001.1_i000_001562	89	429	340	1.0303	0.559211
GCA_018906765.1-Fun_JAESDN010000001.1_i000_001568	89	429	340	1.0303	0.559211
GCA_018907675.1-Fun_JAESDM010000001.1_i000_001573	89	429	340	1.0303	0.559211
GCA_001563135.1-Fun_JFBX01000267.1_i000_004373	122	462	340	1.0303	0.530421
GCA_000151315.2-Pro_KE346376.1_i000_008354	125	453	328	0.993939	0.551261
GCA_008692225.1-Fun_VICG01000011.1_i000_008933	96	436	340	1.0303	0.584192
GCA_008355005.1-Fun_NIDF01000063.1_i000_006614	117	449	332	1.00606	0.588652
GCA_020746995.1-Fun_JAGPXD010000002.1_i000_005264	80	423	343	1.03939	0.568823
GCA_001563115.1-Fun_JEMN01001685.1_i000_013061	124	462	338	1.02424	0.527301
GCA_000804445.1-Fun_AZHE01000007.1_i000_007682	77	421	344	1.04242	0.573333
GCA_001432165.1-Fun_LGUB01000851.1_i000_002589	95	227	132	0.4	0.285714
GCA_001432165.1-Fun_LGUB01000851.1_i000_002589	258	462	204	0.618182	0.441558
GCA_016098025.1-Fun_JAAAIU010001435.1_i000_002329	255	458	203	0.615152	0.443231
GCA_016906325.1-Fun_RKRL01000007.1_i000_003153	97	436	339	1.02727	0.553018
NALO001.0722.00001.C001_01109	30	123	93	0.281818	0.325175
NALO001.0722.00001.C001_01109	107	284	177	0.536364	0.618881
GCA_011692745.1-Fun_JAACJD010000003.1_i000_004247	63	405	342	1.03636	0.583618
GCA_002572885.1-Fun_PDNC01000058.1_i000_006120	95	435	340	1.0303	0.551053
GCA_000426985.1-Fun_KE385327.1_i000_001688	74	419	345	1.04545	0.579832
GCA_000582985.1-Fun_JARH01000541.1_i000_007024	122	462	340	1.0303	0.530421
GCA_000392275.1-Fun_KB933309.1_i000_007569	117	461	344	1.04242	0.546032
GCA_000150705.2-Fun_KN293997.1_i000_002831	93	435	342	1.03636	0.556098
GCA_003434825.1-Pla_CM010633.1_i000_020224	41	375	334	1.01212	0.690083
GCA_000150475.2-Fun_KN305534.1_i000_003567	93	434	341	1.03333	0.552674
GCA_001713645.1-Fun_LZYO01000018.1_i000_001868	93	434	341	1.03333	0.552674
GCA_000150735.2-Fun_KN275958.1_i000_001829	93	434	341	1.03333	0.552674
HAGI002.0722.00001.C001_01659	26	109	83	0.251515	0.296429
HAGI002.0722.00001.C001_01659	115	280	165	0.5	0.589286
GCA_019924755.1-Fun_JAHFYB010004826.1_i000_014644	119	457	338	1.02424	0.717622
NABR001.0722.00001.C001_01136	30	126	96	0.290909	0.335664
NABR001.0722.00001.C001_01136	107	284	177	0.536364	0.618881
GCA_021901695.1-Fun_CM038875.1_i000_008335	1	154	153	0.463636	0.962264
GCA_001563125.1-Fun_JFFI01001517.1_i000_007554	122	463	341	1.03333	0.531981
GCA_020746835.1-Fun_JAGPNK010000002.1_i000_007068	74	417	343	1.03939	0.578415
GCA_904845875.1-Pla_CAJGYO010000007.1_i000_027979	20	344	324	0.981818	0.715232
GCA_020137385.1-Fun_JACLAE010000011.1_i000_001743	101	422	321	0.972727	0.53411
GCA_000412655.1-Ani_KE164236.1_i000_015173	5	193	188	0.569697	0.734375
GCA_902728155.2-Pla_CACVBM020000222.1_i000_003495	38	212	174	0.527273	0.671815
GCA_019924775.1-Fun_JAHFYC010007391.1_i000_013370	8	349	341	1.03333	0.831707
GCA_011800055.1-Fun_WVTB01000057.1_i000_009518	127	463	336	1.01818	0.524181
GCA_003260565.1-Fun_QKRW01000092.1_i000_010272	96	430	334	1.01212	0.563238
GCA_021432635.1-Fun_MU270073.1_i000_017854	85	427	342	1.03636	0.567164
GCA_003958945.1-Ani_QMKO01003443.1_i000_009774	60	320	260	0.787879	0.546218
GCA_003444635.2-Fun_QOKS01000035.1_i000_009203	114	422	308	0.933333	0.512479
GCA_003790465.1-Fun_ML119182.1_i000_010389	114	422	308	0.933333	0.512479
GCA_903819485.1-Fun_CAIJDU010000006.1_i000_005105	120	460	340	1.0303	0.536278
GCA_000151665.1-Pro_FN668646.1_i000_002462	13	327	314	0.951515	0.693157
GCA_000203815.1-Pro_GL883021.1_i000_008638	103	436	333	1.00909	0.587302
GCA_018902385.1-Fun_JABSSW010000013.1_i000_003508	553	887	334	1.01212	0.314205
HAGI002.0722.00002.C001_01683	26	109	83	0.251515	0.296429
HAGI002.0722.00002.C001_01683	120	280	160	0.484848	0.571429
GCA_021730765.1-Ani_JAIZAO010000089.1_i000_006570	39	366	327	0.990909	0.67562
GCA_001625215.1-Pla_CM004285.1_i000_027836	13	343	330	1	0.795181
HASP004.0722.00001.C001_03169	26	125	99	0.3	0.354839
HASP004.0722.00001.C001_03169	111	279	168	0.509091	0.602151
HASP033.0722.00001.C001_00913	27	119	92	0.278788	0.33213
HASP033.0722.00001.C001_00913	112	277	165	0.5	0.595668
HASP046.0722.00001.C001_00962	27	119	92	0.278788	0.33213
HASP046.0722.00001.C001_00962	112	277	165	0.5	0.595668
GCA_013399635.1-Ani_VXAQ01004441.1_i000_013643	101	264	163	0.493939	0.358242
GCA_013399635.1-Ani_VXAQ01004441.1_i000_013643	297	365	68	0.206061	0.149451
GCA_002573585.1-Fun_PDNB01000024.1_i000_004690	93	433	340	1.0303	0.551053
HASP034.0722.00001.C001_00890	27	119	92	0.278788	0.33213
HASP034.0722.00001.C001_00890	112	277	165	0.5	0.595668
HAUT001.0722.00001.C001_00411	28	121	93	0.281818	0.333333
HAUT001.0722.00001.C001_00411	116	279	163	0.493939	0.584229
GCA_001692895.1-Fun_KV748184.1_i000_003449	66	404	338	1.02424	0.57976
GCA_007866325.1-Fun_SBHS01000007.1_i000_007918	56	398	342	1.03636	0.59375
GCA_002920205.1-Fun_PKSM01000337.1_i000_012939	1	151	150	0.454545	0.993377
HASP063.0722.00001.C001_01125	37	131	94	0.284848	0.316498
HASP063.0722.00001.C001_01125	122	296	174	0.527273	0.585859
GCA_019924295.1-Fun_JAHFXI010000751.1_i000_004063	119	457	338	1.02424	0.610108
GCA_015832175.1-Fun_WJXW01000001.1_i000_000066	66	408	342	1.03636	0.601054
GCA_000956045.1-Fun_KQ030501.1_i000_001273	130	473	343	1.03939	0.531783
GCA_010015585.1-Fun_ML975166.1_i000_007199	89	427	338	1.02424	0.575809
GCA_001578225.1-Fun_LFZO01000179.1_i000_002515	110	431	321	0.972727	0.52451
GCA_019633545.1-Fun_WSUF01000180.1_i000_003615	80	243	163	0.493939	0.29529
GCA_019633545.1-Fun_WSUF01000180.1_i000_003615	247	428	181	0.548485	0.327899
GCA_001937105.1-Fun_MPGH01000058.1_i000_007601	87	429	342	1.03636	0.561576
GCA_001642045.1-Fun_KV441548.1_i000_001984	65	408	343	1.03939	0.600701
GCA_010405405.1-Fun_MU004237.1_i000_007880	49	375	326	0.987879	0.602588
GCA_001636745.1-Fun_AZHC01000021.1_i000_003453	73	417	344	1.04242	0.578151
GCA_010094035.1-Fun_ML987189.1_i000_000062	73	417	344	1.04242	0.595156
GCA_014235925.1-Fun_VUJX01000018.1_i000_006501	88	430	342	1.03636	0.5625
GCA_001572075.1-Fun_JOOL01000017.1_i000_000170	78	431	353	1.0697	0.585406
GCA_001592465.1-Fun_JPDO01000036.1_i000_006374	78	431	353	1.0697	0.585406
GCA_004786065.1-Fun_ML220112.1_i000_000574	58	373	315	0.954545	0.567568
GCA_000187405.1-Fun_GL698538.1_i000_007135	73	419	346	1.04848	0.581513
GCA_019434395.1-Fun_JAGRQL010000409.1_i000_007119	73	419	346	1.04848	0.581513
GCA_019434415.1-Fun_JAGRQK010000021.1_i000_008373	73	419	346	1.04848	0.581513
GCA_019925085.1-Fun_JAHFYT010000031.1_i000_005011	119	457	338	1.02424	0.535658
GCA_019925035.1-Fun_JAHFYQ010000033.1_i000_005273	119	457	338	1.02424	0.53481
GCA_019924185.1-Fun_JAHFXE010000140.1_i000_002388	119	457	338	1.02424	0.53481
GCA_019924895.1-Fun_JAHFYM010000131.1_i000_002706	119	457	338	1.02424	0.53481
GCA_019924905.1-Fun_JAHFYL010000170.1_i000_001685	119	457	338	1.02424	0.535658
GCA_019924725.1-Fun_JAHFYF010000071.1_i000_009064	119	457	338	1.02424	0.535658
GCA_019924825.1-Fun_JAHFYH010000075.1_i000_009099	119	457	338	1.02424	0.535658
GCA_019924835.1-Fun_JAHFYI010000069.1_i000_008866	119	457	338	1.02424	0.535658
GCA_019924415.1-Fun_JAHFXV010000050.1_i000_007067	119	457	338	1.02424	0.53481
GCA_019924115.1-Fun_JAHFXA010001569.1_i000_007013	119	457	338	1.02424	0.53481
GCA_019924135.1-Fun_JAHFXB010000295.1_i000_002561	119	457	338	1.02424	0.53481
GCA_019924155.1-Fun_JAHFXD010000270.1_i000_002413	119	457	338	1.02424	0.53481
GCA_019924215.1-Fun_JAHFXC010000281.1_i000_002322	119	457	338	1.02424	0.53481
GCA_019924275.1-Fun_JAHFXJ010000288.1_i000_002457	119	457	338	1.02424	0.53481
GCA_019924315.1-Fun_JAHFXH010000255.1_i000_002434	119	457	338	1.02424	0.53481
GCA_019924375.1-Fun_JAHFXM010003337.1_i000_011605	119	457	338	1.02424	0.53481
GCA_019924395.1-Fun_JAHFXN010000263.1_i000_002331	119	457	338	1.02424	0.53481
GCA_019924435.1-Fun_JAHFXP010000275.1_i000_002311	119	457	338	1.02424	0.53481
GCA_019924575.1-Fun_JAHFXX010000365.1_i000_002904	119	457	338	1.02424	0.53481
GCA_019924615.1-Fun_JAHFXW010000291.1_i000_002510	119	457	338	1.02424	0.53481
GCA_019924655.1-Fun_JAHFXZ010000287.1_i000_002484	119	457	338	1.02424	0.53481
GCA_019924675.1-Fun_JAHFXY010001607.1_i000_007601	119	457	338	1.02424	0.53481
GCA_019924695.1-Fun_JAHFYA010001600.1_i000_007485	119	457	338	1.02424	0.53481
GCA_019924735.1-Fun_JAHFYD010000293.1_i000_002544	119	457	338	1.02424	0.53481
GCA_019925775.1-Fun_JAHFYE010001759.1_i000_011400	119	457	338	1.02424	0.53481
GCA_019924015.1-Fun_JAHFWZ010000057.1_i000_007783	119	457	338	1.02424	0.535658
GCA_019924555.1-Fun_JAHFXU010000461.1_i000_004777	120	457	337	1.02121	0.534073
GCA_000340215.1-Fun_KB446555.1_i000_002115	65	432	367	1.11212	0.600655
HASP040.0722.00001.C001_01183	27	107	80	0.242424	0.273973
HASP040.0722.00001.C001_01183	124	291	167	0.506061	0.571918
GCA_018360365.1-Fun_SRQA01001197.1_i000_000713	77	421	344	1.04242	0.568595
GCA_002120315.1-Fun_KZ111562.1_i000_006583	89	433	344	1.04242	0.562092
GCA_019924775.1-Fun_JAHFYC010006348.1_i000_012511	40	377	337	1.02121	0.659491
GCA_012980515.1-Fun_JAACLJ010000001.1_i000_000156	66	413	347	1.05152	0.608772
GCA_000350065.2-Fun_AMCV02000011.1_i000_005192	88	431	343	1.03939	0.562295
GCA_004367935.1-Fun_QAPF01000106.1_i000_005934	88	431	343	1.03939	0.562295
GCA_003012295.1-Fun_PXXK01000243.1_i000_008117	78	422	344	1.04242	0.577181
GCA_001831195.1-Fun_MJBS01000022.1_i000_005887	88	429	341	1.03333	0.560855
GCA_019924355.1-Fun_JAHFXO010000113.1_i000_002402	119	457	338	1.02424	0.535658
GCA_019924465.1-Fun_JAHFXQ010002220.1_i000_012332	119	457	338	1.02424	0.535658
GCA_019924485.1-Fun_JAHFXR010000080.1_i000_001779	119	457	338	1.02424	0.535658
GCA_019924185.1-Fun_JAHFXE010001706.1_i000_011075	119	457	338	1.02424	0.535658
GCA_019924195.1-Fun_JAHFXF010000124.1_i000_002194	119	457	338	1.02424	0.535658
GCA_019924255.1-Fun_JAHFXK010000084.1_i000_018537	119	457	338	1.02424	0.535658
GCA_019924995.1-Fun_JAHFYO010000023.1_i000_007566	119	457	338	1.02424	0.535658
GCA_001713695.1-Fun_LYUC01000024.1_i000_003398	93	434	341	1.03333	0.552674
GCA_019924265.1-Fun_JAHFXL010000009.1_i000_006797	95	431	336	1.01818	0.554455
GCA_000230625.1-Fun_JH226132.1_i000_004241	95	431	336	1.01818	0.554455
GCA_001883825.1-Fun_LGRN01000323.1_i000_004393	94	434	340	1.0303	0.551053
GCA_019924535.1-Fun_JAHFXS010000130.1_i000_002377	5	344	339	1.02727	0.65444
GCA_013390195.1-Fun_QPNA01000006.1_i000_009455	127	463	336	1.01818	0.524181
GCA_010094045.1-Fun_ML986595.1_i000_004381	66	404	338	1.02424	0.592982
HAHI002.0722.00001.C001_01511	26	125	99	0.3	0.354839
HAHI002.0722.00001.C001_01511	111	279	168	0.509091	0.602151
HAUR001.0722.00001.C001_00195	28	122	94	0.284848	0.33452
HAUR001.0722.00001.C001_00195	113	280	167	0.506061	0.594306
GCA_014080715.1-Pla_JACERP010000122.1_i000_002020	130	402	272	0.824242	0.510319
GCA_022432365.1-Fun_JAJJXE010000007.1_i000_009356	90	433	343	1.03939	0.558632
GCA_000151355.1-Fun_GG698896.1_i000_000512	74	419	345	1.04545	0.579832
GCA_011947395.2-Fun_JAATWM020000064.1_i000_011701	89	430	341	1.03333	0.560855
GCA_012977835.1-Fun_SDJM01000021.1_i000_004888	122	466	344	1.04242	0.548644
GCA_000151005.2-Fun_DS990637.2_i000_000364	94	434	340	1.0303	0.551948
GCA_017310615.1-Fun_CP069102.1_i000_000561	94	434	340	1.0303	0.551948
GCA_010093895.1-Fun_ML996087.1_i000_006516	90	434	344	1.04242	0.571429
GCA_000446055.1-Fun_AMYD01003649.1_i000_013802	127	463	336	1.01818	0.524181
GCA_022264835.1-Fun_JAIFHY010000018.1_i000_004301	90	429	339	1.02727	0.61413
GCA_021432615.1-Fun_MU270215.1_i000_008131	77	430	353	1.0697	0.580592
GCA_000349385.1-Fun_KB705695.1_i000_001803	96	438	342	1.03636	0.556098
GCA_019924175.1-Fun_JAHFXG010000029.1_i000_004405	87	428	341	1.03333	0.566445
GCA_019924715.1-Fun_JAHFYG010000055.1_i000_007474	87	428	341	1.03333	0.566445
GCA_019924815.1-Fun_JAHFYJ010000074.1_i000_009156	87	428	341	1.03333	0.566445
GCA_019923975.1-Fun_JAHFWY010000060.1_i000_007981	87	428	341	1.03333	0.566445
GCA_019924355.1-Fun_JAHFXO010000410.1_i000_004954	119	458	339	1.02727	0.537242
GCA_019924465.1-Fun_JAHFXQ010000398.1_i000_004622	119	458	339	1.02727	0.537242
GCA_019924485.1-Fun_JAHFXR010000078.1_i000_001754	119	458	339	1.02727	0.537242
GCA_019924535.1-Fun_JAHFXS010000101.1_i000_002094	119	458	339	1.02727	0.537242
HAMA003.0722.00001.C001_00784	26	122	96	0.290909	0.342857
HAMA003.0722.00001.C001_00784	111	280	169	0.512121	0.603571
HAMA003.0722.00002.C001_00369	26	122	96	0.290909	0.342857
HAMA003.0722.00002.C001_00369	111	280	169	0.512121	0.603571
GCA_020744385.1-Fun_JAHBOO010000001.1_i000_001350	122	459	337	1.02121	0.532385
GCA_020726575.1-Fun_JAGSXJ010000015.1_i000_002672	80	423	343	1.03939	0.567881
GCA_004366825.1-Fun_QAPG01000022.1_i000_002243	125	464	339	1.02727	0.527216
GCA_905237085.1-Pro_CAJNNV010028222.1_i000_040942	8	340	332	1.00606	0.736142
GCA_017607445.1-Fun_JAEVHH010000003.1_i000_004835	94	434	340	1.0303	0.551948
GCA_003086725.1-Fun_MBFT01000679.1_i000_005658	46	374	328	0.993939	0.676289
GCA_000319635.2-Fun_ANPB02000008.1_i000_013802	68	409	341	1.03333	0.539557
GCA_009771025.1-Fun_SSNE01000046.1_i000_012344	68	409	341	1.03333	0.539557
GCA_003097675.1-Fun_MBFU01000069.1_i000_001218	46	374	328	0.993939	0.676289
GCA_003097675.1-Fun_MBFU01000772.1_i000_006201	46	374	328	0.993939	0.676289
NAPH001.0722.00001.C001_01039	32	112	80	0.242424	0.285714
NAPH001.0722.00001.C001_01039	117	280	163	0.493939	0.582143
GCA_018360145.1-Fun_SRPY01000034.1_i000_003896	84	429	345	1.04545	0.561889
GCA_010093485.1-Fun_MU001496.1_i000_004325	65	408	343	1.03939	0.600701
GCA_002870075.2-Pla_CM022520.1_i000_009479	7	215	208	0.630303	0.885106
HADO001.0722.00001.C001_01339	24	103	79	0.239394	0.284173
HADO001.0722.00001.C001_01339	112	277	165	0.5	0.593525
GCA_022432505.1-Fun_JAJKKH010000001.1_i000_000127	91	435	344	1.04242	0.56486
GCA_021365335.1-Fun_JAJTIZ010000014.1_i000_003019	49	400	351	1.06364	0.624555
GCA_013390205.1-Fun_QPMX01000006.1_i000_009701	113	455	342	1.03636	0.503682
GCA_010093595.1-Fun_MU003693.1_i000_001576	64	399	335	1.01515	0.581597
GCA_019924155.1-Fun_JAHFXD010000170.1_i000_001734	119	457	338	1.02424	0.535658
GCA_019924215.1-Fun_JAHFXC010000165.1_i000_001568	119	457	338	1.02424	0.535658
GCA_019924275.1-Fun_JAHFXJ010000169.1_i000_001647	119	457	338	1.02424	0.535658
GCA_019924315.1-Fun_JAHFXH010000153.1_i000_001745	119	457	338	1.02424	0.535658
GCA_019924375.1-Fun_JAHFXM010001456.1_i000_006992	119	457	338	1.02424	0.535658
GCA_019924435.1-Fun_JAHFXP010000169.1_i000_001619	119	457	338	1.02424	0.535658
GCA_019924575.1-Fun_JAHFXX010000180.1_i000_001755	119	457	338	1.02424	0.535658
GCA_019924615.1-Fun_JAHFXW010000170.1_i000_001693	119	457	338	1.02424	0.535658
GCA_019924655.1-Fun_JAHFXZ010000177.1_i000_001741	119	457	338	1.02424	0.535658
GCA_019924735.1-Fun_JAHFYD010000184.1_i000_001802	119	457	338	1.02424	0.535658
GCA_013201745.1-Fun_QPMT01000059.1_i000_012717	127	463	336	1.01818	0.524181
GCA_013201755.1-Fun_QPMR01000028.1_i000_008106	127	463	336	1.01818	0.524181
GCA_013201795.1-Fun_QPMS01000066.1_i000_013805	127	463	336	1.01818	0.524181
GCA_013201865.1-Fun_QPMU01000054.1_i000_012813	127	463	336	1.01818	0.524181
HALI001.0722.00001.C001_03437	28	285	257	0.778788	0.856667
GCA_013201905.1-Fun_QPMW01000097.1_i000_012604	127	463	336	1.01818	0.524181
GCA_013201925.1-Fun_QPMY01000082.1_i000_011299	127	463	336	1.01818	0.524181
GCA_013201875.1-Fun_QPMV01000124.1_i000_012664	127	463	336	1.01818	0.524181
GCA_003260655.2-Pla_QGKV02000649.1_i000_025132	44	270	226	0.684848	0.45935
GCA_003260655.2-Pla_QGKV02000649.1_i000_025132	300	396	96	0.290909	0.195122
GCA_013201785.1-Fun_QPMP01000019.1_i000_006621	127	463	336	1.01818	0.524181
HAAE003.0722.00001.C001_01769	6	99	93	0.281818	0.363281
HAAE003.0722.00001.C001_01769	92	256	164	0.49697	0.640625
GCA_010405375.1-Fun_MU004414.1_i000_011165	65	405	340	1.0303	0.588235
GCA_012932255.1-Fun_QLYQ01000591.1_i000_008638	138	478	340	1.0303	0.48433
GCA_002591385.1-Fun_NJEV01001567.1_i000_002371	81	423	342	1.03636	0.569052
GCA_013390185.1-Fun_QPNB01000007.1_i000_010683	127	463	336	1.01818	0.524181
GCA_001578235.1-Fun_LFZN01000431.1_i000_007703	228	570	342	1.03636	0.455393
GCA_014298035.1-Fun_JABCIY010000158.1_i000_007332	94	433	339	1.02727	0.553922
GCA_010093795.1-Fun_MU006573.1_i000_005022	66	406	340	1.0303	0.587219
GCA_000507165.2-Ani_KZ500261.1_i000_016341	11	257	246	0.745455	0.604423
HASA002.0722.00001.C001_01327	27	119	92	0.278788	0.33213
HASA002.0722.00001.C001_01327	112	277	165	0.5	0.595668
GCA_003144205.1-Fun_KZ819611.1_i000_007302	96	409	313	0.948485	0.57963
GCA_019924555.1-Fun_JAHFXU010000341.1_i000_003919	120	457	337	1.02121	0.534073
GCA_019924675.1-Fun_JAHFXY010002528.1_i000_010038	52	393	341	1.03333	0.601411
GCA_019924695.1-Fun_JAHFYA010002771.1_i000_010568	52	393	341	1.03333	0.601411
HALU001.0722.00001.C001_02641	30	124	94	0.284848	0.328671
HALU001.0722.00001.C001_02641	107	285	178	0.539394	0.622378
GCA_000151595.1-Fun_GG749422.1_i000_006786	95	434	339	1.02727	0.549433
GCA_019924755.1-Fun_JAHFYB010000209.1_i000_001891	61	402	341	1.03333	0.592014
GCA_000836255.1-Fun_DF938588.1_i000_003346	117	460	343	1.03939	0.546178
GCA_000333975.2-Fun_CAKM01000132.1_i000_002686	129	319	190	0.575758	0.512129
HASP062.0722.00001.C001_01574	31	124	93	0.281818	0.330961
HASP062.0722.00001.C001_01574	116	281	165	0.5	0.587189
GCA_019924115.1-Fun_JAHFXA010002784.1_i000_010123	65	406	341	1.03333	0.587931
GCA_019924135.1-Fun_JAHFXB010000230.1_i000_002111	66	407	341	1.03333	0.586919
GCA_019925775.1-Fun_JAHFYE010002872.1_i000_014233	70	411	341	1.03333	0.582906
HAHA005.0722.00001.C001_00935	31	286	255	0.772727	0.888502
GCA_004155935.1-Fun_QJNV01000337.1_i000_006750	58	398	340	1.0303	0.591304
GCA_000585565.1-Fun_AMGY01000010.1_i000_009538	90	426	336	1.01818	0.56
GCA_000281105.1-Fun_JH767555.1_i000_000582	132	470	338	1.02424	0.524845
GCA_001660665.1-Fun_LGUA01000148.1_i000_001596	94	434	340	1.0303	0.551948
GCA_019924395.1-Fun_JAHFXN010000208.1_i000_001949	86	426	340	1.0303	0.566667
GCA_018360135.1-Fun_SRPV01002324.1_i000_003515	83	427	344	1.04242	0.563934
GCA_001606155.1-Pro_LODT01000035.1_i000_006308	98	431	333	1.00909	0.617811
GCA_013201765.1-Fun_QPMQ01000009.1_i000_001212	128	463	335	1.01515	0.522621
GCA_000003855.2-Fun_GG657459.1_i000_006023	95	434	339	1.02727	0.549433
GCA_000003525.2-Fun_EQ999977.1_i000_005594	95	434	339	1.02727	0.549433
GCA_000166155.1-Fun_GL538444.1_i000_006893	95	434	339	1.02727	0.549433
GCA_905237095.1-Pro_CAJNNW010000395.1_i000_000581	3	320	317	0.960606	0.735499
GCA_015178995.1-Fun_WHVE01000001.1_i000_000142	54	384	330	1	0.59246
GCA_000146915.2-Fun_CH445334.1_i000_009119	63	399	336	1.01818	0.6
GCA_016801405.1-Fun_CP069032.1_i000_009893	63	399	336	1.01818	0.6
GCA_020557385.1-Fun_JAIRDT010000004.1_i000_002610	63	399	336	1.01818	0.6
GCA_020567955.1-Fun_JAIRGA010000007.1_i000_004539	63	399	336	1.01818	0.6
GCA_020568055.1-Fun_JAIRGC010000009.1_i000_003786	63	399	336	1.01818	0.6
GCA_020568205.1-Fun_JAIRGE010000010.1_i000_005943	63	399	336	1.01818	0.6
GCA_020568415.1-Fun_JAIRDV010000002.1_i000_001296	63	399	336	1.01818	0.6
GCA_020568465.1-Fun_JAIRDW010000016.1_i000_009680	63	399	336	1.01818	0.6
GCA_020568635.1-Fun_JAIRDX010000002.1_i000_001416	63	399	336	1.01818	0.6
GCA_020568765.1-Fun_JAIRDY010000002.1_i000_001899	63	399	336	1.01818	0.6
GCA_020568935.1-Fun_JAIRGH010000005.1_i000_003188	63	399	336	1.01818	0.6
GCA_020568945.1-Fun_JAIRDZ010000001.1_i000_000293	63	399	336	1.01818	0.6
GCA_020569145.1-Fun_JAIREA010000001.1_i000_000318	63	399	336	1.01818	0.6
GCA_020570015.1-Fun_JAIREG010000030.1_i000_012552	63	399	336	1.01818	0.6
GCA_020570345.1-Fun_JAIRGM010000029.1_i000_011903	63	399	336	1.01818	0.6
GCA_020570355.1-Fun_JAIREH010000026.1_i000_010583	63	399	336	1.01818	0.6
GCA_020570395.1-Fun_JAIRGN010000005.1_i000_004343	63	399	336	1.01818	0.6
GCA_020570405.1-Fun_JAIREJ010000003.1_i000_002761	63	399	336	1.01818	0.6
GCA_020570415.1-Fun_JAIRGO010000006.1_i000_005317	63	399	336	1.01818	0.6
GCA_020570635.1-Fun_JAIRGP010000004.1_i000_002796	63	399	336	1.01818	0.6
GCA_020570935.1-Fun_JAIREL010000002.1_i000_001742	63	399	336	1.01818	0.6
GCA_020570965.1-Fun_JAIRGS010000004.1_i000_002934	63	399	336	1.01818	0.6
GCA_020570975.1-Fun_JAIRGT010000007.1_i000_004739	63	399	336	1.01818	0.6
GCA_020571295.1-Fun_JAIRGU010000006.1_i000_004191	63	399	336	1.01818	0.6
GCA_020571325.1-Fun_JAIREN010000004.1_i000_002509	63	399	336	1.01818	0.6
GCA_020571545.1-Fun_JAIREO010000002.1_i000_000939	63	399	336	1.01818	0.6
GCA_020571815.1-Fun_JAIRGX010000012.1_i000_005447	63	399	336	1.01818	0.6
GCA_020571885.1-Fun_JAIRGY010000011.1_i000_006296	63	399	336	1.01818	0.6
GCA_020572205.1-Fun_JAIREQ010000019.1_i000_010402	63	399	336	1.01818	0.6
GCA_020572315.1-Fun_JAIRHB010000007.1_i000_005376	63	399	336	1.01818	0.6
GCA_020572395.1-Fun_JAIRHG010000004.1_i000_002691	63	399	336	1.01818	0.6
GCA_020572635.1-Fun_JAIRHE010000003.1_i000_002933	63	399	336	1.01818	0.6
GCA_020572645.1-Fun_JAIRHF010000014.1_i000_006566	63	399	336	1.01818	0.6
GCA_020572945.1-Fun_JAIRHJ010000015.1_i000_007560	63	399	336	1.01818	0.6
GCA_020573315.1-Fun_JAIRHM010000006.1_i000_003501	63	399	336	1.01818	0.6
GCA_020573595.1-Fun_JAIRHO010000001.1_i000_000495	63	399	336	1.01818	0.6
GCA_020573915.1-Fun_JAIRHR010000010.1_i000_004726	63	399	336	1.01818	0.6
GCA_020574085.1-Fun_JAIRHT010000006.1_i000_004253	63	399	336	1.01818	0.6
GCA_020574295.1-Fun_JAIRHV010000003.1_i000_002152	63	399	336	1.01818	0.6
GCA_020574365.1-Fun_JAIRHW010000004.1_i000_002736	63	399	336	1.01818	0.6
GCA_020574385.1-Fun_JAIRFB010000006.1_i000_003690	63	399	336	1.01818	0.6
GCA_020574825.1-Fun_JAIRIB010000002.1_i000_001590	63	399	336	1.01818	0.6
GCA_020575445.1-Fun_JAIRIJ010000001.1_i000_000486	63	399	336	1.01818	0.6
GCA_020575485.1-Fun_JAIRIK010000006.1_i000_003906	63	399	336	1.01818	0.6
GCA_020578265.1-Fun_JAIRIR010000019.1_i000_009241	63	399	336	1.01818	0.6
GCA_020578295.1-Fun_JAIRIT010000001.1_i000_000484	63	399	336	1.01818	0.6
GCA_020579825.1-Fun_JAIRIY010000007.1_i000_002932	63	399	336	1.01818	0.6
GCA_020579845.1-Fun_JAIRJB010000010.1_i000_005856	63	399	336	1.01818	0.6
GCA_020580415.1-Fun_JAIRFW010000008.1_i000_004731	63	399	336	1.01818	0.6
GCA_020580425.1-Fun_JAIRJH010000007.1_i000_004429	63	399	336	1.01818	0.6
GCA_020580485.1-Fun_JAIRJI010000004.1_i000_003282	63	399	336	1.01818	0.6
GCA_020580725.1-Fun_JAIRJJ010000012.1_i000_007634	63	399	336	1.01818	0.6
GCA_020581165.1-Fun_JAIRJO010000006.1_i000_003055	63	399	336	1.01818	0.6
GCA_020726525.1-Fun_JAGPXC010000001.1_i000_001031	121	462	341	1.03333	0.571189
GCA_903819665.1-Fun_CAIJEO010000008.1_i000_006155	120	456	336	1.01818	0.530806
HASP009.0722.00001.C001_02094	33	135	102	0.309091	0.356643
HASP009.0722.00001.C001_02094	116	285	169	0.512121	0.590909
GCA_000721775.1-Fun_KL584828.1_i000_003178	88	428	340	1.0303	0.563847
GCA_019925005.1-Fun_JAHFYP010000046.1_i000_007116	88	428	340	1.0303	0.563847
GCA_019924425.1-Fun_JAHFXT010000068.1_i000_008720	88	427	339	1.02727	0.562189
GCA_019924195.1-Fun_JAHFXF010000546.1_i000_014804	89	428	339	1.02727	0.562189
GCA_019924255.1-Fun_JAHFXK010000594.1_i000_015440	89	428	339	1.02727	0.562189
GCA_019924895.1-Fun_JAHFYM010000086.1_i000_017728	89	428	339	1.02727	0.562189
GCA_019924995.1-Fun_JAHFYO010000611.1_i000_015371	89	428	339	1.02727	0.562189
GCA_000204055.1-Fun_GL883170.1_i000_014558	26	361	335	1.01515	0.692149
GCA_020568045.1-Fun_JAIRGB010000006.1_i000_003424	63	399	336	1.01818	0.6
GCA_020568325.1-Fun_JAIRDU010000004.1_i000_002705	63	399	336	1.01818	0.6
GCA_020568705.1-Fun_JAIRGF010000005.1_i000_003138	63	399	336	1.01818	0.6
GCA_020569285.1-Fun_JAIREC010000009.1_i000_006147	63	399	336	1.01818	0.6
GCA_020569485.1-Fun_JAIRGI010000001.1_i000_000482	63	399	336	1.01818	0.6
GCA_020569495.1-Fun_JAIRED010000009.1_i000_005993	63	399	336	1.01818	0.6
GCA_020569505.1-Fun_JAIREE010000005.1_i000_003706	63	399	336	1.01818	0.6
GCA_020569515.1-Fun_JAIRGJ010000013.1_i000_007869	63	399	336	1.01818	0.6
GCA_020569685.1-Fun_JAIRGK010000020.1_i000_009473	63	399	336	1.01818	0.6
GCA_020569895.1-Fun_JAIRGL010000006.1_i000_003868	63	399	336	1.01818	0.6
GCA_020569945.1-Fun_JAIREF010000002.1_i000_001167	63	399	336	1.01818	0.6
GCA_020570045.1-Fun_JAIREI010000006.1_i000_004304	63	399	336	1.01818	0.6
GCA_020570525.1-Fun_JAIREK010000006.1_i000_003955	63	399	336	1.01818	0.6
GCA_020570685.1-Fun_JAIRGQ010000002.1_i000_001281	63	399	336	1.01818	0.6
GCA_020570735.1-Fun_JAIRGR010000005.1_i000_003382	63	399	336	1.01818	0.6
GCA_020571265.1-Fun_JAIREM010000005.1_i000_003042	63	399	336	1.01818	0.6
GCA_020571575.1-Fun_JAIRGV010000003.1_i000_002076	63	399	336	1.01818	0.6
GCA_020571605.1-Fun_JAIRGW010000005.1_i000_003143	63	399	336	1.01818	0.6
GCA_020571895.1-Fun_JAIREP010000014.1_i000_009133	63	399	336	1.01818	0.6
GCA_020571965.1-Fun_JAIRGZ010000006.1_i000_004201	63	399	336	1.01818	0.6
GCA_020572075.1-Fun_JAIRHA010000003.1_i000_001890	63	399	336	1.01818	0.6
GCA_020572305.1-Fun_JAIRHC010000007.1_i000_004406	63	399	336	1.01818	0.6
GCA_020572345.1-Fun_JAIRHD010000012.1_i000_008085	63	399	336	1.01818	0.6
GCA_020572675.1-Fun_JAIRHH010000005.1_i000_002513	63	399	336	1.01818	0.6
GCA_020572955.1-Fun_JAIRHI010000003.1_i000_002187	63	399	336	1.01818	0.6
GCA_020572985.1-Fun_JAIRER010000005.1_i000_003169	63	399	336	1.01818	0.6
GCA_020572995.1-Fun_JAIRES010000016.1_i000_008615	63	399	336	1.01818	0.6
GCA_020573275.1-Fun_JAIRHK010000028.1_i000_012172	63	399	336	1.01818	0.6
GCA_020573285.1-Fun_JAIRHL010000027.1_i000_013256	63	399	336	1.01818	0.6
GCA_020573325.1-Fun_JAIRET010000016.1_i000_010784	63	399	336	1.01818	0.6
GCA_020573495.1-Fun_JAIRHN010000021.1_i000_009339	63	399	336	1.01818	0.6
GCA_020573605.1-Fun_JAIRHP010000026.1_i000_010569	63	399	336	1.01818	0.6
GCA_020573625.1-Fun_JAIRHQ010000020.1_i000_010027	63	399	336	1.01818	0.6
GCA_020573725.1-Fun_JAIREU010000002.1_i000_001384	63	399	336	1.01818	0.6
GCA_020573765.1-Fun_JAIREV010000031.1_i000_012979	63	399	336	1.01818	0.6
GCA_020574055.1-Fun_JAIRHS010000010.1_i000_006062	63	399	336	1.01818	0.6
GCA_020574115.1-Fun_JAIRHU010000008.1_i000_005459	63	399	336	1.01818	0.6
GCA_020574145.1-Fun_JAIREW010000003.1_i000_003225	63	399	336	1.01818	0.6
GCA_020574155.1-Fun_JAIREX010000001.1_i000_000321	63	399	336	1.01818	0.6
GCA_020574265.1-Fun_JAIREY010000001.1_i000_000484	63	399	336	1.01818	0.6
GCA_020574345.1-Fun_JAIREZ010000002.1_i000_002058	63	399	336	1.01818	0.6
GCA_020574405.1-Fun_JAIRHY010000012.1_i000_006361	63	399	336	1.01818	0.6
GCA_020574595.1-Fun_JAIRHX010000001.1_i000_000638	63	399	336	1.01818	0.6
GCA_020574715.1-Fun_JAIRFC010000020.1_i000_010511	63	399	336	1.01818	0.6
GCA_020574725.1-Fun_JAIRFD010000002.1_i000_001605	63	399	336	1.01818	0.6
GCA_020574875.1-Fun_JAIRIC010000010.1_i000_006098	63	399	336	1.01818	0.6
GCA_020575035.1-Fun_JAIRFE010000011.1_i000_007440	63	399	336	1.01818	0.6
GCA_020575105.1-Fun_JAIRID010000014.1_i000_007831	63	399	336	1.01818	0.6
GCA_020575195.1-Fun_JAIRIE010000032.1_i000_012307	63	399	336	1.01818	0.6
GCA_020575285.1-Fun_JAIRIF010000004.1_i000_002514	63	399	336	1.01818	0.6
GCA_020575355.1-Fun_JAIRIH010000001.1_i000_000318	63	399	336	1.01818	0.6
GCA_020575375.1-Fun_JAIRIG010000015.1_i000_008174	63	399	336	1.01818	0.6
GCA_020575615.1-Fun_JAIRIL010000013.1_i000_005641	63	399	336	1.01818	0.6
GCA_020575645.1-Fun_JAIRIM010000002.1_i000_001369	63	399	336	1.01818	0.6
GCA_020575955.1-Fun_JAIRIO010000014.1_i000_005503	63	399	336	1.01818	0.6
GCA_020575995.1-Fun_JAIRIP010000023.1_i000_010885	63	399	336	1.01818	0.6
GCA_020576185.1-Fun_JAIRIQ010000012.1_i000_007101	63	399	336	1.01818	0.6
GCA_020576195.1-Fun_JAIRFG010000003.1_i000_001984	63	399	336	1.01818	0.6
GCA_020576365.1-Fun_JAIRFI010000006.1_i000_003702	63	399	336	1.01818	0.6
GCA_020577795.1-Fun_JAIRFH010000008.1_i000_004842	63	399	336	1.01818	0.6
GCA_020577805.1-Fun_JAIRFJ010000010.1_i000_006221	63	399	336	1.01818	0.6
GCA_020577855.1-Fun_JAIRFK010000002.1_i000_001039	63	399	336	1.01818	0.6
GCA_020577905.1-Fun_JAIRFL010000017.1_i000_008518	63	399	336	1.01818	0.6
GCA_020577915.1-Fun_JAIRFM010000019.1_i000_008953	63	399	336	1.01818	0.6
GCA_020578075.1-Fun_JAIRFO010000010.1_i000_005696	63	399	336	1.01818	0.6
GCA_020578085.1-Fun_JAIRFN010000015.1_i000_007914	63	399	336	1.01818	0.6
GCA_020578095.1-Fun_JAIRFP010000009.1_i000_004926	63	399	336	1.01818	0.6
GCA_020578105.1-Fun_JAIRFQ010000020.1_i000_008797	63	399	336	1.01818	0.6
GCA_020578115.1-Fun_JAIRFR010000008.1_i000_003892	63	399	336	1.01818	0.6
GCA_020578315.1-Fun_JAIRIS010000018.1_i000_008920	63	399	336	1.01818	0.6
GCA_020578375.1-Fun_JAIRFT010000008.1_i000_005860	63	399	336	1.01818	0.6
GCA_020578445.1-Fun_JAIRIU010000018.1_i000_008173	63	399	336	1.01818	0.6
GCA_020578515.1-Fun_JAIRIV010000010.1_i000_005605	63	399	336	1.01818	0.6
GCA_020578615.1-Fun_JAIRIX010000002.1_i000_001344	63	399	336	1.01818	0.6
GCA_020579815.1-Fun_JAIRIZ010000009.1_i000_007148	63	399	336	1.01818	0.6
GCA_020579835.1-Fun_JAIRJA010000005.1_i000_002380	63	399	336	1.01818	0.6
GCA_020579855.1-Fun_JAIRFU010000061.1_i000_016689	63	399	336	1.01818	0.6
GCA_020580075.1-Fun_JAIRJC010000005.1_i000_003253	63	399	336	1.01818	0.6
GCA_020580085.1-Fun_JAIRJD010000004.1_i000_002807	63	399	336	1.01818	0.6
GCA_020580115.1-Fun_JAIRFV010000021.1_i000_010488	63	399	336	1.01818	0.6
GCA_020580145.1-Fun_JAIRJE010000012.1_i000_005986	63	399	336	1.01818	0.6
GCA_020580155.1-Fun_JAIRJF010000005.1_i000_003379	63	399	336	1.01818	0.6
GCA_020580305.1-Fun_JAIRJG010000010.1_i000_006332	63	399	336	1.01818	0.6
GCA_020580655.1-Fun_JAIRFX010000007.1_i000_004912	63	399	336	1.01818	0.6
GCA_020580695.1-Fun_JAIRJK010000009.1_i000_004671	63	399	336	1.01818	0.6
GCA_020581045.1-Fun_JAIRJM010000020.1_i000_009851	63	399	336	1.01818	0.6
GCA_020581155.1-Fun_JAIRJN010000005.1_i000_001764	63	399	336	1.01818	0.6
GCA_019925055.1-Fun_JAHFYR010000039.1_i000_005531	121	457	336	1.01818	0.530806
GCA_021193595.1-Fun_JAJJMK010000532.1_i000_011769	121	461	340	1.0303	0.539683
GCA_020568095.1-Fun_JAIRGD010000011.1_i000_006702	63	399	336	1.01818	0.6
GCA_020568775.1-Fun_JAIRGG010000008.1_i000_003571	63	399	336	1.01818	0.6
GCA_020569235.1-Fun_JAIREB010000003.1_i000_001964	63	399	336	1.01818	0.6
GCA_020574375.1-Fun_JAIRFA010000002.1_i000_001187	63	399	336	1.01818	0.6
GCA_020574615.1-Fun_JAIRHZ010000061.1_i000_013295	63	399	336	1.01818	0.6
GCA_020574755.1-Fun_JAIRIA010000002.1_i000_001309	63	399	336	1.01818	0.6
GCA_020575405.1-Fun_JAIRII010000015.1_i000_008524	63	399	336	1.01818	0.6
GCA_020575775.1-Fun_JAIRIN010000009.1_i000_005718	63	399	336	1.01818	0.6
GCA_020575975.1-Fun_JAIRFF010000003.1_i000_001697	63	399	336	1.01818	0.6
GCA_020578205.1-Fun_JAIRFS010000004.1_i000_002693	63	399	336	1.01818	0.6
GCA_020578585.1-Fun_JAIRIW010000006.1_i000_004164	63	399	336	1.01818	0.6
GCA_020580665.1-Fun_JAIRFY010000010.1_i000_006639	63	399	336	1.01818	0.6
GCA_020580775.1-Fun_JAIRJL010000002.1_i000_001096	63	399	336	1.01818	0.6
GCA_020580905.1-Fun_JAIRFZ010000024.1_i000_011232	63	399	336	1.01818	0.6
GCA_020581275.1-Fun_JAIRJP010000033.1_i000_011355	63	399	336	1.01818	0.6
GCA_001014755.1-Fun_LDEV01002545.1_i000_005183	95	435	340	1.0303	0.551053
GCA_905397895.1-Ani_CAJPWZ010002729.1_i000_056128	1	208	207	0.627273	0.581461
HADE002.0722.00001.C001_02180	27	121	94	0.284848	0.338129
HADE002.0722.00001.C001_02180	113	278	165	0.5	0.593525
HASI001.0722.00001.C001_01190	26	122	96	0.290909	0.342857
HASI001.0722.00001.C001_01190	111	280	169	0.512121	0.603571
GCA_003260635.2-Pla_QGKW02000276.1_i000_034233	1	241	240	0.727273	0.97561
GCA_004009835.2-Fun_RIBY02002556.1_i000_010046	93	437	344	1.04242	0.563011
GCA_022376535.1-Fun_JAJJKD010000050.1_i000_008694	90	432	342	1.03636	0.563427
GCA_000227095.3-Fun_BACD03000002.1_i000_006714	33	382	349	1.05758	0.695219
GCA_001661265.1-Fun_KV454255.1_i000_000754	33	382	349	1.05758	0.695219
HADE002.0722.00004.C001_00838	27	121	94	0.284848	0.338129
HADE002.0722.00004.C001_00838	115	278	163	0.493939	0.586331
GCA_009806415.1-Fun_WOWK01000105.1_i000_008889	128	463	335	1.01515	0.522621
GCA_001272575.2-Fun_LAZP02000117.1_i000_000631	5	345	340	1.0303	0.666667
GCA_010093605.1-Fun_MU004194.1_i000_011329	60	399	339	1.02727	0.586505
GCA_000585585.1-Fun_AMWN01000007.1_i000_008132	97	431	334	1.01212	0.550247
HASP066.0722.00001.C001_02044	27	120	93	0.281818	0.33574
HASP066.0722.00001.C001_02044	112	277	165	0.5	0.595668
GCA_018360225.1-Fun_SRPW01001064.1_i000_003729	86	427	341	1.03333	0.552674
GCA_000818735.3-Pla_JTFG03002109.1_i000_019560	58	268	210	0.636364	0.462555
GCA_000818735.3-Pla_JTFG03002109.1_i000_019560	273	359	86	0.260606	0.189427
GCA_001884805.1-Pla_MKKS01000202.1_i000_002460	58	268	210	0.636364	0.462555
GCA_001884805.1-Pla_MKKS01000202.1_i000_002460	273	359	86	0.260606	0.189427
GCA_001884845.1-Pla_MKKT01000513.1_i000_004461	58	268	210	0.636364	0.462555
GCA_001884845.1-Pla_MKKT01000513.1_i000_004461	273	359	86	0.260606	0.189427
GCA_000230375.1-Fun_FP929094.1_i000_002791	49	394	345	1.04545	0.620504
GCA_022343315.1-Fun_JACTNS010000014.1_i000_005711	49	394	345	1.04545	0.620504
GCA_001268165.1-Fun_CVQI01001336.1_i000_001450	1	215	214	0.648485	0.584699
GCA_003336725.1-Ani_JOJR01015871.1_i000_028931	1	149	148	0.448485	0.91358
GCA_003144245.1-Fun_KZ819681.1_i000_006781	101	435	334	1.01212	0.56229
HASP011.0722.00001.C001_00184	35	130	95	0.287879	0.315615
HASP011.0722.00001.C001_00184	120	300	180	0.545455	0.598007
GCA_002933655.1-Fun_PNEN01000531.1_i000_009323	76	430	354	1.07273	0.581281
GCA_000709125.1-Fun_AMGV01000006.1_i000_007523	87	425	338	1.02424	0.564274
GCA_002105025.1-Fun_MCFA01000041.1_i000_010555	66	402	336	1.01818	0.587413
GCA_002742065.1-Fun_CM008499.1_i000_001340	76	430	354	1.07273	0.581281
GCA_001883805.1-Fun_LGTZ01000203.1_i000_003513	94	434	340	1.0303	0.551053
GCA_018994095.1-Fun_JAEMWZ010000005.1_i000_013782	87	365	278	0.842424	0.441971
GCA_018994095.1-Fun_JAEMWZ010000005.1_i000_013782	361	449	88	0.266667	0.139905
GCA_004155915.1-Fun_QJOA01000049.1_i000_008259	94	435	341	1.03333	0.55719
GCA_004155035.1-Fun_QJOB01000227.1_i000_005220	94	435	341	1.03333	0.55719
GCA_004155925.1-Fun_QJNX01000497.1_i000_009083	94	435	341	1.03333	0.55719
GCA_002914845.1-Pla_JXTC01000260.1_i000_024665	22	353	331	1.00303	0.707265
SARU002.0722.00001.C001_02126	33	126	93	0.281818	0.319588
SARU002.0722.00001.C001_02126	116	289	173	0.524242	0.594502
HASP059.0722.00001.C001_03403	36	131	95	0.287879	0.317726
HASP059.0722.00001.C001_03403	124	296	172	0.521212	0.575251
GCA_900617775.1-Ani_UYRU01060661.1_i000_010689	7	235	228	0.690909	0.930612
GCA_000331365.3-Pla_AMZH03015451.1_i000_040184	58	268	210	0.636364	0.462555
GCA_000331365.3-Pla_AMZH03015451.1_i000_040184	273	359	86	0.260606	0.189427
GCA_003024175.1-Pro_MDYQ01000122.1_i000_003461	51	373	322	0.975758	0.670833
GCA_004367215.1-Fun_RYZW01000026.1_i000_003934	88	431	343	1.03939	0.559543
GCA_001653265.1-Fun_LSBI01000003.1_i000_003285	79	421	342	1.03636	0.571906
GCA_003144605.1-Fun_LCWV01000018.1_i000_003922	79	421	342	1.03636	0.571906
GCA_001653205.1-Fun_LSBH01000003.1_i000_004074	79	421	342	1.03636	0.571906
GCA_011745865.1-Pla_VYZZ01003009.1_i000_014276	38	331	293	0.887879	0.864307
GCA_000236345.1-Ani_DF143277.1_i000_005241	58	157	99	0.3	0.297297
GCA_000236345.1-Ani_DF143277.1_i000_005241	155	322	167	0.506061	0.501502
GCA_013364965.1-Fun_JAAMOD010000148.1_i000_005676	118	455	337	1.02121	0.534921
METH003.0722.00001.C001_00865	32	112	80	0.242424	0.28777
METH003.0722.00001.C001_00865	121	278	157	0.475758	0.564748
GCA_022432395.1-Fun_JAJKLJ010000016.1_i000_004286	90	433	343	1.03939	0.572621
GCA_905332055.1-Fun_CAJOAW010000095.1_i000_009388	36	378	342	1.03636	0.618445
GCA_001417965.1-Ani_LJWW01000049.1_i000_018661	38	247	209	0.633333	0.458333
GCA_001417965.1-Ani_LJWW01000049.1_i000_018661	244	340	96	0.290909	0.210526
GCA_018360865.1-Fun_SRRG01000003.1_i000_003656	78	422	344	1.04242	0.563011
GCA_018360565.1-Fun_SRQP01000537.1_i000_005936	78	422	344	1.04242	0.563011
GCA_018360065.1-Fun_SRPO01000167.1_i000_001570	78	422	344	1.04242	0.563011
GCA_000347355.1-Fun_CAGA01000051.1_i000_002291	78	422	344	1.04242	0.563011
GCA_018360475.1-Fun_SRQQ01000078.1_i000_007456	78	422	344	1.04242	0.563011
GCA_018360585.1-Fun_SRQN01000257.1_i000_003124	78	422	344	1.04242	0.563011
GCA_018360605.1-Fun_SRQO01000040.1_i000_004844	78	422	344	1.04242	0.563011
GCA_018360655.1-Fun_SRQS01000012.1_i000_000678	78	422	344	1.04242	0.563011
GCA_018360675.1-Fun_SRQZ01000152.1_i000_001321	78	422	344	1.04242	0.563011
GCA_018360725.1-Fun_SRQU01000295.1_i000_003576	78	422	344	1.04242	0.563011
GCA_018360735.1-Fun_SRQX01000503.1_i000_005753	78	422	344	1.04242	0.563011
GCA_018360745.1-Fun_SRQT01000409.1_i000_005047	78	422	344	1.04242	0.563011
GCA_018360755.1-Fun_SRQW01000054.1_i000_006043	78	422	344	1.04242	0.563011
GCA_018360765.1-Fun_SRQV01000148.1_i000_001246	78	422	344	1.04242	0.563011
GCA_018360825.1-Fun_SRRA01000057.1_i000_006333	78	422	344	1.04242	0.563011
GCA_018360835.1-Fun_SRRB01000460.1_i000_005506	78	422	344	1.04242	0.563011
GCA_018360905.1-Fun_SRRI01000073.1_i000_007346	78	422	344	1.04242	0.563011
GCA_018360925.1-Fun_SRRJ01000004.1_i000_005075	78	422	344	1.04242	0.563011
GCA_018360955.1-Fun_SRQY01000184.1_i000_001925	78	422	344	1.04242	0.563011
GCA_018361025.1-Fun_SRRH01000111.1_i000_000465	78	422	344	1.04242	0.563011
GCA_018360685.1-Fun_SRRD01000009.1_i000_007940	78	422	344	1.04242	0.563011
GCA_018360845.1-Fun_SRRE01000085.1_i000_007842	78	422	344	1.04242	0.563011
GCA_018360855.1-Fun_SRRF01000075.1_i000_007368	78	422	344	1.04242	0.563011
GCA_018360935.1-Fun_SRRK01000715.1_i000_007344	78	422	344	1.04242	0.563011
GCA_018360975.1-Fun_SRRC01000012.1_i000_000668	78	422	344	1.04242	0.563011
GCA_018360535.1-Fun_SRQR01000008.1_i000_007750	78	422	344	1.04242	0.563011
GCA_018360045.1-Fun_SRPN01000035.1_i000_004295	78	422	344	1.04242	0.563011
GCA_003814445.1-Fun_CP031387.1_i000_003678	75	419	344	1.04242	0.569536
GCA_018360205.1-Fun_SRPT01000021.1_i000_002467	87	431	344	1.04242	0.563011
GCA_900617965.1-Ani_UYRV01117491.1_i000_011507	1	285	284	0.860606	0.845238
GCA_006013705.1-Pla_RXGB01005996.1_i000_018928	27	354	327	0.990909	0.725055
GCA_013266265.1-Fun_JABFAK010000664.1_i000_009145	116	454	338	1.02424	0.5408
HADE002.0722.00003.C001_01563	27	120	93	0.281818	0.334532
HADE002.0722.00003.C001_01563	115	278	163	0.493939	0.586331
GCA_000240135.3-Fun_CM000574.1_i000_001523	77	419	342	1.03636	0.575758
GCA_900044135.1-Fun_HG970332.2_i000_001609	77	419	342	1.03636	0.575758
HATR001.0722.00001.C001_00371	55	149	94	0.284848	0.297468
HATR001.0722.00001.C001_00371	141	314	173	0.524242	0.547468
GCA_013401255.1-Ani_WBNH01011961.1_i000_012878	115	235	120	0.363636	0.258621
GCA_013401255.1-Ani_WBNH01011961.1_i000_012878	233	351	118	0.357576	0.25431
GCA_900073075.1-Fun_LT222053.1_i000_001625	77	419	342	1.03636	0.575758
GCA_018360055.1-Fun_SRPP01000039.1_i000_004363	78	422	344	1.04242	0.563011
GCA_910393935.1-Fun_CAJSTJ010000111.1_i000_002451	79	422	343	1.03939	0.575503
GCA_020744415.1-Fun_JAGMWT010000017.1_i000_005204	70	405	335	1.01515	0.585664
GCA_001633055.2-Fun_LKCN02000010.1_i000_007834	77	421	344	1.04242	0.569536
GCA_000835505.1-Fun_KN847321.1_i000_007872	87	426	339	1.02727	0.56406
GCA_020310465.1-Fun_JAHSQE010000001.1_i000_000310	96	259	163	0.493939	0.27349
GCA_020310465.1-Fun_JAHSQE010000001.1_i000_000310	263	451	188	0.569697	0.315436
GCA_000338955.1-Fun_KB445550.1_i000_000685	6	346	340	1.0303	0.640301
GCA_010015655.1-Fun_ML976672.1_i000_005492	66	410	344	1.04242	0.600349
ACBO002.0722.00001.C001_00113	36	109	73	0.221212	0.278626
ACBO002.0722.00001.C001_00113	106	262	156	0.472727	0.59542
GCA_003025115.1-Fun_KZ680570.1_i000_009625	14	358	344	1.04242	0.910053
GCA_001618945.2-Fun_CM038150.1_i000_005765	124	463	339	1.02727	0.529687
GCA_001625195.1-Fun_CM004176.1_i000_007895	124	463	339	1.02727	0.529687
GCA_000143105.2-Fun_GL629765.1_i000_001892	77	424	347	1.05152	0.58124
GCA_000836115.1-Fun_KN847493.1_i000_002839	86	424	338	1.02424	0.567114
GCA_020744495.1-Fun_JAGTJS010000002.1_i000_007438	75	419	344	1.04242	0.578151
GCA_003339455.1-Fun_PDHP01000054.1_i000_005223	78	422	344	1.04242	0.565789
GCA_000209535.1-Ani_FN653019.1_i000_004095	43	380	337	1.02121	0.659491
GCA_017506865.1-Pro_JAFCMP010000047.1_i000_003581	63	398	335	1.01515	0.666004
GCA_004155945.1-Fun_QJNY01000226.1_i000_004104	93	435	342	1.03636	0.558824
GCA_002738505.1-Pla_KZ305094.1_i000_022974	38	373	335	1.01515	0.731441
GCA_002116315.1-Fun_KZ107853.1_i000_009622	61	403	342	1.03636	0.610714
GCA_003033665.1-Fun_PVEM01000001.1_i000_001245	77	419	342	1.03636	0.575758
GCA_016952355.1-Fun_CP064750.1_i000_009285	77	419	342	1.03636	0.575758
GCA_000835555.1-Fun_KN847485.1_i000_011037	95	432	337	1.02121	0.555189
GCA_000002945.2-Fun_CU329671.1_i000_002611	67	399	332	1.00606	0.640927
GCA_000512255.2-Pla_CM008461.1_i000_020753	39	347	308	0.933333	0.690583
GCA_010093825.1-Fun_ML995818.1_i000_002898	18	362	344	1.04242	0.649057
GCA_000599445.1-Fun_CM002651.1_i000_001489	117	455	338	1.02424	0.536508
GCA_900492705.2-Fun_UIHA02000070.1_i000_008082	117	455	338	1.02424	0.536508
GCA_901446245.1-Fun_CABDWO010000099.1_i000_010735	117	455	338	1.02424	0.536508
GCA_905332025.1-Fun_CAJOAV010000127.1_i000_010537	117	455	338	1.02424	0.536508
GCA_905359455.1-Fun_CAJPII010000062.1_i000_005390	117	455	338	1.02424	0.536508
GCA_905359465.1-Fun_CAJPIH010000295.1_i000_002347	117	455	338	1.02424	0.536508
GCA_905359475.1-Fun_CAJPIG010000111.1_i000_002396	117	455	338	1.02424	0.536508
GCA_905359485.1-Fun_CAJPIJ010000191.1_i000_012386	117	455	338	1.02424	0.536508
GCA_003957675.1-Fun_MIKF01000178.1_i000_004142	110	451	341	1.03333	0.54386
GCA_003698175.1-Fun_NKUJ01000133.1_i000_002229	110	451	341	1.03333	0.54386
GCA_003946995.1-Fun_NKCK01000019.1_i000_005606	110	451	341	1.03333	0.54386
GCA_003947015.1-Fun_NKCJ01000661.1_i000_012837	110	451	341	1.03333	0.54386
GCA_003947045.1-Fun_NIZV01000020.1_i000_005329	110	451	341	1.03333	0.54386
GCA_007821545.1-Fun_QGMJ01000186.1_i000_003199	95	433	338	1.02424	0.569983
GCA_011745845.1-Pla_VYZY01003022.1_i000_014087	38	332	294	0.890909	0.867257
GCA_018360275.1-Fun_SRQB01000236.1_i000_002616	78	422	344	1.04242	0.563011
GCA_018360355.1-Fun_SRQC01000029.1_i000_003536	78	422	344	1.04242	0.563011
GCA_018360525.1-Fun_SRQD01000021.1_i000_002485	78	422	344	1.04242	0.563011
GCA_018360345.1-Fun_SRQH01000646.1_i000_006402	78	422	344	1.04242	0.563011
GCA_018360375.1-Fun_SRQE01000482.1_i000_005164	78	422	344	1.04242	0.563011
GCA_018360385.1-Fun_SRQF01000498.1_i000_005284	78	422	344	1.04242	0.563011
GCA_005059845.1-Fun_NAJN01001811.1_i000_004234	97	439	342	1.03636	0.564356
GCA_900618435.1-Ani_UYSU01038653.1_i000_014073	74	374	300	0.909091	0.78534
GCA_015951145.1-Fun_MU167255.1_i000_005788	84	422	338	1.02424	0.617916
GCA_003947005.1-Fun_NKCL01000239.1_i000_005987	110	451	341	1.03333	0.54386
GCA_003704355.1-Fun_QWIL01004000.1_i000_016030	8	346	338	1.02424	0.638941
GCA_003704385.1-Fun_QWIM01000966.1_i000_008562	8	346	338	1.02424	0.638941
GCA_001268145.1-Fun_CVQH01017779.1_i000_008873	1	236	235	0.712121	0.571776
GCA_017788925.1-Fun_JACEFK010000014.1_i000_000792	68	385	317	0.960606	0.643002
GCA_012931995.1-Fun_JAADYS010003216.1_i000_016408	117	458	341	1.03333	0.537855
GCA_003946985.1-Fun_NKCI01000009.1_i000_015665	111	451	340	1.0303	0.542265
GCA_013266195.1-Fun_JABEYC010000982.1_i000_009732	104	438	334	1.01212	0.542208
GCA_002980475.2-Fun_PVQB02000320.1_i000_007179	117	456	339	1.02727	0.535545
GCA_000835515.1-Fun_KN847333.1_i000_002002	62	427	365	1.10606	0.609349
GCA_003025115.1-Fun_KZ680217.1_i000_006607	84	428	344	1.04242	0.598261
GCA_010015815.1-Fun_ML977502.1_i000_003551	64	399	335	1.01515	0.601436
GCA_019650295.1-Fun_BOLY01000002.1_i000_003041	76	430	354	1.07273	0.581281
GCA_004355905.1-Fun_RRCK01000002.1_i000_007895	80	424	344	1.04242	0.577181
GCA_001636675.1-Fun_AZGY01000010.1_i000_001402	82	423	341	1.03333	0.56457
GCA_001278385.1-Fun_LGAV01000001.1_i000_000676	101	394	293	0.887879	0.532727
GCA_010093815.1-Fun_ML996566.1_i000_001390	65	398	333	1.00909	0.587302
GCA_000167675.2-Fun_GL985059.1_i000_002208	84	428	344	1.04242	0.563934
GCA_000513815.1-Fun_KI911147.1_i000_004624	84	428	344	1.04242	0.563934
GCA_018292915.1-Ani_JACVVK010000052.1_i000_007387	132	372	240	0.727273	0.466019
GCA_000732775.1-Fun_KL660726.1_i000_006953	117	453	336	1.01818	0.532488
GCA_900169345.1-Fun_FWEW01000060.1_i000_006126	100	424	324	0.981818	0.63035
GCA_003316985.1-Fun_QKXC01000359.1_i000_007514	79	422	343	1.03939	0.575503
GCA_014058105.1-Pla_JACGCM010000252.1_i000_010013	6	231	225	0.681818	0.334324
GCA_018360185.1-Fun_SRPU01001665.1_i000_005457	84	428	344	1.04242	0.55935
GCA_900096505.1-Fun_FMSL01000010.1_i000_013158	74	418	344	1.04242	0.581081
GCA_900096605.1-Fun_FMJS01000022.1_i000_001806	74	418	344	1.04242	0.581081
GCA_900096615.1-Fun_FMJV01000001.1_i000_012162	74	418	344	1.04242	0.581081
GCA_900096625.1-Fun_FMJX01000001.1_i000_004712	74	418	344	1.04242	0.581081
GCA_900096635.1-Fun_FMJW01000001.1_i000_011145	74	418	344	1.04242	0.581081
GCA_900096685.1-Fun_FMSM01000001.1_i000_009340	74	418	344	1.04242	0.581081
GCA_900096705.1-Fun_FMJT01000001.1_i000_009550	74	418	344	1.04242	0.581081
GCA_003339415.1-Fun_PDHQ01000047.1_i000_004565	79	422	343	1.03939	0.566007
GCA_900096645.1-Fun_FMJU01000001.1_i000_011356	74	418	344	1.04242	0.581081
GCA_900067095.1-Fun_FJOF01000001.1_i000_013844	74	418	344	1.04242	0.581081
GCA_900029915.1-Fun_FCQG01000036.1_i000_009753	74	418	344	1.04242	0.581081
GCA_020740775.1-Fun_JAHEWK010000003.1_i000_013758	79	425	346	1.04848	0.577629
GCA_004155055.1-Fun_QJNZ01000419.1_i000_006755	95	435	340	1.0303	0.555556
GCA_002916505.1-Fun_PKSG01000315.1_i000_004088	78	422	344	1.04242	0.571429
GCA_004346965.1-Fun_CP034209.1_i000_010609	80	424	344	1.04242	0.577181
GCA_000835495.1-Fun_KN847041.1_i000_002929	91	429	338	1.02424	0.559603
GCA_000785585.1-Fun_JSEJ01000081.1_i000_010133	91	429	338	1.02424	0.559603
GCA_903819635.1-Fun_CAIJEN010000017.1_i000_009379	74	412	338	1.02424	0.576792
GCA_013266165.1-Fun_JAAGWP010000105.1_i000_003385	122	462	340	1.0303	0.534591
GCA_003704355.1-Fun_QWIL01001146.1_i000_009334	8	346	338	1.02424	0.638941
GCA_003704385.1-Fun_QWIM01002491.1_i000_014070	8	346	338	1.02424	0.638941
GCA_019924025.1-Fun_JAHFWX010005546.1_i000_018753	4	291	287	0.869697	0.618534
GCA_019924875.1-Fun_JAHFYK010005354.1_i000_019372	4	291	287	0.869697	0.618534
GCA_001630375.1-Fun_JYNV01000209.1_i000_005279	59	402	343	1.03939	0.614695
GCA_004011695.1-Fun_RYYQ01000003.1_i000_001461	59	402	343	1.03939	0.614695
HASA001.0722.00001.C001_03179	32	125	93	0.281818	0.328622
HASA001.0722.00001.C001_03179	117	283	166	0.50303	0.586572
GCA_018360075.1-Fun_SRPQ01000476.1_i000_004900	78	422	344	1.04242	0.563011
GCA_022453515.1-Fun_JAJNNY010000006.1_i000_009714	95	440	345	1.04545	0.558252
GCA_001268145.1-Fun_CVQH01008002.1_i000_005012	137	331	194	0.587879	0.421739
GCA_001268145.1-Fun_CVQH01008002.1_i000_005012	329	416	87	0.263636	0.18913
GCA_020169535.1-Pla_CM034988.1_i000_002751	29	357	328	0.993939	0.719298
GCA_020169555.1-Pla_CM035012.1_i000_002921	29	357	328	0.993939	0.719298
GCA_020169585.1-Pla_CM034976.1_i000_002788	29	357	328	0.993939	0.719298
GCA_020744255.1-Fun_JAGTJQ010000008.1_i000_014626	91	434	343	1.03939	0.559543
GCA_010094145.1-Fun_ML978962.1_i000_003529	59	402	343	1.03939	0.614695
GCA_000002495.2-Fun_CM001231.1_i000_001909	80	424	344	1.04242	0.577181
GCA_021442365.1-Fun_PHFK01000002.1_i000_002542	80	424	344	1.04242	0.577181
GCA_021845515.1-Fun_VIDS01000007.1_i000_011028	80	424	344	1.04242	0.577181
GCA_002352725.1-Fun_NQOC01000023.1_i000_008080	117	455	338	1.02424	0.536508
GCA_019721275.1-Fun_JAASLF010000004.1_i000_006252	61	403	342	1.03636	0.610714
GCA_000835475.1-Fun_KN846991.1_i000_007930	94	432	338	1.02424	0.556837
GCA_019297735.1-Ani_CM033247.1_i000_014216	128	281	153	0.463636	0.364286
GCA_019297735.1-Ani_CM033247.1_i000_014216	292	416	124	0.375758	0.295238
GCA_000365165.2-Fun_KB822706.1_i000_006788	89	427	338	1.02424	0.566164
GCA_018360465.1-Fun_SRQM01000001.1_i000_000055	78	422	344	1.04242	0.562092
GCA_010093805.1-Fun_ML996201.1_i000_010413	77	382	305	0.924242	0.531359
GCA_018360215.1-Fun_SRPX01000094.1_i000_008156	78	422	344	1.04242	0.562092
HALA001.0722.00001.C001_01062	27	120	93	0.281818	0.324042
HALA001.0722.00001.C001_01062	110	286	176	0.533333	0.61324
GCA_004011775.1-Fun_NAJM01000009.1_i000_010204	89	426	337	1.02121	0.559801
GCA_008636195.1-Fun_VXIT01000018.1_i000_003888	101	440	339	1.02727	0.5347
GCA_000292585.1-Fun_JH793087.1_i000_002448	76	418	342	1.03636	0.579661
GCA_000260195.2-Fun_JH658272.1_i000_000530	75	418	343	1.03939	0.579392
GCA_000350365.1-Fun_KB726987.1_i000_007959	75	418	343	1.03939	0.579392
GCA_020744335.1-Fun_JAHBOG010000001.1_i000_001448	75	418	343	1.03939	0.579392
GCA_009982855.1-Fun_JAADKA010000003.1_i000_006468	59	402	343	1.03939	0.614695
GCA_013396075.1-Fun_JAAOAV010000247.1_i000_012016	76	418	342	1.03636	0.577703
GCA_003704595.1-Fun_QWIO01000809.1_i000_007438	99	439	340	1.0303	0.546624
GCA_021365365.1-Fun_JAJTIX010000002.1_i000_006786	79	425	346	1.04848	0.577629
GCA_001023035.1-Fun_JRVG01000040.1_i000_009343	117	456	339	1.02727	0.538095
GCA_001023065.1-Fun_JRVH01002170.1_i000_006907	117	456	339	1.02727	0.538095
GCA_009663055.1-Fun_CP023077.1_i000_000557	117	456	339	1.02727	0.538095
GCA_009663095.1-Fun_CP023089.1_i000_000557	117	456	339	1.02727	0.538095
GCA_900079805.1-Fun_HF679023.1_i000_000596	117	456	339	1.02727	0.538095
GCA_901677955.1-Fun_CABFJX010000190.1_i000_005943	117	456	339	1.02727	0.538095
GCA_901677965.1-Fun_CABFJW010000036.1_i000_002152	117	456	339	1.02727	0.538095
GCA_000149555.1-Fun_CM000578.1_i000_000659	76	419	343	1.03939	0.578415
GCA_001023045.1-Fun_JRVF01000194.1_i000_002242	117	456	339	1.02727	0.538095
GCA_003704585.1-Fun_QWIP01000981.1_i000_016058	99	439	340	1.0303	0.552846
GCA_003290285.1-Fun_PKMI01000050.1_i000_011681	117	456	339	1.02727	0.538095
GCA_013396165.1-Fun_JAAQPF010000188.1_i000_004834	117	456	339	1.02727	0.538095
GCA_017309895.1-Fun_PKMJ01000001.1_i000_001360	117	456	339	1.02727	0.538095
GCA_018258275.1-Pla_CM031107.1_i000_011978	28	357	329	0.99697	0.723077
GCA_003704615.1-Fun_QWIQ01000162.1_i000_003036	100	439	339	1.02727	0.545894
GCA_003704675.1-Fun_QWIS01000052.1_i000_006505	99	439	340	1.0303	0.545746
GCA_905332245.1-Ani_CAJOBP010028670.1_i000_032958	1	184	183	0.554545	0.892683
GCA_905332275.1-Ani_CAJOBR010021904.1_i000_032878	1	184	183	0.554545	0.892683
GCA_000171015.2-Fun_ABDG02000027.1_i000_001273	74	421	347	1.05152	0.580268
GCA_020647795.1-Fun_CP084936.1_i000_003879	74	421	347	1.05152	0.580268
GCA_001700775.1-Fun_LGRB01000009.1_i000_004546	86	421	335	1.01515	0.566836
GCA_002873125.1-Fun_PGCI01000064.1_i000_005966	87	425	338	1.02424	0.610108
GCA_002873275.1-Fun_PGCJ01000043.1_i000_004269	87	425	338	1.02424	0.610108
GCA_003704615.1-Fun_QWIQ01001065.1_i000_000641	100	439	339	1.02727	0.545016
GCA_001278495.1-Fun_LGSR01000013.1_i000_004257	89	432	343	1.03939	0.555916
GCA_012932015.1-Fun_JAADJF010000408.1_i000_011776	116	456	340	1.0303	0.539683
GCA_020002365.1-Fun_JAINEY010000001.1_i000_001082	84	428	344	1.04242	0.566722
GCA_020747015.1-Fun_JAGTJM010000014.1_i000_002451	57	399	342	1.03636	0.611807
GCA_000292605.1-Fun_JH794549.1_i000_003803	124	462	338	1.02424	0.533123
GCA_004337985.1-Fun_CM014989.1_i000_009261	103	437	334	1.01212	0.54844
GCA_000835435.1-Fun_KN846959.1_i000_007041	89	427	338	1.02424	0.565217
GCA_013266205.1-Fun_JAAGWO010001008.1_i000_011446	120	460	340	1.0303	0.534591
GCA_013364935.1-Fun_JABEVY010000341.1_i000_011405	116	456	340	1.0303	0.539683
GCA_020744425.1-Fun_JAGMUV010000013.1_i000_003924	118	458	340	1.0303	0.544872
GCA_013396195.1-Fun_JAAQRI010000039.1_i000_002120	118	457	339	1.02727	0.537242
GCA_013396035.1-Fun_JAAOAS010000226.1_i000_008619	118	457	339	1.02727	0.537242
GCA_013396175.1-Fun_JAAOAK010000219.1_i000_007633	118	457	339	1.02727	0.537242
GCA_013758895.1-Fun_JAAOAI010000471.1_i000_008442	116	456	340	1.0303	0.539683
GCA_000732565.1-Fun_KL651596.1_i000_009095	114	453	339	1.02727	0.537242
GCA_000732765.1-Fun_KL657809.1_i000_006616	114	453	339	1.02727	0.537242
GCA_000730325.1-Fun_KL648614.1_i000_007801	114	453	339	1.02727	0.536392
GCA_013396205.1-Fun_JAAOAN010000272.1_i000_008064	117	456	339	1.02727	0.538095
GCA_013396295.1-Fun_JAAGWQ010000085.1_i000_005045	81	426	345	1.04545	0.575
GCA_001481775.2-Fun_JPDN02000004.1_i000_006919	75	421	346	1.04848	0.578595
GCA_003704585.1-Fun_QWIP01000907.1_i000_015477	99	439	340	1.0303	0.546624
GCA_003704575.1-Fun_QWIN01001309.1_i000_002205	99	439	340	1.0303	0.546624
GCA_018360255.1-Fun_SRPZ01000025.1_i000_003461	87	428	341	1.03333	0.554472
GCA_014764975.1-Fun_JACYFE010005807.1_i000_007639	75	418	343	1.03939	0.578415
GCA_004011705.1-Fun_RZGK01000010.1_i000_006003	59	402	343	1.03939	0.614695
GCA_010093535.1-Fun_MU003503.1_i000_006227	67	403	336	1.01818	0.586387
GCA_019157295.1-Fun_JAELUQ010000001.1_i000_001376	117	456	339	1.02727	0.538095
GCA_004154925.1-Fun_QJNS01000746.1_i000_010224	95	436	341	1.03333	0.556281
GCA_004154975.1-Fun_QJNW01001437.1_i000_002425	95	436	341	1.03333	0.556281
GCA_004155895.1-Fun_QJNT01000050.1_i000_008717	95	436	341	1.03333	0.556281
GCA_002895985.1-Fun_NKHZ01000029.1_i000_004698	99	444	345	1.04545	0.569307
GCA_007994515.1-Fun_VMNF01000007.1_i000_013667	117	456	339	1.02727	0.538095
GCA_014607435.1-Fun_JAACFV010000050.1_i000_008949	96	434	338	1.02424	0.537361
GCA_002894205.1-Fun_MTYH01000050.1_i000_007104	75	421	346	1.04848	0.578595
GCA_020744355.1-Fun_JAHEVI010000001.1_i000_000629	117	456	339	1.02727	0.538095
GCA_013395995.1-Fun_JAAOAR010000277.1_i000_005644	118	457	339	1.02727	0.537242
GCA_019915245.1-Fun_CM034114.1_i000_000576	118	457	339	1.02727	0.537242
GCA_003316975.2-Fun_CM010967.1_i000_001828	118	457	339	1.02727	0.537242
GCA_000585535.1-Fun_AMGX01000007.1_i000_005052	90	427	337	1.02121	0.559801
GCA_020744375.1-Fun_JAGMUU010000002.1_i000_007011	76	423	347	1.05152	0.580268
GCA_010094085.1-Fun_ML986486.1_i000_002094	72	414	342	1.03636	0.573826
GCA_013781345.1-Fun_JAAOAJ010000045.1_i000_001254	118	457	339	1.02727	0.537242
GCA_000721765.1-Fun_KL584708.1_i000_004589	88	428	340	1.0303	0.565724
GCA_019924955.1-Fun_JAHFYN010000029.1_i000_004228	88	428	340	1.0303	0.565724
GCA_003025105.1-Fun_KZ679256.1_i000_001235	74	420	346	1.04848	0.579564
GCA_020647865.1-Fun_CP084944.1_i000_003384	74	420	346	1.04848	0.579564
GCA_018360085.1-Fun_SRPR01000245.1_i000_003203	78	422	344	1.04242	0.562092
GCA_018360175.1-Fun_SRPS01000104.1_i000_000322	78	422	344	1.04242	0.562092
GCA_020744475.1-Fun_JAGMUX010000001.1_i000_001463	117	456	339	1.02727	0.538095
GCA_013396185.1-Fun_JAAQPE010000522.1_i000_012129	118	456	338	1.02424	0.536508
GCA_017309325.2-Fun_JAESVG020000007.1_i000_006352	91	435	344	1.04242	0.578151
GCA_013423425.1-Fun_BLZH01000001.1_i000_000895	70	419	349	1.05758	0.58557
GCA_021066465.1-Fun_JAJKFY010000300.1_i000_007706	70	419	349	1.05758	0.58557
GCA_000836435.1-Fun_KN848083.1_i000_009041	90	428	338	1.02424	0.561462
HASO002.0722.00001.C001_02287	55	149	94	0.284848	0.281437
HASO002.0722.00001.C001_02287	143	330	187	0.566667	0.55988
GCA_000350345.1-Fun_KB731261.1_i000_014269	69	412	343	1.03939	0.588336
GCA_020360975.1-Fun_JAIZPD010000021.1_i000_011460	78	406	328	0.993939	0.58467
GCA_903853725.1-Fun_CAINUL010000016.1_i000_007529	74	412	338	1.02424	0.576792
GCA_000149955.2-Fun_CM000589.1_i000_000689	75	418	343	1.03939	0.579392
GCA_000259975.2-Fun_JH650834.1_i000_008352	75	418	343	1.03939	0.579392
GCA_000260075.2-Fun_JH650968.1_i000_001505	75	418	343	1.03939	0.579392
GCA_000260155.3-Fun_JH651392.1_i000_009323	75	418	343	1.03939	0.579392
GCA_000260215.2-Fun_JH658828.1_i000_005754	75	418	343	1.03939	0.579392
GCA_000260235.2-Fun_JH658378.1_i000_007720	75	418	343	1.03939	0.579392
GCA_000260495.2-Fun_JH659329.1_i000_000711	75	418	343	1.03939	0.579392
GCA_000271705.2-Fun_JH717896.1_i000_000707	75	418	343	1.03939	0.579392
GCA_019157275.1-Fun_JAELUR010000001.1_i000_001405	75	418	343	1.03939	0.579392
GCA_000260175.2-Fun_JH657927.1_i000_005742	75	418	343	1.03939	0.579392
GCA_900096695.1-Fun_FMJY01000002.1_i000_001596	75	417	342	1.03636	0.577703
HADE002.0722.00002.C001_01157	27	106	79	0.239394	0.284173
HADE002.0722.00002.C001_01157	113	278	165	0.5	0.593525
GCA_013396025.1-Fun_JAAOAQ010000686.1_i000_012634	117	456	339	1.02727	0.538095
GCA_900074925.1-Fun_FJUY01000021.1_i000_000325	99	442	343	1.03939	0.551447
GCA_022478865.1-Ani_JAHXPS010006279.1_i000_031730	1	209	208	0.630303	0.626506
GCA_008520325.1-Fun_VDEP01000170.1_i000_012080	93	431	338	1.02424	0.602496
GCA_008522505.1-Fun_VSWC01000145.1_i000_028534	93	431	338	1.02424	0.602496
GCA_000149925.1-Fun_DS178304.1_i000_005358	93	431	338	1.02424	0.602496
GCA_000149925.1-Fun_DS178368.1_i000_001179	93	431	338	1.02424	0.602496
GCA_008520325.1-Fun_VDEP01000236.1_i000_016418	93	431	338	1.02424	0.602496
GCA_008522505.1-Fun_VSWC01000158.1_i000_030362	93	431	338	1.02424	0.602496
GCA_001646985.1-Fun_LVCI01000099.1_i000_011754	87	422	335	1.01515	0.562081
GCA_017309875.1-Fun_PKMG01000001.1_i000_001365	117	456	339	1.02727	0.538095
GCA_003615215.1-Fun_MRDB01000018.1_i000_004136	117	456	339	1.02727	0.538095
GCA_017309865.1-Fun_PKMH01000002.1_i000_000830	117	456	339	1.02727	0.538095
GCA_012932025.1-Fun_JAADJG010000009.1_i000_000299	116	456	340	1.0303	0.539683
GCA_019924025.1-Fun_JAHFWX010005558.1_i000_018771	3	291	288	0.872727	0.618026
GCA_019924875.1-Fun_JAHFYK010005364.1_i000_019389	3	291	288	0.872727	0.618026
GCA_011058895.1-Fun_SWKV01000013.1_i000_001658	59	402	343	1.03939	0.613596
GCA_019456465.1-Fun_JAHXPR010000024.1_i000_009138	115	455	340	1.0303	0.541401
GCA_003704375.1-Fun_QWIK01001034.1_i000_000382	99	439	340	1.0303	0.547504
GCA_003704345.1-Fun_QWIJ01003010.1_i000_009058	99	439	340	1.0303	0.546624
GCA_000825705.1-Fun_CDHN01000001.1_i000_002379	70	413	343	1.03939	0.580372
GCA_002894225.1-Fun_MTQA01000078.1_i000_014378	117	456	339	1.02727	0.538095
GCA_010015825.1-Fun_ML977313.1_i000_002622	64	407	343	1.03939	0.598604
GCA_000687475.2-Fun_CP072753.1_i000_001246	76	417	341	1.03333	0.570234
GCA_000965225.2-Fun_BBTG02000019.1_i000_003713	76	417	341	1.03333	0.570234
GCA_000469055.2-Fun_AVOT02031570.1_i000_064842	88	428	340	1.0303	0.614828
GCA_000312925.2-Fun_HE965078.1_i000_002067	57	384	327	0.990909	0.64497
GCA_013363075.1-Fun_JAAFOW010001448.1_i000_008505	117	456	339	1.02727	0.538095
GCA_013396255.1-Fun_JAAOAY010000483.1_i000_012436	117	456	339	1.02727	0.538095
GCA_005382405.1-Fun_PTQR01000050.1_i000_005526	95	440	345	1.04545	0.572139
GCA_011058865.1-Fun_SWKW01000104.1_i000_000562	60	402	342	1.03636	0.611807
GCA_000836275.1-Fun_KN847525.1_i000_007960	89	426	337	1.02121	0.559801
HADE001.0722.00001.C001_02629	30	113	83	0.251515	0.289199
HADE001.0722.00001.C001_02629	125	285	160	0.484848	0.557491
GCA_000820605.1-Fun_AWTV01000006.1_i000_002794	80	424	344	1.04242	0.570481
GCA_002104975.1-Fun_MCOG01000251.1_i000_008915	70	384	314	0.951515	0.646091
GCA_010261695.1-Pla_JAAEJY010002831.1_i000_047192	119	457	338	1.02424	0.535658
GCA_013396005.1-Fun_JAAOAO010000382.1_i000_009309	119	457	338	1.02424	0.535658
HASP037.0722.00001.C001_00571	54	148	94	0.284848	0.299363
HASP037.0722.00001.C001_00571	139	313	174	0.527273	0.55414
GCA_001566295.1-Fun_KQ964256.1_i000_008760	93	435	342	1.03636	0.558824
GCA_002127715.1-Fun_MUNK01000022.1_i000_005232	99	439	340	1.0303	0.545746
GCA_003704685.1-Fun_QWIT01000512.1_i000_011624	99	439	340	1.0303	0.545746
GCA_003693665.1-Fun_QQSL01000061.1_i000_004505	94	431	337	1.02121	0.559801
GCA_005930515.1-Fun_SRMI01000005.1_i000_000640	117	456	339	1.02727	0.538095
GCA_003615075.1-Fun_MRCW01000210.1_i000_006661	117	456	339	1.02727	0.538095
GCA_003615085.1-Fun_CM010800.1_i000_000656	117	456	339	1.02727	0.538095
GCA_003615095.1-Fun_MRCV01000215.1_i000_006923	117	456	339	1.02727	0.538095
GCA_003615185.1-Fun_MRDA01000203.1_i000_006317	117	456	339	1.02727	0.538095
GCA_004141715.1-Fun_MQTW01000053.1_i000_015230	117	456	339	1.02727	0.538095
GCA_013085055.1-Fun_CP052038.1_i000_001542	117	456	339	1.02727	0.538095
GCA_020796175.1-Fun_JAJGYP010000001.1_i000_000649	117	456	339	1.02727	0.538095
GCA_010093945.1-Fun_ML994047.1_i000_006175	70	404	334	1.01212	0.578856
GCA_000349305.2-Fun_HE999552.1_i000_000799	58	379	321	0.972727	0.616123
GCA_900149145.1-Fun_LT671821.1_i000_000113	58	379	321	0.972727	0.616123
GCA_000271745.2-Fun_JH717842.1_i000_007186	117	456	339	1.02727	0.538095
GCA_003615115.1-Fun_MRCX01000287.1_i000_009219	119	456	337	1.02121	0.534921
GCA_020744455.1-Fun_JAHEWL010000007.1_i000_015669	119	456	337	1.02121	0.534921
GCA_000222805.1-Fun_AFQF01000085.1_i000_000229	119	456	337	1.02121	0.534921
GCA_014154955.1-Fun_CM024360.1_i000_000503	119	456	337	1.02121	0.534921
GCA_018894095.1-Fun_RSAI01000007.1_i000_019102	119	456	337	1.02121	0.534921
GCA_902141235.2-Fun_CABFOC020000034.1_i000_006313	78	422	344	1.04242	0.578151
GCA_004337975.1-Fun_RRCJ01000010.1_i000_008636	80	424	344	1.04242	0.577181
GCA_900044065.1-Fun_FCQH01000001.1_i000_002228	74	418	344	1.04242	0.581081
HAEZ001.0722.00001.C001_01078	51	146	95	0.287879	0.304487
HAEZ001.0722.00001.C001_01078	136	311	175	0.530303	0.560897
GCA_902085965.1-Fun_CABFNS010000926.1_i000_016172	120	459	339	1.02727	0.536392
GCA_000005005.6-Pla_CM007647.1_i000_005346	1	147	146	0.442424	0.993197
GCA_003013795.1-Fun_NHZQ01000412.1_i000_001292	94	439	345	1.04545	0.574043
GCA_000321355.1-Pro_DF157101.1_i000_002093	125	439	314	0.951515	0.561717
GCA_010093995.1-Fun_ML992507.1_i000_005292	91	435	344	1.04242	0.578151
GCA_010093625.1-Fun_MU006703.1_i000_001837	60	402	342	1.03636	0.612903
GCA_013266175.1-Fun_JABFAI010000293.1_i000_010467	74	418	344	1.04242	0.581081
GCA_902006505.2-Fun_CABFNO020001560.1_i000_016202	78	422	344	1.04242	0.577181
GCA_010093505.1-Fun_MU001634.1_i000_003914	77	435	358	1.08485	0.583062
GCA_001702695.2-Fun_CM008287.1_i000_001228	117	456	339	1.02727	0.538095
GCA_003615155.1-Fun_MRCY01000032.1_i000_009398	117	456	339	1.02727	0.538095
GCA_003615165.1-Fun_MRCZ01000127.1_i000_002429	117	456	339	1.02727	0.538095
GCA_000474925.1-Fun_KI440843.1_i000_002472	81	425	344	1.04242	0.569536
GCA_904845875.1-Pla_CAJGYO010000004.1_i000_015245	123	282	159	0.481818	0.296642
GCA_904845875.1-Pla_CAJGYO010000004.1_i000_015245	295	424	129	0.390909	0.240672
GCA_902077795.2-Fun_CABFNQ020000555.1_i000_005087	78	422	344	1.04242	0.577181
GCA_003704645.1-Fun_QWIR01000031.1_i000_004807	99	439	340	1.0303	0.547504
GCA_000151525.2-Fun_ADAS02000163.1_i000_010914	93	431	338	1.02424	0.603571
GCA_001651985.1-Fun_LVYI01000013.1_i000_002984	92	430	338	1.02424	0.560531
GCA_011066345.1-Fun_QLNT01000003.1_i000_005732	80	424	344	1.04242	0.572379
GCA_002127715.1-Fun_MUNK01000195.1_i000_004050	99	439	340	1.0303	0.547504
GCA_003704685.1-Fun_QWIT01000003.1_i000_004506	99	439	340	1.0303	0.547504
GCA_020744155.1-Fun_JAGPNQ010000002.1_i000_008942	115	456	341	1.03333	0.54127
GCA_002894145.1-Fun_MTYI01000023.1_i000_005065	80	424	344	1.04242	0.573333
GCA_004154915.1-Fun_QJNU01000043.1_i000_007174	94	435	341	1.03333	0.55719
GCA_000961545.1-Fun_AXCR01000004.1_i000_001850	135	479	344	1.04242	0.522796
GCA_000585515.1-Fun_AMGW01000004.1_i000_006638	89	427	338	1.02424	0.566164
GCA_022343325.1-Fun_JACTNT010000039.1_i000_009340	51	394	343	1.03939	0.619134
GCA_020726555.1-Fun_JAHBNH010000012.1_i000_003103	59	402	343	1.03939	0.613596
GCA_010405425.1-Fun_MU005576.1_i000_005424	64	407	343	1.03939	0.601754
GCA_003012105.1-Fun_PXOA01000870.1_i000_009823	71	414	343	1.03939	0.581356
GCA_000150115.1-Fun_GG663366.1_i000_005449	80	417	337	1.02121	0.637051
GCA_013396015.1-Fun_JAAOAM010000078.1_i000_003722	117	456	339	1.02727	0.538095
GCA_000145635.1-Fun_GL385395.1_i000_001319	86	431	345	1.04545	0.566502
GCA_016647755.1-Fun_JABBWI010000001.1_i000_000701	92	423	331	1.00303	0.612963
HAWA001.0722.00001.C001_01698	32	130	98	0.29697	0.34386
HAWA001.0722.00001.C001_01698	117	285	168	0.509091	0.589474
GCA_001268145.1-Fun_CVQH01011112.1_i000_006361	68	433	365	1.10606	0.595432
GCA_020631695.1-Fun_CM036087.1_i000_000928	75	420	345	1.04545	0.576923
GCA_003709865.1-Fun_QRBJ01000024.1_i000_001661	104	440	336	1.01818	0.587413
GCA_000150675.2-Fun_DS572716.1_i000_001451	87	433	346	1.04848	0.580537
GCA_001306435.1-Fun_LKCW01000143.1_i000_002287	117	457	340	1.0303	0.537975
GCA_013266185.1-Fun_JABEXW010001117.1_i000_013863	117	455	338	1.02424	0.53481
GCA_001268145.1-Fun_CVQH01011112.1_i000_006352	87	433	346	1.04848	0.563518
GCA_002892985.1-Fun_MPSH01000005.1_i000_008198	87	433	346	1.04848	0.563518
GCA_002892995.1-Fun_PHNU01000224.1_i000_003724	87	433	346	1.04848	0.563518
GCA_002893025.1-Fun_PHNV01000465.1_i000_007150	87	433	346	1.04848	0.563518
GCA_002893035.1-Fun_PHNW01000498.1_i000_007081	87	433	346	1.04848	0.563518
GCA_002893045.1-Fun_PHNX01000222.1_i000_003571	87	433	346	1.04848	0.563518
GCA_004109745.1-Fun_CM014041.1_i000_000183	87	433	346	1.04848	0.563518
GCA_020726535.1-Fun_JAHEWJ010000022.1_i000_005932	87	433	346	1.04848	0.563518
GCA_003320035.1-Fun_CM010347.1_i000_000678	87	433	346	1.04848	0.563518
GCA_014235945.1-Fun_WIGO01000272.1_i000_012770	121	456	335	1.01515	0.529226
GCA_013396095.1-Fun_JAAQRM010000494.1_i000_012582	117	455	338	1.02424	0.536508
GCA_002022785.1-Fun_LVVK01000019.1_i000_005266	80	424	344	1.04242	0.572379
GCA_001642475.1-Fun_LVKK01000121.1_i000_001660	95	433	338	1.02424	0.556837
GCA_020310725.1-Fun_LGJB01000016.1_i000_006155	95	433	338	1.02424	0.556837
GCA_000835455.1-Fun_KN846971.1_i000_005679	95	433	338	1.02424	0.556837
GCA_001646965.1-Fun_LVCJ01000068.1_i000_009553	93	431	338	1.02424	0.558678
GCA_000988865.1-Fun_JOKZ01000877.1_i000_011372	80	424	344	1.04242	0.572379
GCA_014235955.1-Fun_WIGN01000090.1_i000_006466	121	456	335	1.01515	0.529226
GCA_002838845.1-Fun_NQLC01000571.1_i000_010189	79	424	345	1.04545	0.574043
GCA_003025095.1-Fun_KZ679676.1_i000_002758	79	424	345	1.04545	0.574043
HASP060.0722.00001.C001_00110	50	144	94	0.284848	0.29375
HASP060.0722.00001.C001_00110	137	317	180	0.545455	0.5625
GCA_000583005.2-Pla_ASHM01005820.1_i000_009511	4	202	198	0.6	0.501266
GCA_000583005.2-Pla_ASHM01005820.1_i000_009511	200	279	79	0.239394	0.2
GCA_000186865.1-Pro_GL833459.1_i000_010693	38	346	308	0.933333	0.88
GCA_003709845.1-Fun_QQXO01000155.1_i000_001267	98	435	337	1.02121	0.556106
HASP052.0722.00001.C001_02452	27	106	79	0.239394	0.262458
HASP052.0722.00001.C001_02452	113	298	185	0.560606	0.614618
GCA_016771965.1-Pla_CM028697.1_i000_052305	37	323	286	0.866667	0.885449
GCA_002844615.1-Fun_MVDW01000006.1_i000_001255	75	430	355	1.07576	0.582923
GCA_000966595.1-Fun_LAFY01000586.1_i000_005677	91	434	343	1.03939	0.555916
GCA_000170995.2-Fun_ABDF02000090.1_i000_001311	79	424	345	1.04545	0.575
GCA_020647635.1-Fun_CP071109.1_i000_005859	79	424	345	1.04545	0.575
GCA_900617985.1-Ani_UYRR01034891.1_i000_018007	41	288	247	0.748485	0.47318
GCA_900617985.1-Ani_UYRR01034891.1_i000_018007	308	398	90	0.272727	0.172414
GCA_004193775.2-Pla_CM014365.1_i000_024476	555	777	222	0.672727	0.236422
GCA_004193775.2-Pla_CM014365.1_i000_024476	778	847	69	0.209091	0.0734824
GCA_000219625.1-Fun_CM001196.1_i000_001635	91	434	343	1.03939	0.555916
GCA_900184115.1-Fun_LT854253.1_i000_001808	91	434	343	1.03939	0.555916
GCA_900091695.1-Fun_LT853692.1_i000_001818	91	434	343	1.03939	0.555916
GCA_900099495.1-Fun_LT882676.1_i000_001799	91	434	343	1.03939	0.555916
GCA_900184105.1-Fun_LT854273.1_i000_001780	91	434	343	1.03939	0.555916
GCA_011058905.1-Fun_SWKU01000030.1_i000_006707	59	402	343	1.03939	0.613596
GCA_010093715.1-Fun_MU005775.1_i000_009088	63	406	343	1.03939	0.606007
GCA_019924435.1-Fun_JAHFXP010005924.1_i000_016254	1	210	209	0.633333	0.728223
GCA_020497155.1-Pla_CM035715.1_i000_025825	588	810	222	0.672727	0.228395
GCA_020497155.1-Pla_CM035715.1_i000_025825	811	880	69	0.209091	0.0709877
GCA_004353045.1-Fun_SKBQ01000013.1_i000_001676	124	469	345	1.04545	0.530769
GCA_018360325.1-Fun_SRQG01000081.1_i000_007602	78	422	344	1.04242	0.562092
GCA_018360435.1-Fun_SRQI01000051.1_i000_005993	78	422	344	1.04242	0.562092
GCA_018360595.1-Fun_SRQJ01000040.1_i000_004903	78	422	344	1.04242	0.562092
GCA_018360445.1-Fun_SRQK01000152.1_i000_001375	78	422	344	1.04242	0.562092
GCA_018360575.1-Fun_SRQL01000081.1_i000_007752	78	422	344	1.04242	0.562092
GCA_001636735.1-Fun_AZHA01000013.1_i000_001752	29	396	367	1.11212	0.632759
GCA_008271595.1-Pro_SMMQ01002160.1_i000_006929	101	417	316	0.957576	0.604207
GCA_018854895.1-Fun_JABAJV010000001.1_i000_000077	31	277	246	0.745455	0.632391
GCA_010583015.1-Fun_MU007052.1_i000_008394	83	423	340	1.0303	0.564784
GCA_010093985.1-Fun_ML992687.1_i000_008757	90	430	340	1.0303	0.558292
GCA_000350225.2-Pro_HG001756.1_i000_006007	16	371	355	1.07576	0.715726
GCA_006981975.1-Fun_SPUL01000007.1_i000_005246	60	400	340	1.0303	0.581197
GCA_006981985.1-Fun_SPUK01000007.1_i000_005767	60	400	340	1.0303	0.581197
GCA_021432655.1-Fun_MU271202.1_i000_001887	42	376	334	1.01212	0.690083
GCA_018296245.1-Fun_JADFTV010000984.1_i000_013880	55	392	337	1.02121	0.595406
GCA_018296265.1-Fun_JADFTU010000981.1_i000_014043	55	392	337	1.02121	0.595406
GCA_018296285.1-Fun_JADFTT010000699.1_i000_012654	55	392	337	1.02121	0.595406
GCA_018296305.1-Fun_JADFTW010000998.1_i000_013178	55	392	337	1.02121	0.595406
GCA_018296325.1-Fun_JADFTY010000805.1_i000_013586	55	392	337	1.02121	0.595406
GCA_018296345.1-Fun_JADFTX010001207.1_i000_013891	55	392	337	1.02121	0.595406
GCA_020647705.1-Fun_CP071117.1_i000_005638	79	424	345	1.04545	0.575
GCA_001636795.1-Fun_AZHF01000002.1_i000_004507	60	400	340	1.0303	0.581197
GCA_011032825.1-Fun_JAADJZ010000015.1_i000_003459	38	408	370	1.12121	0.651408
GCA_003615045.1-Fun_ML014254.1_i000_004540	3	274	271	0.821212	0.888525
GCA_003709825.1-Fun_QQXN01000015.1_i000_000903	93	431	338	1.02424	0.561462
GCA_001373355.1-Fun_CENE01000003.1_i000_001131	88	419	331	1.00303	0.61183
HASP020.0722.00001.C001_01304	50	143	93	0.281818	0.295238
HASP020.0722.00001.C001_01304	135	314	179	0.542424	0.568254
GCA_000236345.1-Ani_DF143554.1_i000_000726	1	154	153	0.463636	0.968354
HARU001.0722.00002.C001_02329	31	124	93	0.281818	0.330961
HARU001.0722.00002.C001_02329	116	281	165	0.5	0.587189
GCA_020736575.1-Fun_JAGPYM010000004.1_i000_010428	75	420	345	1.04545	0.585739
HARU001.0722.00001.C001_02088	31	124	93	0.281818	0.330961
HARU001.0722.00001.C001_02088	116	281	165	0.5	0.587189
GCA_021176775.1-Fun_JAJEVK010000002.1_i000_002643	76	420	344	1.04242	0.587031
GCA_010093695.1-Fun_MU006289.1_i000_000953	60	394	334	1.01212	0.602888
GCA_000464535.1-Fun_KE720951.1_i000_003805	93	434	341	1.03333	0.549114
GCA_020744515.1-Fun_JAGPXF010000002.1_i000_003780	122	460	338	1.02424	0.533123
GCA_020045945.2-Fun_CM034696.1_i000_004648	79	424	345	1.04545	0.574043
GCA_002922495.1-Fun_PJQD01000019.1_i000_001632	89	425	336	1.01818	0.6098
GCA_017310585.1-Fun_CP069114.1_i000_000577	1	167	166	0.50303	0.764977
GCA_016952305.1-Fun_CP064755.1_i000_006550	77	419	342	1.03636	0.575758
GCA_002906115.4-Pla_PKMF03021703.1_i000_076671	82	426	344	1.04242	0.569536
GCA_019425555.1-Fun_MXQG01000031.1_i000_007148	116	456	340	1.0303	0.540541
GCA_020744135.1-Fun_JAGMVI010000001.1_i000_002540	116	456	340	1.0303	0.540541
GCA_900007375.1-Fun_LN649229.1_i000_004462	116	456	340	1.0303	0.540541
GCA_008632915.2-Pla_AP019301.1_i000_014173	63	291	228	0.690909	0.459677
GCA_008632915.2-Pla_AP019301.1_i000_014173	303	386	83	0.251515	0.167339
GCA_003024255.1-Pla_CM009676.1_i000_025465	134	195	61	0.184848	0.138322
GCA_003024255.1-Pla_CM009676.1_i000_025465	204	363	159	0.481818	0.360544
GCA_001189435.1-Fun_LFRF01000013.1_i000_001820	80	421	341	1.03333	0.567388
GCA_014235935.1-Fun_WIGM01000023.1_i000_001369	116	453	337	1.02121	0.534921
GCA_002077065.1-Fun_NAJO01000005.1_i000_014037	82	438	356	1.07879	0.582651
GCA_002901185.1-Fun_NRSZ01000441.1_i000_006412	79	422	343	1.03939	0.570715
GCA_000835395.1-Fun_KN846953.1_i000_006590	98	434	336	1.01818	0.553542
GCA_019609905.1-Fun_CM033785.1_i000_001381	78	420	342	1.03636	0.57479
GCA_001675295.1-Fun_LYXU01000001.1_i000_001342	78	420	342	1.03636	0.57479
HASP047.0722.00001.C001_00361	27	120	93	0.281818	0.33574
HASP047.0722.00001.C001_00361	112	277	165	0.5	0.595668
GCA_015473125.1-Pla_BNJQ01000006.1_i000_002789	103	437	334	1.01212	0.609489
HARU003.0722.00001.C001_01398	30	122	92	0.278788	0.319444
HARU003.0722.00001.C001_01398	114	287	173	0.524242	0.600694
GCA_001654555.2-Fun_LUFC02001146.1_i000_011639	117	456	339	1.02727	0.538095
GCA_007990605.1-Fun_BJWK01000009.1_i000_003861	91	425	334	1.01212	0.613971
GCA_018282135.1-Fun_JAGPUO010000018.1_i000_004171	122	460	338	1.02424	0.533123
GCA_020744115.1-Fun_JAGMVH010000003.1_i000_006856	122	460	338	1.02424	0.533123
GCA_015025155.1-Fun_WITN01000175.1_i000_004520	91	405	314	0.951515	0.598095
MESO001.0722.00001.C001_01341	41	129	88	0.266667	0.296296
MESO001.0722.00001.C001_01341	121	295	174	0.527273	0.585859
GCA_000769215.1-Fun_JPYM01000002.1_i000_005314	122	460	338	1.02424	0.533123
GCA_018857305.1-Fun_JABCKQ010017452.1_i000_006790	94	450	356	1.07879	0.632327
GCA_005059885.1-Fun_NAJL01000017.1_i000_001867	98	439	341	1.03333	0.553571
GCA_010015565.1-Fun_ML975944.1_i000_001832	92	434	342	1.03636	0.568106
GCA_000988875.2-Fun_LCTV02000012.1_i000_001795	91	425	334	1.01212	0.613971
GCA_002077065.1-Fun_NAJO01000020.1_i000_006185	104	450	346	1.04848	0.555377
GCA_000180735.1-Ani_CAAE01018048.1_i000_026803	1	135	134	0.406061	0.992593
GCA_000320785.2-Fun_KB722646.1_i000_002451	91	425	334	1.01212	0.613971
GCA_003234015.1-Fun_LK052940.1_i000_005236	91	425	334	1.01212	0.613971
GCA_001541205.1-Fun_KQ954465.1_i000_000665	30	363	333	1.00909	0.682377
GCA_002105105.1-Fun_MCFI01000008.1_i000_006280	36	370	334	1.01212	0.719828
GCA_001292635.1-Fun_JXCE01000054.1_i000_008725	76	419	343	1.03939	0.578415
GCA_000303195.2-Fun_CM003198.1_i000_001360	76	418	342	1.03636	0.576728
GCA_001703955.2-Fun_CM004556.1_i000_001272	76	418	342	1.03636	0.576728
GCA_006461475.1-Ani_SUNJ01007567.1_i000_006056	1	204	203	0.615152	0.588406
GCA_003724135.2-Fun_RBVV01000044.1_i000_006206	87	433	346	1.04848	0.564437
GCA_014904935.1-Fun_MU123695.1_i000_000097	105	421	316	0.957576	0.583026
GCA_005059875.1-Fun_MXAQ01000002.1_i000_001914	93	426	333	1.00909	0.606557
GCA_016584205.1-Fun_PUHQ01000013.1_i000_001207	93	426	333	1.00909	0.606557
GCA_001191645.1-Fun_AJIL01000309.1_i000_016320	88	426	338	1.02424	0.609009
GCA_021901655.1-Fun_CM038902.1_i000_014620	88	426	338	1.02424	0.609009
GCA_021901695.1-Fun_CM038884.1_i000_014883	88	426	338	1.02424	0.609009
GCA_000448365.1-Fun_KE656087.1_i000_006358	111	448	337	1.02121	0.538339
GCA_021029045.1-Pro_JAFCAI010000050.1_i000_010714	463	792	329	0.99697	0.363536
GCA_000410735.1-Fun_KE148147.1_i000_001331	76	422	346	1.04848	0.581513
GCA_019201745.1-Fun_JABELV010000005.1_i000_005139	99	429	330	1	0.588235
GCA_021052385.1-Fun_JAIFAB010000026.1_i000_005019	99	429	330	1	0.588235
GCA_012934285.1-Fun_JAAVMX010000004.1_i000_003900	79	419	340	1.0303	0.569514
GCA_003012315.1-Fun_PXOF01000002.1_i000_000041	76	419	343	1.03939	0.578415
GCA_002871155.1-Fun_MRVG01000008.1_i000_009778	31	396	365	1.10606	0.62931
GCA_015476325.1-Pro_JADAQX010000747.1_i000_000390	40	379	339	1.02727	0.698969
GCA_000213195.1-Fun_GL890999.1_i000_001688	93	438	345	1.04545	0.564648
GCA_000182925.2-Fun_CM002236.1_i000_000826	93	438	345	1.04545	0.564648
GCA_000786625.1-Fun_KN389625.1_i000_000272	93	438	345	1.04545	0.564648
GCA_020921065.1-Pla_CM037157.1_i000_020182	713	1033	320	0.969697	0.307102
GCA_008692325.1-Fun_NMPR01000009.1_i000_009385	92	435	343	1.03939	0.563218
GCA_020800285.1-Fun_JAGTJO010000011.1_i000_002612	92	435	343	1.03939	0.563218
GCA_020509005.2-Fun_CP090163.1_i000_001519	78	440	362	1.09697	0.584814
MESP047.0722.00001.C001_00603	88	296	208	0.630303	0.702703
GCA_009805615.1-Ani_VIIS01000074.1_i000_001052	48	134	86	0.260606	0.205742
GCA_009805615.1-Ani_VIIS01000074.1_i000_001052	145	356	211	0.639394	0.504785
GCA_000751175.1-Pro_CCKQ01007046.1_i000_007245	47	381	334	1.01212	0.643545
GCA_021365345.1-Fun_JAAZTN010000007.1_i000_009976	31	396	365	1.10606	0.62931
GCA_000280675.1-Fun_JH725179.1_i000_008075	31	396	365	1.10606	0.62931
GCA_001682635.1-Fun_JRHA01000001.1_i000_001484	31	396	365	1.10606	0.62931
GCA_005059865.1-Fun_NAJQ01000039.1_i000_008252	93	439	346	1.04848	0.557166
GCA_000149585.1-Fun_CH476659.1_i000_004087	1	167	166	0.50303	0.343685
GCA_000213175.1-Fun_GL891382.1_i000_009492	93	438	345	1.04545	0.564648
GCA_000770705.1-Fun_ANFO01001292.1_i000_011008	28	396	368	1.11515	0.634483
GCA_001970855.1-Fun_LSSN01003788.1_i000_008665	63	399	336	1.01818	0.641221
GCA_001970855.1-Fun_LSSN01004955.1_i000_010013	63	399	336	1.01818	0.641221
GCA_010093585.1-Fun_MU001836.1_i000_005005	67	405	338	1.02424	0.597173
GCA_000385875.2-Fun_KK365130.1_i000_000104	99	405	306	0.927273	0.748166
HASA004.0722.00001.C001_00338	31	125	94	0.284848	0.312292
HASA004.0722.00001.C001_00338	116	299	183	0.554545	0.607973
GCA_000220395.1-Pro_GL983931.1_i000_004008	81	410	329	0.99697	0.675565
GCA_000968615.1-Fun_LAEV01000350.1_i000_001254	65	408	343	1.03939	0.581356
GCA_000512255.2-Pla_CM008462.1_i000_021779	2	309	307	0.930303	0.623984
GCA_002591405.1-Fun_NJEU01001240.1_i000_000917	77	420	343	1.03939	0.591379
GCA_007735645.1-Fun_CP042195.1_i000_007186	125	458	333	1.00909	0.525237
GCA_003012285.1-Fun_PXOG01000131.1_i000_006060	73	417	344	1.04242	0.582064
GCA_010093935.1-Fun_ML993614.1_i000_011897	95	440	345	1.04545	0.560976
GCA_011745865.1-Pla_VYZZ01000476.1_i000_002612	2	309	307	0.930303	0.623984
GCA_016771965.1-Pla_CM028694.1_i000_034294	3	265	262	0.793939	0.959707
GCA_002906115.4-Pla_PKMF03003070.1_i000_011169	82	426	344	1.04242	0.572379
GCA_002591415.1-Fun_NJET01000183.1_i000_002593	72	415	343	1.03939	0.595486
GCA_001953115.1-Fun_LSSL01000428.1_i000_001167	59	400	341	1.03333	0.658301
GCA_001953115.1-Fun_LSSL01003426.1_i000_005302	59	400	341	1.03333	0.658301
GCA_010099065.1-Fun_PPTI01000008.1_i000_009569	47	390	343	1.03939	0.597561
GCA_000340195.1-Fun_KB446535.1_i000_000828	99	439	340	1.0303	0.551948
HAPE001.0722.00001.C001_00483	32	126	94	0.284848	0.326389
HAPE001.0722.00001.C001_00483	113	288	175	0.530303	0.607639
GCA_000511025.2-Pla_CM002322.2_i000_003329	20	356	336	1.01818	0.913043
GCA_015852495.1-Fun_JAAAIK010000813.1_i000_010190	1	83	82	0.248485	0.292857
GCA_015852495.1-Fun_JAAAIK010000813.1_i000_010190	82	217	135	0.409091	0.482143
GCA_900096595.1-Fun_FMSP01000008.1_i000_006077	99	433	334	1.01212	0.606171
GCA_008080495.1-Fun_CP023324.1_i000_008293	61	402	341	1.03333	0.582906
GCA_001268165.1-Fun_CVQI01033718.1_i000_015915	135	351	216	0.654545	0.546835
GCA_900005765.1-Pro_LN835298.1_i000_000410	69	400	331	1.00303	0.655446
GCA_003351075.1-Fun_QFBF01000010.1_i000_001166	123	458	335	1.01515	0.528391
GCA_009769405.1-Fun_WNWR01000390.1_i000_008335	123	458	335	1.01515	0.528391
GCA_009769425.1-Fun_WNWS01000093.1_i000_003950	123	458	335	1.01515	0.528391
GCA_009769445.1-Fun_WNWQ01000067.1_i000_001728	123	458	335	1.01515	0.528391
GCA_010093745.1-Fun_MU005994.1_i000_005252	60	405	345	1.04545	0.607394
GCA_019565615.1-Fun_CP075866.1_i000_006260	2	285	283	0.857576	0.612554
MECH001.0722.00001.C001_00677	38	136	98	0.29697	0.342657
MECH001.0722.00001.C001_00677	139	284	145	0.439394	0.506993
GCA_006352295.1-Fun_SOZI01000001.1_i000_000039	91	425	334	1.01212	0.608379
GCA_000225605.1-Fun_JH126399.1_i000_001106	61	402	341	1.03333	0.582906
GCA_020169575.1-Pla_CM035000.1_i000_002579	26	357	331	1.00303	0.727473
GCA_000004985.1-Pro_GG738893.1_i000_010526	92	337	245	0.742424	0.401639
GCA_904845875.1-Pla_CAJGYO010000012.1_i000_046053	44	287	243	0.736364	0.671271
GCA_004522655.2-Fun_SNSC02000009.1_i000_005494	88	430	342	1.03636	0.565289
GCA_004522665.1-Fun_SNSD01000009.1_i000_005367	88	430	342	1.03636	0.565289
GCA_000320565.2-Fun_KB456260.1_i000_001167	91	432	341	1.03333	0.55719
HASP057.0722.00001.C001_01155	32	287	255	0.772727	0.888502
GCA_010093785.1-Fun_MU003780.1_i000_003643	87	428	341	1.03333	0.562706
GCA_000389695.3-Fun_APWK03000049.1_i000_004943	90	433	343	1.03939	0.561375
GCA_000978885.1-Fun_LBBL01000029.1_i000_000898	91	434	343	1.03939	0.559543
GCA_910591605.1-Ani_CAJVCH010140173.1_i000_015683	35	276	241	0.730303	0.873188
GCA_900492705.2-Fun_UIHA02000073.1_i000_008833	224	385	161	0.487879	0.297048
GCA_900492705.2-Fun_UIHA02000073.1_i000_008833	383	498	115	0.348485	0.212177
GCA_900005855.1-Pro_CVMV01000143.1_i000_004247	70	400	330	1	0.656064
HAJE001.0722.00001.C001_01549	26	121	95	0.287879	0.344203
HAJE001.0722.00001.C001_01549	119	276	157	0.475758	0.568841
GCA_000241205.2-Fun_BABT02000028.1_i000_005887	86	421	335	1.01515	0.224983
GCA_000708205.1-Fun_KL411544.1_i000_002375	86	421	335	1.01515	0.224983
GCA_002105055.1-Fun_MCGR01000022.1_i000_003504	21	354	333	1.00909	0.708511
GCA_000797555.1-Ani_KN565057.1_i000_014835	40	378	338	1.02424	0.678715
GCA_000150505.2-Fun_KE503206.1_i000_001783	76	378	302	0.915152	0.580769
GCA_013339695.1-Ani_CM023526.1_i000_016472	40	239	199	0.60303	0.427039
GCA_013339695.1-Ani_CM023526.1_i000_016472	231	338	107	0.324242	0.229614
GCA_015178925.1-Fun_WHVC01000016.1_i000_002927	1	236	235	0.712121	0.725309
GCA_019677385.1-Fun_WSLO01005261.1_i000_012217	1	164	163	0.493939	0.318982
GCA_001636725.1-Fun_AZHB01000010.1_i000_001358	60	401	341	1.03333	0.584906
GCA_000166175.1-Fun_GL541645.1_i000_000519	99	431	332	1.00606	0.603636
GCA_019202795.1-Pla_CM032915.1_i000_016146	37	177	140	0.424242	0.311111
GCA_019202795.1-Pla_CM032915.1_i000_016146	173	344	171	0.518182	0.38
GCA_019669845.1-Fun_MU251252.1_i000_004298	80	421	341	1.03333	0.568333
GCA_900622545.1-Ani_UYWY01006005.1_i000_004006	5	160	155	0.469697	0.734597
GCA_005059855.1-Fun_NAJP01000040.1_i000_010601	75	439	364	1.10303	0.586151
GCA_000372725.1-Pro_KB865350.1_i000_017104	117	327	210	0.636364	0.570652
GCA_000372725.1-Pro_KB865350.1_i000_017104	329	354	25	0.0757576	0.0679348
GCA_003144135.1-Fun_KZ819336.1_i000_005869	109	452	343	1.03939	0.540157
GCA_014621425.1-Fun_JAANBB010000610.1_i000_011005	117	413	296	0.89697	0.698113
GCA_001329695.1-Fun_KQ474079.1_i000_003925	78	407	329	0.99697	0.625475
GCA_013401275.1-Ani_VYZV01032024.1_i000_008829	117	304	187	0.566667	0.615132
GCA_001970865.1-Fun_LSSM01001056.1_i000_003107	63	400	337	1.02121	0.641905
GCA_013399675.1-Ani_VXAT01010386.1_i000_006593	5	219	214	0.648485	0.514423
GCA_013399675.1-Ani_VXAT01010386.1_i000_006593	264	331	67	0.20303	0.161058
GCA_005059855.1-Fun_NAJP01000022.1_i000_006425	79	439	360	1.09091	0.57971
GCA_000599465.2-Ani_AWGT02000418.1_i000_013505	148	367	219	0.663636	0.420345
MEMA005.0722.00001.C001_00541	38	124	86	0.260606	0.300699
MEMA005.0722.00001.C001_00541	134	284	150	0.454545	0.524476
GCA_019677385.1-Fun_WSLO01005262.1_i000_012218	1	175	174	0.527273	0.639706
GCA_000365145.2-Fun_KB822725.1_i000_010530	91	428	337	1.02121	0.568297
GCA_001049375.1-Pro_CDSF01000002.1_i000_000749	57	387	330	1	0.656064
GCA_010194725.1-Pro_WXXK01000255.1_i000_001865	57	377	320	0.969697	0.675105
GCA_013423385.1-Fun_BLZA01000007.1_i000_000865	123	451	328	0.993939	0.566494
GCA_905250095.1-Ani_CAJNOR010013248.1_i000_058916	1	168	167	0.506061	0.943503
GCA_002157705.1-Pro_BDQF01000003.1_i000_000413	118	450	332	1.00606	0.603636
GCA_001691775.3-Fun_JNHW02000002.1_i000_001223	196	437	241	0.730303	0.435018
GCA_003704345.1-Fun_QWIJ01002045.1_i000_005961	133	312	179	0.542424	0.573718
GCA_000497085.1-Fun_BAUL01000170.1_i000_003710	8	331	323	0.978788	0.623552
GCA_010093635.1-Fun_MU006786.1_i000_007382	73	413	340	1.0303	0.593368
GCA_004022145.1-Fun_RCNU01000009.1_i000_009142	8	331	323	0.978788	0.621154
GCA_000797555.1-Ani_KN551414.1_i000_007671	1	168	167	0.506061	0.912568
GCA_001662595.1-Fun_KV456259.1_i000_004976	89	414	325	0.984848	0.581395
MEBO004.0722.00001.C001_01672	38	126	88	0.266667	0.307692
MEBO004.0722.00001.C001_01672	139	282	143	0.433333	0.5
GCA_000478725.1-Pla_KI517953.1_i000_026195	40	311	271	0.821212	0.833846
GCA_001644535.1-Fun_KV441644.1_i000_006850	69	401	332	1.00606	0.611418
GCA_006937295.1-Pla_VIBQ01000056.1_i000_025471	86	430	344	1.04242	0.580101
GCA_015178925.1-Fun_WHVC01000011.1_i000_001304	1	225	224	0.678788	0.711111
GCA_000180755.1-Ani_ADBV01000453.1_i000_001856	1	171	170	0.515152	0.568562
GCA_004565275.1-Pro_SDOX01000006.1_i000_007239	100	457	357	1.08182	0.61235
GCA_002220415.3-Pla_CM022215.1_i000_022243	63	268	205	0.621212	0.438034
GCA_002220415.3-Pla_CM022215.1_i000_022243	265	368	103	0.312121	0.220085
MEHA002.0722.00001.C001_00086	50	128	78	0.236364	0.249201
MEHA002.0722.00001.C001_00086	133	303	170	0.515152	0.543131
GCA_001592805.2-Fun_CP051143.1_i000_007578	96	438	342	1.03636	0.560656
GCA_017607565.1-Ani_JAANIB010001770.1_i000_001266	62	267	205	0.621212	0.734767
GCA_002335675.1-Pla_BEGY01000013.1_i000_003014	1	231	230	0.69697	0.670554
GCA_001636815.1-Fun_AZHD01000027.1_i000_005411	81	423	342	1.03636	0.520548
GCA_018994095.1-Fun_JAEMWZ010000566.1_i000_014903	85	384	299	0.906061	0.695349
GCA_001299255.1-Fun_LFJN01000008.1_i000_011050	121	460	339	1.02727	0.538095
GCA_001417965.1-Ani_LJWW01000023.1_i000_009163	88	394	306	0.927273	0.689189
GCA_905250095.1-Ani_CAJNOR010004571.1_i000_040299	169	337	168	0.509091	0.498516
GCA_020747045.1-Fun_JAGTJN010000001.1_i000_000638	64	400	336	1.01818	0.597865
GCA_017607455.1-Ani_JAANHZ010000559.1_i000_004099	131	318	187	0.566667	0.416481
GCA_017607455.1-Ani_JAANHZ010000559.1_i000_004099	318	428	110	0.333333	0.244989
GCA_010015745.1-Fun_ML978176.1_i000_004883	49	393	344	1.04242	0.623188
GCA_000968595.1-Fun_LASV01000732.1_i000_009081	5	338	333	1.00909	0.636711
GCA_900002335.2-Pro_LK022887.2_i000_002453	92	421	329	0.99697	0.631478
GCA_900095555.1-Pro_LT608176.1_i000_002053	92	421	329	0.99697	0.631478
GCA_900095605.1-Pro_LT608162.1_i000_002155	92	421	329	0.99697	0.631478
GCA_002271895.2-Pla_CM008437.1_i000_019992	39	357	318	0.963636	0.194377
GCA_009835225.1-Ani_VUJU01005612.1_i000_018900	4	98	94	0.284848	0.303226
GCA_009835225.1-Ani_VUJU01005612.1_i000_018900	96	244	148	0.448485	0.477419
GCA_000524495.1-Pro_KI965484.1_i000_004523	149	473	324	0.981818	0.565445
GCA_903994225.1-Pro_LR865370.1_i000_001692	91	420	329	0.99697	0.632692
GCA_012550715.1-Fun_JAANYQ010000008.1_i000_006904	117	446	329	0.99697	0.525559
GCA_900095565.1-Pro_LT608204.1_i000_002165	92	421	329	0.99697	0.631478
GCA_900095625.1-Pro_LT608190.1_i000_002158	92	421	329	0.99697	0.631478
GCA_000150085.1-Fun_DS268118.1_i000_010000	135	282	147	0.445455	0.272222
GCA_000150085.1-Fun_DS268118.1_i000_010000	279	348	69	0.209091	0.127778
GCA_900090045.1-Pro_LT594624.1_i000_000427	108	445	337	1.02121	0.620626
GCA_000769265.1-Fun_JPKY01000027.1_i000_004159	81	422	341	1.03333	0.566445
GCA_020647795.1-Fun_CP084936.1_i000_004737	118	316	198	0.6	0.551532
GCA_002249935.1-Ani_KZ269977.1_i000_000341	109	184	75	0.227273	0.164114
GCA_002249935.1-Ani_KZ269977.1_i000_000341	182	332	150	0.454545	0.328228
GCA_002249935.1-Ani_KZ269977.1_i000_000341	331	421	90	0.272727	0.196937
GCA_900088575.1-Pro_FLQW01000118.1_i000_000231	124	459	335	1.01515	0.601436
GCA_000402015.1-Ani_KE124931.1_i000_006199	111	302	191	0.578788	0.541076
GCA_900120095.1-Fun_FQNC01000018.1_i000_003723	118	443	325	0.984848	0.578292
GCA_003426265.1-Fun_NQIL01000086.1_i000_011902	87	423	336	1.01818	0.572402
GCA_001680005.1-Pro_CP016241.1_i000_000546	111	433	322	0.975758	0.602996
GCA_903994265.1-Pro_LR865429.1_i000_001820	91	421	330	1	0.633397
GCA_000524515.1-Pro_KI965399.1_i000_002594	91	421	330	1	0.633397
GCA_903994235.1-Pro_LR865413.1_i000_001768	91	421	330	1	0.633397
GCA_000321355.1-Pro_DF157095.1_i000_000388	134	458	324	0.981818	0.580645
GCA_900090005.1-Pro_LT594491.1_i000_000340	110	444	334	1.01212	0.615101
GCA_001644525.1-Fun_KV441715.1_i000_008810	61	399	338	1.02424	0.601423
GCA_903994205.1-Pro_LR865386.1_i000_001594	90	422	332	1.00606	0.637236
GCA_000002415.2-Pro_CM000444.2_i000_000385	136	440	304	0.921212	0.562963
GCA_000320625.2-Pro_KQ234166.1_i000_000510	136	440	304	0.921212	0.562963
GCA_000320645.2-Pro_KQ234729.1_i000_000512	136	440	304	0.921212	0.562963
GCA_000320665.2-Pro_KQ234986.1_i000_000555	136	440	304	0.921212	0.562963
GCA_000320685.2-Pro_KQ235217.1_i000_000690	136	440	304	0.921212	0.562963
GCA_900093535.1-Pro_LT615258.1_i000_000460	136	440	304	0.921212	0.562963
GCA_900093545.1-Pro_LT615241.1_i000_000419	136	440	304	0.921212	0.562963
GCA_900093555.2-Pro_LT635614.2_i000_000519	136	440	304	0.921212	0.562963
GCA_914969965.1-Pro_CAJZCX010000014.1_i000_005362	136	440	304	0.921212	0.562963
MEBO001.0722.00001.C001_00532	36	136	100	0.30303	0.346021
MEBO001.0722.00001.C001_00532	138	283	145	0.439394	0.50173
GCA_003573695.1-Pla_CM010716.1_i000_006130	58	238	180	0.545455	0.288925
GCA_003573695.1-Pla_CM010716.1_i000_006130	240	313	73	0.221212	0.117175
GCA_003573695.1-Pla_CM010716.1_i000_006130	483	618	135	0.409091	0.216693
GCA_905331525.1-Ani_CAJNZF010000359.1_i000_022263	43	292	249	0.754545	0.846939
GCA_905331535.1-Ani_CAJNZB010000560.1_i000_029034	43	292	249	0.754545	0.846939
GCA_000333975.2-Fun_CAKM01000248.1_i000_001246	39	373	334	1.01212	0.288678
GCA_905332305.1-Ani_CAJOBU010010490.1_i000_030357	43	292	249	0.754545	0.846939
GCA_905331505.1-Ani_CAJNYZ010000537.1_i000_025078	43	292	249	0.754545	0.846939
GCA_900681995.1-Pro_LR215064.1_i000_001511	93	422	329	0.99697	0.631478
GCA_000006355.3-Pro_AM910985.2_i000_000410	112	438	326	0.987879	0.605948
GCA_002140095.1-Pro_NETL01000016.1_i000_002807	112	438	326	0.987879	0.605948
GCA_900004885.2-Pro_CWHQ02000010.1_i000_000448	112	438	326	0.987879	0.605948
GCA_900005025.2-Pro_CWHR02000037.1_i000_000069	112	438	326	0.987879	0.605948
GCA_001447515.1-Pro_LDAU01000100.1_i000_000022	70	374	304	0.921212	0.581262
GCA_000709005.1-Pro_KL446950.1_i000_003188	100	431	331	1.00303	0.623352
GCA_013400355.1-Ani_VXBV01005915.1_i000_009516	1	197	196	0.593939	0.618297
GCA_013401155.1-Ani_VZUF01139884.1_i000_003772	1	197	196	0.593939	0.606811
GCA_004000155.1-Fun_RCSS01000412.1_i000_001690	99	407	308	0.933333	0.754902
GCA_905330235.1-Ani_CAJNUA010000242.1_i000_021492	46	295	249	0.754545	0.808442
GCA_905332115.1-Ani_CAJOBH010009913.1_i000_021597	1	148	147	0.445455	0.807692
GCA_905332185.1-Ani_CAJOBM010008378.1_i000_027731	45	290	245	0.742424	0.844828
MEFO003.0722.00001.C001_02648	37	130	93	0.281818	0.325175
MEFO003.0722.00001.C001_02648	129	286	157	0.475758	0.548951
GCA_902201215.1-Pla_LR694009.1_i000_013569	1	200	199	0.60303	0.637821
GCA_000505035.1-Pro_KI635766.1_i000_003190	88	419	331	1.00303	0.637765
GCA_900002385.2-Pro_LM993664.2_i000_002966	88	419	331	1.00303	0.637765
GCA_900002395.1-Pro_LK934638.1_i000_002462	88	419	331	1.00303	0.637765
GCA_020744215.1-Fun_JAGMVJ010000001.1_i000_001721	50	395	345	1.04545	0.622744
GCA_900002375.2-Pro_LK023125.2_i000_002269	86	417	331	1.00303	0.641473
GCA_900044335.1-Pro_LT160030.1_i000_002230	86	417	331	1.00303	0.641473
GCA_900088445.1-Pro_LT614636.1_i000_002105	86	417	331	1.00303	0.641473
GCA_900095545.1-Pro_LT608146.1_i000_002098	86	417	331	1.00303	0.641473
GCA_900095585.1-Pro_LT608274.1_i000_002105	86	417	331	1.00303	0.641473
GCA_900095635.1-Pro_LT608258.1_i000_002093	86	417	331	1.00303	0.641473
GCA_020744225.1-Fun_JAGMWG010000004.1_i000_011445	50	395	345	1.04545	0.622744
GCA_001402995.1-Fun_CCBN010000023.1_i000_006342	85	418	333	1.00909	0.551325
GCA_014596635.1-Fun_QQZJ01000030.1_i000_002605	85	418	333	1.00909	0.551325
GCA_013365065.1-Fun_QQZO01000214.1_i000_002097	85	418	333	1.00909	0.551325
GCA_013305595.1-Fun_QQZN01000012.1_i000_000597	85	418	333	1.00909	0.551325
GCA_013365125.1-Fun_QQZK01000007.1_i000_004307	85	418	333	1.00909	0.551325
GCA_013365075.1-Fun_QQZL01000072.1_i000_004652	85	418	333	1.00909	0.551325
GCA_014281905.1-Fun_JACBAD010002087.1_i000_006614	6	328	322	0.975758	0.622824
GCA_014281935.1-Fun_JACBAF010002273.1_i000_006892	6	328	322	0.975758	0.622824
GCA_014281895.1-Fun_JACBAE010001143.1_i000_004576	6	331	325	0.984848	0.631068
GCA_000003085.2-Pro_AABL01001227.1_i000_000738	98	427	329	0.99697	0.624288
GCA_015178925.1-Fun_WHVC01000002.1_i000_004302	1	226	225	0.681818	0.728155
GCA_013368755.1-Fun_CP055899.1_i000_003123	7	340	333	1.00909	0.655512
GCA_010015615.1-Fun_ML976619.1_i000_011391	59	397	338	1.02424	0.604651
GCA_011392495.1-Fun_QMIJ01000008.1_i000_011291	5	339	334	1.01212	0.652344
GCA_000003125.1-Fun_EQ962652.1_i000_007289	6	337	331	1.00303	0.643969
GCA_010723975.1-Fun_BLKD01000021.1_i000_004399	6	330	324	0.981818	0.624277
GCA_010724455.1-Fun_BLKH01000076.1_i000_008695	6	330	324	0.981818	0.624277
GCA_010724575.1-Fun_BLKI01000016.1_i000_003694	6	330	324	0.981818	0.624277
GCA_010724635.1-Fun_BLKJ01000024.1_i000_005187	6	330	324	0.981818	0.624277
GCA_010724915.1-Fun_BLKL01000010.1_i000_002204	6	330	324	0.981818	0.624277
GCA_012656335.1-Fun_JAAAPU010000062.1_i000_007676	6	330	324	0.981818	0.624277
GCA_012656375.1-Fun_JAAAPT010000073.1_i000_008344	6	330	324	0.981818	0.624277
GCA_012656395.1-Fun_JAAAPS010000069.1_i000_008109	6	330	324	0.981818	0.624277
GCA_012656435.1-Fun_JAAAPP010000052.1_i000_007050	6	330	324	0.981818	0.624277
GCA_012656445.1-Fun_JAAAPR010000071.1_i000_008146	6	330	324	0.981818	0.624277
GCA_012656455.1-Fun_JAAAPQ010000058.1_i000_007403	6	330	324	0.981818	0.624277
GEAH001.0722.00001.C001_01820	30	110	80	0.242424	0.310078
GEAH001.0722.00001.C001_01820	101	258	157	0.475758	0.608527
GCA_014839935.1-Fun_QTSX01010029.1_i000_006015	39	356	317	0.960606	0.661795
GCA_014281915.1-Fun_JACBAG010001676.1_i000_004625	8	331	323	0.978788	0.627184
GCA_001653215.1-Fun_LUKN01004083.1_i000_001415	26	310	284	0.860606	0.916129
GCA_905332225.1-Ani_CAJOBN010021986.1_i000_040523	111	304	193	0.584848	0.634868
GCA_020499135.1-Fun_JAIBQJ010000001.1_i000_000038	6	331	325	0.984848	0.626204
GCA_000346465.2-Pla_CM007654.1_i000_014261	1	198	197	0.59697	0.960976
GCA_013365045.1-Fun_QQZM01000015.1_i000_001003	85	418	333	1.00909	0.551325
GCA_018340605.1-Fun_BHVY01000002.1_i000_002504	6	330	324	0.981818	0.629126
GCA_002271885.2-Pla_CM008450.1_i000_019418	1	269	268	0.812121	0.785924
GCA_001445615.2-Fun_BCLY01000016.1_i000_008211	7	330	323	0.978788	0.622351
GCA_020501905.1-Fun_JAIBVS010000102.1_i000_000370	6	332	326	0.987879	0.628131
GCA_000525045.1-Fun_KI966469.1_i000_005587	88	341	253	0.766667	0.741935
GCA_014058105.1-Pla_JACGCM010002660.1_i000_006094	120	398	278	0.842424	0.698492
GCA_001078395.2-Fun_BBXM02000006.1_i000_007892	7	329	322	0.975758	0.620424
GCA_010723835.1-Fun_BLKC01000037.1_i000_005781	7	329	322	0.975758	0.620424
GCA_010724135.1-Fun_BLKE01000007.1_i000_000779	7	329	322	0.975758	0.620424
GCA_010724335.1-Fun_BLKG01000034.1_i000_003995	7	329	322	0.975758	0.620424
GCA_010724795.1-Fun_BLKK01000057.1_i000_003432	7	329	322	0.975758	0.620424
GCA_905250095.1-Ani_CAJNOR010007206.1_i000_049145	139	321	182	0.551515	0.566978
GCA_013305805.1-Fun_QVQA01000429.1_i000_003292	86	418	332	1.00606	0.55058
GCA_010015705.1-Fun_ML977145.1_i000_003272	5	344	339	1.02727	0.684848
GCA_003490085.1-Pla_LXQA010213347.1_i000_055150	1	124	123	0.372727	0.991935
GCA_020502025.1-Fun_JAIBVX010000002.1_i000_003407	6	331	325	0.984848	0.626204
GCA_000150145.1-Fun_DS499594.1_i000_009196	6	331	325	0.984848	0.626204
GCA_002234985.1-Fun_NKHS01000083.1_i000_008692	6	331	325	0.984848	0.626204
GCA_012656115.1-Fun_JAAAQC010000280.1_i000_004334	6	331	325	0.984848	0.626204
GCA_012656125.1-Fun_JAAAQD010000251.1_i000_003894	6	331	325	0.984848	0.626204
GCA_012656215.1-Fun_JAAAPZ010000211.1_i000_002812	6	331	325	0.984848	0.626204
GCA_020498725.1-Fun_JAIBPO010000002.1_i000_003298	6	331	325	0.984848	0.626204
GCA_020498735.1-Fun_JAIBPN010000001.1_i000_000025	6	331	325	0.984848	0.626204
GCA_020498745.1-Fun_JAIBPM010000069.1_i000_008011	6	331	325	0.984848	0.626204
GCA_020498805.1-Fun_JAIBPR010000001.1_i000_000166	6	331	325	0.984848	0.626204
GCA_020498865.1-Fun_JAIBPV010000002.1_i000_003380	6	331	325	0.984848	0.626204
GCA_020498875.1-Fun_JAIBPW010000032.1_i000_005297	6	331	325	0.984848	0.626204
GCA_020498905.1-Fun_JAIBPX010000003.1_i000_005073	6	331	325	0.984848	0.626204
GCA_020498945.1-Fun_JAIBPY010000002.1_i000_003349	6	331	325	0.984848	0.626204
GCA_020498965.1-Fun_JAIBPZ010000001.1_i000_000082	6	331	325	0.984848	0.626204
GCA_020498985.1-Fun_JAIBQA010000085.1_i000_008829	6	331	325	0.984848	0.626204
GCA_020499075.1-Fun_JAIBQF010000001.1_i000_000039	6	331	325	0.984848	0.626204
GCA_020499115.1-Fun_JAIBQG010000120.1_i000_001072	6	331	325	0.984848	0.626204
GCA_020499125.1-Fun_JAIBQH010000083.1_i000_008727	6	331	325	0.984848	0.626204
GCA_020499185.1-Fun_JAIBQL010000035.1_i000_005851	6	331	325	0.984848	0.626204
GCA_020499255.1-Fun_JAIBQP010000092.1_i000_009089	6	331	325	0.984848	0.626204
GCA_020499265.1-Fun_JAIBQO010000003.1_i000_005232	6	331	325	0.984848	0.626204
GCA_020499485.1-Fun_JAIBRA010000058.1_i000_007452	6	331	325	0.984848	0.626204
GCA_020499565.1-Fun_JAIBRD010000021.1_i000_003492	6	331	325	0.984848	0.626204
GCA_020499575.1-Fun_JAIBRE010000001.1_i000_000034	6	331	325	0.984848	0.626204
GCA_020499605.1-Fun_JAIBRI010000019.1_i000_003010	6	331	325	0.984848	0.626204
GCA_020499715.1-Fun_JAIBSB010000003.1_i000_004772	6	331	325	0.984848	0.626204
GCA_020499805.1-Fun_JAIBSF010000090.1_i000_009011	6	331	325	0.984848	0.626204
GCA_020499815.1-Fun_JAIBSG010000003.1_i000_004548	6	331	325	0.984848	0.626204
GCA_020499825.1-Fun_JAIBSH010000086.1_i000_008677	6	331	325	0.984848	0.626204
GCA_020499865.1-Fun_JAIBSI010000002.1_i000_003220	6	331	325	0.984848	0.626204
GCA_020499915.1-Fun_JAIBRL010000027.1_i000_004390	6	331	325	0.984848	0.626204
GCA_020499975.1-Fun_JAIBRN010000001.1_i000_000180	6	331	325	0.984848	0.626204
GCA_020499985.1-Fun_JAIBRO010000099.1_i000_009251	6	331	325	0.984848	0.626204
GCA_020499995.1-Fun_JAIBRP010000001.1_i000_000053	6	331	325	0.984848	0.626204
GCA_020500025.1-Fun_JAIBRQ010000001.1_i000_000167	6	331	325	0.984848	0.626204
GCA_020500065.1-Fun_JAIBRT010000069.1_i000_008227	6	331	325	0.984848	0.626204
GCA_020500075.1-Fun_JAIBRR010000013.1_i000_001455	6	331	325	0.984848	0.626204
GCA_020500105.1-Fun_JAIBRU010000094.1_i000_009195	6	331	325	0.984848	0.626204
GCA_020500165.1-Fun_JAIBRW010000113.1_i000_000759	6	331	325	0.984848	0.626204
GCA_020500185.1-Fun_JAIBSL010000009.1_i000_008918	6	331	325	0.984848	0.626204
GCA_020500195.1-Fun_JAIBRX010000005.1_i000_006958	6	331	325	0.984848	0.626204
GCA_020500205.1-Fun_JAIBSJ010000093.1_i000_009255	6	331	325	0.984848	0.626204
GCA_020500275.1-Fun_JAIBSO010000001.1_i000_000126	6	331	325	0.984848	0.626204
GCA_020500285.1-Fun_JAIBSP010000062.1_i000_007401	6	331	325	0.984848	0.626204
GCA_020500305.1-Fun_JAIBSQ010000002.1_i000_003289	6	331	325	0.984848	0.626204
GCA_020500385.1-Fun_JAIBST010000002.1_i000_003059	6	331	325	0.984848	0.626204
GCA_020500485.1-Fun_JAIBSZ010000008.1_i000_008447	6	331	325	0.984848	0.626204
GCA_020500545.1-Fun_JAIBTC010000054.1_i000_007535	6	331	325	0.984848	0.626204
GCA_020500605.1-Fun_JAIBTG010000038.1_i000_005495	6	331	325	0.984848	0.626204
GCA_020500685.1-Fun_JAIBTJ010000004.1_i000_005657	6	331	325	0.984848	0.626204
GCA_020500775.1-Fun_JAIBTM010000014.1_i000_001821	6	331	325	0.984848	0.626204
GCA_020500785.1-Fun_JAIBTN010000005.1_i000_006428	6	331	325	0.984848	0.626204
GCA_020500875.1-Fun_JAIBTR010000009.1_i000_009170	6	331	325	0.984848	0.626204
GCA_020500935.1-Fun_JAIBTU010000047.1_i000_006123	6	331	325	0.984848	0.626204
GCA_020500965.1-Fun_JAIBTW010000037.1_i000_005852	6	331	325	0.984848	0.626204
GCA_020500995.1-Fun_JAIBTY010000002.1_i000_003229	6	331	325	0.984848	0.626204
GCA_020501075.1-Fun_JAIBUB010000003.1_i000_005006	6	331	325	0.984848	0.626204
GCA_020501095.1-Fun_JAIBUC010000002.1_i000_003412	6	331	325	0.984848	0.626204
GCA_020501105.1-Fun_JAIBUE010000101.1_i000_000400	6	331	325	0.984848	0.626204
GCA_020501135.1-Fun_JAIBUF010000001.1_i000_000108	6	331	325	0.984848	0.626204
GCA_020501145.1-Fun_JAIBUG010000085.1_i000_008737	6	331	325	0.984848	0.626204
GCA_020501255.1-Fun_JAIBUO010000081.1_i000_008615	6	331	325	0.984848	0.626204
GCA_020501265.1-Fun_JAIBUM010000004.1_i000_005918	6	331	325	0.984848	0.626204
GCA_020501325.1-Fun_JAIBUL010000004.1_i000_006225	6	331	325	0.984848	0.626204
GCA_020501345.1-Fun_JAIBUP010000110.1_i000_000606	6	331	325	0.984848	0.626204
GCA_020501355.1-Fun_JAIBUQ010000060.1_i000_007880	6	331	325	0.984848	0.626204
GCA_020501405.1-Fun_JAIBUS010000098.1_i000_009255	6	331	325	0.984848	0.626204
GCA_020501445.1-Fun_JAIBUU010000087.1_i000_008838	6	331	325	0.984848	0.626204
GCA_020501535.1-Fun_JAIBUY010000002.1_i000_003513	6	331	325	0.984848	0.626204
GCA_020501545.1-Fun_JAIBUZ010000001.1_i000_000059	6	331	325	0.984848	0.626204
GCA_020501555.1-Fun_JAIBVA010000085.1_i000_008822	6	331	325	0.984848	0.626204
GCA_020501575.1-Fun_JAIBVB010000042.1_i000_006419	6	331	325	0.984848	0.626204
GCA_020501605.1-Fun_JAIBVC010000093.1_i000_009059	6	331	325	0.984848	0.626204
GCA_020501645.1-Fun_JAIBVF010000003.1_i000_005001	6	331	325	0.984848	0.626204
GCA_020501715.1-Fun_JAIBVH010000001.1_i000_000037	6	331	325	0.984848	0.626204
GCA_020501735.1-Fun_JAIBVJ010000085.1_i000_008719	6	331	325	0.984848	0.626204
GCA_020501805.1-Fun_JAIBVM010000001.1_i000_000038	6	331	325	0.984848	0.626204
GCA_020501875.1-Fun_JAIBVP010000018.1_i000_002843	6	331	325	0.984848	0.626204
GCA_020501885.1-Fun_JAIBVR010000002.1_i000_003389	6	331	325	0.984848	0.626204
GCA_020501895.1-Fun_JAIBVQ010000001.1_i000_000037	6	331	325	0.984848	0.626204
GCA_020501985.1-Fun_JAIBVU010000097.1_i000_009296	6	331	325	0.984848	0.626204
GCA_020502035.1-Fun_JAIBVY010000103.1_i000_000337	6	331	325	0.984848	0.626204
GCA_020502105.1-Fun_JAIBWB010000099.1_i000_009502	6	331	325	0.984848	0.626204
GCA_020502125.1-Fun_JAIBWD010000103.1_i000_000351	6	331	325	0.984848	0.626204
GCA_020502185.1-Fun_JAIBWF010000086.1_i000_008785	6	331	325	0.984848	0.626204
GCA_020502325.1-Fun_JAIBWK010000088.1_i000_008983	6	331	325	0.984848	0.626204
GCA_020502375.1-Fun_JAIBWN010000022.1_i000_003788	6	331	325	0.984848	0.626204
GCA_020502385.1-Fun_JAIBWO010000376.1_i000_005127	6	331	325	0.984848	0.626204
GCA_020502455.1-Fun_JAIBWR010000071.1_i000_008313	6	331	325	0.984848	0.626204
GCA_020502495.1-Fun_JAIBWT010000022.1_i000_003744	6	331	325	0.984848	0.626204
GCA_020502525.1-Fun_JAIBWU010000070.1_i000_008203	6	331	325	0.984848	0.626204
GCA_020502545.1-Fun_JAIBWV010000117.1_i000_000854	6	331	325	0.984848	0.626204
GCA_020502575.1-Fun_JAIBWW010000001.1_i000_000057	6	331	325	0.984848	0.626204
GCA_020502595.1-Fun_JAIBWX010000082.1_i000_008680	6	331	325	0.984848	0.626204
GCA_020502605.1-Fun_JAIBWY010000023.1_i000_003985	6	331	325	0.984848	0.626204
GCA_020502625.1-Fun_JAIBXA010000001.1_i000_000038	6	331	325	0.984848	0.626204
GCA_020502695.1-Fun_JAIBXC010000007.1_i000_008039	6	331	325	0.984848	0.626204
GCA_020502715.1-Fun_JAIBXE010000080.1_i000_008666	6	331	325	0.984848	0.626204
GCA_020502875.1-Fun_JAIBXG010000082.1_i000_008776	6	331	325	0.984848	0.626204
GCA_020503065.1-Fun_JAIBXL010000003.1_i000_005156	6	331	325	0.984848	0.626204
GCA_020503095.1-Fun_JAIBXN010000001.1_i000_000111	6	331	325	0.984848	0.626204
GCA_020503205.1-Fun_JAIBXS010000078.1_i000_008375	6	331	325	0.984848	0.626204
GCA_020503265.1-Fun_JAIBXV010000094.1_i000_009292	6	331	325	0.984848	0.626204
GCA_020503295.1-Fun_JAIBXX010000169.1_i000_001817	6	331	325	0.984848	0.626204
GCA_020503365.1-Fun_JAIBYA010000008.1_i000_008501	6	331	325	0.984848	0.626204
GCA_020503395.1-Fun_JAIBYC010000001.1_i000_000110	6	331	325	0.984848	0.626204
GCA_020503445.1-Fun_JAIBYF010000020.1_i000_003500	6	331	325	0.984848	0.626204
GCA_020503455.1-Fun_JAIBYD010000001.1_i000_000110	6	331	325	0.984848	0.626204
GCA_020503515.1-Fun_JAIBYH010000159.1_i000_002132	6	331	325	0.984848	0.626204
GCA_020503635.1-Fun_JAIBYN010000076.1_i000_008477	6	331	325	0.984848	0.626204
GCA_020503725.1-Fun_JAIBYS010000081.1_i000_008611	6	331	325	0.984848	0.626204
GCA_020503735.1-Fun_JAIBYT010000103.1_i000_000442	6	331	325	0.984848	0.626204
GCA_020503825.1-Fun_JAIBYY010000113.1_i000_000880	6	331	325	0.984848	0.626204
GCA_020503885.1-Fun_JAIBYZ010000096.1_i000_009172	6	331	325	0.984848	0.626204
GCA_000002655.1-Fun_CM000169.1_i000_000859	6	331	325	0.984848	0.626204
GCA_001029325.1-Fun_KQ087361.1_i000_002753	6	331	325	0.984848	0.626204
GCA_002234955.1-Fun_NKHT01000103.1_i000_000292	6	331	325	0.984848	0.626204
GCA_012656165.1-Fun_JAAAQB010000068.1_i000_007635	6	331	325	0.984848	0.626204
GCA_012656185.1-Fun_JAAAQA010000212.1_i000_002514	6	331	325	0.984848	0.626204
GCA_020498755.1-Fun_JAIBPP010000125.1_i000_001104	6	331	325	0.984848	0.626204
GCA_020498765.1-Fun_JAIBPQ010000070.1_i000_008409	6	331	325	0.984848	0.626204
GCA_020498815.1-Fun_JAIBPS010000101.1_i000_000434	6	331	325	0.984848	0.626204
GCA_020498885.1-Fun_JAIBPT010000009.1_i000_008955	6	331	325	0.984848	0.626204
GCA_020498895.1-Fun_JAIBPU010000008.1_i000_008744	6	331	325	0.984848	0.626204
GCA_020499005.1-Fun_JAIBQC010000006.1_i000_007637	6	331	325	0.984848	0.626204
GCA_020499015.1-Fun_JAIBQB010000024.1_i000_004311	6	331	325	0.984848	0.626204
GCA_020499045.1-Fun_JAIBQE010000070.1_i000_008191	6	331	325	0.984848	0.626204
GCA_020499195.1-Fun_JAIBQM010000056.1_i000_007596	6	331	325	0.984848	0.626204
GCA_020499225.1-Fun_JAIBQN010000099.1_i000_009359	6	331	325	0.984848	0.626204
GCA_020499245.1-Fun_JAIBQI010000083.1_i000_009346	6	331	325	0.984848	0.626204
GCA_020499325.1-Fun_JAIBQS010000085.1_i000_008733	6	331	325	0.984848	0.626204
GCA_020499335.1-Fun_JAIBQT010000089.1_i000_009002	6	331	325	0.984848	0.626204
GCA_020499355.1-Fun_JAIBQU010000169.1_i000_001856	6	331	325	0.984848	0.626204
GCA_020499395.1-Fun_JAIBQV010000012.1_i000_000889	6	331	325	0.984848	0.626204
GCA_020499405.1-Fun_JAIBQW010000086.1_i000_008848	6	331	325	0.984848	0.626204
GCA_020499415.1-Fun_JAIBQX010000108.1_i000_000580	6	331	325	0.984848	0.626204
GCA_020499455.1-Fun_JAIBQY010000077.1_i000_008319	6	331	325	0.984848	0.626204
GCA_020499475.1-Fun_JAIBQZ010000005.1_i000_007151	6	331	325	0.984848	0.626204
GCA_020499495.1-Fun_JAIBRB010000091.1_i000_008983	6	331	325	0.984848	0.626204
GCA_020499505.1-Fun_JAIBRC010000006.1_i000_007655	6	331	325	0.984848	0.626204
GCA_020499585.1-Fun_JAIBRG010000001.1_i000_000053	6	331	325	0.984848	0.626204
GCA_020499595.1-Fun_JAIBRF010000009.1_i000_008914	6	331	325	0.984848	0.626204
GCA_020499645.1-Fun_JAIBRJ010000022.1_i000_003764	6	331	325	0.984848	0.626204
GCA_020499675.1-Fun_JAIBRZ010000016.1_i000_002528	6	331	325	0.984848	0.626204
GCA_020499685.1-Fun_JAIBSA010000010.1_i000_000304	6	331	325	0.984848	0.626204
GCA_020499695.1-Fun_JAIBRY010000002.1_i000_003214	6	331	325	0.984848	0.626204
GCA_020499755.1-Fun_JAIBSC010000008.1_i000_008566	6	331	325	0.984848	0.626204
GCA_020499775.1-Fun_JAIBSD010000005.1_i000_006882	6	331	325	0.984848	0.626204
GCA_020499785.1-Fun_JAIBSE010000099.1_i000_009540	6	331	325	0.984848	0.626204
GCA_020499885.1-Fun_JAIBRH010000021.1_i000_003615	6	331	325	0.984848	0.626204
GCA_020499905.1-Fun_JAIBRK010000119.1_i000_001115	6	331	325	0.984848	0.626204
GCA_020499935.1-Fun_JAIBRM010000045.1_i000_006423	6	331	325	0.984848	0.626204
GCA_020500085.1-Fun_JAIBRS010000001.1_i000_000135	6	331	325	0.984848	0.626204
GCA_020500115.1-Fun_JAIBRV010000121.1_i000_001274	6	331	325	0.984848	0.626204
GCA_020500235.1-Fun_JAIBSM010000004.1_i000_006397	6	331	325	0.984848	0.626204
GCA_020500295.1-Fun_JAIBSN010000003.1_i000_004411	6	331	325	0.984848	0.626204
GCA_020500355.1-Fun_JAIBSS010000011.1_i000_000762	6	331	325	0.984848	0.626204
GCA_020500365.1-Fun_JAIBSR010000002.1_i000_003217	6	331	325	0.984848	0.626204
GCA_020500395.1-Fun_JAIBSU010000083.1_i000_008532	6	331	325	0.984848	0.626204
GCA_020500445.1-Fun_JAIBSV010000003.1_i000_004434	6	331	325	0.984848	0.626204
GCA_020500455.1-Fun_JAIBSW010000052.1_i000_006840	6	331	325	0.984848	0.626204
GCA_020500465.1-Fun_JAIBSY010000019.1_i000_002944	6	331	325	0.984848	0.626204
GCA_020500475.1-Fun_JAIBSX010000009.1_i000_008907	6	331	325	0.984848	0.626204
GCA_020500535.1-Fun_JAIBTB010000004.1_i000_006437	6	331	325	0.984848	0.626204
GCA_020500555.1-Fun_JAIBTD010000022.1_i000_004001	6	331	325	0.984848	0.626204
GCA_020500565.1-Fun_JAIBTE010000185.1_i000_003072	6	331	325	0.984848	0.626204
GCA_020500595.1-Fun_JAIBTF010000001.1_i000_000074	6	331	325	0.984848	0.626204
GCA_020500645.1-Fun_JAIBTH010000008.1_i000_008472	6	331	325	0.984848	0.626204
GCA_020500655.1-Fun_JAIBTI010000024.1_i000_003703	6	331	325	0.984848	0.626204
GCA_020500695.1-Fun_JAIBTK010000042.1_i000_005715	6	331	325	0.984848	0.626204
GCA_020500705.1-Fun_JAIBTL010000016.1_i000_002318	6	331	325	0.984848	0.626204
GCA_020500765.1-Fun_JAIBTA010000051.1_i000_006530	6	331	325	0.984848	0.626204
GCA_020500805.1-Fun_JAIBTO010000059.1_i000_006980	6	331	325	0.984848	0.626204
GCA_020500815.1-Fun_JAIBTP010000004.1_i000_005472	6	331	325	0.984848	0.626204
GCA_020500845.1-Fun_JAIBTQ010000003.1_i000_004321	6	331	325	0.984848	0.626204
GCA_020500865.1-Fun_JAIBTS010000050.1_i000_006346	6	331	325	0.984848	0.626204
GCA_020500945.1-Fun_JAIBTV010000001.1_i000_000095	6	331	325	0.984848	0.626204
GCA_020500975.1-Fun_JAIBTX010000083.1_i000_008659	6	331	325	0.984848	0.626204
GCA_020501005.1-Fun_JAIBTZ010000009.1_i000_009287	6	331	325	0.984848	0.626204
GCA_020501045.1-Fun_JAIBUA010000004.1_i000_006332	6	331	325	0.984848	0.626204
GCA_020501115.1-Fun_JAIBUD010000292.1_i000_004827	6	331	325	0.984848	0.626204
GCA_020501175.1-Fun_JAIBUH010000075.1_i000_008608	6	331	325	0.984848	0.626204
GCA_020501185.1-Fun_JAIBUI010000008.1_i000_008382	6	331	325	0.984848	0.626204
GCA_020501235.1-Fun_JAIBUJ010000002.1_i000_002956	6	331	325	0.984848	0.626204
GCA_020501245.1-Fun_JAIBUK010000020.1_i000_003465	6	331	325	0.984848	0.626204
GCA_020501335.1-Fun_JAIBUN010000001.1_i000_000038	6	331	325	0.984848	0.626204
GCA_020501375.1-Fun_JAIBUR010000004.1_i000_006144	6	331	325	0.984848	0.626204
GCA_020501425.1-Fun_JAIBUT010000002.1_i000_003199	6	331	325	0.984848	0.626204
GCA_020501465.1-Fun_JAIBUV010000111.1_i000_000584	6	331	325	0.984848	0.626204
GCA_020501475.1-Fun_JAIBUX010000001.1_i000_000059	6	331	325	0.984848	0.626204
GCA_020501495.1-Fun_JAIBUW010000113.1_i000_000960	6	331	325	0.984848	0.626204
GCA_020501615.1-Fun_JAIBVD010000002.1_i000_003406	6	331	325	0.984848	0.626204
GCA_020501695.1-Fun_JAIBVG010000023.1_i000_004030	6	331	325	0.984848	0.626204
GCA_020501705.1-Fun_JAIBVI010000018.1_i000_002674	6	331	325	0.984848	0.626204
GCA_020501765.1-Fun_JAIBVK010000039.1_i000_006196	6	331	325	0.984848	0.626204
GCA_020501785.1-Fun_JAIBVL010000012.1_i000_000965	6	331	325	0.984848	0.626204
GCA_020501835.1-Fun_JAIBVN010000001.1_i000_000004	6	331	325	0.984848	0.626204
GCA_020501935.1-Fun_JAIBVT010000001.1_i000_000033	6	331	325	0.984848	0.626204
GCA_020501995.1-Fun_JAIBVV010000030.1_i000_006499	6	331	325	0.984848	0.626204
GCA_020502005.1-Fun_JAIBVW010000004.1_i000_005887	6	331	325	0.984848	0.626204
GCA_020502045.1-Fun_JAIBVZ010000050.1_i000_006589	6	331	325	0.984848	0.626204
GCA_020502095.1-Fun_JAIBWA010000005.1_i000_006641	6	331	325	0.984848	0.626204
GCA_020502115.1-Fun_JAIBWC010000056.1_i000_007642	6	331	325	0.984848	0.626204
GCA_020502215.1-Fun_JAIBWG010000086.1_i000_008839	6	331	325	0.984848	0.626204
GCA_020502225.1-Fun_JAIBWH010000010.1_i000_000194	6	331	325	0.984848	0.626204
GCA_020502235.1-Fun_JAIBWJ010000001.1_i000_000081	6	331	325	0.984848	0.626204
GCA_020502245.1-Fun_JAIBWI010000001.1_i000_000004	6	331	325	0.984848	0.626204
GCA_020502335.1-Fun_JAIBWL010000102.1_i000_000337	6	331	325	0.984848	0.626204
GCA_020502365.1-Fun_JAIBWM010000002.1_i000_003136	6	331	325	0.984848	0.626204
GCA_020502435.1-Fun_JAIBWQ010000085.1_i000_008813	6	331	325	0.984848	0.626204
GCA_020502485.1-Fun_JAIBWS010000097.1_i000_009287	6	331	325	0.984848	0.626204
GCA_020502615.1-Fun_JAIBWZ010000104.1_i000_000435	6	331	325	0.984848	0.626204
GCA_020502675.1-Fun_JAIBXB010000007.1_i000_008066	6	331	325	0.984848	0.626204
GCA_020502725.1-Fun_JAIBXF010000049.1_i000_007080	6	331	325	0.984848	0.626204
GCA_020502985.1-Fun_JAIBXH010000001.1_i000_000003	6	331	325	0.984848	0.626204
GCA_020503055.1-Fun_JAIBXK010000002.1_i000_003038	6	331	325	0.984848	0.626204
GCA_020503085.1-Fun_JAIBXM010000092.1_i000_009065	6	331	325	0.984848	0.626204
GCA_020503105.1-Fun_JAIBXO010000113.1_i000_000710	6	331	325	0.984848	0.626204
GCA_020503175.1-Fun_JAIBXP010000003.1_i000_005126	6	331	325	0.984848	0.626204
GCA_020503185.1-Fun_JAIBXR010000101.1_i000_000272	6	331	325	0.984848	0.626204
GCA_020503195.1-Fun_JAIBXT010000028.1_i000_004855	6	331	325	0.984848	0.626204
GCA_020503245.1-Fun_JAIBXU010000056.1_i000_007639	6	331	325	0.984848	0.626204
GCA_020503275.1-Fun_JAIBXW010000056.1_i000_007438	6	331	325	0.984848	0.626204
GCA_020503305.1-Fun_JAIBXY010000103.1_i000_000359	6	331	325	0.984848	0.626204
GCA_020503345.1-Fun_JAIBXZ010000098.1_i000_009495	6	331	325	0.984848	0.626204
GCA_020503375.1-Fun_JAIBYB010000038.1_i000_006054	6	331	325	0.984848	0.626204
GCA_020503435.1-Fun_JAIBYE010000001.1_i000_000168	6	331	325	0.984848	0.626204
GCA_020503465.1-Fun_JAIBYG010000002.1_i000_003139	6	331	325	0.984848	0.626204
GCA_020503535.1-Fun_JAIBYI010000089.1_i000_009127	6	331	325	0.984848	0.626204
GCA_020503545.1-Fun_JAIBYK010000002.1_i000_003150	6	331	325	0.984848	0.626204
GCA_020503555.1-Fun_JAIBYJ010000006.1_i000_007717	6	331	325	0.984848	0.626204
GCA_020503565.1-Fun_JAIBYL010000080.1_i000_008815	6	331	325	0.984848	0.626204
GCA_020503595.1-Fun_JAIBYM010000016.1_i000_002199	6	331	325	0.984848	0.626204
GCA_020503645.1-Fun_JAIBYO010000106.1_i000_000423	6	331	325	0.984848	0.626204
GCA_020503665.1-Fun_JAIBYP010000012.1_i000_000892	6	331	325	0.984848	0.626204
GCA_020503705.1-Fun_JAIBYQ010000114.1_i000_000759	6	331	325	0.984848	0.626204
GCA_020503745.1-Fun_JAIBYU010000015.1_i000_001980	6	331	325	0.984848	0.626204
GCA_020503795.1-Fun_JAIBYX010000102.1_i000_000465	6	331	325	0.984848	0.626204
GCA_020503805.1-Fun_JAIBYW010000090.1_i000_009058	6	331	325	0.984848	0.626204
GCA_020503815.1-Fun_JAIBYV010000011.1_i000_000556	6	331	325	0.984848	0.626204
GCA_020503895.1-Fun_JAIBZA010000046.1_i000_006385	6	331	325	0.984848	0.626204
GCA_020503905.1-Fun_JAIBZB010000049.1_i000_006598	6	331	325	0.984848	0.626204
GCA_020503915.1-Fun_JAIBZC010000034.1_i000_005645	6	331	325	0.984848	0.626204
GCA_020503935.1-Fun_JAIBZD010000008.1_i000_008509	6	331	325	0.984848	0.626204
GCA_020510485.1-Fun_JAIBQR010000110.1_i000_000694	6	331	325	0.984848	0.626204
GCA_902459845.2-Pro_CABPSV020000458.1_i000_002713	160	489	329	0.99697	0.557627
GCA_020499035.1-Fun_JAIBQD010000314.1_i000_004755	6	331	325	0.984848	0.626204
GCA_000731615.1-Fun_JHOI01000627.1_i000_007951	6	331	325	0.984848	0.626204
GCA_020499155.1-Fun_JAIBQK010000005.1_i000_006862	6	331	325	0.984848	0.626204
GCA_020499315.1-Fun_JAIBQQ010000009.1_i000_009059	6	331	325	0.984848	0.626204
GCA_020500215.1-Fun_JAIBSK010000011.1_i000_000840	6	331	325	0.984848	0.626204
GCA_020500905.1-Fun_JAIBTT010000006.1_i000_006984	6	331	325	0.984848	0.626204
GCA_020501635.1-Fun_JAIBVE010000001.1_i000_000038	6	331	325	0.984848	0.626204
GCA_020501815.1-Fun_JAIBVO010000013.1_i000_001407	6	331	325	0.984848	0.626204
GCA_020502165.1-Fun_JAIBWE010000011.1_i000_000598	6	331	325	0.984848	0.626204
GCA_020502425.1-Fun_JAIBWP010000019.1_i000_003042	6	331	325	0.984848	0.626204
GCA_020502705.1-Fun_JAIBXD010000026.1_i000_004499	6	331	325	0.984848	0.626204
GCA_020502995.1-Fun_JAIBXI010000001.1_i000_000078	6	331	325	0.984848	0.626204
GCA_020503015.1-Fun_JAIBXJ010000006.1_i000_007622	6	331	325	0.984848	0.626204
GCA_020503165.1-Fun_JAIBXQ010000018.1_i000_002780	6	331	325	0.984848	0.626204
GCA_020503715.1-Fun_JAIBYR010000003.1_i000_005182	6	331	325	0.984848	0.626204
GCA_000165395.2-Pro_CM031753.1_i000_001225	44	367	323	0.978788	0.684322
GCA_900090035.2-Pro_LT594584.1_i000_000360	126	446	320	0.969697	0.587156
GCA_000829775.1-Fun_DF933838.1_i000_002405	7	339	332	1.00606	0.648438
GCA_001305275.1-Fun_LHCL01000003.1_i000_005129	7	339	332	1.00606	0.648438
GCA_003073855.1-Fun_KZ805305.1_i000_001581	67	413	346	1.04848	0.598616
MEPE002.0722.00001.C001_00403	38	140	102	0.309091	0.350515
MEPE002.0722.00001.C001_00403	131	286	155	0.469697	0.532646
GCA_019804575.1-Fun_JAHQZX010000299.1_i000_002661	5	333	328	0.993939	0.636893
GCA_000510995.2-Pla_KQ134137.1_i000_002418	1	165	164	0.49697	0.987952
GCA_011057905.1-Fun_WUBL01000061.1_i000_008700	242	307	65	0.19697	0.126706
GCA_011057905.1-Fun_WUBL01000061.1_i000_008700	304	458	154	0.466667	0.300195
GCA_018446385.1-Pla_CM031522.1_i000_052731	1	221	220	0.666667	0.797101
GCA_000149645.3-Fun_DS027688.1_i000_007476	5	330	325	0.984848	0.626204
GCA_016748045.1-Fun_WHVT01000013.1_i000_001074	5	330	325	0.984848	0.626204
GCA_000330505.1-Pro_KB206474.1_i000_004115	33	364	331	1.00303	0.747178
GCA_001890705.1-Fun_KV878582.1_i000_000172	10	339	329	0.99697	0.629063
GCA_000956335.1-Pro_KQ001662.1_i000_001935	178	506	328	0.993939	0.541254
GCA_900090025.2-Pro_LT594507.1_i000_000330	126	446	320	0.969697	0.587156
GCA_900088565.1-Pro_FLQU01000054.1_i000_000383	268	587	319	0.966667	0.465015
GCA_018404265.1-Fun_BOPL01000004.1_i000_004894	6	331	325	0.984848	0.626204
GCA_000511025.2-Pla_CM002323.2_i000_006009	10	355	345	1.04545	0.798611
GCA_010724255.1-Fun_BLKF01000167.1_i000_009975	7	329	322	0.975758	0.620424
GCA_902729315.2-Pla_LR746274.1_i000_015529	68	227	159	0.481818	0.353333
GCA_902729315.2-Pla_LR746274.1_i000_015529	225	342	117	0.354545	0.26
GCA_012656225.1-Fun_JAAAPY010000068.1_i000_008867	6	330	324	0.981818	0.624277
GCA_012656285.1-Fun_JAAAPX010000059.1_i000_007947	6	330	324	0.981818	0.624277
GCA_012656295.1-Fun_JAAAPW010000067.1_i000_008399	6	330	324	0.981818	0.624277
GCA_012656325.1-Fun_JAAAPV010000066.1_i000_008550	6	330	324	0.981818	0.624277
GCA_019968955.1-Pro_JAHYSE010000215.1_i000_001205	43	366	323	0.978788	0.82398
GCA_002563875.1-Pro_CM008354.1_i000_005645	140	479	339	1.02727	0.559406
GCA_000985935.1-Fun_CVMT01000002.1_i000_002230	8	339	331	1.00303	0.64775
GCA_002847465.1-Fun_MSZS01000004.1_i000_006992	6	330	324	0.981818	0.624277
GCA_905216605.1-Pla_LR999453.1_i000_008242	38	134	96	0.290909	0.218182
GCA_905216605.1-Pla_LR999453.1_i000_008242	131	338	207	0.627273	0.470455
GCA_001651475.1-Pla_CM004361.1_i000_016059	37	175	138	0.418182	0.312217
GCA_001651475.1-Pla_CM004361.1_i000_016059	169	336	167	0.506061	0.377828
GCA_019202805.1-Pla_CM032902.1_i000_015547	37	175	138	0.418182	0.312217
GCA_019202805.1-Pla_CM032902.1_i000_015547	169	336	167	0.506061	0.377828
GCA_900088485.1-Pro_FLRD01000011.1_i000_000547	183	503	320	0.969697	0.531561
GCA_900088545.1-Pro_FLRE01000024.1_i000_000558	183	503	320	0.969697	0.531561
GCA_910591925.1-Fun_CAJVPW010025700.1_i000_011749	1	157	156	0.472727	0.443182
GCA_910591925.1-Fun_CAJVPW010025700.1_i000_011749	170	254	84	0.254545	0.238636
GCA_905182995.1-Pro_CAJJDP010000011.1_i000_004902	10	348	338	1.02424	0.730022
GCA_001907595.1-Fun_LFMY01000006.1_i000_007103	9	341	332	1.00606	0.642166
GCA_002234965.2-Fun_NKHV02000092.1_i000_008939	4	329	325	0.984848	0.628627
GCA_002234975.2-Fun_NIDN02000192.1_i000_003084	4	329	325	0.984848	0.628627
GCA_008704605.1-Fun_SWFS01000317.1_i000_005592	47	377	330	1	0.64833
GCA_000165425.1-Pro_CT868429.1_i000_026636	10	348	338	1.02424	0.730022
GCA_016861865.1-Fun_AP024447.1_i000_008592	48	392	344	1.04242	0.597222
GCA_014925825.1-Fun_JACGCK010000001.1_i000_000612	105	339	234	0.709091	0.441509
GCA_014925825.1-Fun_JACGCK010000001.1_i000_000612	337	412	75	0.227273	0.141509
GCA_905183005.1-Pro_CAJJDO010000016.1_i000_007983	19	348	329	0.99697	0.710583
GCA_002237265.2-Fun_NKHU02000054.1_i000_007563	5	330	325	0.984848	0.625
GCA_010093685.1-Fun_MU006216.1_i000_000280	47	393	346	1.04848	0.626812
GCA_019968985.1-Pro_JAHYSF010000259.1_i000_001027	39	363	324	0.981818	0.832905
GCA_021604985.1-Pla_BQKI01000009.1_i000_017768	45	224	179	0.542424	0.441975
GCA_021604985.1-Pla_BQKI01000009.1_i000_017768	223	342	119	0.360606	0.293827
GCA_904420315.1-Pla_LR881468.1_i000_013486	151	289	138	0.418182	0.248201
GCA_904420315.1-Pla_LR881468.1_i000_013486	284	446	162	0.490909	0.291367
GCA_905182975.1-Pro_CAJJDM010000010.1_i000_004487	12	348	336	1.01818	0.725702
GCA_001640025.2-Fun_CP014500.1_i000_004417	98	403	305	0.924242	0.537919
GCA_002382835.1-Fun_NPFJ01000117.1_i000_000742	7	339	332	1.00606	0.648438
GCA_002382855.1-Fun_NPFK01000115.1_i000_000708	7	339	332	1.00606	0.648438
GCA_001896365.1-Fun_MIKG01000002.1_i000_004592	7	340	333	1.00909	0.650391
GCA_016618355.2-Fun_JADGIP010000027.1_i000_001238	95	406	311	0.942424	0.594646
GCA_011752425.2-Ani_CACVKT020005209.1_i000_028476	1	167	166	0.50303	0.68595
GCA_017607545.1-Ani_JAANIC010001043.1_i000_001025	105	309	204	0.618182	0.554348
GCA_002794465.1-Fun_MTSL01000178.1_i000_000107	6	287	281	0.851515	0.294858
GCA_000149615.1-Fun_CH476594.1_i000_009630	6	336	330	1	0.633397
GCA_000691945.2-Pro_FO082872.1_i000_001209	51	384	333	1.00909	0.680982
GCA_000388065.2-Pro_KB932201.1_i000_000587	114	429	315	0.954545	0.544041
GCA_905182995.1-Pro_CAJJDP010000015.1_i000_005975	8	348	340	1.0303	0.734341
GCA_001675575.1-Ani_LZPO01117145.1_i000_023821	123	288	165	0.5	0.350318
GCA_003260675.2-Pla_QGKX02000088.1_i000_051223	17	268	251	0.760606	0.667553
GCA_015844325.1-Fun_VCAU01000060.1_i000_010008	69	396	327	0.990909	0.558974
GCA_019924185.1-Fun_JAHFXE010004762.1_i000_018278	1	196	195	0.590909	0.716912
GCA_905182975.1-Pro_CAJJDM010000016.1_i000_006202	12	348	336	1.01818	0.725702
GCA_905183005.1-Pro_CAJJDO010000022.1_i000_010433	11	348	337	1.02121	0.727862
GCA_001890125.1-Fun_KV878125.1_i000_001777	19	342	323	0.978788	0.614068
GCA_018127125.1-Pla_CM030799.1_i000_034242	41	346	305	0.924242	0.824324
GCA_905182985.1-Pro_CAJJDN010000012.1_i000_006319	9	348	339	1.02727	0.732181
GCA_000165425.1-Pro_CT868052.1_i000_011917	8	348	340	1.0303	0.734341
GCA_001511075.1-Fun_CDMC01000007.1_i000_008885	6	335	329	0.99697	0.630268
GCA_003184585.1-Fun_KZ821228.1_i000_003847	12	342	330	1	0.620301
GCA_000002715.1-Fun_DS027059.1_i000_001565	7	331	324	0.981818	0.625483
GCA_905332125.1-Ani_CAJOBJ010013102.1_i000_020271	1	142	141	0.427273	0.992958
GCA_009014675.2-Fun_BKZM02000003.1_i000_002132	7	336	329	0.99697	0.631478
GCA_009932835.1-Fun_BLJY01000003.1_i000_002377	7	336	329	0.99697	0.631478
GCA_009176345.1-Fun_ML732169.1_i000_002367	8	334	326	0.987879	0.626923
GCA_011763645.1-Fun_JAASGZ010007049.1_i000_019285	128	322	194	0.587879	0.596923
GCA_019924185.1-Fun_JAHFXE010000951.1_i000_007891	1	194	193	0.584848	0.709559
GCA_021365285.1-Fun_JAJTJA010000010.1_i000_002007	7	339	332	1.00606	0.645914
GCA_000143415.2-Pla_GL377675.1_i000_030590	1	255	254	0.769697	0.872852
GCA_018360595.1-Fun_SRQJ01000128.1_i000_000902	1	79	78	0.236364	0.330508
GCA_018360595.1-Fun_SRQJ01000128.1_i000_000902	77	128	51	0.154545	0.216102
GCA_018360595.1-Fun_SRQJ01000128.1_i000_000902	148	235	87	0.263636	0.368644
GCA_000583005.2-Pla_ASHM01016385.1_i000_020967	2	210	208	0.630303	0.750903
GCA_000583005.2-Pla_ASHM01031757.1_i000_032393	2	210	208	0.630303	0.750903
GCA_015852375.1-Fun_JAAAIF010003037.1_i000_005540	1	144	143	0.433333	0.986207
GCA_016808415.1-Fun_JAAWWR010000007.1_i000_006469	6	336	330	1	0.633397
GCA_905332015.1-Ani_CAJOAZ010002591.1_i000_026235	1	166	165	0.5	0.882353
GCA_003194525.1-Pro_NBIV01000001.1_i000_000073	34	363	329	0.99697	0.67418
GCA_000011425.1-Fun_BN001308.1_i000_009141	10	335	325	0.984848	0.6238
GCA_000149205.2-Fun_CH236920.1_i000_008991	10	335	325	0.984848	0.6238
GCA_902206195.3-Pla_CABITT030000004.1_i000_010736	1	184	183	0.554545	0.994565
GCA_000006565.2-Pro_CM002040.1_i000_002240	82	423	341	1.03333	0.616637
GCA_013099955.1-Pro_CM023087.1_i000_001964	82	423	341	1.03333	0.616637
GCA_000150015.2-Pro_KI544502.1_i000_004855	82	423	341	1.03333	0.616637
GCA_001663975.1-Ani_CM004467.1_i000_003789	123	299	176	0.533333	0.351297
GCA_001663975.1-Ani_CM004467.1_i000_003789	298	346	48	0.145455	0.0958084
GCA_001663975.1-Ani_CM004467.1_i000_003789	343	411	68	0.206061	0.135729
GCA_900617915.1-Ani_UYRT01078280.1_i000_010986	73	303	230	0.69697	0.451866
GCA_900617915.1-Ani_UYRT01078280.1_i000_010986	301	378	77	0.233333	0.151277
GCA_000757645.3-Ani_AZBU02000002.1_i000_010500	1	215	214	0.648485	0.90678
GCA_010015635.1-Fun_ML976042.1_i000_006256	52	395	343	1.03939	0.614695
GCA_003589665.1-Fun_MVGC01000151.1_i000_004886	2	329	327	0.990909	0.638672
GCA_003046395.2-Pla_CM009690.2_i000_003062	376	657	281	0.851515	0.427052
GCA_011066485.2-Fun_MU009886.1_i000_002991	87	375	288	0.872727	0.530387
GCA_003369625.1-Fun_PVWQ01000007.1_i000_009528	11	336	325	0.984848	0.6238
GCA_018360445.1-Fun_SRQK01000093.1_i000_008145	1	79	78	0.236364	0.330508
GCA_018360445.1-Fun_SRQK01000093.1_i000_008145	77	128	51	0.154545	0.216102
GCA_018360445.1-Fun_SRQK01000093.1_i000_008145	148	235	87	0.263636	0.368644
GCA_000143415.2-Pla_GL377576.1_i000_008798	9	293	284	0.860606	0.943522
MEPA004.0722.00001.C001_02804	39	129	90	0.272727	0.313589
MEPA004.0722.00001.C001_02804	135	283	148	0.448485	0.515679
GCA_019924875.1-Fun_JAHFYK010010085.1_i000_023663	1	155	154	0.466667	0.980892
GCA_019924875.1-Fun_JAHFYK010010087.1_i000_023664	1	155	154	0.466667	0.980892
GCA_001263375.1-Fun_LAVV01002344.1_i000_001834	105	313	208	0.630303	0.34958
GCA_001263375.1-Fun_LAVV01002344.1_i000_001834	332	466	134	0.406061	0.22521
GCA_000346795.1-Fun_KB644414.1_i000_007115	6	330	324	0.981818	0.624277
GCA_000230395.2-Fun_ACJE01000021.1_i000_000184	5	332	327	0.990909	0.631274
GCA_002211485.2-Fun_NKJJ02000001.1_i000_000685	5	332	327	0.990909	0.631274
GCA_003184595.1-Fun_KZ821350.1_i000_006666	5	332	327	0.990909	0.631274
GCA_003344505.1-Fun_KZ851844.1_i000_000789	5	332	327	0.990909	0.631274
GCA_003344705.1-Fun_KZ851904.1_i000_002596	5	332	327	0.990909	0.631274
GCA_003344945.1-Fun_KZ852098.1_i000_012613	5	332	327	0.990909	0.631274
GCA_003850985.1-Fun_BDHI01000014.1_i000_005348	5	332	327	0.990909	0.631274
GCA_900248155.1-Fun_OGUI01000017.1_i000_001838	5	332	327	0.990909	0.631274
GCA_003184925.1-Fun_KZ821641.1_i000_010403	5	332	327	0.990909	0.631274
GCA_003184835.1-Fun_KZ824536.1_i000_000901	6	332	326	0.987879	0.629344
GCA_000239835.2-Fun_DF126468.1_i000_007664	6	332	326	0.987879	0.629344
GCA_001515345.1-Fun_BCMY01000006.1_i000_004204	6	332	326	0.987879	0.629344
GCA_001602395.1-Fun_BCWF01000028.1_i000_005569	6	332	326	0.987879	0.629344
GCA_001890685.1-Fun_KV878239.1_i000_004306	6	332	326	0.987879	0.629344
GCA_001890745.1-Fun_KV878176.1_i000_000777	6	332	326	0.987879	0.629344
GCA_013340325.1-Fun_BLWE01000009.1_i000_008931	6	332	326	0.987879	0.629344
GCA_016861625.1-Fun_AP024427.1_i000_004515	6	332	326	0.987879	0.629344
GCA_016865315.1-Fun_AP024436.1_i000_004314	6	332	326	0.987879	0.629344
GCA_003184755.1-Fun_KZ825056.1_i000_002389	6	332	326	0.987879	0.629344
GCA_003184535.1-Fun_MSFU01000022.1_i000_004688	7	332	325	0.984848	0.627413
GCA_000208865.2-Pro_FR823387.1_i000_001905	87	423	336	1.01818	0.188552
GCA_001683735.1-Fun_LUGG01000019.1_i000_011263	127	291	164	0.49697	0.327345
GCA_001683735.1-Fun_LUGG01000019.1_i000_011263	301	418	117	0.354545	0.233533
GCA_014839625.1-Fun_WIWV01000006.1_i000_006351	6	331	325	0.984848	0.625
GCA_014839855.1-Fun_WIWU01000030.1_i000_004391	6	331	325	0.984848	0.625
GCA_905182995.1-Pro_CAJJDP010000009.1_i000_004039	1	169	168	0.509091	0.865979
GCA_001889945.1-Fun_KV878682.1_i000_005171	8	333	325	0.984848	0.627413
GCA_001890725.1-Fun_KV878210.1_i000_002835	12	332	320	0.969697	0.618956
GCA_900624965.1-Ani_UYYB01100476.1_i000_012793	4	238	234	0.709091	0.9
GCA_015178925.1-Fun_WHVC01000003.1_i000_006421	41	180	139	0.421212	0.355499
GCA_015178925.1-Fun_WHVC01000003.1_i000_006421	181	268	87	0.263636	0.222506
GCA_003184865.1-Fun_KZ824288.1_i000_006334	17	341	324	0.981818	0.611321
MELA003.0722.00001.C001_01738	29	127	98	0.29697	0.353791
MELA003.0722.00001.C001_01738	122	277	155	0.469697	0.559567
GCA_000750115.1-Fun_JPOX01000014.1_i000_004398	8	339	331	1.00303	0.645224
GCA_001048715.1-Fun_CDHK01000006.1_i000_007622	3	332	329	0.99697	0.637597
GCA_002016555.1-Fun_LJBN01000068.1_i000_001405	3	332	329	0.99697	0.637597
GCA_003184635.1-Fun_KZ826382.1_i000_009431	6	333	327	0.990909	0.630058
GCA_003184685.1-Fun_KZ825471.1_i000_001898	29	342	313	0.948485	0.587242
GCA_000001985.1-Fun_DS995904.1_i000_001999	8	339	331	1.00303	0.645224
GCA_009556855.1-Fun_CP045654.1_i000_003126	8	339	331	1.00303	0.645224
GCA_009650675.1-Fun_CM018878.1_i000_008022	8	339	331	1.00303	0.645224
GCA_907166805.1-Fun_CAJRGZ010000009.1_i000_000106	58	363	305	0.924242	0.559633
GCA_000733215.1-Pla_KL662148.1_i000_005089	24	254	230	0.69697	0.519187
GCA_000733215.1-Pla_KL662148.1_i000_005089	251	331	80	0.242424	0.180587
GCA_003184745.1-Fun_KZ821698.1_i000_005267	29	342	313	0.948485	0.587242
GCA_003184705.1-Fun_KZ825161.1_i000_007830	29	342	313	0.948485	0.587242
GCA_003184785.1-Fun_KZ824795.1_i000_006267	29	342	313	0.948485	0.587242
GCA_003184825.1-Fun_KZ824622.1_i000_000394	29	342	313	0.948485	0.586142
GCA_003184695.1-Fun_KZ825361.1_i000_008072	29	342	313	0.948485	0.586142
GCA_003184765.1-Fun_KZ824950.1_i000_004497	29	342	313	0.948485	0.586142
GCA_001890905.1-Fun_KV878976.1_i000_005163	5	309	304	0.921212	0.608
GCA_002072255.1-Fun_MDYP01000016.1_i000_004844	16	334	318	0.963636	0.611538
GCA_003184545.1-Fun_MSFL01000013.1_i000_002137	8	335	327	0.990909	0.625239
GCA_010094095.1-Fun_ML979136.1_i000_006421	62	372	310	0.939394	0.579439
GCA_011392555.1-Fun_QMFL01000027.1_i000_002167	5	334	329	0.99697	0.635135
GCA_001990825.1-Fun_KV907493.1_i000_000838	11	332	321	0.972727	0.619691
GCA_006542485.1-Fun_VIFY01000060.1_i000_006560	4	334	330	1	0.626186
GCA_014058105.1-Pla_JACGCM010002660.1_i000_006086	21	344	323	0.978788	0.925501
GCA_003184625.1-Fun_KZ821445.1_i000_000522	6	332	326	0.987879	0.629344
GCA_003184845.1-Fun_KZ824485.1_i000_010655	12	332	320	0.969697	0.618956
GCA_002217885.1-Pro_BDSP01000153.1_i000_001056	39	379	340	1.0303	0.809524
GCA_903114435.1-Pla_CAEKKB010000005.1_i000_017507	58	260	202	0.612121	0.770992
GCA_000344595.1-Ani_KB588327.1_i000_017163	3	157	154	0.466667	0.369305
GCA_000344595.1-Ani_KB588327.1_i000_017163	178	275	97	0.293939	0.232614
GCA_002849105.1-Fun_MSFO01000010.1_i000_002751	8	340	332	1.00606	0.625235
GCA_001908125.1-Fun_MNBE01000099.1_i000_014176	5	334	329	0.99697	0.635135
GCA_900240055.1-Pro_LT969441.1_i000_000603	112	435	323	0.978788	0.606004
GCA_015178925.1-Fun_WHVC01000005.1_i000_009787	492	789	297	0.9	0.342166
GCA_021605095.1-Ani_BPLR01009570.1_i000_036594	125	282	157	0.475758	0.285455
GCA_021605095.1-Ani_BPLR01009570.1_i000_036594	279	428	149	0.451515	0.270909
GCA_001602025.1-Pro_CM003859.1_i000_000556	123	447	324	0.981818	0.594495
GCA_006783055.1-Ani_VCRD01007018.1_i000_021245	4	153	149	0.451515	0.937107
GCA_019154785.2-Pro_JAGRRH010000006.1_i000_031853	94	431	337	1.02121	0.620626
GCA_000149985.1-Fun_DS231615.1_i000_010534	44	387	343	1.03939	0.625912
GCA_003171515.3-Fun_CM025795.1_i000_001004	44	387	343	1.03939	0.625912
GCA_003171545.1-Fun_NQWZ01000101.1_i000_004594	44	387	343	1.03939	0.625912
GCA_003231325.2-Fun_MVBF02000001.1_i000_000330	44	387	343	1.03939	0.625912
GCA_003231345.1-Fun_MVBI01000238.1_i000_007470	44	387	343	1.03939	0.625912
GCA_003231355.1-Fun_MVBG01000121.1_i000_005612	44	387	343	1.03939	0.625912
GCA_003231365.1-Fun_MVBH01000163.1_i000_006246	44	387	343	1.03939	0.625912
GCA_003231415.2-Fun_MUXC02000001.1_i000_000934	44	387	343	1.03939	0.625912
GCA_003231425.1-Fun_NRDI01000088.1_i000_004301	44	387	343	1.03939	0.625912
GCA_008692205.1-Fun_SAXQ01000001.1_i000_000957	44	387	343	1.03939	0.625912
GCA_001661255.1-Fun_KV454212.1_i000_004591	18	351	333	1.00909	0.763761
GCA_003426965.1-Fun_QUQM01000002.1_i000_002951	6	338	332	1.00606	0.628788
GCA_004798825.1-Fun_SOSA01000169.1_i000_002970	6	338	332	1.00606	0.628788
GCA_000003195.3-Pla_CM000763.3_i000_017440	21	337	316	0.957576	0.723112
GCA_900232045.3-Fun_HG992978.1_i000_001925	36	387	351	1.06364	0.640511
GCA_003184645.1-Fun_KZ825975.1_i000_009567	7	332	325	0.984848	0.629845
GCA_000521035.1-Pro_KI925496.1_i000_000731	106	436	330	1	0.617978
GCA_000231115.1-Fun_JH370140.1_i000_001284	77	414	337	1.02121	0.812048
GCA_900095595.1-Pro_LT963417.1_i000_000666	108	436	328	0.993939	0.613084
GCA_001601855.1-Pro_CM003845.1_i000_000536	109	437	328	0.993939	0.613084
GCA_000521075.1-Pro_KI926023.1_i000_000772	106	436	330	1	0.617978
GCA_018360575.1-Fun_SRQL01000002.1_i000_002317	1	79	78	0.236364	0.330508
GCA_018360575.1-Fun_SRQL01000002.1_i000_002317	77	128	51	0.154545	0.216102
GCA_018360575.1-Fun_SRQL01000002.1_i000_002317	148	235	87	0.263636	0.368644
GCA_900097015.1-Pro_LT969413.1_i000_000602	114	435	321	0.972727	0.602251
GCA_015680625.1-Fun_JAAAXW010000267.1_i000_005748	1	149	148	0.448485	0.8
GCA_000521155.1-Pro_KI927810.1_i000_000407	106	435	329	0.99697	0.616105
GCA_019776745.2-Pla_CM034148.1_i000_011735	1	169	168	0.509091	0.796209
GCA_009193485.1-Fun_ML738665.1_i000_008743	7	335	328	0.993939	0.629559
GCA_017911155.1-Fun_JAEFCI010007051.1_i000_004499	1	158	157	0.475758	0.679654
GCA_000149665.2-Pro_CH672011.1_i000_001745	133	467	334	1.01212	0.590106
GCA_000149795.1-Pro_DS016083.1_i000_003218	133	467	334	1.01212	0.590106
GCA_015529785.1-Fun_JAAAUK010000452.1_i000_007478	126	313	187	0.566667	0.597444
GCA_000986645.1-Fun_JZBS01003505.1_i000_005049	8	339	331	1.00303	0.6341
GCA_000986665.1-Fun_JYKN01000301.1_i000_006799	8	339	331	1.00303	0.6341
GCA_002846915.2-Fun_MSFN02000002.1_i000_003114	8	339	331	1.00303	0.6341
GCA_010015605.1-Fun_ML975291.1_i000_004637	51	388	337	1.02121	0.618349
GCA_002217885.1-Pro_BDSP01000025.1_i000_000026	39	379	340	1.0303	0.693878
GCA_003024255.1-Pla_CM009663.1_i000_010456	113	296	183	0.554545	0.616162
FEPL001.0722.00001.C001_02164	32	113	81	0.245455	0.316406
FEPL001.0722.00001.C001_02164	104	256	152	0.460606	0.59375
GCA_010458925.1-Pla_CM021239.1_i000_033561	1	178	177	0.536364	0.542945
GCA_900660405.1-Pro_CAACVS010000001.1_i000_000146	80	419	339	1.02727	0.638418
GCA_000002765.3-Pro_AL844503.2_i000_000679	106	436	330	1	0.617978
GCA_000150435.3-Pro_KE123714.1_i000_006212	106	436	330	1	0.617978
GCA_000186055.2-Pro_GG664961.1_i000_004982	106	436	330	1	0.617978
GCA_000401695.2-Pro_KE123739.1_i000_000697	106	436	330	1	0.617978
GCA_000401715.2-Pro_KE124427.1_i000_000788	106	436	330	1	0.617978
GCA_000521015.1-Pro_KI925021.1_i000_000698	106	436	330	1	0.617978
GCA_000521055.1-Pro_KI926305.1_i000_000778	106	436	330	1	0.617978
GCA_000521095.1-Pro_KI927252.1_i000_000475	106	436	330	1	0.617978
GCA_000521115.1-Pro_KI927475.1_i000_000721	106	436	330	1	0.617978
GCA_002831795.1-Pro_NYMT01000003.1_i000_001675	106	436	330	1	0.617978
GCA_012898025.1-Pro_QFXU01000010.1_i000_001006	106	436	330	1	0.617978
GCA_009735665.1-Ani_MQTX01002515.1_i000_009743	1	191	190	0.575758	0.994764
GCA_900100905.1-Fun_FMWP01000012.1_i000_007944	119	448	329	0.99697	0.580247
GCA_900102585.1-Fun_FMWQ01000021.1_i000_005506	119	448	329	0.99697	0.580247
GCA_000224865.2-Pro_KN046786.1_i000_009649	1	282	281	0.851515	0.683698
GCA_000250965.2-Pro_KQ973619.1_i000_004700	1	282	281	0.851515	0.683698
GCA_010015725.1-Fun_ML977575.1_i000_005425	26	368	342	1.03636	0.645283
GCA_020617735.1-Fun_JAFCIX010000030.1_i000_000693	79	281	202	0.612121	0.422594
GCA_020617735.1-Fun_JAFCIX010000030.1_i000_000693	278	374	96	0.290909	0.200837
GCA_015476325.1-Pro_JADAQX010000480.1_i000_003793	32	176	144	0.436364	0.318584
GCA_015476325.1-Pro_JADAQX010000480.1_i000_003793	170	346	176	0.533333	0.389381
GCA_001266575.1-Ani_JTDY01005801.1_i000_012938	88	162	74	0.224242	0.23053
GCA_001266575.1-Ani_JTDY01005801.1_i000_012938	155	208	53	0.160606	0.165109
GCA_001266575.1-Ani_JTDY01005801.1_i000_012938	206	319	113	0.342424	0.352025
GCA_009193565.1-Fun_ML739102.1_i000_003771	8	335	327	0.990909	0.631274
GCA_000981445.1-Pro_LK391707.1_i000_000400	63	381	318	0.963636	0.641129
GCA_018360435.1-Fun_SRQI01000060.1_i000_006617	1	79	78	0.236364	0.364486
GCA_018360435.1-Fun_SRQI01000060.1_i000_006617	78	213	135	0.409091	0.630841
GCA_014904985.1-Fun_MU128919.1_i000_002000	89	400	311	0.942424	0.581308
GCA_019154785.2-Pro_JAGRRH010000020.1_i000_017204	82	419	337	1.02121	0.635849
GCA_013421405.2-Fun_SPNV01000116.1_i000_000975	4	333	329	0.99697	0.631478
GCA_013467485.1-Pla_CM025283.1_i000_024812	1	169	168	0.509091	0.583333
GCA_000189635.1-Pro_GG662798.1_i000_004313	80	401	321	0.972727	0.5136
GCA_013487665.1-Pla_CM025192.1_i000_024353	1	165	164	0.49697	0.628352
GCA_003698115.1-Fun_RAQS01000545.1_i000_007900	3	329	326	0.987879	0.636719
GCA_003184525.1-Fun_MSFK01000019.1_i000_003777	11	334	323	0.978788	0.621154
GCA_009193465.1-Fun_ML742209.1_i000_007964	5	332	327	0.990909	0.627639
GCA_009193585.1-Fun_ML737651.1_i000_006509	8	335	327	0.990909	0.627639
GCA_009193665.1-Fun_ML735756.1_i000_007873	8	335	327	0.990909	0.627639
GCA_900097035.1-Pro_LT969553.1_i000_000541	165	487	322	0.975758	0.544839
GCA_013398345.1-Ani_WBNA01000666.1_i000_012441	1	153	152	0.460606	0.638655
GCA_013398735.1-Ani_VZSV01000449.1_i000_009212	1	154	153	0.463636	0.642857
GCA_000723685.1-Pro_HG810765.1_i000_001156	111	442	331	1.00303	0.612963
GCA_009176365.1-Fun_ML733061.1_i000_000707	7	333	326	0.987879	0.62572
GCA_009193605.1-Fun_ML735224.1_i000_002454	7	333	326	0.987879	0.62572
GCA_015178925.1-Fun_WHVC01000016.1_i000_002818	1	206	205	0.621212	0.702055
GCA_900097025.1-Pro_LT969567.1_i000_000697	113	444	331	1.00303	0.610701
GCA_013487665.1-Pla_CM025186.1_i000_012715	1	166	165	0.5	0.56701
GCA_900618405.1-Ani_UYSL01002647.1_i000_002365	7	236	229	0.693939	0.704615
GCA_014282245.1-Pla_CM024954.1_i000_004031	58	200	142	0.430303	0.421365
GCA_014282245.1-Pla_CM024954.1_i000_004031	198	270	72	0.218182	0.21365
GCA_015852395.1-Fun_JAAAII010004384.1_i000_012440	82	270	188	0.569697	0.696296
GCA_001696595.2-Fun_MBFL02000478.1_i000_009052	30	366	336	1.01818	0.608696
GCA_002072425.1-Fun_MOOB01000036.1_i000_007158	11	334	323	0.978788	0.622351
GCA_001890105.1-Fun_KV878337.1_i000_001565	22	340	318	0.963636	0.602273
GCA_000166005.1-Fun_GL533847.1_i000_003196	36	387	351	1.06364	0.653631
GCA_009728635.1-Fun_WJSK01000002.1_i000_001672	36	387	351	1.06364	0.653631
GCA_009728645.1-Fun_WJSL01000002.1_i000_001700	36	387	351	1.06364	0.653631
GCA_009728655.1-Fun_WJSN01000001.1_i000_000430	36	387	351	1.06364	0.653631
GCA_009728665.1-Fun_WJSO01000001.1_i000_000420	36	387	351	1.06364	0.653631
GCA_009728675.1-Fun_WJSM01000001.1_i000_000978	36	387	351	1.06364	0.653631
GCA_900231935.2-Fun_OCTF02000002.1_i000_001834	36	387	351	1.06364	0.653631
GCA_000005005.6-Pla_CM000782.4_i000_026329	84	289	205	0.621212	0.709343
GCA_016097325.1-Fun_JADPPX010000002.1_i000_003529	16	342	326	0.987879	0.611632
GCA_000313485.1-Fun_CAIF01000043.1_i000_004782	63	395	332	1.00606	0.691667
GCA_019924185.1-Fun_JAHFXE010009849.1_i000_023003	2	152	150	0.454545	0.986842
GCA_019925215.1-Fun_JAHFYS010001878.1_i000_006321	86	348	262	0.793939	0.752874
GCA_000710275.1-Fun_CM002801.1_i000_010594	12	334	322	0.975758	0.620424
GCA_011058885.1-Fun_SWKS01000054.1_i000_009378	12	334	322	0.975758	0.620424
GCA_001750085.1-Pro_KV784359.1_i000_008220	40	379	339	1.02727	0.70332
GCA_001792695.1-Fun_LYCR01000022.1_i000_003849	7	337	330	1	0.662651
GCA_000331365.3-Pla_AMZH03009647.1_i000_029801	4	205	201	0.609091	0.630094
GCA_001561935.1-Fun_LHQR01000070.1_i000_006906	3	334	331	1.00303	0.638996
GCA_000004155.2-Fun_KE546995.1_i000_004613	79	402	323	0.978788	0.625969
GCA_009193595.1-Fun_ML736405.1_i000_012245	7	334	327	0.990909	0.627639
GCA_016861735.1-Fun_AP024418.1_i000_004276	38	343	305	0.924242	0.577652
GCA_905250055.1-Ani_CAJNOF010001039.1_i000_031596	694	936	242	0.733333	0.257996
GCA_905250075.1-Ani_CAJNOP010001602.1_i000_056186	694	936	242	0.733333	0.257996
GCA_001717485.1-Fun_JXNT01000002.1_i000_004639	39	343	304	0.921212	0.575758
GCA_002072365.1-Fun_MLQL01000027.1_i000_007233	12	334	322	0.975758	0.620424
GCA_014905375.1-Pla_BMAC01001247.1_i000_027889	1	214	213	0.645455	0.661491
GCA_000359705.1-Fun_KB908855.1_i000_010559	49	388	339	1.02727	0.619744
GCA_010194725.1-Pro_WXXK01000658.1_i000_004422	104	231	127	0.384848	0.321519
GCA_010194725.1-Pro_WXXK01000658.1_i000_004422	222	275	53	0.160606	0.134177
GCA_003260675.2-Pla_QGKX02002183.1_i000_041511	1	167	166	0.50303	0.640927
GCA_001661325.1-Fun_KV454290.1_i000_001408	42	368	326	0.987879	0.84456
GCA_003704575.1-Fun_QWIN01001423.1_i000_002894	97	363	266	0.806061	0.732782
GCA_002271895.2-Pla_CM008438.1_i000_021471	2	308	306	0.927273	0.801047
GCA_000004255.1-Pla_GL348719.1_i000_027488	104	383	279	0.845455	0.722798
GCA_020536225.1-Fun_JAEUBG010003403.1_i000_006205	57	394	337	1.02121	0.71097
GCA_002072405.1-Fun_MDDG01000009.1_i000_006908	12	333	321	0.972727	0.618497
GCA_002072265.1-Fun_MDYM01000010.1_i000_007311	9	335	326	0.987879	0.628131
GCA_001513925.1-Fun_LLXE01000125.1_i000_001181	9	335	326	0.987879	0.628131
GCA_000769765.1-Fun_JQGA01000031.1_i000_000655	13	335	322	0.975758	0.620424
GCA_000327385.1-Ani_KB203683.1_i000_022297	7	172	165	0.5	0.9375
GCA_000513335.1-Fun_HG793136.1_i000_002358	8	335	327	0.990909	0.630058
GCA_905338405.1-Ani_CAJPEX010000289.1_i000_002534	62	195	133	0.40303	0.157957
GCA_905338405.1-Ani_CAJPEX010000289.1_i000_002534	234	379	145	0.439394	0.172209
GCA_014462685.1-Ani_JAACXV010013921.1_i000_015187	46	242	196	0.593939	0.425163
GCA_014462685.1-Ani_JAACXV010013921.1_i000_015187	247	351	104	0.315152	0.225597
GCA_014621375.1-Fun_JAAOZQ010000136.1_i000_002048	8	335	327	0.990909	0.630058
GCA_003573695.1-Pla_PUWZ01028491.1_i000_049449	1	108	107	0.324242	0.493088
GCA_003573695.1-Pla_PUWZ01028491.1_i000_049449	105	214	109	0.330303	0.502304
GCA_001884805.1-Pla_MKKS01012425.1_i000_039835	5	203	198	0.6	0.536585
GCA_001278595.1-Fun_LHQQ01000053.1_i000_010207	7	335	328	0.993939	0.627151
GCA_001884845.1-Pla_MKKT01002983.1_i000_017001	5	203	198	0.6	0.528
GCA_000818735.3-Pla_JTFG03002889.1_i000_023782	5	204	199	0.60303	0.539295
GCA_000315645.2-Fun_JH993636.1_i000_000622	11	334	323	0.978788	0.622351
GCA_000315665.1-Fun_JH993724.1_i000_004177	11	334	323	0.978788	0.622351
GCA_016767815.1-Fun_CP060778.1_i000_007222	11	334	323	0.978788	0.622351
GCA_012295545.2-Fun_JAAQRF020000025.1_i000_007165	11	334	323	0.978788	0.622351
GCA_001773325.1-Fun_LXJU01000003.1_i000_002589	6	333	327	0.990909	0.637427
GCA_000513255.1-Fun_HG792016.1_i000_004091	13	334	321	0.972727	0.618497
GCA_015533775.1-Fun_JABCSE010000011.1_i000_004867	13	334	321	0.972727	0.618497
GCA_002007945.1-Fun_MKZY01000005.1_i000_006484	7	334	327	0.990909	0.627639
GCA_000600275.1-Fun_KK088447.1_i000_008747	15	344	329	0.99697	0.623106
GCA_002847485.1-Fun_MSFM01000002.1_i000_004955	10	340	330	1	0.632184
GCA_002847045.1-Fun_KZ559126.1_i000_002662	9	340	331	1.00303	0.6341
GCA_001890805.1-Fun_KV878899.1_i000_006152	16	344	328	0.993939	0.621212
GCA_902702955.1-Ani_CACRXO010000051.1_i000_005760	126	259	133	0.40303	0.266
GCA_902702955.1-Ani_CACRXO010000051.1_i000_005760	256	382	126	0.381818	0.252
GCA_000150455.3-Pro_KE123476.1_i000_000651	106	436	330	1	0.112016
GCA_905332015.1-Ani_CAJOAZ010013981.1_i000_044695	96	283	187	0.566667	0.660777
GCA_000769735.1-Fun_JQFY01000032.1_i000_008154	10	334	324	0.981818	0.624277
GCA_001204775.2-Fun_JNOM01000495.1_i000_010635	7	334	327	0.990909	0.627639
GCA_009176395.1-Fun_ML734373.1_i000_011636	7	334	327	0.990909	0.627639
GCA_009193645.1-Fun_ML736755.1_i000_003863	7	334	327	0.990909	0.627639
GCA_905332015.1-Ani_CAJOAZ010000718.1_i000_012338	110	298	188	0.569697	0.630872
GCA_002749805.1-Fun_NEXV01000567.1_i000_000479	7	334	327	0.990909	0.627639
GCA_009193545.1-Fun_ML737115.1_i000_001332	7	334	327	0.990909	0.627639
GCA_009176385.1-Fun_ML734942.1_i000_002115	7	334	327	0.990909	0.627639
GCA_009176405.1-Fun_ML733430.1_i000_006538	7	334	327	0.990909	0.627639
GCA_009193505.1-Fun_ML738349.1_i000_009545	7	334	327	0.990909	0.627639
GCA_009193525.1-Fun_ML741811.1_i000_008984	7	334	327	0.990909	0.627639
GCA_000006275.3-Fun_AAIH03000170.1_i000_008760	7	334	327	0.990909	0.627639
GCA_000184455.3-Fun_BA000054.1_i000_009521	7	334	327	0.990909	0.627639
GCA_000952835.1-Fun_JZDT01000862.1_i000_010104	7	334	327	0.990909	0.627639
GCA_002443195.2-Fun_NWUI02000026.1_i000_003155	7	334	327	0.990909	0.627639
GCA_002443215.2-Fun_NWUG02001363.1_i000_008940	7	334	327	0.990909	0.627639
GCA_002456175.2-Fun_NWUH02000093.1_i000_009985	7	334	327	0.990909	0.627639
GCA_009017415.1-Fun_CP044623.1_i000_010496	7	334	327	0.990909	0.627639
GCA_009176455.1-Fun_ML732769.1_i000_001765	7	334	327	0.990909	0.627639
GCA_014117465.1-Fun_CP059871.1_i000_009553	7	334	327	0.990909	0.627639
GCA_014117485.1-Fun_CP059863.1_i000_009597	7	334	327	0.990909	0.627639
GCA_002072345.1-Fun_MDYN01000046.1_i000_009652	5	332	327	0.990909	0.638672
GCA_000269785.2-Fun_AKHY01000187.1_i000_008895	8	334	326	0.987879	0.62572
GCA_000691885.1-Fun_AMCJ01000185.1_i000_010786	8	334	326	0.987879	0.62572
GCA_003709025.1-Fun_QQZZ01000052.1_i000_002488	8	334	326	0.987879	0.62572
GCA_009176375.1-Fun_ML734646.1_i000_010195	8	334	326	0.987879	0.62572
GCA_014784225.2-Fun_CP061809.2_i000_010355	8	334	326	0.987879	0.62572
GCA_002072245.1-Fun_MDYL01000002.1_i000_001060	5	330	325	0.984848	0.638507
GCA_002946415.1-Fun_NJPS01000048.1_i000_005523	121	362	241	0.730303	0.451311
GCA_009193445.1-Fun_ML743593.1_i000_008613	7	335	328	0.993939	0.629559
GCA_000004255.1-Pla_GL348715.1_i000_011552	40	135	95	0.287879	0.213964
GCA_000004255.1-Pla_GL348715.1_i000_011552	130	341	211	0.639394	0.475225
GCA_000296195.2-Pro_AGNL01039177.1_i000_025284	609	928	319	0.966667	0.307618
GCA_003073045.1-Ani_CM009758.1_i000_000897	85	236	151	0.457576	0.356974
GCA_003073045.1-Ani_CM009758.1_i000_000897	232	348	116	0.351515	0.274232
GCA_000769745.1-Fun_JQFZ01000064.1_i000_007622	13	334	321	0.972727	0.618497
GCA_000769755.1-Fun_JQFX01000864.1_i000_002533	13	334	321	0.972727	0.618497
GCA_013138035.1-Fun_JAASRZ010000043.1_i000_013017	9	335	326	0.987879	0.648111
GCA_002850765.1-Fun_KZ559536.1_i000_004491	9	338	329	0.99697	0.630268
GCA_002072235.1-Fun_MDYO01000103.1_i000_011493	9	335	326	0.987879	0.628131
GCA_902860255.1-Pla_LR794324.1_i000_007231	47	253	206	0.624242	0.814229
ARVE002.0722.00001.C001_01312	33	106	73	0.221212	0.281853
ARVE002.0722.00001.C001_01312	100	259	159	0.481818	0.6139
GCA_000523435.1-Fun_KI964693.1_i000_008804	50	389	339	1.02727	0.619744
GCA_905337335.1-Fun_CAJPDQ010000015.1_i000_004911	59	412	353	1.0697	0.60034
GCA_000499605.1-Pro_HG719365.1_i000_001804	64	402	338	1.02424	0.746137
GCA_001661245.1-Fun_KV454015.1_i000_003919	26	367	341	1.03333	0.695918
GCA_000149405.2-Pro_CM000643.1_i000_005177	58	395	337	1.02121	0.671315
ARPR002.0722.00001.C001_00709	36	117	81	0.245455	0.306818
ARPR002.0722.00001.C001_00709	107	264	157	0.475758	0.594697
GCA_016508695.1-Fun_VNKQ01000007.1_i000_006593	142	335	193	0.584848	0.305864
GCA_016508695.1-Fun_VNKQ01000007.1_i000_006593	333	451	118	0.357576	0.187005
GCA_000338975.1-Fun_KB445576.1_i000_006686	50	389	339	1.02727	0.619744
GCA_000354255.1-Fun_KB733447.1_i000_002228	50	389	339	1.02727	0.619744
GCA_019454015.1-Fun_JAHUAA010000005.1_i000_008789	50	389	339	1.02727	0.619744
GCA_900618415.1-Ani_UZAM01018352.1_i000_012593	4	189	185	0.560606	0.973684
GCA_008330625.1-Pro_VLTM01000090.1_i000_006137	133	428	295	0.893939	0.545287
GCA_008330635.1-Pro_VLTL01000093.1_i000_004977	133	428	295	0.893939	0.545287
GCA_008330645.1-Pro_VLTN01000053.1_i000_006642	133	428	295	0.893939	0.545287
GCA_008330665.1-Pro_VLTO01000011.1_i000_002578	133	428	295	0.893939	0.545287
GCA_000523455.1-Fun_KI964001.1_i000_006839	50	389	339	1.02727	0.619744
GCA_000338995.1-Fun_KB445648.1_i000_008524	50	389	339	1.02727	0.619744
GCA_013416765.1-Fun_WNKQ01000005.1_i000_003068	50	389	339	1.02727	0.619744
GCA_015680905.1-Pla_CM027380.1_i000_014376	21	286	265	0.80303	0.640097
GCA_014282095.1-Pla_CM024921.1_i000_026065	8	214	206	0.624242	0.698305
GCA_014282095.1-Pla_CM024921.1_i000_026065	220	290	70	0.212121	0.237288
GCA_019343175.1-Ani_CM033270.1_i000_001107	1	184	183	0.554545	0.7625
GCA_002135145.1-Ani_MUJZ01005909.1_i000_001273	1	152	151	0.457576	0.743842
GCA_907166805.1-Fun_CAJRGZ010000017.1_i000_004945	50	387	337	1.02121	0.614964
GCA_003568945.1-Pro_BDIP01000689.1_i000_003555	1	196	195	0.590909	0.696429
GCA_003568945.1-Pro_BDIP01001293.1_i000_005498	1	196	195	0.590909	0.696429
GCA_003568945.1-Pro_BDIP01002074.1_i000_007390	1	196	195	0.590909	0.696429
GCA_001191545.1-Fun_LGLR01000178.1_i000_003052	50	389	339	1.02727	0.611913
GCA_003268315.1-Fun_QGDG01000089.1_i000_008492	50	389	339	1.02727	0.611913
GCA_003268335.1-Fun_QGDH01000076.1_i000_007922	50	389	339	1.02727	0.611913
GCA_004154745.1-Fun_PDXA01000015.1_i000_002616	49	386	337	1.02121	0.613843
GCA_000150955.2-Pro_CM000606.1_i000_001379	47	382	335	1.01515	0.693582
GCA_020736505.1-Fun_JAHBNI010000010.1_i000_002205	52	390	338	1.02424	0.61343
GCA_015178925.1-Fun_WHVC01000031.1_i000_007068	175	310	135	0.409091	0.269461
GCA_015178925.1-Fun_WHVC01000031.1_i000_007068	311	395	84	0.254545	0.167665
GCA_001642055.1-Fun_KV441503.1_i000_012575	49	386	337	1.02121	0.613843
GCA_016097525.1-Fun_JADAKD010000009.1_i000_024222	49	386	337	1.02121	0.613843
GCA_004154815.1-Fun_PEJP01000022.1_i000_004288	49	386	337	1.02121	0.616088
GCA_905332305.1-Ani_CAJOBU010008682.1_i000_028144	1	155	154	0.466667	0.9625
GCA_004154755.1-Fun_PDXD01000042.1_i000_009542	49	386	337	1.02121	0.616088
GCA_004154835.1-Fun_PDUP01000019.1_i000_003863	49	386	337	1.02121	0.616088
GCA_004154845.1-Fun_PDXH01000047.1_i000_009548	49	386	337	1.02121	0.616088
GCA_004156025.2-Fun_PDWZ02000011.1_i000_003640	49	386	337	1.02121	0.616088
GCA_004156035.1-Fun_PDXC01000002.1_i000_004974	49	386	337	1.02121	0.616088
GCA_004168565.1-Fun_PDXF01000055.1_i000_010093	49	386	337	1.02121	0.616088
GCA_020736535.1-Fun_JAHBNJ010000011.1_i000_003322	49	386	337	1.02121	0.616088
GCA_905332325.1-Ani_CAJOBW010074004.1_i000_041368	1	155	154	0.466667	0.9625
GCA_003845795.1-Ani_CM011678.1_i000_004386	1	135	134	0.406061	0.87013
GCA_905221625.1-Pro_CAJNDU010009187.1_i000_010939	146	466	320	0.969697	0.341515
GCA_000230595.3-Fun_AFBI03000004.1_i000_002437	8	225	217	0.657576	0.960177
GCA_003574525.1-Fun_QPFE01000110.1_i000_007521	50	386	336	1.01818	0.612022
GCA_013036055.1-Fun_JAAABM010000006.1_i000_007185	50	386	336	1.01818	0.612022
ARFU001.0722.00001.C001_02167	30	111	81	0.245455	0.313953
ARFU001.0722.00001.C001_02167	103	258	155	0.469697	0.600775
GCA_003072535.2-Pro_CP056071.1_i000_001275	47	370	323	0.978788	0.687234
GCA_900231445.1-Pla_LT934114.1_i000_015513	25	243	218	0.660606	0.858268
GCA_905331535.1-Ani_CAJNZB010000875.1_i000_032404	158	312	154	0.466667	0.482759
GCA_022117675.1-Ani_JACEFF010000584.1_i000_002233	128	315	187	0.566667	0.483204
GCA_022117675.1-Ani_JACEFF010000584.1_i000_002233	316	383	67	0.20303	0.173127
GCA_003072545.2-Pro_CP056068.1_i000_001446	49	372	323	0.978788	0.684322
GCA_015178925.1-Fun_WHVC01000013.1_i000_002140	58	209	151	0.457576	0.345538
GCA_019650175.1-Pla_BNCO01000105.1_i000_012162	392	595	203	0.615152	0.287535
GCA_017309695.1-Pro_RCMJ01003620.1_i000_029561	1	181	180	0.545455	0.547112
GCA_004154765.1-Fun_PDXG01000005.1_i000_010499	49	386	337	1.02121	0.616088
GCA_004154735.1-Fun_PDXE01000010.1_i000_000832	49	386	337	1.02121	0.616088
GCA_013396955.1-Ani_VWZN01002372.1_i000_001389	48	118	70	0.212121	0.189702
GCA_013396955.1-Ani_VWZN01002372.1_i000_001389	128	279	151	0.457576	0.409214
GCA_000193285.1-Fun_GL876970.1_i000_006560	85	357	272	0.824242	0.723404
GCA_001572055.1-Fun_LPVP01000012.1_i000_007091	49	386	337	1.02121	0.613843
GCA_905332135.1-Ani_CAJOBI010329702.1_i000_074225	1	152	151	0.457576	0.888235
GCA_002906115.4-Pla_PKMF03015734.1_i000_055044	33	356	323	0.978788	0.416237
GCA_905332035.1-Ani_CAJOAY010022454.1_i000_049143	1	165	164	0.49697	0.926554
GCA_013235015.1-Ani_BGPR01046930.1_i000_193617	4	159	155	0.469697	0.974843
GCA_002897355.1-Pro_BEYU01000034.1_i000_003888	55	386	331	1.00303	0.638996
GCA_019702505.1-Fun_JAANER010000008.1_i000_011044	52	390	338	1.02424	0.610108
GCA_000223845.4-Pro_KK211489.1_i000_004199	154	360	206	0.624242	0.390152
GCA_000223845.4-Pro_KK211489.1_i000_004199	381	502	121	0.366667	0.229167
GCA_000740895.1-Pro_AP011947.1_i000_001794	48	370	322	0.975758	0.685106
GCA_008009225.1-Pla_CM017761.1_i000_000781	27	312	285	0.863636	0.7289
GCA_015952705.1-Pla_CM027683.1_i000_017807	6	103	97	0.293939	0.309904
GCA_015952705.1-Pla_CM027683.1_i000_017807	101	258	157	0.475758	0.501597
GCA_017635955.1-Fun_JAAQQV010000003.1_i000_003199	60	390	330	1	0.632184
ARSU002.0722.00001.C001_00235	31	108	77	0.233333	0.291667
ARSU002.0722.00001.C001_00235	104	264	160	0.484848	0.606061
GCA_004155955.1-Fun_PDWY01000021.1_i000_004593	49	386	337	1.02121	0.616088
GCA_010356995.1-Fun_ML996687.1_i000_000449	4	239	235	0.712121	0.574572
GCA_004798865.1-Ani_SJPD01000064.1_i000_013987	11	184	173	0.524242	0.559871
GCA_004798865.1-Ani_SJPD01000064.1_i000_013987	184	274	90	0.272727	0.291262
GCA_000002525.1-Fun_CR382128.1_i000_001216	65	391	326	0.987879	0.624521
GCA_001761485.1-Fun_CP017554.1_i000_001587	65	391	326	0.987879	0.624521
GCA_003367845.1-Fun_KZ859275.1_i000_000904	65	391	326	0.987879	0.624521
GCA_003367865.1-Fun_KZ858973.1_i000_002446	65	391	326	0.987879	0.624521
GCA_003367925.1-Fun_KZ858295.1_i000_002918	65	391	326	0.987879	0.624521
GCA_003367945.1-Fun_KZ858018.1_i000_000783	65	391	326	0.987879	0.624521
GCA_003367965.1-Fun_KZ858608.1_i000_001673	65	391	326	0.987879	0.624521
GCA_003698155.1-Fun_PKSB01000001.1_i000_000577	65	391	326	0.987879	0.624521
GCA_009194645.1-Fun_ML736603.1_i000_001536	65	391	326	0.987879	0.624521
GCA_009372015.1-Fun_ML755978.1_i000_000468	65	391	326	0.987879	0.624521
GCA_014490615.1-Fun_CP061014.1_i000_002143	65	391	326	0.987879	0.624521
GCA_900087985.1-Fun_LT576315.1_i000_000800	65	391	326	0.987879	0.624521
GCA_900537225.1-Fun_UTQH01000003.1_i000_000871	65	391	326	0.987879	0.624521
GCA_000342415.1-Pro_CP001669.1_i000_000646	57	369	312	0.945455	0.656842
GCA_021461655.1-Ani_CM038282.1_i000_000085	60	288	228	0.690909	0.498906
GCA_000230445.1-Ani_JH170704.1_i000_012489	1	143	142	0.430303	0.679426
GCA_002600585.1-Pro_MIGC01000004.1_i000_000004	113	445	332	1.00606	0.734513
GCA_018360325.1-Fun_SRQG01000041.1_i000_005240	1	77	76	0.230303	0.356808
GCA_018360325.1-Fun_SRQG01000041.1_i000_005240	76	127	51	0.154545	0.239437
GCA_018360325.1-Fun_SRQG01000041.1_i000_005240	147	212	65	0.19697	0.305164
GCA_905216605.1-Pla_LR999453.1_i000_008368	88	322	234	0.709091	0.549296
GCA_013397195.1-Ani_VYXD01007639.1_i000_006101	55	235	180	0.545455	0.478723
GCA_013397195.1-Ani_VYXD01007639.1_i000_006101	290	366	76	0.230303	0.202128
GCA_905178165.1-Pro_CAJINU010000038.1_i000_014266	69	403	334	1.01212	0.632576
GCA_021927905.1-Pro_BLLK01000047.1_i000_010563	34	365	331	1.00303	0.901907
GCA_001661475.1-Fun_KV453842.1_i000_003006	23	349	326	0.987879	0.848958
GCA_900617965.1-Ani_UYRV01010245.1_i000_003878	2	96	94	0.284848	0.376
GCA_900617965.1-Ani_UYRV01010245.1_i000_003878	112	200	88	0.266667	0.352
GCA_008932095.1-Pla_CM018519.1_i000_034299	43	285	242	0.733333	0.556322
GCA_000194455.1-Pro_CP002173.1_i000_000214	112	407	295	0.893939	0.716019
GCA_000165365.1-Pro_AAGK01000002.1_i000_001799	45	361	316	0.957576	0.675214
GCA_000836295.1-Fun_KN847534.1_i000_002393	83	426	343	1.03939	0.569767
GCA_014362265.1-Pla_BJWL01000019.1_i000_027687	519	657	138	0.418182	0.209726
GCA_001983305.1-Fun_MPUK01000001.1_i000_000518	65	394	329	0.99697	0.686848
GCA_003205855.1-Fun_LK052886.1_i000_005069	65	394	329	0.99697	0.686848
GCA_015849305.1-Fun_JAAAHY010000398.1_i000_006792	126	307	181	0.548485	0.589577
MESP076.0722.00001.C001_03116	48	141	93	0.281818	0.315254
MESP076.0722.00001.C001_03116	136	293	157	0.475758	0.532203
GCA_000004655.2-Pla_CM000132.1_i000_025885	125	309	184	0.557576	0.382536
GCA_000004655.2-Pla_CM000132.1_i000_025885	313	384	71	0.215152	0.147609
GCA_000149285.1-Pla_CM000144.1_i000_024370	125	309	184	0.557576	0.382536
GCA_000149285.1-Pla_CM000144.1_i000_024370	313	384	71	0.215152	0.147609
GCA_000763605.2-Pla_JRKL02003099.1_i000_018458	27	356	329	0.99697	0.820449
GCA_000769155.2-Pro_JROU02000337.1_i000_006701	119	301	182	0.551515	0.366197
GCA_000769155.2-Pro_JROU02000337.1_i000_006701	337	440	103	0.312121	0.207243
GCA_021927905.1-Pro_BLLK01000047.1_i000_010562	36	390	354	1.07273	0.698225
GCA_905250015.1-Ani_CAJNOM010000308.1_i000_033436	7	81	74	0.224242	0.204986
GCA_905250015.1-Ani_CAJNOM010000308.1_i000_033436	78	206	128	0.387879	0.354571
GCA_905250115.1-Ani_CAJNOI010000149.1_i000_022924	7	81	74	0.224242	0.204986
GCA_905250115.1-Ani_CAJNOI010000149.1_i000_022924	78	206	128	0.387879	0.354571
GCA_000733195.1-Pla_CM002871.1_i000_004744	19	331	312	0.945455	0.878873
GCA_017639365.1-Fun_JAAQQX010000002.1_i000_001708	67	390	323	0.978788	0.618774
GCA_017639385.1-Fun_JAAQQW010000001.1_i000_000408	67	390	323	0.978788	0.618774
GCA_000151295.1-Fun_GG745329.1_i000_017363	109	476	367	1.11212	0.547761
GCA_004014815.1-Fun_RYZI01000487.1_i000_008079	4	265	261	0.790909	0.984906
GCA_002197005.1-Ani_CM008040.1_i000_018494	1	122	121	0.366667	0.991803
GCA_001661315.1-Fun_KV454410.1_i000_003370	4	319	315	0.954545	0.670213
GCA_000512085.1-Pro_ASPP01035117.1_i000_034371	1	198	197	0.59697	0.985
GCA_021604985.1-Pla_BQKI01000018.1_i000_026419	258	375	117	0.354545	0.196309
GCA_021604985.1-Pla_BQKI01000018.1_i000_026419	373	492	119	0.360606	0.199664
GCA_000003225.1-Pro_CR940348.1_i000_001529	44	376	332	1.00606	0.707889
GCA_000151295.1-Fun_GG745333.1_i000_014141	85	454	369	1.11818	0.569444
GCA_900617775.1-Ani_UYRU01043287.1_i000_003185	83	163	80	0.242424	0.278746
GCA_900617775.1-Ani_UYRU01043287.1_i000_003185	162	244	82	0.248485	0.285714
GCA_004156015.1-Fun_PDXB01000048.1_i000_009207	49	386	337	1.02121	0.616088
GCA_015849295.1-Fun_JAAAHW010004734.1_i000_005849	123	304	181	0.548485	0.595395
GCA_002003505.1-Fun_BDMC01000001.1_i000_000108	6	266	260	0.787879	0.977444
GCA_013396815.1-Ani_WBMX01030538.1_i000_011406	53	238	185	0.560606	0.777311
GCA_013400995.1-Ani_VZUB01054366.1_i000_011914	2	121	119	0.360606	0.425
GCA_013400995.1-Ani_VZUB01054366.1_i000_011914	135	155	20	0.0606061	0.0714286
GCA_013400995.1-Ani_VZUB01054366.1_i000_011914	163	234	71	0.215152	0.253571
GCA_019650175.1-Pla_BNCO01000001.1_i000_000420	1	223	222	0.672727	0.627119
GCA_905221625.1-Pro_CAJNDU010043274.1_i000_030638	1	159	158	0.478788	0.686957
GCA_000512085.1-Pro_ASPP01018222.1_i000_020594	1	228	227	0.687879	0.671598
GCA_020536175.1-Fun_JAEUBF010000782.1_i000_004997	56	384	328	0.993939	0.717724
GCA_015529785.1-Fun_JAAAUK010000136.1_i000_001840	75	237	162	0.490909	0.334021
GCA_015529785.1-Fun_JAAAUK010000136.1_i000_001840	235	366	131	0.39697	0.270103
GCA_001445595.3-Fun_DF977528.1_i000_011318	1	118	117	0.354545	0.266515
GCA_001445595.3-Fun_DF977528.1_i000_011318	118	260	142	0.430303	0.323462
GCA_902498895.1-Fun_CABVLU010000003.1_i000_003321	330	679	349	1.05758	0.427173
GCA_019722365.1-Pla_JADFUC010001333.1_i000_002608	1	111	110	0.333333	0.282776
GCA_019722365.1-Pla_JADFUC010001333.1_i000_002608	108	269	161	0.487879	0.413882
GCA_004768795.1-Fun_SKBN01000038.1_i000_007048	12	304	292	0.884848	0.941935
GCA_903112645.1-Pla_CAEKDK010000005.1_i000_017617	88	238	150	0.454545	0.625
GCA_014058105.1-Pla_JACGCM010001662.1_i000_022777	1	215	214	0.648485	0.990741
GCA_017607545.1-Ani_JAANIC010001043.1_i000_000995	1	158	157	0.475758	0.720183
GCA_002218305.1-Ani_MCFN01024344.1_i000_016975	65	248	183	0.554545	0.701149
GCA_000006405.1-Pro_GG673648.1_i000_005685	66	410	344	1.04242	0.623188
GCA_000006405.1-Pro_GG677981.1_i000_014602	66	410	344	1.04242	0.623188
GCA_015039405.1-Fun_WJDU01000054.1_i000_012622	85	365	280	0.848485	0.564516
GCA_001245095.1-Fun_CDQK01000001.1_i000_000196	28	356	328	0.993939	0.754023
GCA_008636045.1-Pro_SNRW01000043.1_i000_000517	419	744	325	0.984848	0.404732
GCA_002897235.1-Pro_BDSA01000002.1_i000_002236	51	356	305	0.924242	0.664488
GCA_009797565.1-Pla_CM020522.1_i000_008039	96	163	67	0.20303	0.14922
GCA_009797565.1-Pla_CM020522.1_i000_008039	160	321	161	0.487879	0.358575
GCA_015680905.1-Pla_CM027377.1_i000_000876	28	252	224	0.678788	0.602151
GCA_018107945.1-Pla_JACEIK010006309.1_i000_043285	45	172	127	0.384848	0.363897
GCA_018107945.1-Pla_JACEIK010006309.1_i000_043285	168	341	173	0.524242	0.495702
GCA_002738505.1-Pla_KZ305034.1_i000_012221	34	342	308	0.933333	0.88
GCA_004786185.1-Ani_CM015718.1_i000_007676	57	251	194	0.587879	0.668966
GCA_000499425.1-Pro_HG670747.1_i000_001478	143	387	244	0.739394	0.508333
GCA_013387185.1-Ani_CP045890.1_i000_000976	115	347	232	0.70303	0.507659
GCA_000142905.1-Pro_GL349439.1_i000_001921	97	406	309	0.936364	0.660256
MEHU001.0722.00001.C001_02376	50	128	78	0.236364	0.264407
MEHU001.0722.00001.C001_02376	132	293	161	0.487879	0.545763
GCA_014281875.1-Ani_CM024804.1_i000_010607	1	163	162	0.490909	0.570423
GCA_002920205.1-Fun_PKSM01000162.1_i000_009280	79	318	239	0.724242	0.485772
GCA_000005425.2-Pla_AP008213.2_i000_019800	129	309	180	0.545455	0.57508
GCA_001433935.1-Pla_AP014963.1_i000_029838	129	309	180	0.545455	0.57508
GCA_004007595.1-Pla_CM012947.1_i000_022896	129	309	180	0.545455	0.57508
GCA_009797565.1-Pla_CM020527.1_i000_024240	129	309	180	0.545455	0.57508
GCA_000182765.2-Fun_HE605203.1_i000_004838	66	398	332	1.00606	0.649706
GCA_014049445.1-Fun_JABWAB010000003.1_i000_002060	66	398	332	1.00606	0.649706
GCA_014049455.1-Fun_JABWAA010000005.1_i000_003433	66	398	332	1.00606	0.649706
GCA_014049495.1-Fun_JABWAC010000002.1_i000_001857	66	398	332	1.00606	0.649706
GCA_014049585.1-Fun_JABVZZ010000004.1_i000_002908	66	398	332	1.00606	0.649706
GCA_903989565.1-Fun_CAJEJE010000002.1_i000_001866	66	398	332	1.00606	0.649706
GCA_011763605.1-Fun_JAANIO010016667.1_i000_014358	1	97	96	0.290909	0.979592
GCA_000576695.1-Fun_HG793126.1_i000_001658	31	369	338	1.02424	0.759551
GCA_008009225.1-Pla_CM017761.1_i000_000776	27	142	115	0.348485	0.309973
GCA_008009225.1-Pla_CM017761.1_i000_000776	140	313	173	0.524242	0.466307
GCA_010458925.1-Pla_CM021239.1_i000_033555	1	138	137	0.415152	0.791908
GCA_019207715.1-Fun_JAHLVL010000001.1_i000_001979	33	371	338	1.02424	0.723769
GCA_019207815.1-Fun_JAHLVO010000001.1_i000_001952	33	371	338	1.02424	0.723769
GCA_019207825.1-Fun_JAHLVP010000002.1_i000_002074	33	371	338	1.02424	0.723769
GCA_019207965.1-Fun_JAHLVM010000002.1_i000_002248	33	371	338	1.02424	0.723769
GCA_020536115.1-Fun_JAEUBD010000983.1_i000_003071	33	371	338	1.02424	0.723769
GCA_001664045.1-Fun_AECK01000002.1_i000_001292	34	371	337	1.02121	0.721627
GCA_019207725.1-Fun_JAHLVK010000002.1_i000_002585	34	371	337	1.02121	0.721627
GCA_019207735.1-Fun_JAHLVJ010000007.1_i000_004666	34	371	337	1.02121	0.721627
GCA_019207835.1-Fun_JAHLVN010000001.1_i000_001549	34	371	337	1.02121	0.721627
GCA_019207905.1-Fun_JAHLVQ010000003.1_i000_003164	34	371	337	1.02121	0.721627
GCA_019207995.1-Fun_JAHLVT010000004.1_i000_003629	34	371	337	1.02121	0.721627
GCA_019208005.1-Fun_JAHLVR010000002.1_i000_002396	34	371	337	1.02121	0.721627
GCA_019208045.1-Fun_JAHLVS010000002.1_i000_002398	34	371	337	1.02121	0.721627
GCA_014058105.1-Pla_JACGCM010002299.1_i000_028294	22	265	243	0.736364	0.595588
GCA_000187245.3-Fun_CM002305.1_i000_003954	33	371	338	1.02424	0.723769
GCA_019207595.1-Fun_JAHLVG010000002.1_i000_002589	33	371	338	1.02424	0.723769
GCA_019207695.1-Fun_JAHLVH010000001.1_i000_001547	33	371	338	1.02424	0.723769
GCA_018397855.1-Fun_JAGFBS010000006.1_i000_010755	89	225	136	0.412121	0.267191
GCA_018397855.1-Fun_JAGFBS010000006.1_i000_010755	236	360	124	0.375758	0.243615
GCA_002271885.2-Pla_CM008447.1_i000_012817	30	341	311	0.942424	0.749398
GCA_001661405.1-Fun_KV453932.1_i000_003441	1	294	293	0.887879	0.827684
GCA_002102555.1-Fun_MCFL01000092.1_i000_012631	46	391	345	1.04545	0.669903
GCA_000315875.1-Fun_HE681720.1_i000_001871	64	397	333	1.00909	0.654224
GCA_016413895.1-Pla_CM028154.1_i000_012282	27	92	65	0.19697	0.163728
GCA_016413895.1-Pla_CM028154.1_i000_012282	90	118	28	0.0848485	0.070529
GCA_016413895.1-Pla_CM028154.1_i000_012282	123	245	122	0.369697	0.307305
GCA_013397315.1-Ani_WBMY01017427.1_i000_012639	53	235	182	0.551515	0.774468
GCA_013339695.1-Ani_CM023520.1_i000_002705	164	352	188	0.569697	0.436195
GCA_017607525.1-Ani_JAANIA010000477.1_i000_000926	105	269	164	0.49697	0.504615
GCA_002271895.2-Pla_CM008435.1_i000_014040	32	346	314	0.951515	0.756627
GCA_018258275.1-Pla_CM031107.1_i000_011982	1	234	233	0.706061	0.703927
GCA_013398615.1-Ani_VZSR01002477.1_i000_005247	53	235	182	0.551515	0.774468
GCA_001742945.1-Pla_DF973672.1_i000_026445	1	114	113	0.342424	0.355346
GCA_001742945.1-Pla_DF973672.1_i000_026445	115	203	88	0.266667	0.27673
GCA_000825725.1-Fun_CDGI01000041.1_i000_002568	48	190	142	0.430303	0.617391
GCA_019207935.1-Fun_JAHLVI010000005.1_i000_003995	34	372	338	1.02424	0.723769
GCA_000006515.1-Pro_DS989730.1_i000_002446	15	346	331	1.00303	0.786223
GCA_002087875.1-Fun_LTAI01000048.1_i000_002073	81	396	315	0.954545	0.793451
GCA_000150825.1-Fun_DS985219.1_i000_004428	86	402	316	0.957576	0.542955
GCA_001643675.2-Pro_LSRY02000004.1_i000_011296	16	343	327	0.990909	0.375431
GCA_001432165.1-Fun_LGUB01001126.1_i000_000083	18	223	205	0.621212	0.90708
GCA_013396775.1-Ani_VZRE01001870.1_i000_001729	10	188	178	0.539394	0.418824
GCA_013396775.1-Ani_VZRE01001870.1_i000_001729	268	339	71	0.215152	0.167059
GCA_007844105.2-Pla_CM017577.2_i000_025907	93	293	200	0.606061	0.262812
GCA_007844105.2-Pla_CM017577.2_i000_025907	291	318	27	0.0818182	0.0354796
GCA_014058105.1-Pla_JACGCM010001659.1_i000_015130	131	312	181	0.548485	0.334566
GCA_020921065.1-Pla_CM037158.1_i000_020719	23	178	155	0.469697	0.525424
GCA_020921065.1-Pla_CM037158.1_i000_020719	176	273	97	0.293939	0.328814
GCA_905332325.1-Ani_CAJOBW010072130.1_i000_040493	133	305	172	0.521212	0.563934
GCA_001643675.2-Pro_LSRY02000014.1_i000_002399	4	188	184	0.557576	0.880383
GCA_905332135.1-Ani_CAJOBI010138964.1_i000_045457	112	293	181	0.548485	0.617747
GCA_019207235.1-Fun_JAHLUK010000002.1_i000_002741	33	370	337	1.02121	0.721627
GCA_019207415.1-Fun_JAHLUU010000001.1_i000_001638	33	370	337	1.02121	0.721627
GCA_910592135.1-Fun_CAJVPZ010020541.1_i000_010412	43	173	130	0.393939	0.333333
GCA_910592135.1-Fun_CAJVPZ010020541.1_i000_010412	181	278	97	0.293939	0.248718
GCA_019206905.1-Fun_JAHLUB010000001.1_i000_002022	33	370	337	1.02121	0.721627
GCA_019206915.1-Fun_JAHLUA010000005.1_i000_003967	33	370	337	1.02121	0.721627
GCA_019206925.1-Fun_JAHLUE010000008.1_i000_004954	33	370	337	1.02121	0.721627
GCA_019206965.1-Fun_JAHLUF010000007.1_i000_004707	33	370	337	1.02121	0.721627
GCA_019206985.1-Fun_JAHLUC010000008.1_i000_005028	33	370	337	1.02121	0.721627
GCA_019207125.1-Fun_JAHLUD010000003.1_i000_003234	33	370	337	1.02121	0.721627
GCA_019207165.1-Fun_JAHLUV010000009.1_i000_005300	33	370	337	1.02121	0.721627
GCA_019207175.1-Fun_JAHLUI010000006.1_i000_004456	33	370	337	1.02121	0.721627
GCA_019207185.1-Fun_JAHLUG010000003.1_i000_003017	33	370	337	1.02121	0.721627
GCA_019207205.1-Fun_JAHLUJ010000002.1_i000_002617	33	370	337	1.02121	0.721627
GCA_019207265.1-Fun_JAHLUN010000009.1_i000_005217	33	370	337	1.02121	0.721627
GCA_019207285.1-Fun_JAHLUL010000002.1_i000_002803	33	370	337	1.02121	0.721627
GCA_019207295.1-Fun_JAHLUM010000002.1_i000_002831	33	370	337	1.02121	0.721627
GCA_019207315.1-Fun_JAHLUO010000002.1_i000_002619	33	370	337	1.02121	0.721627
GCA_019207325.1-Fun_JAHLUP010000001.1_i000_001660	33	370	337	1.02121	0.721627
GCA_019207365.1-Fun_JAHLUQ010000007.1_i000_004780	33	370	337	1.02121	0.721627
GCA_019207375.1-Fun_JAHLUR010000006.1_i000_004516	33	370	337	1.02121	0.721627
GCA_019207405.1-Fun_JAHLUS010000005.1_i000_003749	33	370	337	1.02121	0.721627
GCA_019207435.1-Fun_JAHLUT010000001.1_i000_001676	33	370	337	1.02121	0.721627
GCA_008403515.1-Pro_VFQX01000002.1_i000_002706	203	438	235	0.712121	0.317568
GCA_008403515.1-Pro_VFQX01000002.1_i000_002706	465	578	113	0.342424	0.152703
GCA_015178925.1-Fun_WHVC01000021.1_i000_004703	175	307	132	0.4	0.26087
GCA_015178925.1-Fun_WHVC01000021.1_i000_004703	308	399	91	0.275758	0.179842
GCA_013396775.1-Ani_VZRE01009989.1_i000_008243	5	167	162	0.490909	0.593407
GCA_003324165.2-Pro_PYSW02000014.1_i000_004734	200	433	233	0.706061	0.317007
GCA_003324165.2-Pro_PYSW02000014.1_i000_004734	460	574	114	0.345455	0.155102
GCA_001708105.1-Fun_CP014586.1_i000_003628	38	359	321	0.972727	0.716518
GCA_019207005.1-Fun_JAHLUH010000007.1_i000_004770	33	370	337	1.02121	0.721627
GCA_009445465.1-Pla_NMUH01004148.1_i000_040827	167	347	180	0.545455	0.337711
GCA_009445465.1-Pla_NMUH01004148.1_i000_040827	346	424	78	0.236364	0.146341
GCA_905178155.1-Pro_CAJINV010000004.1_i000_011024	139	456	317	0.960606	0.550347
GCA_000611645.1-Pla_KK103642.1_i000_012759	126	288	162	0.490909	0.517572
GCA_000227115.2-Fun_HE580273.2_i000_003736	54	393	339	1.02727	0.683468
GCA_002087885.1-Fun_LVKB01000021.1_i000_002438	80	339	259	0.784848	0.752907
GCA_019924185.1-Fun_JAHFXE010009124.1_i000_022593	1	141	140	0.424242	0.689655
GCA_000583005.2-Pla_ASHM01096417.1_i000_053785	1	138	137	0.415152	0.951389
GCA_902702945.1-Fun_CACRXN010000252.1_i000_004462	117	231	114	0.345455	0.197232
GCA_902702945.1-Fun_CACRXN010000252.1_i000_004462	237	404	167	0.506061	0.288927
GCA_002135145.1-Ani_MUJZ01022229.1_i000_004631	147	327	180	0.545455	0.550459
GCA_002104985.1-Fun_MCGO01000002.1_i000_004510	13	177	164	0.49697	0.41519
GCA_002104985.1-Fun_MCGO01000002.1_i000_004510	174	282	108	0.327273	0.273418
GCA_902206195.3-Pla_CABITT030000004.1_i000_010737	1	198	197	0.59697	0.960976
GCA_905338395.1-Ani_CAJPEW010000022.1_i000_000335	375	521	146	0.442424	0.195973
GCA_905338395.1-Ani_CAJPEW010000022.1_i000_000335	518	603	85	0.257576	0.114094
GCA_000583005.2-Pla_ASHM01096358.1_i000_053770	1	138	137	0.415152	0.951389
GCA_000316135.1-Fun_JH994096.1_i000_003068	70	414	344	1.04242	0.570481
GCA_001865355.1-Pro_LRBS01000109.1_i000_001926	245	586	341	1.03333	0.52381
GCA_004837865.1-Pla_CM017196.1_i000_024983	40	212	172	0.521212	0.43
GCA_004837865.1-Pla_CM017196.1_i000_024983	211	284	73	0.221212	0.1825
GCA_019632305.1-Fun_WSTW01001030.1_i000_000276	164	360	196	0.593939	0.333901
GCA_013115145.1-Pro_JAAPAO010000041.1_i000_006862	77	431	354	1.07273	0.292079
GCA_900074765.1-Fun_LT598488.1_i000_002505	41	374	333	1.00909	0.702532
GCA_015849325.1-Fun_JAAAIB010002060.1_i000_003002	1	121	120	0.363636	0.991736
GCA_000209165.1-Fun_CP000499.1_i000_004142	77	414	337	1.02121	0.619485
GCA_002157105.1-Fun_KZ151150.1_i000_011790	1	166	165	0.5	0.625
GCA_001661335.1-Fun_KV454438.1_i000_005512	61	391	330	1	0.723684
GCA_000027005.1-Fun_FN392321.1_i000_003642	40	336	296	0.89697	0.662192
GCA_000223565.1-Fun_FR839630.1_i000_003404	40	336	296	0.89697	0.662192
GCA_001708085.1-Fun_CP014710.1_i000_003605	40	336	296	0.89697	0.662192
GCA_001746955.1-Fun_CP014717.1_i000_003600	40	336	296	0.89697	0.662192
GCA_900235035.1-Fun_LT962478.1_i000_003405	40	336	296	0.89697	0.662192
GCA_001839685.1-Pro_MLAK01000533.1_i000_004342	2	311	309	0.936364	0.841962
GCA_012184645.1-Fun_WYDC01000029.1_i000_002771	66	408	342	1.03636	0.66537
GCA_012184655.1-Fun_WYDD01000092.1_i000_005380	66	408	342	1.03636	0.66537
GCA_019924185.1-Fun_JAHFXE010009121.1_i000_022590	1	140	139	0.421212	0.688119
GCA_002926055.1-Fun_PKFO01000003.1_i000_002112	77	418	341	1.03333	0.649524
GCA_000004985.1-Pro_GG738845.1_i000_000549	91	325	234	0.709091	0.375
GCA_000004985.1-Pro_GG738845.1_i000_000549	356	463	107	0.324242	0.171474
GCA_902728275.1-Fun_CACVBS010000024.1_i000_001140	119	278	159	0.481818	0.302857
GCA_902728275.1-Fun_CACVBS010000024.1_i000_001140	284	410	126	0.381818	0.24
GCA_016859295.1-Fun_CM029108.1_i000_004305	58	435	377	1.14242	0.667257
GCA_021556665.1-Fun_JAKFGG010000003.1_i000_001155	83	373	290	0.878788	0.597938
GCA_004936735.2-Pro_SCFC02000028.1_i000_003538	29	364	335	1.01515	0.761364
GCA_019207455.1-Fun_JAHLUW010000002.1_i000_002347	33	370	337	1.02121	0.721627
GCA_020379485.1-Pla_CM035461.1_i000_071444	71	235	164	0.49697	0.653386
GCA_003573695.1-Pla_PUWZ01001678.1_i000_042903	1	102	101	0.306061	0.478673
GCA_003573695.1-Pla_PUWZ01001678.1_i000_042903	99	209	110	0.333333	0.521327
GCA_015178925.1-Fun_WHVC01000012.1_i000_001864	1	115	114	0.345455	0.339286
GCA_015178925.1-Fun_WHVC01000012.1_i000_001864	126	238	112	0.339394	0.333333
GCA_000751015.1-Pla_LK032453.1_i000_032345	41	223	182	0.551515	0.399123
GCA_000751015.1-Pla_LK032453.1_i000_032345	221	343	122	0.369697	0.267544
GCA_019776745.2-Pla_CM034156.1_i000_036096	11	143	132	0.4	0.5
GCA_019776745.2-Pla_CM034156.1_i000_036096	141	209	68	0.206061	0.257576
GCA_000344705.1-Fun_AOGT01000133.1_i000_000404	73	398	325	0.984848	0.632296
GCA_019207635.1-Fun_JAHLVE010000005.1_i000_003854	33	370	337	1.02121	0.721627
GCA_019207515.1-Fun_JAHLVA010000003.1_i000_002807	33	370	337	1.02121	0.721627
GCA_019207525.1-Fun_JAHLVB010000001.1_i000_001759	33	370	337	1.02121	0.721627
GCA_019207585.1-Fun_JAHLVF010000002.1_i000_002203	33	370	337	1.02121	0.721627
GCA_019207605.1-Fun_JAHLVD010000001.1_i000_001618	33	370	337	1.02121	0.721627
GCA_019207615.1-Fun_JAHLVC010000002.1_i000_002429	33	370	337	1.02121	0.721627
GCA_016984195.1-Ani_JAAWVQ010180023.1_i000_018554	23	172	149	0.451515	0.593625
GCA_002759435.2-Fun_PEKT02000007.1_i000_000237	68	407	339	1.02727	0.660819
GCA_019332045.1-Fun_CP076749.1_i000_001082	68	407	339	1.02727	0.660819
GCA_001189475.1-Fun_LGST01000017.1_i000_000819	76	415	339	1.02727	0.650672
GCA_002775015.1-Fun_PGLS01000004.1_i000_000735	68	406	338	1.02424	0.658869
GCA_003013715.2-Fun_CP043531.1_i000_000650	68	406	338	1.02424	0.658869
GCA_003014415.1-Fun_PYGM01000055.1_i000_003303	68	406	338	1.02424	0.658869
GCA_007168705.1-Fun_BGOX01000002.1_i000_002413	68	406	338	1.02424	0.658869
GCA_008275145.1-Fun_CP043442.1_i000_001228	68	406	338	1.02424	0.658869
GCA_019677385.1-Fun_WSLO01005687.1_i000_012615	1	167	166	0.50303	0.574394
GCA_019207505.1-Fun_JAHLUZ010000001.1_i000_001870	33	370	337	1.02121	0.721627
GCA_019207555.1-Fun_JAHLUY010000001.1_i000_001753	33	370	337	1.02121	0.721627
GCA_904845875.1-Pla_CAJGYO010000008.1_i000_033423	132	280	148	0.448485	0.154812
GCA_904845875.1-Pla_CAJGYO010000008.1_i000_033423	271	385	114	0.345455	0.119247
GCA_002251995.2-Fun_NDIQ01000001.1_i000_000404	20	300	280	0.848485	0.883281
GCA_019207475.1-Fun_JAHLUX010000002.1_i000_002232	33	371	338	1.02424	0.723769
GCA_006381635.2-Pla_VEPZ02000929.1_i000_026152	119	280	161	0.487879	0.568905
GCA_007210665.1-Pro_PYHZ01000004.1_i000_001383	32	365	333	1.00909	0.756818
GCA_013115865.1-Pro_JABANO010007042.1_i000_005635	439	792	353	1.0697	0.377137
GCA_013115115.1-Pro_JABAHT010000061.1_i000_008415	428	778	350	1.06061	0.37961
GCA_002946425.1-Fun_NJPT01000014.1_i000_000768	1	185	184	0.557576	0.516854
GCA_000149685.1-Fun_CH981525.1_i000_004022	96	421	325	0.984848	0.762911
GCA_009792415.2-Pro_VHLK02000076.1_i000_003579	20	346	326	0.987879	0.779904
GCA_015502475.1-Fun_JAAAUL010000076.1_i000_011061	1	135	134	0.406061	0.797619
GCA_015502505.1-Fun_JAAAUQ010000100.1_i000_000047	1	135	134	0.406061	0.788235
GCA_016809505.1-Fun_CP050673.1_i000_000652	69	407	338	1.02424	0.658869
GCA_001593465.1-Pro_JIBM01000098.1_i000_001507	32	365	333	1.00909	0.756818
GCA_002223825.1-Pro_LN877950.1_i000_001282	32	365	333	1.00909	0.756818
GCA_000192795.1-Fun_GL877430.1_i000_001654	72	397	325	0.984848	0.431607
GCA_002920065.1-Fun_PKSL01000178.1_i000_011582	88	402	314	0.951515	0.616896
GCA_011745845.1-Pla_VYZY01000856.1_i000_004574	2	119	117	0.354545	0.312834
GCA_011745845.1-Pla_VYZY01000856.1_i000_004574	114	277	163	0.493939	0.435829
GCA_008704595.1-Fun_SWFT01000067.1_i000_000044	47	381	334	1.01212	0.776744
GCA_015849305.1-Fun_JAAAHY010001887.1_i000_003290	1	134	133	0.40303	0.801205
GCA_003327735.1-Fun_QLNQ01000030.1_i000_004087	68	403	335	1.01515	0.632075
GCA_002271885.2-Pla_CM008449.1_i000_017922	1	201	200	0.606061	0.135318
GCA_001593475.1-Pro_JIBN01000123.1_i000_001537	3	312	309	0.936364	0.800518
GCA_001483515.1-Pro_JTAI01000022.1_i000_002532	3	312	309	0.936364	0.800518
GCA_013266265.1-Fun_JABFAK010009070.1_i000_013941	1	211	210	0.636364	0.548303
GCA_020796205.1-Pla_CM036898.1_i000_017873	1	107	106	0.321212	0.990654
GCA_001661415.1-Fun_KV453909.1_i000_000666	72	408	336	1.01818	0.649903
GCA_000331365.3-Pla_AMZH03002068.1_i000_009332	100	194	94	0.284848	0.244156
GCA_000331365.3-Pla_AMZH03002068.1_i000_009332	215	287	72	0.218182	0.187013
GCA_001884805.1-Pla_MKKS01006588.1_i000_027784	100	194	94	0.284848	0.244156
GCA_001884805.1-Pla_MKKS01006588.1_i000_027784	215	287	72	0.218182	0.187013
GCA_015245375.1-Pro_CP044419.1_i000_001311	31	365	334	1.01212	0.759091
GCA_001865345.1-Pro_LRBP01000023.1_i000_001677	29	367	338	1.02424	0.769932
GCA_000165345.1-Pro_CM000432.1_i000_001270	54	388	334	1.01212	0.721382
GCA_000818735.3-Pla_JTFG03000049.1_i000_001169	142	236	94	0.284848	0.220141
GCA_000818735.3-Pla_JTFG03000049.1_i000_001169	257	329	72	0.218182	0.168618
GCA_001884845.1-Pla_MKKT01006424.1_i000_028569	142	236	94	0.284848	0.220141
GCA_001884845.1-Pla_MKKT01006424.1_i000_028569	257	329	72	0.218182	0.168618
GCA_000187875.1-Ani_GL733634.1_i000_028062	1	125	124	0.375758	0.433566
GCA_018446385.1-Pla_CM031516.1_i000_031085	1	131	130	0.393939	0.462633
GCA_000975585.2-Fun_CP005196.2_i000_001986	49	390	341	1.03333	0.690283
GCA_000346465.2-Pla_CM007655.1_i000_015432	1	138	137	0.415152	0.861635
GCA_003327735.1-Fun_QLNQ01000001.1_i000_000672	71	404	333	1.00909	0.628302
GCA_900618415.1-Ani_UZAM01008124.1_i000_004087	29	171	142	0.430303	0.806818
GCA_000492115.1-Pro_AUPL01006999.1_i000_006881	127	322	195	0.590909	0.60559
GCA_003260675.2-Pla_QGKX02001521.1_i000_024228	136	303	167	0.506061	0.40241
GCA_003676035.1-Fun_NSGQ01000004.1_i000_002473	78	412	334	1.01212	0.621974
GCA_003013735.1-Fun_PYFQ01000001.1_i000_000686	71	408	337	1.02121	0.658203
GCA_018994105.1-Fun_JAFKAI010011605.1_i000_004660	1	199	198	0.6	0.546961
THVO001.0722.00001.C001_00375	81	230	149	0.451515	0.647826
GCA_000511025.2-Pla_CM002326.2_i000_013595	14	163	149	0.451515	0.805405
GCA_014529505.1-Pro_JABXOJ010000025.1_i000_001526	1	282	281	0.851515	0.793785
GCA_010085335.1-Ani_VULH01015478.1_i000_004272	115	279	164	0.49697	0.587814
GCA_000006335.3-Fun_GG692396.1_i000_001795	71	409	338	1.02424	0.631776
GCA_017315405.1-Fun_JAFIQD010000002.1_i000_002123	71	409	338	1.02424	0.631776
GCA_000223485.1-Fun_GL996501.1_i000_002617	78	408	330	1	0.614525
GCA_014058105.1-Pla_JACGCM010002660.1_i000_006101	1	215	214	0.648485	0.396296
GCA_000224805.2-Pro_KN039996.1_i000_005413	85	310	225	0.681818	0.692308
GCA_017607455.1-Ani_JAANHZ010000576.1_i000_002614	85	253	168	0.509091	0.545455
GCA_000977745.2-Fun_CP005265.2_i000_001988	50	390	340	1.0303	0.688259
GCA_000512085.1-Pro_ASPP01022055.1_i000_025285	1	186	185	0.560606	0.685185
GCA_019049425.1-Fun_JAHMUF010000002.1_i000_002090	39	374	335	1.01515	0.717345
GCA_000182175.1-Fun_ABSV01000946.1_i000_001728	3	324	321	0.972727	0.904225
GCA_000976335.2-Fun_CP005216.2_i000_001989	49	390	341	1.03333	0.690283
GCA_000977025.2-Fun_CP005241.1_i000_001976	49	390	341	1.03333	0.690283
GCA_000976965.3-Fun_CP005239.1_i000_001947	49	390	341	1.03333	0.690283
GCA_020536065.1-Fun_JAEUBE010000295.1_i000_003805	38	377	339	1.02727	0.724359
GCA_000182315.2-Fun_ACFL01000396.1_i000_000606	49	390	341	1.03333	0.690283
GCA_000977445.2-Fun_CP005255.2_i000_001980	49	390	341	1.03333	0.690283
GCA_000977565.2-Fun_CP005259.1_i000_001941	49	390	341	1.03333	0.690283
GCA_905220325.1-Fun_HG994146.1_i000_002085	49	390	341	1.03333	0.690283
GCA_011022315.1-Fun_CP048988.1_i000_002005	49	390	341	1.03333	0.690283
GCA_000977265.3-Fun_CP005249.1_i000_001982	49	390	341	1.03333	0.690283
GCA_000146045.2-Fun_BK006941.2_i000_002201	49	390	341	1.03333	0.690283
GCA_000149365.1-Fun_CH408044.1_i000_004116	49	390	341	1.03333	0.690283
GCA_000181435.1-Fun_AAFW02000102.1_i000_001930	49	390	341	1.03333	0.690283
GCA_000218975.1-Fun_FN393070.1_i000_002215	49	390	341	1.03333	0.690283
GCA_000269885.1-Fun_CM001528.1_i000_001994	49	390	341	1.03333	0.690283
GCA_000568005.1-Fun_CM002410.1_i000_001909	49	390	341	1.03333	0.690283
GCA_000568055.1-Fun_CM002428.1_i000_001764	49	390	341	1.03333	0.690283
GCA_000568295.1-Fun_CM002338.1_i000_001348	49	390	341	1.03333	0.690283
GCA_000568365.1-Fun_CM002444.1_i000_001872	49	390	341	1.03333	0.690283
GCA_000662435.2-Fun_CP005226.2_i000_001997	49	390	341	1.03333	0.690283
GCA_000975615.2-Fun_CP005197.2_i000_001953	49	390	341	1.03333	0.690283
GCA_000975645.3-Fun_CP004105.2_i000_001957	49	390	341	1.03333	0.690283
GCA_000975705.2-Fun_CP005229.1_i000_001990	49	390	341	1.03333	0.690283
GCA_000975735.4-Fun_CP005194.2_i000_001984	49	390	341	1.03333	0.690283
GCA_000975795.2-Fun_CP005198.2_i000_001952	49	390	341	1.03333	0.690283
GCA_000975885.2-Fun_CP005201.2_i000_001937	49	390	341	1.03333	0.690283
GCA_000975915.2-Fun_CP005202.2_i000_001944	49	390	341	1.03333	0.690283
GCA_000975945.2-Fun_CP005203.2_i000_001962	49	390	341	1.03333	0.690283
GCA_000976035.2-Fun_CP005206.2_i000_001922	49	390	341	1.03333	0.690283
GCA_000976125.2-Fun_CP005209.1_i000_001977	49	390	341	1.03333	0.690283
GCA_000976155.4-Fun_CP005210.2_i000_001972	49	390	341	1.03333	0.690283
GCA_000976185.2-Fun_CP005211.2_i000_002002	49	390	341	1.03333	0.690283
GCA_000976245.2-Fun_CP005213.2_i000_001959	49	390	341	1.03333	0.690283
GCA_000976275.4-Fun_CP005214.2_i000_001964	49	390	341	1.03333	0.690283
GCA_000976305.2-Fun_CP005215.2_i000_001992	49	390	341	1.03333	0.690283
GCA_000976365.2-Fun_CP005217.2_i000_001993	49	390	341	1.03333	0.690283
GCA_000976395.2-Fun_CP005218.2_i000_001985	49	390	341	1.03333	0.690283
GCA_000976425.2-Fun_CP005219.1_i000_001992	49	390	341	1.03333	0.690283
GCA_000976455.3-Fun_CP005220.2_i000_001995	49	390	341	1.03333	0.690283
GCA_000976485.2-Fun_CP005221.2_i000_001956	49	390	341	1.03333	0.690283
GCA_000976515.2-Fun_CP005222.2_i000_001982	49	390	341	1.03333	0.690283
GCA_000976545.2-Fun_CP005223.2_i000_001989	49	390	341	1.03333	0.690283
GCA_000976575.4-Fun_CP005224.2_i000_001995	49	390	341	1.03333	0.690283
GCA_000976605.3-Fun_CP005225.2_i000_001893	49	390	341	1.03333	0.690283
GCA_000976665.2-Fun_CP005227.2_i000_001987	49	390	341	1.03333	0.690283
GCA_000976695.3-Fun_CP005230.2_i000_001866	49	390	341	1.03333	0.690283
GCA_000976725.3-Fun_CP005231.2_i000_001978	49	390	341	1.03333	0.690283
GCA_000976845.3-Fun_CP005235.2_i000_001936	49	390	341	1.03333	0.690283
GCA_000976875.3-Fun_CP005236.2_i000_001943	49	390	341	1.03333	0.690283
GCA_000976935.2-Fun_CP005238.2_i000_001984	49	390	341	1.03333	0.690283
GCA_000977085.2-Fun_CP005243.2_i000_001992	49	390	341	1.03333	0.690283
GCA_000977145.2-Fun_CP005245.2_i000_001991	49	390	341	1.03333	0.690283
GCA_000977175.3-Fun_CP005246.2_i000_001949	49	390	341	1.03333	0.690283
GCA_000977205.2-Fun_CP005247.2_i000_001979	49	390	341	1.03333	0.690283
GCA_000977235.2-Fun_CP005248.2_i000_001990	49	390	341	1.03333	0.690283
GCA_000977325.2-Fun_CP005251.2_i000_001984	49	390	341	1.03333	0.690283
GCA_000977355.3-Fun_CP005252.2_i000_001990	49	390	341	1.03333	0.690283
GCA_000977385.2-Fun_CP005253.2_i000_001976	49	390	341	1.03333	0.690283
GCA_000977415.2-Fun_CP005254.1_i000_001981	49	390	341	1.03333	0.690283
GCA_000977475.3-Fun_CP005256.2_i000_001983	49	390	341	1.03333	0.690283
GCA_000977685.2-Fun_CP005263.2_i000_001992	49	390	341	1.03333	0.690283
GCA_000977715.4-Fun_CP005264.1_i000_001982	49	390	341	1.03333	0.690283
GCA_000977805.2-Fun_CP005267.2_i000_001949	49	390	341	1.03333	0.690283
GCA_000977985.2-Fun_CP005273.2_i000_001921	49	390	341	1.03333	0.690283
GCA_000978045.2-Fun_CP005275.2_i000_001929	49	390	341	1.03333	0.690283
GCA_000978075.3-Fun_CP005276.2_i000_001973	49	390	341	1.03333	0.690283
GCA_000978165.2-Fun_CP005279.1_i000_001991	49	390	341	1.03333	0.690283
GCA_000978195.2-Fun_CP005280.2_i000_001991	49	390	341	1.03333	0.690283
GCA_001298375.2-Fun_CM003543.1_i000_001837	49	390	341	1.03333	0.690283
GCA_001413975.1-Fun_CM003562.1_i000_002052	49	390	341	1.03333	0.690283
GCA_002571405.2-Fun_CP046087.1_i000_002154	49	390	341	1.03333	0.690283
GCA_002804325.1-Fun_PEJR01000135.1_i000_000792	49	390	341	1.03333	0.690283
GCA_003046695.1-Fun_PTEP01000009.1_i000_005211	49	390	341	1.03333	0.690283
GCA_003046745.1-Fun_PTER01000009.1_i000_005275	49	390	341	1.03333	0.690283
GCA_010356925.1-Fun_CM021133.1_i000_002137	49	390	341	1.03333	0.690283
GCA_010356935.1-Fun_CM021117.1_i000_002118	49	390	341	1.03333	0.690283
GCA_016858165.1-Fun_CM029095.1_i000_002150	49	390	341	1.03333	0.690283
GCA_016858175.1-Fun_CM029079.1_i000_002122	49	390	341	1.03333	0.690283
GCA_905220315.1-Fun_LR999878.1_i000_002090	49	390	341	1.03333	0.690283
GCA_003704595.1-Fun_QWIO01001256.1_i000_009703	97	310	213	0.645455	0.687097
GCA_019202705.1-Fun_JAGSYN010000219.1_i000_003079	73	410	337	1.02121	0.620626
GCA_000530735.1-Fun_CBTC010000046.1_i000_004225	35	358	323	0.978788	0.713024
GCA_001984395.2-Fun_CP019490.1_i000_000783	35	358	323	0.978788	0.713024
GCA_000975975.3-Fun_CP005204.2_i000_001981	49	390	341	1.03333	0.690283
GCA_000977295.2-Fun_CP005250.2_i000_001969	49	390	341	1.03333	0.690283
GCA_000975765.2-Fun_CP005195.2_i000_001967	49	390	341	1.03333	0.690283
GCA_000975855.3-Fun_CP005200.2_i000_001967	49	390	341	1.03333	0.690283
GCA_009014655.1-Fun_BKZN01000080.1_i000_004340	49	390	341	1.03333	0.690283
GCA_903819195.2-Fun_LR813608.2_i000_002050	49	390	341	1.03333	0.690283
GCA_013305925.1-Fun_QVTG01000260.1_i000_001313	1	211	210	0.636364	0.626866
GCA_903819205.2-Fun_LR813557.2_i000_002050	49	390	341	1.03333	0.690283
GCA_000260735.1-Fun_DG000043.1_i000_002112	49	390	341	1.03333	0.690283
GCA_000975675.2-Fun_CP005228.2_i000_001960	49	390	341	1.03333	0.690283
GCA_000976005.2-Fun_CP005205.2_i000_001992	49	390	341	1.03333	0.690283
GCA_000976065.2-Fun_CP005207.2_i000_002002	49	390	341	1.03333	0.690283
GCA_000976755.2-Fun_CP005232.2_i000_001990	49	390	341	1.03333	0.690283
GCA_000976785.2-Fun_CP005233.2_i000_001960	49	390	341	1.03333	0.690283
GCA_000976815.3-Fun_CP005234.1_i000_001967	49	390	341	1.03333	0.690283
GCA_000976995.2-Fun_CP005240.2_i000_002002	49	390	341	1.03333	0.690283
GCA_000977115.3-Fun_CP005244.1_i000_001982	49	390	341	1.03333	0.690283
GCA_000977505.2-Fun_CP005257.2_i000_001975	49	390	341	1.03333	0.690283
GCA_000977535.2-Fun_CP005258.2_i000_001956	49	390	341	1.03333	0.690283
GCA_000977595.2-Fun_CP005260.2_i000_001970	49	390	341	1.03333	0.690283
GCA_000977625.2-Fun_CP005261.2_i000_001973	49	390	341	1.03333	0.690283
GCA_000977655.2-Fun_CP005262.2_i000_001991	49	390	341	1.03333	0.690283
GCA_000977775.3-Fun_CP005266.2_i000_001974	49	390	341	1.03333	0.690283
GCA_000977835.2-Fun_CP005268.2_i000_002004	49	390	341	1.03333	0.690283
GCA_000977895.2-Fun_CP005270.2_i000_001962	49	390	341	1.03333	0.690283
GCA_000977925.2-Fun_CP005271.2_i000_001922	49	390	341	1.03333	0.690283
GCA_000978015.2-Fun_CP005274.1_i000_001980	49	390	341	1.03333	0.690283
GCA_000978135.2-Fun_CP005278.2_i000_001969	49	390	341	1.03333	0.690283
GCA_000978255.2-Fun_CP005282.2_i000_001987	49	390	341	1.03333	0.690283
GCA_000978315.2-Fun_CP005284.1_i000_001963	49	390	341	1.03333	0.690283
GCA_000978345.2-Fun_CP005285.2_i000_001941	49	390	341	1.03333	0.690283
GCA_002335645.1-Fun_BEGW01000003.1_i000_002115	49	390	341	1.03333	0.690283
GCA_014132375.1-Fun_BLZP01000003.1_i000_001465	49	390	341	1.03333	0.690283
GCA_014905575.1-Fun_BNHH01000140.1_i000_004743	49	390	341	1.03333	0.690283
GCA_014132395.1-Fun_BLZQ01000002.1_i000_000917	49	390	341	1.03333	0.690283
GCA_000224885.2-Pro_KL998095.1_i000_004441	82	304	222	0.672727	0.695925
GCA_000190195.1-Fun_CM001084.1_i000_001321	49	390	341	1.03333	0.690283
GCA_903819145.2-Fun_LR813523.2_i000_002080	49	390	341	1.03333	0.690283
GCA_002926085.1-Fun_PKFP01000008.1_i000_000616	70	424	354	1.07273	0.778022
GCA_019677385.1-Fun_WSLO01005526.1_i000_012467	1	165	164	0.49697	0.575439
GCA_000977955.2-Fun_CP005272.2_i000_001897	55	390	335	1.01515	0.678138
GCA_000235365.1-Fun_CP002500.1_i000_002234	40	351	311	0.942424	0.67316
GCA_001634645.1-Fun_CM004300.1_i000_002323	49	390	341	1.03333	0.690283
GCA_008690995.1-Pro_VRMN01000003.1_i000_001984	79	415	336	1.01818	0.607595
GCA_000180755.1-Ani_ADBV01002264.1_i000_005736	116	299	183	0.554545	0.60396
GCA_001983315.1-Fun_MQVN01000058.1_i000_003968	49	390	341	1.03333	0.690283
GCA_000978105.2-Fun_CP005277.2_i000_001957	49	390	341	1.03333	0.690283
GCA_000978225.2-Fun_CP005281.2_i000_001997	49	390	341	1.03333	0.690283
GCA_000977055.3-Fun_CP005242.2_i000_001989	49	390	341	1.03333	0.690283
GCA_000975825.2-Fun_CP005199.1_i000_001990	49	390	341	1.03333	0.690283
GCA_000978285.2-Fun_CP005283.2_i000_001909	49	390	341	1.03333	0.690283
GCA_003046715.1-Fun_PTEQ01000152.1_i000_001435	49	390	341	1.03333	0.690283
GCA_903819155.2-Fun_LR813506.2_i000_002079	51	390	339	1.02727	0.686235
GCA_000976095.2-Fun_CP005208.2_i000_001987	49	390	341	1.03333	0.690283
GCA_019332025.1-Fun_CP076661.1_i000_000559	70	409	339	1.02727	0.662109
GCA_903819175.2-Fun_LR813591.2_i000_002079	50	390	340	1.0303	0.688259
GCA_001447935.2-Fun_LMYN01000007.1_i000_000629	78	412	334	1.01212	0.630189
GCA_003614695.1-Fun_ML004474.1_i000_003311	66	405	339	1.02727	0.719745
GCA_003426235.1-Fun_NQIM01000025.1_i000_004456	12	312	300	0.909091	0.952381
GCA_902206195.3-Pla_CABITT030000007.1_i000_020400	1	104	103	0.312121	0.476852
GCA_902206195.3-Pla_CABITT030000007.1_i000_020400	121	215	94	0.284848	0.435185
GCA_011745845.1-Pla_VYZY01001217.1_i000_006207	32	243	211	0.639394	0.548052
GCA_011745845.1-Pla_VYZY01001217.1_i000_006207	257	323	66	0.2	0.171429
GCA_011745865.1-Pla_VYZZ01009424.1_i000_030809	32	243	211	0.639394	0.548052
GCA_011745865.1-Pla_VYZZ01009424.1_i000_030809	257	323	66	0.2	0.171429
GCA_000002825.1-Pro_DS113257.1_i000_051258	7	299	292	0.884848	0.824859
GCA_000976215.2-Fun_CP005212.2_i000_001964	49	390	341	1.03333	0.690283
GCA_000976905.2-Fun_CP005237.2_i000_001956	49	390	341	1.03333	0.690283
GCA_000977865.2-Fun_CP005269.1_i000_001959	49	390	341	1.03333	0.690283
GCA_903819135.2-Fun_LR813540.2_i000_002092	49	390	341	1.03333	0.690283
GCA_000750675.1-Fun_JPJR01001111.1_i000_005542	87	301	214	0.648485	0.710963
GCA_013358455.1-Pla_JABWDY010007207.1_i000_005344	1	185	184	0.557576	0.989247
GCA_000149425.1-Fun_CH408159.1_i000_001487	85	418	333	1.00909	0.702532
GCA_004369065.1-Fun_ML208300.1_i000_006243	124	306	182	0.551515	0.448276
GCA_000326105.1-Fun_AGVY01000023.1_i000_001853	49	390	341	1.03333	0.690283
GCA_000325965.1-Fun_ADVV01000036.1_i000_001343	49	390	341	1.03333	0.690283
GCA_022432385.1-Fun_JAJJXC010000001.1_i000_000010	99	233	134	0.406061	0.465278
GCA_005406105.1-Fun_BIMX01000011.1_i000_002561	29	326	297	0.9	0.671946
GCA_000237345.1-Fun_HE576756.1_i000_003586	60	403	343	1.03939	0.716075
GCA_006381635.2-Pla_VEPZ02001419.1_i000_062086	136	311	175	0.530303	0.508721
GCA_000243375.1-Fun_HE616747.1_i000_003781	26	361	335	1.01515	0.771889
GCA_015342795.1-Ani_CM027187.1_i000_007108	1	163	162	0.490909	0.915254
THAC002.0722.00001.C001_01304	46	190	144	0.436364	0.757895
GCA_017552425.1-Pla_CM029812.1_i000_024063	45	236	191	0.578788	0.589506
GCA_017552425.1-Pla_CM029812.1_i000_024063	273	317	44	0.133333	0.135802
GCA_900162805.1-Fun_FUGC01000002.1_i000_002456	32	358	326	0.987879	0.719647
GCA_001661425.1-Fun_KV453859.1_i000_004240	50	394	344	1.04242	0.661538
GCA_903819125.2-Fun_LR813489.2_i000_002058	52	390	338	1.02424	0.684211
GCA_000256725.2-Pro_KQ986313.1_i000_008309	1	163	162	0.490909	0.915254
GCA_000224845.2-Pro_KN042481.1_i000_004059	1	162	161	0.487879	0.909605
GCA_010458925.1-Pla_CM021239.1_i000_033569	1	98	97	0.293939	0.567251
GCA_010458925.1-Pla_CM021239.1_i000_033569	91	167	76	0.230303	0.444444
GCA_000224905.2-Pro_KN000241.1_i000_002664	1	160	159	0.481818	0.898305
GCA_000325525.2-Pro_KN003134.1_i000_007310	1	160	159	0.481818	0.898305
GCA_013358455.1-Pla_JABWDY010014209.1_i000_010680	1	205	204	0.618182	0.957746
GCA_018107945.1-Pla_JACEIK010001419.1_i000_023493	1	141	140	0.424242	0.992908
GCA_013389845.1-Ani_VWPX01004300.1_i000_002872	5	155	150	0.454545	0.35461
GCA_000530735.1-Fun_CBTC010000099.1_i000_007733	31	359	328	0.993939	0.724062
GCA_001593445.1-Pro_JIBK01000017.1_i000_001689	30	368	338	1.02424	0.771689
GCA_000006445.2-Fun_CR382135.2_i000_001681	79	412	333	1.00909	0.628302
GCA_900106125.1-Fun_LT635764.1_i000_001304	61	399	338	1.02424	0.681452
GCA_905332295.1-Ani_CAJOBT010004589.1_i000_021719	1	148	147	0.445455	0.875
GCA_001970955.1-Pro_MPUH01001899.1_i000_010000	18	343	325	0.984848	0.748848
GCA_900106115.1-Fun_LT635756.1_i000_000304	65	399	334	1.01212	0.687243
GCA_000751015.1-Pla_LK033138.1_i000_045596	56	149	93	0.281818	0.287926
GCA_000751015.1-Pla_LK033138.1_i000_045596	145	278	133	0.40303	0.411765
GCA_020379485.1-Pla_CM035460.1_i000_068381	56	149	93	0.281818	0.287926
GCA_020379485.1-Pla_CM035460.1_i000_068381	145	278	133	0.40303	0.411765
GCA_001984395.2-Fun_CP019499.1_i000_007179	30	358	328	0.993939	0.724062
GCA_013396775.1-Ani_VZRE01000561.1_i000_000568	107	269	162	0.490909	0.60223
GCA_000769155.2-Pro_JROU02000749.1_i000_002304	107	341	234	0.709091	0.488518
GCA_000304475.1-Fun_HE650831.1_i000_005060	61	398	337	1.02121	0.666008
GCA_903064755.1-Fun_CAEFZW010000001.1_i000_000053	56	405	349	1.05758	0.731656
GCA_903987035.1-Fun_CAJDZR010000001.1_i000_000053	56	405	349	1.05758	0.731656
GCA_905332125.1-Ani_CAJOBJ010326978.1_i000_067925	1	142	141	0.427273	0.875776
GCA_905332115.1-Ani_CAJOBH010223388.1_i000_056623	1	142	141	0.427273	0.87037
GCA_905332135.1-Ani_CAJOBI010009116.1_i000_018726	1	142	141	0.427273	0.87037
GCA_000190255.1-Fun_CM001116.1_i000_001277	1	281	280	0.848485	0.73107
GCA_900624965.1-Ani_UYYB01096125.1_i000_010878	13	154	141	0.427273	0.915584
GCA_009768925.2-Pro_VHIT02000022.1_i000_002453	32	359	327	0.990909	0.765808
GCA_905332045.1-Ani_CAJOBB010024824.1_i000_051167	1	111	110	0.333333	0.916667
FEAC001.0722.00001.C001_00185	87	239	152	0.460606	0.633333
FEAC002.0722.00001.C001_01164	87	239	152	0.460606	0.633333
GCA_905331515.1-Ani_CAJNZC010000729.1_i000_027531	425	567	142	0.430303	0.241087
GCA_900074755.1-Fun_LT598453.1_i000_003707	42	366	324	0.981818	0.673597
GCA_001972345.1-Fun_BDGX01000035.1_i000_006822	30	353	323	0.978788	0.732426
GCA_000142805.1-Fun_CU928170.1_i000_003249	97	416	319	0.966667	0.608779
GCA_003676015.1-Fun_NSDU01000021.1_i000_003579	94	417	323	0.978788	0.682875
GCA_016584175.1-Fun_PUHR01000094.1_i000_005323	55	403	348	1.05455	0.735729
GCA_002079055.1-Fun_CP020248.1_i000_002026	53	389	336	1.01818	0.680162
GCA_905332225.1-Ani_CAJOBN010003952.1_i000_016253	1	142	141	0.427273	0.87037
GCA_001972345.1-Fun_BDGX01000009.1_i000_001806	22	356	334	1.01212	0.752252
GCA_000026365.1-Fun_CU928175.1_i000_001800	22	354	332	1.00606	0.747748
GCA_021535285.1-Fun_JAKETS010000002.1_i000_001316	22	354	332	1.00606	0.747748
GCA_000315915.1-Fun_HE806318.1_i000_002231	102	416	314	0.951515	0.614481
GCA_015679495.1-Fun_JAAAUW010003316.1_i000_010571	126	290	164	0.49697	0.565517
GCA_016771965.1-Pla_CM028699.1_i000_066701	98	185	87	0.263636	0.24234
GCA_016771965.1-Pla_CM028699.1_i000_066701	184	312	128	0.387879	0.356546
GCA_001661345.1-Fun_KV454478.1_i000_002620	109	235	126	0.381818	0.236398
GCA_001661345.1-Fun_KV454478.1_i000_002620	232	456	224	0.678788	0.420263
GCA_022059095.1-Pro_JAJSEB010000060.1_i000_008756	44	339	295	0.893939	0.828652
GCA_003719485.1-Pro_MKKU01000599.1_i000_007497	42	330	288	0.872727	0.813559
GCA_002007985.1-Fun_MSRX01000017.1_i000_001357	61	405	344	1.04242	0.653992
GCA_002008025.1-Fun_MSRY01000025.1_i000_002057	61	405	344	1.04242	0.653992
GCA_004217705.1-Fun_CP034458.1_i000_002710	69	402	333	1.00909	0.660714
GCA_000478725.1-Pla_KI517408.1_i000_007574	25	323	298	0.90303	0.894895
GCA_000499545.1-Pro_HG677472.1_i000_007681	1	154	153	0.463636	0.980769
GCA_905216605.1-Pla_LR999453.1_i000_008366	161	306	145	0.439394	0.269517
GCA_905216605.1-Pla_LR999453.1_i000_008366	299	436	137	0.415152	0.254647
GCA_000375325.1-Pla_KB870807.1_i000_007466	34	347	313	0.948485	0.845946
GCA_900074735.1-Fun_LT598476.1_i000_004468	53	364	311	0.942424	0.71659
GCA_001879085.1-Pla_MJEQ01009756.1_i000_032558	29	312	283	0.857576	0.904153
GCA_003573695.1-Pla_PUWZ01006673.1_i000_046113	139	313	174	0.527273	0.384106
GCA_003573695.1-Pla_PUWZ01006673.1_i000_046113	311	388	77	0.233333	0.169978
GCA_000820885.1-Fun_CCBQ010000027.1_i000_002253	46	369	323	0.978788	0.725843
GCA_015342445.1-Pla_JACEFO010001785.1_i000_029882	1	161	160	0.484848	0.629921
GCA_018446385.1-Pla_CM031514.1_i000_024811	1	167	166	0.50303	0.631179
GCA_007993695.1-Fun_CP042458.1_i000_002940	44	380	336	1.01818	0.719486
GCA_011022315.1-Fun_CP049004.1_i000_007539	47	387	340	1.0303	0.688259
GCA_001298625.1-Fun_CM003588.1_i000_001946	47	387	340	1.0303	0.688259
GCA_015680905.1-Pla_CM027383.1_i000_029558	65	258	193	0.584848	0.745174
GCA_015033655.1-Pro_CM026629.1_i000_002554	43	331	288	0.872727	0.813559
GCA_002087225.1-Pro_NBCO01000008.1_i000_010723	44	339	295	0.893939	0.828652
GCA_005406065.1-Fun_BIMT01000050.1_i000_003835	73	408	335	1.01515	0.662055
GCA_000300495.1-Pro_AHKC01009743.1_i000_003496	43	329	286	0.866667	0.80791
GCA_004115385.1-Pla_CM014063.1_i000_035842	8	134	126	0.381818	0.933333
GCA_013339685.1-Ani_CM023490.1_i000_024795	30	226	196	0.593939	0.863436
GCA_000188675.2-Pro_ADWP02014321.1_i000_004721	43	329	286	0.866667	0.80791
GCA_003177105.1-Pro_PRFA01000113.1_i000_001199	43	329	286	0.866667	0.80791
GCA_003719455.1-Pro_MKKV01000182.1_i000_007889	43	329	286	0.866667	0.80791
GCA_015033625.1-Pro_CM026586.1_i000_002561	43	329	286	0.866667	0.80791
GCA_000209065.1-Pro_CH473698.1_i000_000716	43	331	288	0.872727	0.813559
GCA_003177095.1-Pro_PRFC01000019.1_i000_007494	43	331	288	0.872727	0.813559
GCA_014905795.1-Fun_JACBPP010000001.1_i000_000037	70	402	332	1.00606	0.65873
GCA_014636115.1-Fun_JAASFG010000002.1_i000_001351	66	402	336	1.01818	0.689938
GCA_002008015.1-Fun_MSSE01000067.1_i000_004450	61	407	346	1.04848	0.657795
GCA_002008075.1-Fun_MSSB01000174.1_i000_001474	61	407	346	1.04848	0.657795
GCA_000002515.1-Fun_CR382124.1_i000_002580	44	380	336	1.01818	0.719486
GCA_001673695.2-Fun_LYUB02000002.1_i000_001061	66	402	336	1.01818	0.689938
GCA_000512255.2-Pla_CM008459.1_i000_015134	31	244	213	0.645455	0.737024
GCA_000150035.1-Fun_DS480378.1_i000_005275	62	412	350	1.06061	0.709939
GCA_000209065.1-Pro_CH473479.1_i000_004931	43	329	286	0.866667	0.80791
GCA_003177095.1-Pro_PRFC01000167.1_i000_006040	43	329	286	0.866667	0.80791
GCA_000209485.1-Fun_ABGB01000014.1_i000_003615	76	245	169	0.512121	0.457995
GCA_000209485.1-Fun_ABGB01000014.1_i000_003615	257	368	111	0.336364	0.300813
GCA_000496795.1-Pro_AYLP01000075.1_i000_005273	43	329	286	0.866667	0.80791
GCA_002219105.2-Pro_MBSY01000545.1_i000_005879	43	329	286	0.866667	0.80791
GCA_009498055.1-Fun_CP038485.1_i000_002006	65	402	337	1.02121	0.691992
GCA_009498075.1-Fun_CP039551.1_i000_001998	65	402	337	1.02121	0.691992
GCA_009498095.1-Fun_CP039653.1_i000_002005	65	402	337	1.02121	0.691992
GCA_009498115.1-Fun_CP039661.1_i000_002004	65	402	337	1.02121	0.691992
GCA_009498135.1-Fun_CP039619.1_i000_002005	65	402	337	1.02121	0.691992
GCA_003675555.2-Fun_QOBI02000002.1_i000_001252	66	402	336	1.01818	0.689938
GCA_002127325.2-Pla_CM007893.2_i000_014734	1	88	87	0.263636	0.966667
GCA_020184695.1-Pro_JAANOX010000280.1_i000_011084	1	311	310	0.939394	0.844687
GCA_020186115.1-Pro_WSYJ01000142.1_i000_006614	1	311	310	0.939394	0.844687
GCA_003719475.1-Pro_MKGL01000190.1_i000_005526	42	330	288	0.872727	0.813559
GCA_003325415.1-Fun_PJQM01002225.1_i000_006726	1	168	167	0.506061	0.180541
GCA_015680905.1-Pla_CM027381.1_i000_019633	1	195	194	0.587879	0.994872
GCA_905231905.1-Pro_CAJNIZ010000676.1_i000_000779	95	258	163	0.493939	0.631783
GCA_000402015.1-Ani_KE131919.1_i000_015816	3	151	148	0.448485	0.980132
GCA_014058105.1-Pla_JACGCM010002293.1_i000_014458	10	114	104	0.315152	0.654088
GCA_014058105.1-Pla_JACGCM010002293.1_i000_014458	112	158	46	0.139394	0.289308
GCA_016584185.1-Fun_PUHS01000079.1_i000_004679	66	412	346	1.04848	0.671845
GCA_900180425.1-Fun_FXLY01000002.1_i000_001080	60	398	338	1.02424	0.707113
GCA_000348985.1-Fun_HE978315.1_i000_000760	103	393	290	0.878788	0.589431
GCA_015852375.1-Fun_JAAAIF010001996.1_i000_003541	372	524	152	0.460606	0.290076
GCA_013115895.1-Pro_JABANM010018810.1_i000_015423	1	147	146	0.442424	0.993197
GCA_000167075.2-Fun_JH797135.1_i000_002135	57	392	335	1.01515	0.676768
GCA_900074745.1-Fun_LT598465.1_i000_001978	61	376	315	0.954545	0.645492
GCA_000448345.1-Ani_KE682364.1_i000_018817	78	257	179	0.542424	0.696498
GCA_000492115.1-Pro_AUPL01001491.1_i000_001466	42	330	288	0.872727	0.813559
GCA_002007995.1-Fun_MSRZ01000001.1_i000_001492	60	406	346	1.04848	0.656546
GCA_002008065.1-Fun_MSSA01000001.1_i000_001817	60	406	346	1.04848	0.656546
GCA_002008085.1-Fun_MSSD01000089.1_i000_005240	60	406	346	1.04848	0.656546
GCA_002008095.1-Fun_MSSC01000009.1_i000_005479	60	406	346	1.04848	0.656546
GCA_000691245.1-Pro_JMRU01000033.1_i000_000955	42	332	290	0.878788	0.819209
GCA_009835205.1-Pro_VJMI01016570.1_i000_010726	1021	1190	169	0.512121	0.142017
GCA_021029115.1-Pro_JAFCAG010000005.1_i000_012725	1	40	39	0.118182	0.191176
GCA_021029115.1-Pro_JAFCAG010000005.1_i000_012725	38	166	128	0.387879	0.627451
GCA_001268165.1-Fun_CVQI01035050.1_i000_017639	85	297	212	0.642424	0.616279
GCA_000223465.1-Fun_GL996527.1_i000_003451	1	250	249	0.754545	0.655263
GCA_006547085.1-Pla_VIEB01000381.1_i000_021540	1	107	106	0.321212	0.375887
GCA_006547085.1-Pla_VIEB01000381.1_i000_021540	101	179	78	0.236364	0.276596
GCA_015680905.1-Pla_CM027383.1_i000_029852	33	241	208	0.630303	0.709898
GCA_002900925.1-Fun_LN890563.1_i000_003555	41	372	331	1.00303	0.698312
GCA_900074725.1-Fun_LT598459.1_i000_001114	51	374	323	0.978788	0.660532
GCA_002738505.1-Pla_KZ305023.1_i000_004778	156	343	187	0.566667	0.329806
GCA_900618505.1-Ani_UZAH01032280.1_i000_020517	110	266	156	0.472727	0.586466
GCA_000002445.1-Pro_CM000208.1_i000_006534	43	328	285	0.863636	0.802817
GCA_000210295.1-Pro_FN554973.1_i000_007218	43	328	285	0.863636	0.802817
GCA_001457755.2-Pro_CZPT02001685.1_i000_007583	43	328	285	0.863636	0.802817
GCA_003604175.2-Ani_CM030370.1_i000_007394	140	328	188	0.569697	0.287023
GCA_003604175.2-Ani_CM030370.1_i000_007394	346	404	58	0.175758	0.0885496
GCA_003604175.2-Ani_CM030370.1_i000_007394	442	555	113	0.342424	0.172519
GCA_009663115.1-Fun_CP023101.1_i000_000555	117	231	114	0.345455	0.201058
GCA_009663115.1-Fun_CP023101.1_i000_000555	239	393	154	0.466667	0.271605
GCA_001742945.1-Pla_DF973223.1_i000_010011	13	178	165	0.5	0.711207
GCA_001742945.1-Pla_DF973223.1_i000_010011	177	227	50	0.151515	0.215517
GCA_000236345.1-Ani_DF143195.1_i000_004604	173	361	188	0.569697	0.273256
GCA_000236345.1-Ani_DF143195.1_i000_004604	379	437	58	0.175758	0.0843023
GCA_000236345.1-Ani_DF143195.1_i000_004604	475	588	113	0.342424	0.164244
GCA_001664035.1-Fun_LXTC01000001.1_i000_000028	13	353	340	1.0303	0.769231
GCA_002738505.1-Pla_KZ305019.1_i000_001016	71	259	188	0.569697	0.389234
GCA_003543875.1-Pro_CM010681.1_i000_005494	83	368	285	0.863636	0.721519
GCA_015529785.1-Fun_JAAAUK010000293.1_i000_005583	1	127	126	0.381818	0.741176
GCA_000982615.1-Pro_HF955199.1_i000_000222	39	327	288	0.872727	0.837209
GCA_000715545.1-Ani_KL596635.1_i000_002005	190	378	188	0.569697	0.268956
GCA_000715545.1-Ani_KL596635.1_i000_002005	395	453	58	0.175758	0.0829757
GCA_000715545.1-Ani_KL596635.1_i000_002005	492	537	45	0.136364	0.0643777
GCA_001990785.1-Ani_KV906429.1_i000_009322	209	397	188	0.569697	0.261838
GCA_001990785.1-Ani_KV906429.1_i000_009322	414	472	58	0.175758	0.0807799
GCA_001990785.1-Ani_KV906429.1_i000_009322	511	556	45	0.136364	0.0626741
GCA_002738505.1-Pla_KZ305033.1_i000_011620	369	555	186	0.563636	0.238768
GCA_004011995.1-Pla_QGNW01000004.1_i000_002133	44	133	89	0.269697	0.440594
GCA_004011995.1-Pla_QGNW01000004.1_i000_002133	135	202	67	0.20303	0.331683
GCA_013694445.1-Fun_CP059270.1_i000_002465	44	374	330	1	0.741573
GCA_905332305.1-Ani_CAJOBU010022256.1_i000_038626	127	289	162	0.490909	0.560554
GCA_000448345.1-Ani_KE664658.1_i000_002237	4	186	182	0.551515	0.978495
GCA_000026945.1-Fun_FM992689.1_i000_002825	78	421	343	1.03939	0.611408
GCA_000695385.1-Fun_KK764657.1_i000_002844	363	488	125	0.378788	0.211506
GCA_000209485.1-Fun_ABGB01000015.1_i000_003513	174	346	172	0.521212	0.495677
GCA_016098165.1-Fun_JAAAJA010000621.1_i000_007801	1	124	123	0.372727	0.81457
GCA_021029115.1-Pro_JAFCAG010000004.1_i000_011387	519	667	148	0.448485	0.175563
GCA_021029115.1-Pro_JAFCAG010000004.1_i000_011387	667	738	71	0.215152	0.084223
GCA_000775465.1-Fun_AJIZ01000014.1_i000_001344	96	443	347	1.05152	0.597246
GCA_000784615.1-Fun_JPEW01000016.1_i000_000844	96	443	347	1.05152	0.597246
GCA_000775505.1-Fun_AJJB01000009.1_i000_005935	96	443	347	1.05152	0.598276
GCA_000784515.1-Fun_JSXQ01000009.1_i000_006253	90	438	348	1.05455	0.610526
GCA_000773735.1-Fun_AJIW01000012.1_i000_000611	91	439	348	1.05455	0.605217
GCA_000784695.1-Fun_AJJG01000014.1_i000_004617	91	439	348	1.05455	0.605217
GCA_004794785.1-Ani_SJOL01003848.1_i000_002161	140	328	188	0.569697	0.287023
GCA_004794785.1-Ani_SJOL01003848.1_i000_002161	346	403	57	0.172727	0.0870229
GCA_004794785.1-Ani_SJOL01003848.1_i000_002161	442	556	114	0.345455	0.174046
GCA_000784635.1-Fun_AJJF01000006.1_i000_005750	93	440	347	1.05152	0.606643
GCA_000775445.1-Fun_AJIV01000012.1_i000_000580	90	438	348	1.05455	0.609457
GCA_011074865.2-Fun_CP064812.1_i000_000811	29	362	333	1.00909	0.730263
GCA_000774085.1-Fun_AJIT01000008.1_i000_005858	89	437	348	1.05455	0.60733
GCA_000784595.1-Fun_JPEV01000011.1_i000_000454	90	438	348	1.05455	0.606272
GCA_000775525.1-Fun_AJJC01000012.1_i000_000509	90	438	348	1.05455	0.60733
GCA_001268165.1-Fun_CVQI01000086.1_i000_000467	1	91	90	0.272727	0.967742
GCA_014133895.1-Fun_CP059252.1_i000_004116	58	369	311	0.942424	0.698876
GCA_000773825.1-Fun_AJJA01000011.1_i000_000193	93	440	347	1.05152	0.606643
GCA_000784655.1-Fun_JTBX01000023.1_i000_001528	93	440	347	1.05152	0.607706
GCA_000773745.1-Fun_AJIU01000007.1_i000_005873	93	440	347	1.05152	0.605585
GCA_000773805.1-Fun_AJIY01000006.1_i000_005859	84	432	348	1.05455	0.614841
GCA_000784505.1-Fun_AJJD01000006.1_i000_005330	84	432	348	1.05455	0.614841
GCA_019776745.2-Pla_CM034148.1_i000_011734	94	238	144	0.436364	0.60251
GCA_000938715.1-Fun_LN736362.1_i000_001605	60	364	304	0.921212	0.642706
GCA_000784495.1-Fun_AJJE01000008.1_i000_005856	84	432	348	1.05455	0.614841
GCA_000773755.1-Fun_AJIS01000033.1_i000_001964	91	439	348	1.05455	0.606272
GCA_001548555.1-Fun_CP014244.1_i000_002220	49	358	309	0.936364	0.667387
GCA_905332245.1-Ani_CAJOBP010037010.1_i000_037349	1	122	121	0.366667	0.98374
GCA_905332275.1-Ani_CAJOBR010029324.1_i000_036594	1	122	121	0.366667	0.98374
GCA_013398345.1-Ani_WBNA01001137.1_i000_012914	1	142	141	0.427273	0.52809
GCA_013398735.1-Ani_VZSV01000902.1_i000_012661	1	142	141	0.427273	0.52809
GCA_000784525.1-Fun_JSXP01000007.1_i000_005878	90	438	348	1.05455	0.598967
GCA_000691765.2-Fun_KK667224.1_i000_001999	93	441	348	1.05455	0.606272
GCA_000784575.1-Fun_JSXR01000016.1_i000_001284	89	437	348	1.05455	0.612676
GCA_000182965.3-Fun_CP017624.1_i000_001962	90	438	348	1.05455	0.611599
GCA_900074715.1-Fun_LT598481.1_i000_001948	46	364	318	0.963636	0.686825
GCA_000773725.1-Fun_AJIX01000013.1_i000_000599	90	438	348	1.05455	0.609457
GCA_013398375.1-Ani_VZSI01000512.1_i000_010343	1	144	143	0.433333	0.531599
GCA_013398715.1-Ani_VZSU01004026.1_i000_013358	1	144	143	0.433333	0.531599
GCA_015178925.1-Fun_WHVC01000021.1_i000_004641	132	235	103	0.312121	0.239535
GCA_015178925.1-Fun_WHVC01000021.1_i000_004641	236	345	109	0.330303	0.253488
GCA_900618425.1-Ani_UZAN01044772.1_i000_007555	36	216	180	0.545455	0.821918
GCA_013115895.1-Pro_JABANM010015503.1_i000_012790	1	112	111	0.336364	0.991071
GCA_000236905.1-Fun_HE612859.1_i000_001933	48	400	352	1.06667	0.747346
GCA_013397935.1-Ani_VZRN01003028.1_i000_006536	1	142	141	0.427273	0.534091
GCA_000149445.2-Fun_CH672350.1_i000_001916	93	440	347	1.05152	0.606643
GCA_000775455.1-Fun_AJIR01000008.1_i000_005894	93	440	347	1.05152	0.606643
GCA_902206195.3-Pla_CABITT030000003.1_i000_007084	20	139	119	0.360606	0.382637
GCA_902206195.3-Pla_CABITT030000003.1_i000_007084	134	297	163	0.493939	0.524116
GCA_014217725.1-Fun_CP048236.1_i000_001726	59	393	334	1.01212	0.697286
GCA_900096545.1-Fun_FMSJ01000007.1_i000_001898	59	393	334	1.01212	0.697286
GCA_900166875.1-Fun_FWDN01000007.1_i000_004964	59	393	334	1.01212	0.697286
GCA_000750745.1-Fun_JPJV01001888.1_i000_004763	85	290	205	0.621212	0.706897
GCA_000582765.1-Pro_HF955072.1_i000_003515	43	330	287	0.869697	0.834302
GCA_000797555.1-Ani_KN612517.1_i000_024336	1	125	124	0.375758	0.992
GCA_018994065.1-Fun_JAFKAH010000225.1_i000_002546	175	350	175	0.530303	0.434243
GCA_014049485.1-Fun_JABWAD010000060.1_i000_005222	63	397	334	1.01212	0.632576
PITO001.0722.00001.C001_00717	89	238	149	0.451515	0.62605
GCA_020797195.1-Fun_CM036808.1_i000_001736	59	393	334	1.01212	0.697286
GCA_020797205.1-Fun_CM036829.1_i000_001731	59	393	334	1.01212	0.697286
GCA_002049455.2-Pro_KV918858.1_i000_004775	140	290	150	0.454545	0.188679
GCA_002049455.2-Pro_KV918858.1_i000_004775	314	471	157	0.475758	0.197484
GCA_000002545.2-Fun_CR380953.1_i000_001709	58	393	335	1.01515	0.699374
GCA_001466525.1-Fun_LLWO01000031.1_i000_000120	58	393	335	1.01515	0.699374
GCA_001466535.1-Fun_LMAA01000132.1_i000_004977	58	393	335	1.01515	0.699374
GCA_001466565.1-Fun_LMAB01000103.1_i000_002265	58	393	335	1.01515	0.699374
GCA_001466575.1-Fun_LLZY01000043.1_i000_001660	58	393	335	1.01515	0.699374
GCA_001466635.1-Fun_LLZZ01000107.1_i000_001652	58	393	335	1.01515	0.699374
GCA_001466685.1-Fun_LMAY01000101.1_i000_000080	58	393	335	1.01515	0.699374
GCA_010111755.1-Fun_CP048124.1_i000_001735	58	393	335	1.01515	0.699374
GCA_020797185.1-Fun_CM036837.1_i000_001738	58	393	335	1.01515	0.699374
GCA_020797215.1-Fun_CM036799.1_i000_001744	58	393	335	1.01515	0.699374
GCA_020797225.1-Fun_CM036820.1_i000_001745	58	393	335	1.01515	0.699374
GCA_020797325.1-Fun_CM036845.1_i000_001734	58	393	335	1.01515	0.699374
GCA_020797355.1-Fun_CM036856.1_i000_001725	58	393	335	1.01515	0.699374
GCA_001266575.1-Ani_JTDY01000091.1_i000_000612	30	161	131	0.39697	0.286026
GCA_001266575.1-Ani_JTDY01000091.1_i000_000612	160	196	36	0.109091	0.0786026
GCA_001266575.1-Ani_JTDY01000091.1_i000_000612	194	243	49	0.148485	0.106987
GCA_020450195.1-Fun_CP053492.1_i000_001737	58	391	333	1.00909	0.695198
GCA_020450215.1-Fun_CP053518.1_i000_001735	58	391	333	1.00909	0.695198
GCA_020450235.1-Fun_CP053531.1_i000_001735	58	391	333	1.00909	0.695198
GCA_020450265.1-Fun_CP060149.1_i000_001735	58	391	333	1.00909	0.695198
GCA_001974805.1-Pla_AWWV01006115.1_i000_002314	30	228	198	0.6	0.636656
GCA_001974805.1-Pla_AWWV01006115.1_i000_002314	248	309	61	0.184848	0.196141
GCA_000331365.3-Pla_AMZH03001119.1_i000_005682	96	218	122	0.369697	0.429577
GCA_001974825.1-Pla_AWUE01012331.1_i000_003904	33	227	194	0.587879	0.713235
GCA_905397895.1-Ani_CAJPWZ010001460.1_i000_029657	232	414	182	0.551515	0.302829
GCA_008638375.1-Pla_CM018042.1_i000_033166	1	105	104	0.315152	0.442553
GCA_000511025.2-Pla_KQ090245.1_i000_006889	25	256	231	0.7	0.898833
GCA_000750715.1-Fun_JPJT01003672.1_i000_005898	136	287	151	0.457576	0.526132
GCA_018446385.1-Pla_CM031515.1_i000_027314	124	281	157	0.475758	0.541379
GCA_002219185.1-Fun_CM008087.1_i000_002028	58	393	335	1.01515	0.699374
GCA_002219195.1-Fun_CM008101.1_i000_002026	58	393	335	1.01515	0.699374
GCA_001268145.1-Fun_CVQH01025048.1_i000_018284	1	93	92	0.278788	0.989247
GCA_003260655.2-Pla_QGKV02001556.1_i000_060514	1	93	92	0.278788	0.647887
GCA_000372725.1-Pro_KB865350.1_i000_016998	283	443	160	0.484848	0.253968
GCA_905216605.1-Pla_LR999453.1_i000_008362	41	184	143	0.433333	0.362944
GCA_905216605.1-Pla_LR999453.1_i000_008362	178	296	118	0.357576	0.299492
GCA_905216605.1-Pla_LR999453.1_i000_008374	41	184	143	0.433333	0.362944
GCA_905216605.1-Pla_LR999453.1_i000_008374	178	296	118	0.357576	0.299492
GCA_003260675.2-Pla_QGKX02001347.1_i000_018468	1	93	92	0.278788	0.647887
GCA_002081675.1-Fun_MNPJ01000002.1_i000_001741	215	405	190	0.575758	0.469136
GCA_001293395.1-Pro_LGTL01000019.1_i000_007428	33	318	285	0.863636	0.835777
GCA_900618425.1-Ani_UZAN01049057.1_i000_010426	9	147	138	0.418182	0.480836
GCA_001299535.1-Pro_LJSK01000112.1_i000_004009	35	319	284	0.860606	0.832845
GCA_011752425.2-Ani_CACVKT020007209.1_i000_039790	234	417	183	0.554545	0.30298
GCA_014282245.1-Pla_CM024964.1_i000_027521	35	214	179	0.542424	0.613014
GCA_010085335.1-Ani_VULH01045817.1_i000_014711	1	124	123	0.372727	0.803922
GCA_007726485.1-Pla_CM017443.1_i000_021064	1	163	162	0.490909	0.666667
GCA_019425475.1-Pro_NLFJ01000118.1_i000_001782	42	329	287	0.869697	0.813031
GCA_021307395.1-Pro_SOPI01000598.1_i000_014766	42	329	287	0.869697	0.813031
GCA_002087915.1-Fun_LWDP01000029.1_i000_000873	135	341	206	0.624242	0.602339
GCA_905330535.1-Ani_CAJNVN010000035.1_i000_011823	6	145	139	0.421212	0.637615
GCA_905330535.1-Ani_CAJNVN010000035.1_i000_011823	144	207	63	0.190909	0.288991
GCA_905332185.1-Ani_CAJOBM010000840.1_i000_006478	6	145	139	0.421212	0.637615
GCA_905332185.1-Ani_CAJOBM010000840.1_i000_006478	144	207	63	0.190909	0.288991
GCA_017916325.1-Pro_CM030428.1_i000_005958	34	317	283	0.857576	0.829912
GCA_905332135.1-Ani_CAJOBI010344608.1_i000_080192	1	100	99	0.3	0.99
GCA_900660285.1-Fun_CAACVR010000012.1_i000_002303	44	376	332	1.00606	0.674797
GCA_002127325.2-Pla_CM007890.2_i000_003565	1	98	97	0.293939	0.989796
GCA_013402915.1-Fun_CP058605.1_i000_001483	56	393	337	1.02121	0.713983
GCA_000002845.2-Pro_FR799008.1_i000_006396	36	314	278	0.842424	0.815249
GCA_900537975.1-Pro_LS997632.1_i000_006629	36	314	278	0.842424	0.815249
GCA_019924735.1-Fun_JAHFYD010006345.1_i000_016986	1	153	152	0.460606	0.663755
GCA_000755165.1-Pro_CP009402.1_i000_006178	36	313	277	0.839394	0.812317
GCA_017918235.1-Pro_CM030536.1_i000_005518	33	306	273	0.827273	0.800587
GCA_000182805.2-Fun_CABT02000019.1_i000_004120	128	303	175	0.530303	0.281804
GCA_000182805.2-Fun_CABT02000019.1_i000_004120	323	447	124	0.375758	0.199678
GCA_900618005.1-Ani_UYRS01018323.1_i000_003966	136	323	187	0.566667	0.28858
GCA_900618005.1-Ani_UYRS01018323.1_i000_003966	342	389	47	0.142424	0.0725309
GCA_900618005.1-Ani_UYRS01018323.1_i000_003966	444	552	108	0.327273	0.166667
GCA_013396435.1-Ani_WBMU01008607.1_i000_013458	1	109	108	0.327273	0.53202
GCA_905221625.1-Pro_CAJNDU010025374.1_i000_022873	29	202	173	0.524242	0.856436
GCA_001460835.1-Pro_CYKH01001149.1_i000_008397	40	343	303	0.918182	0.851124
GCA_001742945.1-Pla_DF974331.1_i000_036566	85	282	197	0.59697	0.627389
GCA_004000445.1-Ani_RSAL01001208.1_i000_014462	169	296	127	0.384848	0.426174
GCA_900617795.1-Ani_CAAALY010001107.1_i000_000586	4	140	136	0.412121	0.451827
GCA_905250035.1-Ani_CAJNOE010000301.1_i000_024608	786	937	151	0.457576	0.0913491
GCA_016771965.1-Pla_CM028702.1_i000_082380	1	88	87	0.263636	0.450777
GCA_002087915.1-Fun_LWDP01000009.1_i000_002081	70	370	300	0.909091	0.808625
GCA_013115865.1-Pro_JABANO010007524.1_i000_006033	2	135	133	0.40303	0.985185
GCA_905250045.1-Ani_CAJNOG010000561.1_i000_031919	544	701	157	0.475758	0.214188
GCA_002081675.1-Fun_MNPJ01000017.1_i000_001237	65	373	308	0.933333	0.823529
GCA_000412225.2-Fun_CP006023.1_i000_002001	54	302	248	0.751515	0.661333
GCA_001045655.1-Ani_LBMM01036290.1_i000_018204	1	130	129	0.390909	0.854305
GCA_014058105.1-Pla_JACGCM010000772.1_i000_032171	148	243	95	0.287879	0.383065
GCA_000002425.2-Pla_CM009322.1_i000_010539	82	229	147	0.445455	0.641921
GCA_010085335.1-Ani_VULH01051089.1_i000_017061	5	67	62	0.187879	0.19375
GCA_010085335.1-Ani_VULH01051089.1_i000_017061	104	194	90	0.272727	0.28125
GCA_014108235.1-Ani_JABWUV010000018.1_i000_008190	43	242	199	0.60303	0.812245
GCA_000234665.4-Pro_FR799585.1_i000_006734	38	313	275	0.833333	0.806452
GCA_017916335.1-Pro_CM030464.1_i000_006130	43	313	270	0.818182	0.791789
GCA_017918215.1-Pro_CM030500.1_i000_006052	43	313	270	0.818182	0.791789
GCA_900618515.1-Ani_UZAO01056536.1_i000_006408	131	319	188	0.569697	0.29653
GCA_900618515.1-Ani_UZAO01056536.1_i000_006408	337	389	52	0.157576	0.0820189
GCA_900618515.1-Ani_UZAO01056536.1_i000_006408	425	485	60	0.181818	0.0946372
GCA_000227135.2-Pro_FR799620.2_i000_006024	38	312	274	0.830303	0.803519
GCA_003719575.1-Pro_CP029532.1_i000_006468	38	312	274	0.830303	0.803519
GCA_900635355.2-Pro_LR812653.1_i000_006284	38	312	274	0.830303	0.803519
GCA_003730175.1-Pro_RHLD01000006.1_i000_001794	40	314	274	0.830303	0.798834
GCA_003730215.1-Pro_RHLC01000007.1_i000_001572	40	314	274	0.830303	0.798834
GCA_017918225.1-Pro_CM030572.1_i000_006194	43	313	270	0.818182	0.791789
GCA_001298355.1-Ani_KQ460129.1_i000_003256	205	358	153	0.463636	0.358314
GCA_001298355.1-Ani_KQ460129.1_i000_003256	354	422	68	0.206061	0.159251
GCA_013368495.1-Ani_LUCH01007744.1_i000_009855	46	235	189	0.572727	0.348708
GCA_013368495.1-Ani_LUCH01007744.1_i000_009855	253	311	58	0.175758	0.107011
GCA_013368495.1-Ani_LUCH01007744.1_i000_009855	340	449	109	0.330303	0.201107
GCA_000002725.2-Pro_FR796429.1_i000_006215	40	312	272	0.824242	0.797654
GCA_916722125.1-Pro_OU755567.1_i000_006382	40	312	272	0.824242	0.797654
GCA_900622495.1-Ani_UYWX01020295.1_i000_006186	135	323	188	0.569697	0.148499
GCA_900622495.1-Ani_UYWX01020295.1_i000_006186	342	389	47	0.142424	0.0371248
GCA_900622495.1-Ani_UYWX01020295.1_i000_006186	444	543	99	0.3	0.0781991
GCA_018107945.1-Pla_JACEIK010000014.1_i000_000729	47	173	126	0.381818	0.381818
GCA_018107945.1-Pla_JACEIK010000014.1_i000_000729	169	231	62	0.187879	0.187879
GCA_018107945.1-Pla_JACEIK010000014.1_i000_000729	247	323	76	0.230303	0.230303
GCA_902728155.2-Pla_CACVBM020001884.1_i000_048681	1	107	106	0.321212	0.638554
GCA_015252655.1-Ani_JTDF01004738.1_i000_005823	244	430	186	0.563636	0.252374
GCA_015252655.1-Ani_JTDF01004738.1_i000_005823	452	505	53	0.160606	0.0719132
GCA_015252655.1-Ani_JTDF01004738.1_i000_005823	538	640	102	0.309091	0.138399
GCA_000504015.1-Pla_KI630401.1_i000_006110	14	202	188	0.569697	0.87037
GCA_900618435.1-Ani_UYSU01037356.1_i000_012518	136	330	194	0.587879	0.279137
GCA_900618435.1-Ani_UYSU01037356.1_i000_012518	349	396	47	0.142424	0.0676259
GCA_900618435.1-Ani_UYSU01037356.1_i000_012518	434	529	95	0.287879	0.136691
GCA_017916305.1-Pro_CM030608.1_i000_006288	44	315	271	0.821212	0.792398
GCA_000002875.2-Pro_FR796465.1_i000_006093	38	312	274	0.830303	0.803519
GCA_900500625.2-Pro_LR812966.1_i000_006410	38	312	274	0.830303	0.803519
GCA_022478985.1-Fun_JAKSZP010003099.1_i000_000944	40	212	172	0.521212	0.369099
GCA_022478985.1-Fun_JAKSZP010003099.1_i000_000944	236	355	119	0.360606	0.255365
GCA_900604375.1-Ani_UXSR01000192.1_i000_001491	133	323	190	0.575758	0.368932
GCA_900604375.1-Ani_UXSR01000192.1_i000_001491	345	397	52	0.157576	0.100971
GCA_900604375.1-Ani_UXSR01000192.1_i000_001491	425	509	84	0.254545	0.163107
GCA_015529785.1-Fun_JAAAUK010002793.1_i000_005353	43	191	148	0.448485	0.774869
CUDI001.0722.00001.C001_01501	109	262	153	0.463636	0.581749
CUDI001.0722.00002.C001_01485	109	262	153	0.463636	0.581749
GCA_900618395.1-Ani_UZAI01017030.1_i000_015574	61	244	183	0.554545	0.331522
GCA_900618395.1-Ani_UZAI01017030.1_i000_015574	261	313	52	0.157576	0.0942029
GCA_900618395.1-Ani_UZAI01017030.1_i000_015574	350	470	120	0.363636	0.217391
GCA_905397895.1-Ani_CAJPWZ010000459.1_i000_008391	34	140	106	0.321212	0.504762
GCA_000181695.1-Fun_AAYY01000006.1_i000_002445	1	180	179	0.542424	0.561129
GCA_004011995.1-Pla_QGNW01000034.1_i000_013471	50	195	145	0.439394	0.36802
GCA_004011995.1-Pla_QGNW01000034.1_i000_013471	194	245	51	0.154545	0.129442
GCA_004011995.1-Pla_QGNW01000034.1_i000_013471	240	304	64	0.193939	0.162437
GCA_019650175.1-Pla_BNCO01000043.1_i000_008986	1	105	104	0.315152	0.327044
GCA_902155815.1-Fun_CABFWN010000004.1_i000_003243	33	374	341	1.03333	0.714885
GCA_002127325.2-Pla_CM007893.2_i000_012426	1	94	93	0.281818	0.853211
GCA_012275245.1-Fun_WMJW01000015.1_i000_002329	3	217	214	0.648485	0.672956
GCA_002897195.1-Pla_BDQV01000530.1_i000_024505	6	314	308	0.933333	0.971609
GCA_014176175.1-Fun_JABCYN010000057.1_i000_005344	30	374	344	1.04242	0.721174
GCA_014220965.1-Ani_LOND01020971.1_i000_011324	144	330	186	0.563636	0.291994
GCA_014220965.1-Ani_LOND01020971.1_i000_011324	351	405	54	0.163636	0.0847724
GCA_014220965.1-Ani_LOND01020971.1_i000_011324	440	545	105	0.318182	0.164835
GCA_000493195.1-Pla_KI536312.1_i000_004034	6	317	311	0.942424	0.896254
GCA_022201045.1-Pla_CM039162.1_i000_003800	6	317	311	0.942424	0.896254
GCA_000583005.2-Pla_ASHM01033310.1_i000_033313	62	264	202	0.612121	0.682432
GCA_013397325.1-Ani_VZTC01009318.1_i000_012115	2	151	149	0.451515	0.55597
GCA_003260695.2-Pla_QGKY02002305.1_i000_039349	118	264	146	0.442424	0.488294
GCA_004931855.1-Fun_SELW01000142.1_i000_000690	41	334	293	0.887879	0.773087
GCA_000442575.2-Pro_ATMG01008579.1_i000_008322	30	332	302	0.915152	0.890855
GCA_000583005.2-Pla_ASHM01017621.1_i000_022086	86	283	197	0.59697	0.625397
GCA_010085315.1-Ani_VULG01053826.1_i000_013396	1	128	127	0.384848	0.783951
GCA_019924395.1-Fun_JAHFXN010006312.1_i000_016807	1	146	145	0.439394	0.644444
GCA_002914845.1-Pla_JXTC01000007.1_i000_002532	3	167	164	0.49697	0.942529
GCA_016584345.1-Fun_JABCPV010000396.1_i000_010717	58	241	183	0.554545	0.740891
GCA_000695605.1-Pla_KK784936.1_i000_013190	2	284	282	0.854545	0.982578
GCA_022201065.1-Pla_CM039171.1_i000_004418	6	299	293	0.887879	0.885196
GCA_001661395.1-Fun_KV454545.1_i000_005267	3	213	210	0.636364	0.648148
GCA_000524195.1-Ani_APAU02000019.1_i000_007689	134	323	189	0.572727	0.291217
GCA_000524195.1-Ani_APAU02000019.1_i000_007689	342	384	42	0.127273	0.0647149
GCA_000524195.1-Ani_APAU02000019.1_i000_007689	444	484	40	0.121212	0.0616333
GCA_021556725.1-Ani_CM038616.1_i000_007052	134	323	189	0.572727	0.291217
GCA_021556725.1-Ani_CM038616.1_i000_007052	342	384	42	0.127273	0.0647149
GCA_021556725.1-Ani_CM038616.1_i000_007052	444	484	40	0.121212	0.0616333
GCA_021461655.1-Ani_CM038289.1_i000_008331	141	330	189	0.572727	0.295312
GCA_021461655.1-Ani_CM038289.1_i000_008331	350	515	165	0.5	0.257812
GCA_903995115.1-Pro_LR877153.1_i000_005221	30	332	302	0.915152	0.890855
GCA_000583005.2-Pla_ASHM01046650.1_i000_039873	1	121	120	0.363636	0.655738
GCA_000583005.2-Pla_ASHM01064432.1_i000_046241	1	121	120	0.363636	0.655738
GCA_014176185.1-Fun_JABCYO010000002.1_i000_000141	38	374	336	1.01818	0.704403
GCA_009731335.1-Pro_BLBS01000050.1_i000_006400	42	312	270	0.818182	0.791789
GCA_011074885.2-Fun_CP063136.1_i000_003505	33	374	341	1.03333	0.714885
GCA_001266575.1-Ani_JTDY01002389.1_i000_008033	44	207	163	0.493939	0.455307
GCA_001266575.1-Ani_JTDY01002389.1_i000_008033	208	281	73	0.221212	0.203911
GCA_006368765.1-Ani_SKCS01000574.1_i000_008454	142	331	189	0.572727	0.294852
GCA_006368765.1-Ani_SKCS01000574.1_i000_008454	351	481	130	0.393939	0.202808
GCA_018360465.1-Fun_SRQM01000327.1_i000_004143	119	264	145	0.439394	0.549242
GCA_015500155.1-Fun_JAAAUE010005810.1_i000_008006	671	813	142	0.430303	0.174662
GCA_015679595.1-Fun_JAAAVB010003310.1_i000_006524	1	129	128	0.387879	0.805031
GCA_014338405.1-Ani_JTDE01003539.1_i000_006796	209	361	152	0.460606	0.229607
GCA_014338405.1-Ani_JTDE01003539.1_i000_006796	379	446	67	0.20303	0.101208
GCA_014338405.1-Ani_JTDE01003539.1_i000_006796	467	575	108	0.327273	0.163142
GCA_000751015.1-Pla_LK032987.1_i000_044060	282	377	95	0.287879	0.188492
GCA_000751015.1-Pla_LK032987.1_i000_044060	375	429	54	0.163636	0.107143
GCA_000751015.1-Pla_LK032987.1_i000_044060	430	504	74	0.224242	0.146825
GCA_014058105.1-Pla_JACGCM010001219.1_i000_040293	1	136	135	0.409091	0.695876
GCA_001444175.2-Ani_KQ570532.1_i000_016238	9	140	131	0.39697	0.534694
GCA_015852385.1-Fun_JAAAIE010000578.1_i000_008633	1	129	128	0.387879	0.680851
GCA_017607525.1-Ani_JAANIA010000477.1_i000_000895	33	216	183	0.554545	0.337017
GCA_000469725.3-Ani_LN902843.1_i000_005347	134	323	189	0.572727	0.291217
GCA_000469725.3-Ani_LN902843.1_i000_005347	342	384	42	0.127273	0.0647149
GCA_000469725.3-Ani_LN902843.1_i000_005347	444	556	112	0.339394	0.172573
GCA_000442575.2-Pro_ATMG01006513.1_i000_010387	30	332	302	0.915152	0.890855
GCA_015679495.1-Fun_JAAAUW010005269.1_i000_012066	1	128	127	0.384848	0.686486
GCA_021461655.1-Ani_CM038289.1_i000_008333	46	235	189	0.572727	0.346789
GCA_021461655.1-Ani_CM038289.1_i000_008333	254	385	131	0.39697	0.240367
GCA_018360085.1-Fun_SRPR01000042.1_i000_005305	127	256	129	0.390909	0.503906
GCA_018360175.1-Fun_SRPS01000095.1_i000_008244	127	256	129	0.390909	0.503906
GCA_905330665.1-Ani_HG994580.1_i000_001151	1	48	47	0.142424	0.180077
GCA_905330665.1-Ani_HG994580.1_i000_001151	46	142	96	0.290909	0.367816
GCA_000751015.1-Pla_LK032378.1_i000_029259	43	137	94	0.284848	0.224344
GCA_000751015.1-Pla_LK032378.1_i000_029259	135	185	50	0.151515	0.119332
GCA_000751015.1-Pla_LK032378.1_i000_029259	184	309	125	0.378788	0.298329
GCA_018127125.1-Pla_CM030794.1_i000_021464	22	375	353	1.0697	0.886935
GCA_013389845.1-Ani_VWPX01066227.1_i000_013840	3	121	118	0.357576	0.848921
GCA_015679535.1-Fun_JAAAUX010000743.1_i000_010377	1	130	129	0.390909	0.68617
GCA_013389825.1-Ani_VWPW01075165.1_i000_013643	3	121	118	0.357576	0.848921
GCA_009445465.1-Pla_NMUH01000089.1_i000_003416	129	194	65	0.19697	0.16129
GCA_009445465.1-Pla_NMUH01000089.1_i000_003416	192	312	120	0.363636	0.297767
GCA_900617995.1-Ani_UZAL01034196.1_i000_013604	149	332	183	0.554545	0.287284
GCA_900617995.1-Ani_UZAL01034196.1_i000_013604	348	405	57	0.172727	0.0894819
GCA_900617995.1-Ani_UZAL01034196.1_i000_013604	439	481	42	0.127273	0.0659341
GCA_000091025.4-Fun_AE016817.6_i000_001788	55	317	262	0.793939	0.706199
GCA_000968835.1-Fun_CP002708.1_i000_001788	55	317	262	0.793939	0.706199
GCA_003958945.1-Ani_QMKO01002905.1_i000_008794	51	234	183	0.554545	0.339518
GCA_003958945.1-Ani_QMKO01002905.1_i000_008794	251	303	52	0.157576	0.096475
GCA_003958945.1-Ani_QMKO01002905.1_i000_008794	340	383	43	0.130303	0.0797774
GCA_020921065.1-Pla_CM037155.1_i000_012864	40	371	331	1.00303	0.78436
GCA_013396435.1-Ani_WBMU01006862.1_i000_012948	2	127	125	0.378788	0.589623
GCA_018446385.1-Pla_CM031515.1_i000_027315	87	238	151	0.457576	0.452096
GCA_020497155.1-Pla_CM035720.1_i000_040527	32	125	93	0.281818	0.455882
GCA_020497155.1-Pla_CM035720.1_i000_040527	122	201	79	0.239394	0.387255
GCA_010087175.1-Ani_VULM01005893.1_i000_004624	4	126	122	0.369697	0.589372
GCA_019677385.1-Fun_WSLO01007559.1_i000_014162	122	277	155	0.469697	0.559567
GCA_000699445.3-Ani_CM039142.1_i000_000702	147	330	183	0.554545	0.288189
GCA_000699445.3-Ani_CM039142.1_i000_000702	347	399	52	0.157576	0.0818898
GCA_000699445.3-Ani_CM039142.1_i000_000702	436	554	118	0.357576	0.185827
GCA_000764455.1-Fun_JQFK01000031.1_i000_005161	52	346	294	0.890909	0.65625
GCA_010078415.1-Ani_VUKZ01012408.1_i000_010340	2	121	119	0.360606	0.7
GCA_010080355.1-Ani_VULC01011628.1_i000_006314	4	125	121	0.366667	0.578947
GCA_900617975.1-Ani_UZAE01012306.1_i000_008406	134	324	190	0.575758	0.278184
GCA_900617975.1-Ani_UZAE01012306.1_i000_008406	342	393	51	0.154545	0.0746706
GCA_900617975.1-Ani_UZAE01012306.1_i000_008406	428	530	102	0.309091	0.149341
GCA_010078485.1-Ani_VULA01010458.1_i000_009823	4	128	124	0.375758	0.599034
GCA_003260635.2-Pla_QGKW02002005.1_i000_025081	1	147	146	0.442424	0.577075
GCA_010090195.1-Ani_VUKY01001919.1_i000_001535	5	126	121	0.366667	0.581731
GCA_019722365.1-Pla_JADFUC010000501.1_i000_013405	1	91	90	0.272727	0.947368
GCA_013400815.1-Ani_WBNK01005379.1_i000_012798	5	127	122	0.369697	0.564815
GCA_013400655.1-Ani_VYZQ01064124.1_i000_007072	1	122	121	0.366667	0.581731
GCA_013397615.1-Ani_WBNI01006786.1_i000_013044	1	123	122	0.369697	0.51046
GCA_019924535.1-Fun_JAHFXS010002364.1_i000_012931	133	256	123	0.372727	0.480469
GCA_001983325.1-Fun_MQVM01000013.1_i000_002897	52	355	303	0.918182	0.676339
GCA_003054445.1-Fun_CP028773.1_i000_000807	52	355	303	0.918182	0.676339
GCA_019455555.1-Ani_JAGFMF010011380.1_i000_000455	29	146	117	0.354545	0.413428
GCA_902201215.1-Pla_LR694010.1_i000_014855	43	189	146	0.442424	0.672811
GCA_900618505.1-Ani_UZAH01029137.1_i000_015909	43	248	205	0.621212	0.779468
GCA_016584195.1-Fun_PUHU01000058.1_i000_004205	38	363	325	0.984848	0.743707
GCA_016584265.1-Fun_PUHW01000076.1_i000_004783	38	363	325	0.984848	0.743707
GCA_016771965.1-Pla_CM028698.1_i000_061170	167	258	91	0.275758	0.211137
GCA_016771965.1-Pla_CM028698.1_i000_061170	257	337	80	0.242424	0.185615
GCA_902702955.1-Ani_CACRXO010000088.1_i000_008156	134	330	196	0.593939	0.280401
GCA_902702955.1-Ani_CACRXO010000088.1_i000_008156	351	398	47	0.142424	0.0672389
GCA_902702955.1-Ani_CACRXO010000088.1_i000_008156	433	532	99	0.3	0.141631
GCA_014905375.1-Pla_BMAC01001247.1_i000_027891	1	134	133	0.40303	0.970803
GCA_000599465.2-Ani_AWGT02014240.1_i000_016700	1	117	116	0.351515	0.571429
GCA_009746105.1-Pla_CM019268.1_i000_009305	41	372	331	1.00303	0.315238
GCA_002166775.1-Fun_NHMM01000007.1_i000_004033	52	355	303	0.918182	0.676339
GCA_000512085.1-Pro_ASPP01022055.1_i000_025284	2	137	135	0.409091	0.823171
GCA_001661235.1-Fun_KV454005.1_i000_004665	36	368	332	1.00606	0.754545
GCA_902702965.1-Ani_CACRXP010000103.1_i000_007335	134	330	196	0.593939	0.281205
GCA_902702965.1-Ani_CACRXP010000103.1_i000_007335	352	400	48	0.145455	0.0688666
GCA_902702965.1-Ani_CACRXP010000103.1_i000_007335	433	530	97	0.293939	0.139168
GCA_022496225.1-Fun_WTXE01000115.1_i000_001441	1	60	59	0.178788	0.331461
GCA_022496225.1-Fun_WTXE01000115.1_i000_001441	65	176	111	0.336364	0.623596
GCA_002218305.1-Ani_MCFN01001405.1_i000_015512	4	138	134	0.406061	0.606335
GCA_014058105.1-Pla_JACGCM010000252.1_i000_010019	40	168	128	0.387879	0.761905
GCA_000773845.1-Fun_AJIQ01000008.1_i000_006104	6	259	253	0.766667	0.647059
GCA_013339685.1-Ani_CM023490.1_i000_024796	1	134	133	0.40303	0.53629
GCA_003568945.1-Pro_BDIP01007418.1_i000_014407	1	122	121	0.366667	0.960317
GCA_008787405.2-Ani_CM018485.1_i000_013326	215	339	124	0.375758	0.255144
GCA_900618445.1-Ani_UYSG01000146.1_i000_000945	134	326	192	0.581818	0.283186
GCA_900618445.1-Ani_UYSG01000146.1_i000_000945	342	391	49	0.148485	0.0722714
GCA_900618445.1-Ani_UYSG01000146.1_i000_000945	429	541	112	0.339394	0.165192
GCA_902177915.1-Ani_CABIJS010000355.1_i000_009137	134	326	192	0.581818	0.283186
GCA_902177915.1-Ani_CABIJS010000355.1_i000_009137	342	391	49	0.148485	0.0722714
GCA_902177915.1-Ani_CABIJS010000355.1_i000_009137	429	541	112	0.339394	0.165192
GCA_000372725.1-Pro_KB869132.1_i000_034192	55	217	162	0.490909	0.498462
GCA_013115895.1-Pro_JABANM010011900.1_i000_009859	521	682	161	0.487879	0.23607
GCA_016097925.1-Fun_JAAAIQ010002098.1_i000_004421	1	121	120	0.363636	0.916031
GCA_015178925.1-Fun_WHVC01000007.1_i000_011384	174	264	90	0.272727	0.340909
GCA_008787405.2-Ani_CM018493.1_i000_020522	186	317	131	0.39697	0.293065
GCA_020424065.1-Pla_CM035471.1_i000_022775	126	214	88	0.266667	0.294314
GCA_020424065.1-Pla_CM035471.1_i000_022775	212	271	59	0.178788	0.197324
GCA_001186125.1-Pro_KQ242554.1_i000_009410	1	74	73	0.221212	0.701923
GCA_014058105.1-Pla_JACGCM010001529.1_i000_042293	72	174	102	0.309091	0.447368
GCA_014058105.1-Pla_JACGCM010001529.1_i000_042293	171	227	56	0.169697	0.245614
GCA_000442495.1-Pro_ATMH01001626.1_i000_001623	28	318	290	0.878788	0.857988
GCA_000442495.1-Pro_ATMH01002459.1_i000_002454	28	318	290	0.878788	0.857988
GCA_000442495.1-Pro_ATMH01004699.1_i000_004688	28	318	290	0.878788	0.857988
GCA_003568945.1-Pro_BDIP01002991.1_i000_009105	4	230	226	0.684848	0.982609
GCA_003521335.2-Ani_QWLN02014001.1_i000_013010	1	122	121	0.366667	0.467181
GCA_002087875.1-Fun_LTAI01000304.1_i000_001581	166	304	138	0.418182	0.453947
GCA_001879085.1-Pla_MJEQ01002129.1_i000_025727	10	152	142	0.430303	0.934211
GCA_020623625.1-Fun_CM036082.1_i000_002211	54	367	313	0.948485	0.652083
GCA_900491785.1-Fun_UFAJ01000227.1_i000_000962	54	367	313	0.948485	0.652083
GCA_013339725.1-Ani_CM023466.1_i000_019477	93	165	72	0.218182	0.209302
GCA_013339725.1-Ani_CM023466.1_i000_019477	234	344	110	0.333333	0.319767
GCA_900000135.1-Fun_CCYT01000234.1_i000_015143	57	214	157	0.475758	0.716895
GCA_016098025.1-Fun_JAAAIU010000416.1_i000_008252	1	125	124	0.375758	0.688889
GCA_002906115.4-Pla_PKMF03013286.1_i000_046448	40	160	120	0.363636	0.714286
GCA_015852395.1-Fun_JAAAII010001515.1_i000_008410	118	213	95	0.287879	0.446009
GCA_003490085.1-Pla_LXQA010521491.1_i000_077719	1	78	77	0.233333	0.974684
GCA_000816745.1-Ani_KN785438.1_i000_026169	4	132	128	0.387879	0.969697
GCA_022085475.1-Pla_JAIUZE010045862.1_i000_015660	302	467	165	0.5	0.353319
GCA_905216605.1-Pla_LR999452.1_i000_005048	3	166	163	0.493939	0.953216
GCA_011745845.1-Pla_VYZY01002554.1_i000_012140	2	146	144	0.436364	0.986301
GCA_011745865.1-Pla_VYZZ01001890.1_i000_009649	2	146	144	0.436364	0.986301
GCA_015852425.1-Fun_JAAAIG010001555.1_i000_002422	1	112	111	0.336364	0.792857
GCA_000004255.1-Pla_GL348714.1_i000_007247	3	164	161	0.487879	0.952663
GCA_000816745.1-Ani_KN740860.1_i000_016063	1	135	134	0.406061	0.529644
GCA_019364655.1-Ani_JAGXCG010013462.1_i000_037858	56	204	148	0.448485	0.72549
GCA_005286985.1-Pla_CM016552.1_i000_003438	1	122	121	0.366667	0.930769
GCA_000442575.2-Pro_ATMG01010842.1_i000_006064	2	220	218	0.660606	0.960352
GCA_015501535.1-Fun_JADNRW010000078.1_i000_021149	10	127	117	0.354545	0.688235
GCA_014282245.1-Pla_CM024959.1_i000_017160	42	370	328	0.993939	0.788462
GCA_019202805.1-Pla_CM032906.1_i000_032313	283	456	173	0.524242	0.24435
GCA_000611835.1-Ani_KK110928.1_i000_016444	71	205	134	0.406061	0.653659
GCA_002895965.2-Ani_PIJE02002588.1_i000_026610	105	260	155	0.469697	0.591603
GCA_018446385.1-Pla_CM031525.1_i000_065073	1	126	125	0.378788	0.423729
GCA_000827895.1-Ani_JWZT01003622.1_i000_009167	1	140	139	0.421212	0.528517
GCA_016584275.1-Fun_PUHV01000041.1_i000_003189	14	279	265	0.80303	0.728022
GCA_018292915.1-Ani_JACVVK010000152.1_i000_014283	150	286	136	0.412121	0.331707
GCA_018292915.1-Ani_JACVVK010000152.1_i000_014283	281	349	68	0.206061	0.165854
GCA_015679495.1-Fun_JAAAUW010004222.1_i000_011457	117	245	128	0.387879	0.522449
GCA_013115135.1-Pro_JABANP010000068.1_i000_012397	1	169	168	0.509091	0.126888
GCA_016097855.1-Fun_JAAAIM010002678.1_i000_005606	1	135	134	0.406061	0.54251
GCA_016584165.1-Fun_PUHT01000290.1_i000_002470	66	335	269	0.815152	0.645084
GCA_006368765.1-Ani_SKCS01000693.1_i000_008846	5	173	168	0.509091	0.506024
GCA_006368765.1-Ani_SKCS01000693.1_i000_008846	192	233	41	0.124242	0.123494
GCA_013115895.1-Pro_JABANM010005005.1_i000_004136	3	144	141	0.427273	0.979167
GCA_001742945.1-Pla_DF973517.1_i000_022145	1	58	57	0.172727	0.387755
GCA_001742945.1-Pla_DF973517.1_i000_022145	56	82	26	0.0787879	0.176871
GCA_001742945.1-Pla_DF973517.1_i000_022145	80	146	66	0.2	0.44898
GCA_900617795.1-Ani_CAAALY010040675.1_i000_012645	151	353	202	0.612121	0.495098
GCA_900617795.1-Ani_CAAALY010040675.1_i000_012645	369	408	39	0.118182	0.0955882
GCA_002087885.1-Fun_LVKB01000074.1_i000_002557	167	304	137	0.415152	0.450658
GCA_001432165.1-Fun_LGUB01000255.1_i000_003057	1	133	132	0.4	0.970588
GCA_902206195.3-Pla_CABITT030000004.1_i000_011491	296	497	201	0.609091	0.212698
GCA_902206195.3-Pla_CABITT030000004.1_i000_011491	500	590	90	0.272727	0.0952381
GCA_003260655.2-Pla_QGKV02000297.1_i000_013101	1	78	77	0.233333	0.330472
GCA_003260655.2-Pla_QGKV02000297.1_i000_013101	77	118	41	0.124242	0.175966
GCA_003260655.2-Pla_QGKV02000297.1_i000_013101	114	184	70	0.212121	0.300429
GCA_014282345.1-Pla_CM024981.1_i000_039993	38	138	100	0.30303	0.384615
GCA_014282345.1-Pla_CM024981.1_i000_039993	135	235	100	0.30303	0.384615
GCA_011745845.1-Pla_VYZY01003846.1_i000_016987	29	224	195	0.590909	0.805785
GCA_001432165.1-Fun_LGUB01001450.1_i000_001250	1	137	136	0.412121	0.971429
GCA_019426215.1-Pla_CM033405.1_i000_024380	43	119	76	0.230303	0.254181
GCA_019426215.1-Pla_CM033405.1_i000_024380	126	268	142	0.430303	0.474916
GCA_001625215.1-Pla_CM004285.1_i000_027837	90	260	170	0.515152	0.609319
GCA_019202795.1-Pla_CM032919.1_i000_032227	3	161	158	0.478788	0.84492
GCA_018127125.1-Pla_CM030792.1_i000_014801	23	115	92	0.278788	0.793103
GCA_001417885.1-Fun_AP012217.1_i000_003352	63	340	277	0.839394	0.662679
GCA_000142905.1-Pro_GL349448.1_i000_003973	97	213	116	0.351515	0.212454
GCA_000512255.2-Pla_CM008459.1_i000_014498	41	177	136	0.412121	0.415902
GCA_000512255.2-Pla_CM008459.1_i000_014498	194	274	80	0.242424	0.244648
GCA_001417835.1-Fun_AP014603.1_i000_003331	137	312	175	0.530303	0.422705
GCA_016097855.1-Fun_JAAAIM010002023.1_i000_004294	77	245	168	0.509091	0.685714
GCA_902728155.2-Pla_CACVBM020000199.1_i000_002964	2	153	151	0.457576	0.974194
GCA_902728155.2-Pla_CACVBM020000410.1_i000_005875	2	153	151	0.457576	0.974194
GCA_002271885.2-Pla_CM008444.1_i000_003526	30	224	194	0.587879	0.815126
GCA_000004255.1-Pla_GL348714.1_i000_007245	380	544	164	0.49697	0.287719
GCA_003573695.1-Pla_PUWZ01003678.1_i000_044893	2	119	117	0.354545	0.549296
GCA_905231915.1-Pro_CAJNJA010043593.1_i000_023401	29	159	130	0.393939	0.297483
GCA_905331535.1-Ani_CAJNZB010000828.1_i000_031979	136	256	120	0.363636	0.446097
GCA_900618515.1-Ani_UZAO01079827.1_i000_014393	1	83	82	0.248485	0.891304
GCA_002911725.1-Pro_NCKW01003646.1_i000_006158	92	262	170	0.515152	0.636704
GCA_002911725.1-Pro_NCKW01011280.1_i000_018106	93	262	169	0.512121	0.632959
GCA_014281875.1-Ani_CM024804.1_i000_010608	51	213	162	0.490909	0.760563
GCA_011766145.1-Pla_BLLF01004124.1_i000_023452	1	116	115	0.348485	0.982906
GCA_902728155.2-Pla_CACVBM020001884.1_i000_048668	1	87	86	0.260606	0.521212
GCA_018107945.1-Pla_JACEIK010000925.1_i000_018146	1	80	79	0.239394	0.302682
GCA_000512255.2-Pla_CM008455.1_i000_000654	3	141	138	0.418182	0.347607
GCA_001268165.1-Fun_CVQI01034557.1_i000_017057	39	160	121	0.366667	0.75625
GCA_001854445.2-Fun_CP015058.1_i000_003432	60	332	272	0.824242	0.669951
GCA_006381635.2-Pla_VEPZ02000002.1_i000_000230	268	385	117	0.354545	0.262921
GCA_902705455.1-Pla_CACSHJ010000096.1_i000_024293	134	184	50	0.151515	0.151515
GCA_902705455.1-Pla_CACSHJ010000096.1_i000_024293	158	259	101	0.306061	0.306061
GCA_902705455.1-Pla_CACSHJ010000096.1_i000_024293	259	327	68	0.206061	0.206061
GCA_003490085.1-Pla_LXQA010222628.1_i000_056109	1	48	47	0.142424	0.484536
GCA_003490085.1-Pla_LXQA010222628.1_i000_056109	42	97	55	0.166667	0.56701
GCA_017607565.1-Ani_JAANIB010010429.1_i000_008622	1	59	58	0.175758	0.331429
GCA_902728155.2-Pla_CACVBM020000221.1_i000_003308	1	50	49	0.148485	0.374046
GCA_902728155.2-Pla_CACVBM020000221.1_i000_003308	49	126	77	0.233333	0.587786
GCA_015680905.1-Pla_CM027382.1_i000_025638	30	154	124	0.375758	0.78481
GCA_001268145.1-Fun_CVQH01006513.1_i000_004148	117	235	118	0.357576	0.5
GCA_900618515.1-Ani_UZAO01084459.1_i000_015520	17	114	97	0.293939	0.850877
GCA_018855395.1-Fun_JABAJW010005624.1_i000_005208	1	89	88	0.266667	0.977778
GCA_902651935.1-Pla_CACRSJ010000104.1_i000_006074	3	162	159	0.481818	0.850267
GCA_902705455.1-Pla_CACSHJ010000087.1_i000_005964	3	162	159	0.481818	0.850267
GCA_013400055.1-Ani_VXBJ01007307.1_i000_013328	39	149	110	0.333333	0.331325
GCA_013400055.1-Ani_VXBJ01007307.1_i000_013328	162	260	98	0.29697	0.295181
GCA_001651475.1-Pla_CM004359.1_i000_005914	3	163	160	0.484848	0.744186
GCA_904420315.1-Pla_LR881466.1_i000_004900	3	163	160	0.484848	0.744186
GCA_019924195.1-Fun_JAHFXF010000430.1_i000_012976	133	241	108	0.327273	0.448133
GCA_019924255.1-Fun_JAHFXK010000145.1_i000_003823	133	241	108	0.327273	0.448133
GCA_905332135.1-Ani_CAJOBI010325068.1_i000_072136	112	228	116	0.351515	0.508772
GCA_019202795.1-Pla_CM032913.1_i000_005815	3	162	159	0.481818	0.580292
GCA_019202805.1-Pla_CM032900.1_i000_005674	3	162	159	0.481818	0.580292
GCA_905332035.1-Ani_CAJOAY010030702.1_i000_052523	1	51	50	0.151515	0.980392
GCA_002271885.2-Pla_CM008443.1_i000_000539	1	137	136	0.412121	0.564315
GCA_018107945.1-Pla_JACEIK010007073.1_i000_044573	3	194	191	0.578788	0.795833
GCA_003061485.1-Pla_CM009750.1_i000_007864	125	261	136	0.412121	0.51711
GCA_000733195.1-Pla_CM002869.1_i000_002152	4	160	156	0.472727	0.0840065
GCA_905250095.1-Ani_CAJNOR010021505.1_i000_064159	3	118	115	0.348485	0.974576
GCA_013339695.1-Ani_CM023520.1_i000_000918	36	158	122	0.369697	0.521368
GCA_010108815.1-Ani_QWKW01006058.1_i000_003706	1	112	111	0.336364	0.447581
GCA_000004515.5-Pla_CM000842.4_i000_023399	1	62	61	0.184848	0.273543
GCA_000004515.5-Pla_CM000842.4_i000_023399	61	132	71	0.215152	0.318386
GCA_012273815.2-Pla_CM022567.2_i000_025370	1	62	61	0.184848	0.273543
GCA_012273815.2-Pla_CM022567.2_i000_025370	61	132	71	0.215152	0.318386
GCA_014282035.1-Pla_CM024841.1_i000_014078	1	62	61	0.184848	0.273543
GCA_014282035.1-Pla_CM024841.1_i000_014078	61	132	71	0.215152	0.318386
GCA_011764045.1-Fun_JAANQQ010012574.1_i000_018010	1	74	73	0.221212	0.986486
GCA_008508345.1-Ani_QNGE01001631.1_i000_005363	166	252	86	0.260606	0.148532
GCA_008508345.1-Ani_QNGE01001631.1_i000_005363	287	345	58	0.175758	0.100173
GCA_008508345.1-Ani_QNGE01001631.1_i000_005363	380	486	106	0.321212	0.183074
GCA_905332275.1-Ani_CAJOBR010005265.1_i000_024541	57	201	144	0.436364	0.699029
GCA_000224885.2-Pro_KL998096.1_i000_004666	115	237	122	0.369697	0.453532
GCA_008009225.1-Pla_CM017761.1_i000_000769	28	191	163	0.493939	0.657258
GCA_007726485.1-Pla_CM017439.1_i000_000798	1	135	134	0.406061	0.558333
GCA_015500155.1-Fun_JAAAUE010002813.1_i000_003695	1	118	117	0.354545	0.657303
GCA_011745865.1-Pla_VYZZ01000998.1_i000_005071	51	187	136	0.412121	0.676617
GCA_002895965.2-Ani_PIJE02011986.1_i000_033236	91	257	166	0.50303	0.384259
GCA_002895965.2-Ani_PIJE02011986.1_i000_033236	280	336	56	0.169697	0.12963
GCA_002895965.2-Ani_PIJE02011986.1_i000_033236	354	426	72	0.218182	0.166667
GCA_001884845.1-Pla_MKKT01001753.1_i000_011595	150	256	106	0.321212	0.412451
GCA_000818735.3-Pla_JTFG03001496.1_i000_015556	150	256	106	0.321212	0.412451
GCA_001884805.1-Pla_MKKS01001020.1_i000_007936	150	256	106	0.321212	0.412451
GCA_000331365.3-Pla_AMZH03002417.1_i000_010572	154	260	106	0.321212	0.40613
GCA_000224805.2-Pro_KN040001.1_i000_006576	115	233	118	0.357576	0.506438
GCA_000224865.2-Pro_KN044642.1_i000_005991	115	233	118	0.357576	0.506438
GCA_000250965.2-Pro_KQ973610.1_i000_001224	115	233	118	0.357576	0.506438
GCA_000256725.2-Pro_KQ983279.1_i000_004316	115	233	118	0.357576	0.506438
GCA_020424065.1-Pla_CM035467.1_i000_011305	270	367	97	0.293939	0.261456
GCA_000818735.3-Pla_JTFG03002729.1_i000_023027	1	59	58	0.175758	0.349398
GCA_001884805.1-Pla_MKKS01004507.1_i000_021994	1	59	58	0.175758	0.347305
GCA_000224905.2-Pro_KN000265.1_i000_006653	115	237	122	0.369697	0.453532
GCA_000818735.3-Pla_JTFG03001496.1_i000_015557	1	73	72	0.218182	0.24
GCA_001884805.1-Pla_MKKS01001020.1_i000_007935	1	73	72	0.218182	0.24
GCA_001884845.1-Pla_MKKT01001753.1_i000_011594	1	73	72	0.218182	0.24
GCA_008782695.1-Ani_CM018501.1_i000_010822	189	321	132	0.4	0.341969
GCA_008787405.2-Ani_CM018480.1_i000_007215	200	332	132	0.4	0.332494
GCA_014282035.1-Pla_CM024846.1_i000_028625	65	177	112	0.339394	0.358974
GCA_014282035.1-Pla_CM024846.1_i000_028625	170	258	88	0.266667	0.282051
GCA_014282085.1-Pla_CM024906.1_i000_013692	65	177	112	0.339394	0.358974
GCA_014282085.1-Pla_CM024906.1_i000_013692	170	258	88	0.266667	0.282051
GCA_014282095.1-Pla_CM024926.1_i000_040769	65	177	112	0.339394	0.358974
GCA_014282095.1-Pla_CM024926.1_i000_040769	170	258	88	0.266667	0.282051
GCA_014282145.1-Pla_CM024946.1_i000_040185	65	177	112	0.339394	0.358974
GCA_014282145.1-Pla_CM024946.1_i000_040185	170	258	88	0.266667	0.282051
GCA_014058105.1-Pla_JACGCM010002299.1_i000_028299	1	167	166	0.50303	0.610294
GCA_001235845.1-Pro_LFNC01000001.1_i000_000407	91	315	224	0.678788	0.42344
GCA_001235845.1-Pro_LFNC01000001.1_i000_000407	332	445	113	0.342424	0.213611
GCA_011745845.1-Pla_VYZY01002554.1_i000_012141	1	134	133	0.40303	0.685567
GCA_011745865.1-Pla_VYZZ01001890.1_i000_009650	1	134	133	0.40303	0.685567
GCA_905250045.1-Ani_CAJNOG010000319.1_i000_025054	125	242	117	0.354545	0.443182
GCA_019279435.1-Pla_JAAALK010000579.1_i000_047464	123	278	155	0.469697	0.549645
GCA_015679645.1-Fun_JAAAVC010002137.1_i000_004591	1	116	115	0.348485	0.653409
GCA_013235015.1-Ani_BGPR01188865.1_i000_263567	3	55	52	0.157576	0.945455
GCA_013235015.1-Ani_BGPR01188879.1_i000_263574	3	55	52	0.157576	0.945455
GCA_014462685.1-Ani_JAACXV010010242.1_i000_011593	8	129	121	0.366667	0.640212
GCA_015679645.1-Fun_JAAAVC010000867.1_i000_011278	1	114	113	0.342424	0.656977
GCA_000203815.1-Pro_GL883014.1_i000_005771	2	148	146	0.442424	0.973333
GCA_000147415.1-Pla_GL433839.1_i000_002446	54	191	137	0.415152	0.433544
GCA_001268145.1-Fun_CVQH01022253.1_i000_014333	49	156	107	0.324242	0.685897
GCA_014058105.1-Pla_JACGCM010001183.1_i000_030147	1	133	132	0.4	0.970588
GCA_022376555.1-Fun_WTXH01000466.1_i000_007305	4	51	47	0.142424	0.155116
GCA_022376555.1-Fun_WTXH01000466.1_i000_007305	47	83	36	0.109091	0.118812
GCA_022376555.1-Fun_WTXH01000466.1_i000_007305	79	221	142	0.430303	0.468647
GCA_000760515.2-Fun_JMKJ01000592.1_i000_003046	3	151	148	0.448485	0.368159
GCA_000760515.2-Fun_JMKJ01000592.1_i000_003046	163	292	129	0.390909	0.320896
GCA_011766145.1-Pla_BLLF01004124.1_i000_023449	17	82	65	0.19697	0.792683
MESP047.0722.00001.C001_00602	1	73	72	0.218182	0.986301
GCA_000262585.1-Ani_JH668296.1_i000_001348	12	151	139	0.421212	0.5
GCA_013995675.1-Pro_VWRR01000007.1_i000_004595	4	198	194	0.587879	0.563953
GCA_013995675.1-Pro_VWRR01000007.1_i000_004595	209	283	74	0.224242	0.215116
GCA_021029035.1-Pro_JAFCAH010000114.1_i000_001775	462	552	90	0.272727	0.145867
GCA_021029035.1-Pro_JAFCAH010000114.1_i000_001775	552	615	63	0.190909	0.102107
GCA_001235845.1-Pro_LFNC01000477.1_i000_004745	185	391	206	0.624242	0.507389
GCA_905332045.1-Ani_CAJOBB010015662.1_i000_046540	11	116	105	0.318182	0.897436
GCA_008124465.1-Pla_CM017872.1_i000_000365	421	570	149	0.451515	0.242671
GCA_009887335.1-Ani_SGJC01004914.1_i000_006274	1	134	133	0.40303	0.542857
GCA_010458925.1-Pla_CM021239.1_i000_033566	68	183	115	0.348485	0.61828
GCA_000722935.2-Pla_KN667244.1_i000_041893	70	187	117	0.354545	0.615789
GCA_018688675.1-Pla_CM031825.1_i000_000852	2	74	72	0.218182	0.808989
GCA_000091205.1-Pro_AP006501.2_i000_004299	2	219	217	0.657576	0.596154
GCA_000091205.1-Pro_AP006501.2_i000_004299	234	311	77	0.233333	0.211538
GCA_000219495.2-Pla_CM001222.2_i000_034914	124	192	68	0.206061	0.354167
GCA_001970865.1-Fun_LSSM01006085.1_i000_009553	122	229	107	0.324242	0.467249
GCA_015883425.1-Ani_JADDUC010000013.1_i000_001664	129	220	91	0.275758	0.413636
GCA_007224835.1-Ani_SRMA01016720.1_i000_001205	60	153	93	0.281818	0.603896
GCA_003260385.1-Pla_NQVE01000018.1_i000_012229	2	120	118	0.357576	0.907692
GCA_905397405.1-Ani_CAJPVJ010019059.1_i000_016403	1	111	110	0.333333	0.488889
GCA_904845875.1-Pla_CAJGYO010000018.1_i000_060810	316	377	61	0.184848	0.0982287
GCA_019202805.1-Pla_CM032907.1_i000_034629	34	158	124	0.375758	0.623116
GCA_014058105.1-Pla_JACGCM010002660.1_i000_006019	4	90	86	0.260606	0.955556
GCA_000698435.2-Pro_CP006629.1_i000_000481	152	304	152	0.460606	0.5
GCA_009887335.1-Ani_SGJC01006288.1_i000_006823	31	192	161	0.487879	0.838542
GCA_013115865.1-Pro_JABANO010033400.1_i000_026674	121	212	91	0.275758	0.429245
GCA_008360955.1-Ani_LUCM01001435.1_i000_001488	31	93	62	0.187879	0.176136
GCA_008360955.1-Ani_LUCM01001435.1_i000_001488	125	240	115	0.348485	0.326705
GCA_000223135.1-Ani_JH000069.1_i000_002696	129	215	86	0.260606	0.392694
GCA_009445465.1-Pla_NMUH01000724.1_i000_016174	85	184	99	0.3	0.480583
GCA_006348945.1-Ani_SRLO01000285.1_i000_026906	484	619	135	0.409091	0.214968
GCA_000827895.1-Ani_JWZT01003622.1_i000_009168	15	176	161	0.487879	0.889503
GCA_000512085.1-Pro_ASPP01011140.1_i000_015080	125	255	130	0.393939	0.496183
GCA_003568945.1-Pro_BDIP01008126.1_i000_014984	13	137	124	0.375758	0.905109
GCA_000690575.1-Pla_AYPS01000243.1_i000_000807	13	174	161	0.487879	0.925287
GCA_000003835.1-Fun_CH408077.1_i000_001751	52	263	211	0.639394	0.667722
GCA_010108815.1-Ani_QWKW01008341.1_i000_004177	36	194	158	0.478788	0.814433
GCA_000313135.1-Pro_KB007909.1_i000_004958	130	330	200	0.606061	0.332779
GCA_003260385.1-Pla_NQVE01000018.1_i000_012230	1	39	38	0.115152	0.372549
GCA_003260385.1-Pla_NQVE01000018.1_i000_012230	35	101	66	0.2	0.647059
GCA_000512255.2-Pla_CM008456.1_i000_004172	29	205	176	0.533333	0.854369
GCA_019788955.1-Ani_JAFBMS010000154.1_i000_007869	53	187	134	0.406061	0.716578
GCA_003097735.1-Ani_NHOQ01001560.1_i000_009495	80	222	142	0.430303	0.628319
GCA_007252995.1-Ani_SWJQ01002202.1_i000_020343	1	53	52	0.157576	0.440678
GCA_007252995.1-Ani_SWJQ01002202.1_i000_020343	52	114	62	0.187879	0.525424
GCA_000350365.1-Fun_KB726235.1_i000_001541	32	130	98	0.29697	0.541436
GCA_001747045.1-Fun_LPNM01000012.1_i000_001360	143	413	270	0.818182	0.545455
GCA_014362265.1-Pla_BJWL01000211.1_i000_045234	686	754	68	0.206061	0.0803783
GCA_014362265.1-Pla_BJWL01000211.1_i000_045234	751	798	47	0.142424	0.0555556
GCA_002786265.1-Pla_KZ451979.1_i000_011848	1	52	51	0.154545	0.87931
GCA_014839935.1-Fun_QTSX01006703.1_i000_004267	119	244	125	0.378788	0.360231
GCA_002763495.2-Ani_JXXN02003060.1_i000_007134	5	57	52	0.157576	0.158537
GCA_002763495.2-Ani_JXXN02003060.1_i000_007134	96	212	116	0.351515	0.353659
GCA_900617965.1-Ani_UYRV01008428.1_i000_003309	90	204	114	0.345455	0.553398
GCA_003260675.2-Pla_QGKX02000088.1_i000_056135	151	211	60	0.181818	0.167598
GCA_003260675.2-Pla_QGKX02000088.1_i000_056135	209	317	108	0.327273	0.301676
GCA_009746105.1-Pla_CM019275.1_i000_020157	1	55	54	0.163636	0.391304
GCA_013467475.1-Pla_CM025179.1_i000_024386	1	107	106	0.321212	0.532663
GCA_013467475.1-Pla_CM025173.1_i000_012641	1	106	105	0.318182	0.456522
GCA_015849295.1-Fun_JAAAHW010011890.1_i000_012751	1	96	95	0.287879	0.742188
GCA_002211085.2-Pla_CM008047.2_i000_008077	125	288	163	0.493939	0.562069
GCA_014108415.1-Ani_JACASF010000003.1_i000_014043	70	175	105	0.318182	0.561497
GCA_015039355.1-Fun_MU134448.1_i000_011766	139	239	100	0.30303	0.416667
GCA_014058105.1-Pla_JACGCM010001067.1_i000_031474	1	72	71	0.215152	0.816092
GCA_006368765.1-Ani_SKCS01000693.1_i000_008849	36	126	90	0.272727	0.205011
GCA_006368765.1-Ani_SKCS01000693.1_i000_008849	149	337	188	0.569697	0.428246
GCA_022201045.1-Pla_CM039162.1_i000_004641	961	1017	56	0.169697	0.0489083
GCA_022201045.1-Pla_CM039162.1_i000_004641	1014	1063	49	0.148485	0.0427948
GCA_022201045.1-Pla_CM039162.1_i000_004641	1067	1144	77	0.233333	0.0672489
GCA_016098005.1-Fun_JAAAIS010000175.1_i000_003078	1	92	91	0.275758	0.674074
GCA_002870075.2-Pla_CM022521.1_i000_016783	41	92	51	0.154545	0.536842
GCA_000224845.2-Pro_KN044600.1_i000_007841	137	242	105	0.318182	0.433884
GCA_000224885.2-Pro_KL998082.1_i000_000784	137	242	105	0.318182	0.433884
GCA_000224905.2-Pro_KN000238.1_i000_001828	137	242	105	0.318182	0.433884
GCA_000256705.2-Pro_ML130728.1_i000_005148	137	242	105	0.318182	0.433884
GCA_000230795.1-Ani_CM001267.1_i000_013048	3	73	70	0.212121	0.921053
GCA_000230815.1-Ani_CM001290.1_i000_011883	3	73	70	0.212121	0.921053
GCA_014058105.1-Pla_JACGCM010002299.1_i000_028298	20	152	132	0.4	0.868421
GCA_905332135.1-Ani_CAJOBI010302270.1_i000_065013	1	43	42	0.127273	0.954545
GCA_000149285.1-Pla_CM000139.1_i000_007854	66	192	126	0.381818	0.398734
GCA_002271885.2-Pla_CM008447.1_i000_012816	1	160	159	0.481818	0.673729
GCA_000004655.2-Pla_CM000127.1_i000_008482	132	237	105	0.318182	0.307018
GCA_017639395.1-Pla_CM029883.1_i000_023580	9	130	121	0.366667	0.930769
GCA_000005425.2-Pla_AP008208.2_i000_006587	135	260	125	0.378788	0.324675
GCA_000569095.1-Pro_CM002459.1_i000_002246	1	134	133	0.40303	0.977941
GCA_010458925.1-Pla_CM021239.1_i000_033562	104	173	69	0.209091	0.396552
GCA_910591605.1-Ani_CAJVCH010553695.1_i000_039817	1	103	102	0.309091	0.953271
GCA_003845795.1-Ani_CM011678.1_i000_004385	7	107	100	0.30303	0.458716
GCA_903112645.1-Pla_CAEKDK010000004.1_i000_016267	13	60	47	0.142424	0.712121
GCA_903114435.1-Pla_CAEKKB010000004.1_i000_016082	13	60	47	0.142424	0.712121
GCA_008795845.1-Ani_SGJD01003122.1_i000_014127	4	62	58	0.175758	0.232
GCA_008795845.1-Ani_SGJD01003122.1_i000_014127	60	96	36	0.109091	0.144
GCA_002870075.2-Pla_CM022519.1_i000_005568	21	65	44	0.133333	0.60274
GCA_011745845.1-Pla_VYZY01000102.1_i000_000469	35	184	149	0.451515	0.411602
GCA_013358455.1-Pla_JABWDY010008988.1_i000_006716	2	60	58	0.175758	0.467742
GCA_000733195.1-Pla_CM002875.1_i000_015261	5	114	109	0.330303	0.283854
GCA_002271885.2-Pla_CM008454.1_i000_027908	320	408	88	0.266667	0.213592
GCA_019154785.2-Pro_JAGRRH010000069.1_i000_011179	94	251	157	0.475758	0.594697
GCA_013358455.1-Pla_JABWDY010040026.1_i000_030008	1	44	43	0.130303	0.275641
GCA_013358455.1-Pla_JABWDY010040026.1_i000_030008	42	125	83	0.251515	0.532051
GCA_900618025.1-Ani_UZAG01001951.1_i000_002327	35	180	145	0.439394	0.805556
GCA_013387185.1-Ani_CP045901.1_i000_013664	1	54	53	0.160606	0.353333
GCA_015852385.1-Fun_JAAAIE010002048.1_i000_003768	118	210	92	0.278788	0.438095
GCA_000412655.1-Ani_KE164236.1_i000_015172	1	98	97	0.293939	0.557471
GCA_018804465.1-Pla_CM032005.1_i000_023431	3	68	65	0.19697	0.236364
GCA_018804465.1-Pla_CM032005.1_i000_023431	66	148	82	0.248485	0.298182
GCA_900332095.2-Pla_OOIL02006764.1_i000_043251	1	84	83	0.251515	0.988095
GCA_013467475.1-Pla_CM025173.1_i000_010850	1	90	89	0.269697	0.89
GCA_011066465.2-Fun_MU009422.1_i000_005896	86	247	161	0.487879	0.387019
GCA_011754075.1-Ani_PGGH01055981.1_i000_000935	1	99	98	0.29697	0.406639
GCA_000757645.3-Ani_AZBU02000002.1_i000_010150	1	157	156	0.472727	0.945455
GCA_003490085.1-Pla_LXQA010311312.1_i000_063708	1	55	54	0.163636	0.981818
GCA_008787405.2-Ani_CM018478.1_i000_003162	119	262	143	0.433333	0.41691
GCA_002271895.2-Pla_CM008442.1_i000_029961	55	137	82	0.248485	0.106632
GCA_015680905.1-Pla_CM027377.1_i000_002233	37	122	85	0.257576	0.314815
GCA_016098165.1-Fun_JAAAJA010001848.1_i000_002566	120	208	88	0.266667	0.423077
GCA_016098165.1-Fun_JAAAJA010001234.1_i000_000976	127	216	89	0.269697	0.412037
GCA_015679645.1-Fun_JAAAVC010001196.1_i000_001134	124	209	85	0.257576	0.406699
GCA_016097925.1-Fun_JAAAIQ010001112.1_i000_000681	124	209	85	0.257576	0.406699
GCA_015679545.1-Fun_JAAAUZ010000823.1_i000_007726	125	209	84	0.254545	0.401914
GCA_003260635.2-Pla_QGKW02001911.1_i000_007462	114	204	90	0.272727	0.367347
GCA_001186125.1-Pro_KQ242217.1_i000_007654	74	202	128	0.387879	0.633663
GCA_003112345.1-Pla_PKPP01012615.1_i000_054184	70	149	79	0.239394	0.530201
GCA_015502485.1-Fun_JAAAUO010001027.1_i000_000258	124	209	85	0.257576	0.406699
GCA_015852495.1-Fun_JAAAIK010001066.1_i000_000395	200	284	84	0.254545	0.295775
GCA_000187875.1-Ani_GL732678.1_i000_022990	1	71	70	0.212121	0.57377
GCA_020379485.1-Pla_CM035450.1_i000_019638	164	291	127	0.384848	0.436426
GCA_000150455.3-Pro_KE123540.1_i000_005990	1	142	141	0.427273	0.623894
GCA_014282245.1-Pla_CM024964.1_i000_027488	631	760	129	0.390909	0.169737
GCA_015502475.1-Fun_JAAAUL010000562.1_i000_009364	174	258	84	0.254545	0.325581
GCA_016098085.1-Fun_JAAAIX010000577.1_i000_009302	183	267	84	0.254545	0.314607
GCA_005223365.2-Pla_SPHZ02000007.1_i000_021943	61	184	123	0.372727	0.418367
GCA_904845875.1-Pla_CAJGYO010000012.1_i000_046085	131	245	114	0.345455	0.322946
GCA_020169585.1-Pla_CM034986.1_i000_034697	1314	1393	79	0.239394	0.0565093
GCA_900617775.1-Ani_UYRU01056284.1_i000_009207	119	328	209	0.633333	0.616519
GCA_020169535.1-Pla_CM034998.1_i000_035517	1328	1401	73	0.221212	0.0519203
GCA_020169555.1-Pla_CM035022.1_i000_034297	1328	1401	73	0.221212	0.0519203
GCA_015852605.2-Pla_CM027586.2_i000_027572	1	90	89	0.269697	0.473404
GCA_019925215.1-Fun_JAHFYS010014579.1_i000_017984	1	123	122	0.369697	0.564815
GCA_019925215.1-Fun_JAHFYS010014573.1_i000_017979	1	123	122	0.369697	0.564815
GCA_003112345.1-Pla_PKPP01010204.1_i000_049864	26	109	83	0.251515	0.248503
GCA_001879085.1-Pla_CM007391.1_i000_000594	90	165	75	0.227273	0.267857
GCA_001879085.1-Pla_CM007391.1_i000_000594	166	248	82	0.248485	0.292857
GCA_002211085.2-Pla_CM008047.2_i000_008078	1	99	98	0.29697	0.823529
GCA_900332095.2-Pla_OOIL02005488.1_i000_036689	48	101	53	0.160606	0.335443
GCA_900332095.2-Pla_OOIL02005488.1_i000_036689	96	150	54	0.163636	0.341772
GCA_016255985.1-Fun_SDVW01000750.1_i000_000961	122	239	117	0.354545	0.367925
GCA_016255985.1-Fun_SDVW01000750.1_i000_000961	271	318	47	0.142424	0.147799
GCA_022117675.1-Ani_JACEFF010000511.1_i000_014380	115	206	91	0.275758	0.441748
GCA_002271895.2-Pla_CM008435.1_i000_013421	14	116	102	0.309091	0.857143
GCA_008787405.2-Ani_CM018496.1_i000_017893	170	293	123	0.372727	0.317829
GCA_900659725.1-Ani_CAACVG010011777.1_i000_017063	1	103	102	0.309091	0.51
GCA_008787405.2-Ani_CM018493.1_i000_020791	134	267	133	0.40303	0.354667
GCA_000230445.1-Ani_JH172486.1_i000_017190	137	241	104	0.315152	0.133163
GCA_016808335.1-Pla_CM029042.1_i000_053267	1	80	79	0.239394	0.975309
GCA_003568945.1-Pro_BDIP01001991.1_i000_007208	1	95	94	0.284848	0.77686
GCA_002271885.2-Pla_CM008449.1_i000_017921	37	147	110	0.333333	0.748299
GCA_016771965.1-Pla_CM028698.1_i000_061171	4	121	117	0.354545	0.458824
GCA_011745865.1-Pla_VYZZ01011883.1_i000_033643	1	141	140	0.424242	0.622222
GCA_900618425.1-Ani_UZAN01045143.1_i000_007830	50	103	53	0.160606	0.16358
GCA_900618425.1-Ani_UZAN01045143.1_i000_007830	147	235	88	0.266667	0.271605
GCA_015680905.1-Pla_CM027380.1_i000_016643	552	643	91	0.275758	0.134218
GCA_019154785.2-Pro_JAGRRH010000069.1_i000_011180	6	133	127	0.384848	0.520492
GCA_910591605.1-Ani_CAJVCH010051083.1_i000_007545	1	52	51	0.154545	0.980769
GCA_904845875.1-Pla_CAJGYO010000003.1_i000_010943	124	194	70	0.212121	0.175439
GCA_904845875.1-Pla_CAJGYO010000003.1_i000_010943	192	223	31	0.0939394	0.0776942
GCA_904845875.1-Pla_CAJGYO010000003.1_i000_010943	221	290	69	0.209091	0.172932
GCA_003568945.1-Pro_BDIP01010851.1_i000_016838	1	45	44	0.133333	0.977778
GCA_000005005.6-Pla_CM007647.1_i000_000271	1	118	117	0.354545	0.495763
GCA_000204515.1-Ani_GL888062.1_i000_002677	20	153	133	0.40303	0.852564
GCA_900005705.1-Ani_FR904750.1_i000_018720	4	108	104	0.315152	0.832
GCA_022201065.1-Pla_CM039171.1_i000_005250	1051	1128	77	0.233333	0.0682019
GCA_001664025.1-Fun_LXPE01000642.1_i000_004113	1	88	87	0.263636	0.612676
GCA_002197005.1-Ani_CM008011.1_i000_002658	115	176	61	0.184848	0.335165
GCA_000183025.1-Fun_ABRE01012274.1_i000_007138	89	209	120	0.363636	0.56872
GCA_014466195.1-Ani_CM025385.1_i000_017097	101	209	108	0.327273	0.299169
GCA_014466195.1-Ani_CM025385.1_i000_017097	219	327	108	0.327273	0.299169
GCA_008638375.1-Pla_CM018031.1_i000_000200	239	365	126	0.381818	0.328982
GCA_009746105.1-Pla_CM019266.1_i000_004168	48	162	114	0.345455	0.556098
GCA_000611645.1-Pla_KK105888.1_i000_015774	1	98	97	0.293939	0.416309
GCA_000698435.2-Pro_CP006629.1_i000_000522	3	199	196	0.593939	0.728625
GCA_000698435.2-Pro_CP006629.1_i000_000522	225	268	43	0.130303	0.159851
GCA_000376725.2-Ani_KZ309475.1_i000_017138	41	147	106	0.321212	0.430894
GCA_015680905.1-Pla_CM027378.1_i000_007343	289	389	100	0.30303	0.252525
GCA_015852435.1-Fun_JAAAIJ010001232.1_i000_001233	248	326	78	0.236364	0.239264
GCA_900332095.2-Pla_OOIL02005488.1_i000_036690	1	78	77	0.233333	0.927711
GCA_002271895.2-Pla_CM008435.1_i000_014039	1	145	144	0.436364	0.539326
GCA_003719485.1-Pro_MKKU01000489.1_i000_006786	6	174	168	0.509091	0.702929
GCA_001974805.1-Pla_AWWV01014414.1_i000_024513	1	54	53	0.160606	0.963636
GCA_905250035.1-Ani_CAJNOE010000051.1_i000_007776	23	121	98	0.29697	0.382812
GCA_000004985.1-Pro_GG738930.1_i000_014429	350	449	99	0.3	0.219027
GCA_020921065.1-Pla_CM037157.1_i000_020179	1	62	61	0.184848	0.592233
GCA_011752425.2-Ani_CACVKT020005888.1_i000_032563	54	172	118	0.357576	0.371069
GCA_022201045.1-Pla_CM039162.1_i000_003801	30	145	115	0.348485	0.782313
GCA_000385855.2-Fun_KK358453.1_i000_000934	1	67	66	0.2	0.970588
GCA_013115895.1-Pro_JABANM010019060.1_i000_015632	1	89	88	0.266667	0.642336
GCA_000002455.1-Pro_DQ158857.1_i000_000207	87	264	177	0.536364	0.520588
GCA_000002455.1-Pro_DQ158857.1_i000_000207	283	340	57	0.172727	0.167647
GCA_003490085.1-Pla_LXQA010717351.1_i000_088199	1	61	60	0.181818	0.983607
GCA_002920065.1-Fun_PKSL01000020.1_i000_002797	134	197	63	0.190909	0.133192
GCA_002920065.1-Fun_PKSL01000020.1_i000_002797	234	293	59	0.178788	0.124736
GCA_014905375.1-Pla_BMAC01001247.1_i000_027890	1	75	74	0.224242	0.986667
GCA_000797555.1-Ani_KN609667.1_i000_021458	1	96	95	0.287879	0.443925
GCA_015852435.1-Fun_JAAAIJ010000026.1_i000_005613	1	97	96	0.290909	0.615385
GCA_015852435.1-Fun_JAAAIJ010002067.1_i000_004312	1	98	97	0.293939	0.60625
GCA_011800875.2-Fun_JRHT02000153.1_i000_004591	125	219	94	0.284848	0.360153
GCA_905250095.1-Ani_CAJNOR010018722.1_i000_063058	1	95	94	0.284848	0.643836
GCA_905331505.1-Ani_CAJNYZ010000160.1_i000_018578	3	87	84	0.254545	0.378378
GCA_003692655.1-Ani_QRBI01000105.1_i000_005957	1	160	159	0.481818	0.736111
GCA_020536535.1-Pro_JAHLWZ010000187.1_i000_002359	337	509	172	0.521212	0.310469
GCA_905250035.1-Ani_CAJNOE010000225.1_i000_020991	7	87	80	0.242424	0.357143
GCA_905331525.1-Ani_CAJNZF010000179.1_i000_018819	3	87	84	0.254545	0.378378
GCA_905331535.1-Ani_CAJNZB010000157.1_i000_020799	14	100	86	0.260606	0.364407
GCA_016097525.1-Fun_JADAKD010000014.1_i000_006792	56	139	83	0.251515	0.494048
GCA_905332185.1-Ani_CAJOBM010081367.1_i000_054497	1	58	57	0.172727	0.95
GCA_019279435.1-Pla_JAAALK010000579.1_i000_047465	24	110	86	0.260606	0.441026
GCA_905330235.1-Ani_CAJNUA010004655.1_i000_037846	16	100	84	0.254545	0.358974
GCA_008782695.1-Ani_CM018501.1_i000_006144	131	264	133	0.40303	0.357527
GCA_001293395.1-Pro_LGTL01000015.1_i000_006610	2	174	172	0.521212	0.719665
GCA_905332185.1-Ani_CAJOBM010032513.1_i000_045352	1	89	88	0.266667	0.407407
GCA_905332305.1-Ani_CAJOBU010017555.1_i000_036234	1	81	80	0.242424	0.37037
GCA_002087225.1-Pro_NBCO01000010.1_i000_000117	3	175	172	0.521212	0.719665
GCA_014905375.1-Pla_BMAC01001247.1_i000_027892	43	150	107	0.324242	0.713333
GCA_900618405.1-Ani_UYSL01009400.1_i000_004710	109	190	81	0.245455	0.426316
GCA_022201065.1-Pla_CM039171.1_i000_004419	4	90	86	0.260606	0.699187
GCA_900618805.1-Ani_UYJE01000484.1_i000_002974	232	340	108	0.327273	0.128878
GCA_910591605.1-Ani_CAJVCH010165399.1_i000_017358	1	32	31	0.0939394	0.96875
GCA_000583005.2-Pla_ASHM01090858.1_i000_052713	1	81	80	0.242424	0.740741
GCA_900659725.1-Ani_CAACVG010009229.1_i000_012679	72	161	89	0.269697	0.317857
GCA_905237095.1-Pro_CAJNNW010031658.1_i000_034907	1	102	101	0.306061	0.523316
GCA_000002725.2-Pro_FR796412.1_i000_002141	2	173	171	0.518182	0.715481
GCA_916722125.1-Pro_OU755550.1_i000_002178	2	173	171	0.518182	0.715481
GCA_905332225.1-Ani_CAJOBN010009435.1_i000_027137	48	184	136	0.412121	0.444444
GCA_002914805.1-Pla_JXTB01000014.1_i000_002966	108	164	56	0.169697	0.265403
GCA_009731335.1-Pro_BLBS01000020.1_i000_002177	1	176	175	0.530303	0.732218
GCA_017916335.1-Pro_CM030447.1_i000_002064	1	178	177	0.536364	0.740586
GCA_004153795.2-Pla_SDRB02011545.1_i000_023009	186	307	121	0.366667	0.389068
GCA_000151035.1-Fun_GG692420.1_i000_007996	91	217	126	0.381818	0.550218
GCA_017918225.1-Pro_CM030555.1_i000_002101	1	178	177	0.536364	0.740586
GCA_017918215.1-Pro_CM030483.1_i000_001996	1	174	173	0.524242	0.723849
GCA_900618445.1-Ani_UYSG01010926.1_i000_007313	2	79	77	0.233333	0.611111
GCA_900618445.1-Ani_UYSG01010926.1_i000_007313	74	123	49	0.148485	0.388889
GCA_905330805.1-Ani_CAJNWK010004074.1_i000_035780	97	232	135	0.409091	0.380282
GCA_000224885.2-Pro_KL998095.1_i000_004442	18	157	139	0.421212	0.487719
GCA_000224905.2-Pro_KN000241.1_i000_002665	18	157	139	0.421212	0.487719
GCA_016628075.1-Fun_JABBWC010000156.1_i000_003936	11	82	71	0.215152	0.845238
GCA_000385855.2-Fun_KK358248.1_i000_000604	83	169	86	0.260606	0.508876
GCA_015849325.1-Fun_JAAAIB010001377.1_i000_001320	1	80	79	0.239394	0.681034
GCA_017916305.1-Pro_CM030591.1_i000_002102	1	177	176	0.533333	0.736402
GCA_000256705.2-Pro_ML130747.1_i000_007630	20	157	137	0.415152	0.480702
GCA_003730175.1-Pro_RHLD01000028.1_i000_004973	2	178	176	0.533333	0.736402
GCA_900635355.2-Pro_LR812636.1_i000_002146	2	178	176	0.533333	0.736402
GCA_003185045.1-Pla_CM009908.1_i000_010635	22	156	134	0.406061	0.414861
GCA_000492115.1-Pro_AUPL01005743.1_i000_005655	7	174	167	0.506061	0.698745
GCA_000313135.1-Pro_KB007939.1_i000_006834	2	66	64	0.193939	0.927536
GCA_000004255.1-Pla_GL348715.1_i000_008968	29	119	90	0.272727	0.703125
GCA_000227135.2-Pro_FR799603.2_i000_002043	2	175	173	0.524242	0.723849
GCA_003719575.1-Pro_CP029515.1_i000_002239	2	175	173	0.524242	0.723849
GCA_003730215.1-Pro_RHLC01000028.1_i000_004995	2	175	173	0.524242	0.723849
GCA_000325525.2-Pro_KN003134.1_i000_007311	1	134	133	0.40303	0.689119
GCA_000002875.2-Pro_FR796448.1_i000_002075	2	177	175	0.530303	0.732218
GCA_905332015.1-Ani_CAJOAZ010020202.1_i000_048391	1	92	91	0.275758	0.478947
GCA_022059095.1-Pro_JAJSEB010000047.1_i000_007223	4	177	173	0.524242	0.723849
GCA_015679645.1-Fun_JAAAVC010002772.1_i000_005888	1	81	80	0.242424	0.661157
GCA_002271895.2-Pla_CM008432.1_i000_003397	82	152	70	0.212121	0.411765
GCA_000234665.4-Pro_FR799569.1_i000_002328	2	177	175	0.530303	0.732218
GCA_002197005.1-Ani_CM008013.1_i000_004524	1	82	81	0.245455	0.487952
GCA_905397405.1-Ani_CAJPVJ010000897.1_i000_003166	1	90	89	0.269697	0.514451
GCA_011745865.1-Pla_VYZZ01006004.1_i000_023921	85	152	67	0.20303	0.394118
GCA_000224845.2-Pro_KN042481.1_i000_004058	1	133	132	0.4	0.505747
GCA_000256725.2-Pro_KQ986313.1_i000_008308	1	133	132	0.4	0.505747
GCA_003490085.1-Pla_LXQA010159278.1_i000_048183	1	90	89	0.269697	0.864078
GCA_002763495.2-Ani_JXXN02018238.1_i000_011161	45	212	167	0.506061	0.787736
GCA_000280035.2-Fun_CP003529.1_i000_001480	140	251	111	0.336364	0.426923
GCA_000430065.1-Fun_ATCN01001135.1_i000_002208	165	243	78	0.236364	0.318367
GCA_015178925.1-Fun_WHVC01000007.1_i000_011383	2	103	101	0.306061	0.95283
GCA_019924295.1-Fun_JAHFXI010013738.1_i000_017326	1	101	100	0.30303	0.515464
GCA_910591605.1-Ani_CAJVCH010197645.1_i000_019279	1	89	88	0.266667	0.470588
GCA_003490085.1-Pla_LXQA010049703.1_i000_023373	1	35	34	0.10303	0.971429
GCA_910591605.1-Ani_CAJVCH010005229.1_i000_000964	3	105	102	0.309091	0.971429
GCA_017916325.1-Pro_CM030411.1_i000_002009	1	174	173	0.524242	0.723849
GCA_000277815.3-Fun_CP002723.1_i000_001557	142	250	108	0.327273	0.413793
GCA_900059795.1-Pla_HG974432.1_i000_013096	4	93	89	0.269697	0.712
GCA_905330535.1-Ani_CAJNVN010001507.1_i000_032389	953	1085	132	0.4	0.109001
GCA_003490085.1-Pla_LXQA010010274.1_i000_007156	115	220	105	0.318182	0.416667
GCA_002763495.2-Ani_JXXN02018019.1_i000_011148	45	210	165	0.5	0.785714
GCA_902860255.1-Pla_LR794324.1_i000_007232	1	91	90	0.272727	0.461538
GCA_001432165.1-Fun_LGUB01000703.1_i000_001904	73	265	192	0.581818	0.724528
GCA_018342045.1-Fun_JAGEXW010000002.1_i000_000259	142	249	107	0.324242	0.409962
GCA_905332185.1-Ani_CAJOBM010001915.1_i000_011497	1039	1170	131	0.39697	0.101002
GCA_000149815.1-Fun_DS017026.1_i000_001926	7	104	97	0.293939	0.906542
GCA_009746105.1-Pla_CM019275.1_i000_020516	43	94	51	0.154545	0.189591
GCA_009746105.1-Pla_CM019275.1_i000_020516	89	131	42	0.127273	0.156134
GCA_905182985.1-Pro_CAJJDN010000014.1_i000_007286	16	196	180	0.545455	0.9
GCA_900618025.1-Ani_UZAG01019252.1_i000_012287	2	93	91	0.275758	0.433333
GCA_000691245.1-Pro_JMRU01000095.1_i000_002150	5	176	171	0.518182	0.718487
GCA_003325435.1-Fun_PJQL01000681.1_i000_006174	1	92	91	0.275758	0.883495
GCA_014282245.1-Pla_CM024958.1_i000_014860	115	168	53	0.160606	0.218107
GCA_015178925.1-Fun_WHVC01000026.1_i000_005716	2	75	73	0.221212	0.948052
GCA_013266205.1-Fun_JAAGWO010001633.1_i000_015154	123	194	71	0.215152	0.365979
GCA_001299535.1-Pro_LJSK01000114.1_i000_004047	1	172	171	0.518182	0.715481
GCA_000091225.2-Fun_AL590449.1_i000_001719	141	249	108	0.327273	0.415385
GCA_001078035.1-Fun_LFTZ01000014.1_i000_001468	141	249	108	0.327273	0.415385
GCA_002081575.1-Pro_JNBS01002046.1_i000_008216	2	108	106	0.321212	0.507177
GCA_000582765.1-Pro_HF955089.1_i000_005104	1	48	47	0.142424	0.194215
GCA_000582765.1-Pro_HF955089.1_i000_005104	83	174	91	0.275758	0.376033
GCA_000146465.1-Fun_CP001951.1_i000_001562	143	250	107	0.324242	0.413127
GCA_905332135.1-Ani_CAJOBI010101650.1_i000_038667	1	60	59	0.178788	0.983333
GCA_905332135.1-Ani_CAJOBI010138677.1_i000_045403	1	60	59	0.178788	0.983333
GCA_008360955.1-Ani_LUCM01011796.1_i000_011810	139	306	167	0.506061	0.513846
GCA_017918235.1-Pro_CM030519.1_i000_001874	1	174	173	0.524242	0.723849
GCA_017524585.1-Ani_CM029836.1_i000_015556	15	111	96	0.290909	0.0416305
GCA_008636045.1-Pro_SNRW01025403.1_i000_042937	1	41	40	0.121212	0.430108
GCA_008782695.1-Ani_CM018501.1_i000_006385	135	168	33	0.1	0.0926966
GCA_008782695.1-Ani_CM018501.1_i000_006385	180	255	75	0.227273	0.210674
GCA_003490085.1-Pla_LXQA010425416.1_i000_071756	1	50	49	0.148485	0.98
GCA_000256705.2-Pro_ML130747.1_i000_007629	85	182	97	0.293939	0.532967
GCA_003112345.1-Pla_PKPP01000635.1_i000_008846	3	81	78	0.236364	0.438202
GCA_014282245.1-Pla_CM024957.1_i000_012556	6	117	111	0.336364	0.143596
GCA_014282245.1-Pla_CM024957.1_i000_012556	114	255	141	0.427273	0.182406
GCA_000209065.1-Pro_CH473438.1_i000_006726	5	175	170	0.515152	0.711297
GCA_003177095.1-Pro_PRFC01000320.1_i000_013515	5	175	170	0.515152	0.711297
GCA_905330665.1-Ani_HG994585.1_i000_007329	1	87	86	0.260606	0.502924
GCA_000188675.2-Pro_ADWP02004346.1_i000_000968	6	172	166	0.50303	0.697479
GCA_000300495.1-Pro_AHKC01011356.1_i000_005205	5	177	172	0.521212	0.719665
GCA_008787405.2-Ani_CM018480.1_i000_007991	169	226	57	0.172727	0.14578
GCA_008787405.2-Ani_CM018480.1_i000_007991	218	279	61	0.184848	0.15601
GCA_013358655.1-Pro_JABDHM010000018.1_i000_003329	4	178	174	0.527273	0.728033
GCA_015033655.1-Pro_CM026647.1_i000_009535	4	178	174	0.527273	0.728033
GCA_000496795.1-Pro_AYLP01000031.1_i000_003099	5	175	170	0.515152	0.714286
GCA_002219105.2-Pro_MBSY01000614.1_i000_009413	5	175	170	0.515152	0.714286
GCA_003177105.1-Pro_PRFA01000055.1_i000_011924	5	175	170	0.515152	0.714286
GCA_003719455.1-Pro_MKKV01000018.1_i000_002051	5	175	170	0.515152	0.714286
GCA_015033625.1-Pro_CM026608.1_i000_009848	5	175	170	0.515152	0.714286
GCA_008782695.1-Ani_CM018501.1_i000_010045	169	230	61	0.184848	0.153266
GCA_008782695.1-Ani_CM018501.1_i000_010045	218	280	62	0.187879	0.155779
GCA_013115895.1-Pro_JABANM010003733.1_i000_003153	84	193	109	0.330303	0.547739
GCA_000209065.1-Pro_CH473392.1_i000_009337	5	175	170	0.515152	0.711297
GCA_003177095.1-Pro_PRFC01000006.1_i000_019283	5	175	170	0.515152	0.711297
GCA_015529785.1-Fun_JAAAUK010001321.1_i000_001702	1	90	89	0.269697	0.605442
GCA_000499725.1-Pro_HG712843.1_i000_005868	1	70	69	0.209091	0.226974
GCA_000499725.1-Pro_HG712843.1_i000_005868	119	215	96	0.290909	0.315789
GCA_002914845.1-Pla_JXTC01000273.1_i000_025305	107	156	49	0.148485	0.231132
GCA_014282245.1-Pla_CM024964.1_i000_027491	1	77	76	0.230303	0.0723121
GCA_003719475.1-Pro_MKGL01000184.1_i000_005406	3	174	171	0.518182	0.715481
GCA_900617775.1-Ani_UYRU01075428.1_i000_014671	68	166	98	0.29697	0.590361
GCA_910592045.1-Fun_CAJVPX010078788.1_i000_025264	1	91	90	0.272727	0.652174
GCA_000512085.1-Pro_ASPP01018222.1_i000_020595	126	231	105	0.318182	0.432099
GCA_002135145.1-Ani_MUJZ01050453.1_i000_010525	1	89	88	0.266667	0.594595
GCA_012275245.1-Fun_WMJW01000015.1_i000_002328	50	165	115	0.348485	0.692771
GCA_000755165.1-Pro_CP009385.1_i000_001929	1	180	179	0.542424	0.748954
GCA_004115385.1-Pla_CM014063.1_i000_035843	1	89	88	0.266667	0.446701
GCA_000442575.2-Pro_ATMG01001370.1_i000_015521	4	177	173	0.524242	0.726891
GCA_903995115.1-Pro_LR877158.1_i000_006786	4	177	173	0.524242	0.726891
GCA_014466175.1-Ani_CM025350.1_i000_014250	1	34	33	0.1	0.266129
GCA_014466175.1-Ani_CM025350.1_i000_014250	39	117	78	0.236364	0.629032
GCA_905250045.1-Ani_CAJNOG010000283.1_i000_023583	3	73	70	0.212121	0.333333
GCA_002284835.2-Ani_KV923189.1_i000_020991	1	62	61	0.184848	0.968254
GCA_014282245.1-Pla_CM024964.1_i000_027489	1	87	86	0.260606	0.158672
GCA_016808335.1-Pla_CM029041.1_i000_015016	125	288	163	0.493939	0.510972
GCA_900618445.1-Ani_UYSG01010926.1_i000_007314	6	82	76	0.230303	0.915663
GCA_000002845.2-Pro_FR798990.1_i000_001980	1	177	176	0.533333	0.736402
GCA_900537975.1-Pro_LS997615.1_i000_002154	1	177	176	0.533333	0.736402
GCA_905332045.1-Ani_CAJOBB010003589.1_i000_031391	1	69	68	0.206061	0.330097
GCA_021307395.1-Pro_SOPI01000504.1_i000_011740	4	53	49	0.148485	0.205021
GCA_021307395.1-Pro_SOPI01000504.1_i000_011740	85	170	85	0.257576	0.355649
GCA_905332115.1-Ani_CAJOBH010239316.1_i000_064665	1	79	78	0.236364	0.742857
GCA_905332125.1-Ani_CAJOBJ010338988.1_i000_073604	1	79	78	0.236364	0.742857
GCA_002352805.1-Ani_KZ345014.1_i000_000830	30	118	88	0.266667	0.374468
GCA_905332115.1-Ani_CAJOBH010288621.1_i000_078569	1	82	81	0.245455	0.84375
GCA_905332125.1-Ani_CAJOBJ010024419.1_i000_023024	1	82	81	0.245455	0.84375
GCA_905332045.1-Ani_CAJOBB010000280.1_i000_007021	1	73	72	0.218182	0.349515
GCA_019425475.1-Pro_NLFJ01000305.1_i000_003428	4	53	49	0.148485	0.205021
GCA_019425475.1-Pro_NLFJ01000305.1_i000_003428	85	174	89	0.269697	0.372385
GCA_000499385.1-Pro_HG725401.1_i000_006117	1	88	87	0.263636	0.330798
GCA_000204515.1-Ani_GL888646.1_i000_012525	1	84	83	0.251515	0.592857
GCA_013401445.1-Pla_CM023873.1_i000_006617	32	132	100	0.30303	0.740741
GCA_000209555.1-Ani_FN656912.1_i000_008196	1	81	80	0.242424	0.382775
GCA_013115865.1-Pro_JABANO010034396.1_i000_027475	1	82	81	0.245455	0.582734
GCA_013115895.1-Pro_JABANM010029807.1_i000_024489	1	82	81	0.245455	0.582734
GCA_900618405.1-Ani_UYSL01010237.1_i000_004894	1	84	83	0.251515	0.619403
GCA_000230595.3-Fun_AFBI03000004.1_i000_002438	91	205	114	0.345455	0.553398
GCA_014805705.1-Fun_SBJP01000387.1_i000_001688	102	285	183	0.554545	0.588424
GCA_000982615.1-Pro_HF955214.1_i000_005838	1	43	42	0.127273	0.173554
GCA_000982615.1-Pro_HF955214.1_i000_005838	82	173	91	0.275758	0.376033
GCA_002742825.1-Ani_CM008512.1_i000_015979	31	57	26	0.0787879	0.153846
GCA_002742825.1-Ani_CM008512.1_i000_015979	53	133	80	0.242424	0.473373
GCA_905250035.1-Ani_CAJNOE010001566.1_i000_041181	1	68	67	0.20303	0.328431
FAPR001.0722.00004.C001_00184	85	291	206	0.624242	0.526854
FAPR001.0722.00004.C001_00955	85	291	206	0.624242	0.526854
FAPR001.0722.00004.C001_01767	85	291	206	0.624242	0.526854
FAPR001.0722.00004.C001_01972	85	291	206	0.624242	0.526854
FAPR001.0722.00004.C001_02491	85	291	206	0.624242	0.526854
FAPR001.0722.00004.C001_02513	85	291	206	0.624242	0.526854
FASP002.0722.00001.C001_00113	85	291	206	0.624242	0.526854
FASP002.0722.00001.C001_00346	85	291	206	0.624242	0.526854
FASP002.0722.00001.C001_00511	85	291	206	0.624242	0.526854
FASP002.0722.00001.C001_00533	85	291	206	0.624242	0.526854
FASP002.0722.00001.C001_00893	85	291	206	0.624242	0.526854
FASP002.0722.00001.C001_02748	85	291	206	0.624242	0.526854
GCA_014466175.1-Ani_CM025360.1_i000_018432	77	179	102	0.309091	0.317757
GCA_014466175.1-Ani_CM025360.1_i000_018432	205	295	90	0.272727	0.280374
GCA_000499725.1-Pro_HG712394.1_i000_005153	134	197	63	0.190909	0.219512
GCA_006461475.1-Ani_SUNJ01010334.1_i000_008230	232	351	119	0.360606	0.266816
GCA_900618405.1-Ani_UYSL01026986.1_i000_021813	4	145	141	0.427273	0.972414
GCA_900617985.1-Ani_UYRR01039140.1_i000_020276	44	82	38	0.115152	0.463415
GCA_001876935.1-Pla_CM007387.1_i000_019663	11	140	129	0.390909	0.895833
FASP004.0722.00001.C001_01967	85	292	207	0.627273	0.529412
FASP004.0722.00001.C001_02705	85	292	207	0.627273	0.529412
GCA_003573695.1-Pla_CM010715.1_i000_000777	1	97	96	0.290909	0.979592
GCA_014058105.1-Pla_JACGCM010001067.1_i000_031475	1	100	99	0.3	0.490099
GCA_001268145.1-Fun_CVQH01008047.1_i000_005025	1	87	86	0.260606	0.378855
GCA_014805555.1-Fun_SBIQ01000005.1_i000_000151	133	199	66	0.2	0.255814
STMA001.0722.00001.C001_01505	80	268	188	0.569697	0.493438
GCA_007646595.3-Ani_VBQZ03000014.1_i000_003867	11	109	98	0.29697	0.0647292
GCA_001749795.1-Fun_LPNL01000004.1_i000_001452	309	403	94	0.284848	0.20524
SPUR001.0722.00002.C001_00325	80	266	186	0.563636	0.457002
GCA_017607565.1-Ani_JAANIB010001770.1_i000_001267	1	87	86	0.260606	0.767857
GCA_014282245.1-Pla_CM024957.1_i000_012521	2	186	184	0.557576	0.70229
GCA_003185045.1-Pla_CM009914.1_i000_033399	230	327	97	0.293939	0.221968
GCA_000311805.2-Ani_KB017026.1_i000_010569	50	150	100	0.30303	0.160256
GCA_014058105.1-Pla_JACGCM010000772.1_i000_032170	125	241	116	0.351515	0.481328
LYSP018.0722.00001.C001_02505	81	266	185	0.560606	0.455665
GCA_900119595.1-Fun_FQNF01000035.1_i000_003527	298	403	105	0.318182	0.229258
GCA_010458925.1-Pla_CM021239.1_i000_033565	1	90	89	0.269697	0.622378
GCA_008932095.1-Pla_CM018511.1_i000_014459	4	121	117	0.354545	0.966942
GCA_904845875.1-Pla_CAJGYO010000002.1_i000_007098	59	230	171	0.518182	0.286432
GCA_904845875.1-Pla_CAJGYO010000002.1_i000_007098	379	465	86	0.260606	0.144054
GCA_000002775.3-Pla_CM009302.1_i000_031225	1	36	35	0.106061	0.3125
GCA_005239225.1-Pla_RCHU01001190.1_i000_006566	56	145	89	0.269697	0.110422
GCA_000803265.1-Fun_JOKQ01000005.1_i000_000798	144	255	111	0.336364	0.418868
GCA_004324935.1-Fun_PITG01000005.1_i000_000792	144	255	111	0.336364	0.418868
GCA_004324945.1-Fun_PITF01000006.1_i000_000791	144	255	111	0.336364	0.418868
GCA_004325055.1-Fun_PITH01000008.1_i000_000787	144	255	111	0.336364	0.418868
GCA_000005005.6-Pla_CM000786.4_i000_038119	49	90	41	0.124242	0.356522
GCA_905331535.1-Ani_CAJNZB010003864.1_i000_040755	6	75	69	0.209091	0.249097
GCA_905331535.1-Ani_CAJNZB010003864.1_i000_040755	133	209	76	0.230303	0.274368
ERRA001.0722.00001.C001_02808	84	262	178	0.539394	0.452926
GCA_002197005.1-Ani_CM008012.1_i000_004013	86	225	139	0.421212	0.308204
PASP010.0722.00001.C001_02868	80	267	187	0.566667	0.460591
FASP008.0722.00001.C001_02018	85	289	204	0.618182	0.521739
FASP008.0722.00001.C001_02251	85	289	204	0.618182	0.521739
FAPR001.0722.00004.C001_01763	85	289	204	0.618182	0.521739
FASP002.0722.00001.C001_00924	85	289	204	0.618182	0.521739
GCA_900618405.1-Ani_UYSL01025538.1_i000_020753	40	132	92	0.278788	0.69697
GCA_022376555.1-Fun_WTXH01000093.1_i000_010670	1	92	91	0.275758	0.565217
ALSP031.0722.00001.C001_01248	482	619	137	0.415152	0.215748
GCA_013398885.1-Ani_VYZL01004194.1_i000_009573	2	138	136	0.412121	0.561983
GCA_000383075.1-Fun_KB909415.1_i000_003416	58	152	94	0.284848	0.61039
GCA_002880755.3-Ani_CM009255.2_i000_014504	87	225	138	0.418182	0.295503
GCA_022376445.1-Fun_JACBKP010000038.1_i000_010545	10	134	124	0.375758	0.568807
GCA_011800145.1-Ani_JAAMPH010000065.1_i000_012646	87	225	138	0.418182	0.105103
GCA_011800145.1-Ani_JAAMPH010000065.1_i000_012646	530	668	138	0.418182	0.105103
GCA_003185045.1-Pla_CM009909.1_i000_014970	103	146	43	0.130303	0.136943
GCA_008782695.1-Ani_CM018502.1_i000_015675	259	371	112	0.339394	0.24086
GCA_020536995.1-Ani_CM035916.1_i000_025264	59	171	112	0.339394	0.422642
GCA_000827895.1-Ani_JWZT01004020.1_i000_010156	2	101	99	0.3	0.970588
GCA_002742825.1-Ani_CM008509.1_i000_003765	36	119	83	0.251515	0.572414
STPN001.0722.00057.C001_00399	81	255	174	0.527273	0.513274
STPN001.0722.00066.C001_00443	81	255	174	0.527273	0.513274
STPN001.0722.00054.C001_00472	81	255	174	0.527273	0.513274
GCA_014466195.1-Ani_CM025385.1_i000_017152	2	40	38	0.115152	0.271429
GCA_014466195.1-Ani_CM025385.1_i000_017152	32	70	38	0.115152	0.271429
AEPA001.0722.00001.C001_00787	80	266	186	0.563636	0.458128
AEPA001.0722.00001.C001_03518	80	266	186	0.563636	0.458128
TAKY001.0722.00001.C001_00499	88	264	176	0.533333	0.446701
TAKY001.0722.00001.C001_01385	88	264	176	0.533333	0.446701
EGLE001.0722.00005.C001_02328	162	254	92	0.278788	0.262857
EGLE001.0722.00007.C001_01029	162	254	92	0.278788	0.262857
EGLE001.0722.00007.C001_01692	162	254	92	0.278788	0.262857
EGLE001.0722.00001.C001_00833	162	254	92	0.278788	0.262857
EGLE001.0722.00002.C001_00093	162	254	92	0.278788	0.262857
EGLE001.0722.00003.C001_00089	162	254	92	0.278788	0.262857
EGLE001.0722.00003.C001_00655	162	254	92	0.278788	0.262857
EGLE001.0722.00004.C001_00662	162	254	92	0.278788	0.262857
EGLE001.0722.00006.C001_00093	162	254	92	0.278788	0.262857
EGLE001.0722.00008.C001_00090	162	254	92	0.278788	0.262857
EGLE001.0722.00009.C001_00095	162	254	92	0.278788	0.262857
GCA_003185045.1-Pla_CM009908.1_i000_012415	260	304	44	0.133333	0.100686
GCA_900622545.1-Ani_UYWY01005794.1_i000_003945	120	198	78	0.236364	0.39196
GCA_000471905.1-Pla_KI393609.1_i000_012763	27	67	40	0.121212	0.25
FASP008.0722.00001.C001_01172	85	288	203	0.615152	0.519182
GCA_000708225.1-Ani_KL410191.1_i000_003971	60	167	107	0.324242	0.277922
GCA_016881025.1-Ani_JAESOR010000662.1_i000_012922	82	221	139	0.421212	0.311659
GCA_000499545.1-Pro_HG676067.1_i000_006727	3	42	39	0.118182	0.171806
GCA_000230795.1-Ani_CM001268.1_i000_013944	87	225	138	0.418182	0.295503
GCA_001664025.1-Fun_LXPE01000007.1_i000_004175	216	282	66	0.2	0.135524
GCA_001664025.1-Fun_LXPE01000007.1_i000_004175	312	407	95	0.287879	0.195072
GCA_000230815.1-Ani_CM001291.1_i000_012663	87	225	138	0.418182	0.295503
FUMO001.0722.00001.C001_02662	90	295	205	0.621212	0.551075
GCA_002880775.3-Ani_CM009279.2_i000_014671	87	225	138	0.418182	0.295503
FUMO001.0722.00001.C001_00337	90	295	205	0.621212	0.524297
FUMO001.0722.00001.C001_01844	90	295	205	0.621212	0.524297
FUMO001.0722.00001.C001_02667	90	295	205	0.621212	0.524297
GCA_901343595.1-Ani_CABDUW010001780.1_i000_023646	82	220	138	0.418182	0.3
GCA_018107945.1-Pla_JACEIK010195167.1_i000_052056	40	114	74	0.224242	0.649123
GCA_000002445.1-Pro_CP000071.1_i000_003942	3	65	62	0.187879	0.260504
GCA_001457755.2-Pro_CZPT02001143.1_i000_005784	3	65	62	0.187879	0.260504
GCA_003543875.1-Pro_CM010679.1_i000_003727	3	65	62	0.187879	0.260504
GCA_003568945.1-Pro_BDIP01004206.1_i000_010871	1	62	61	0.184848	0.266376
STPN001.0722.00051.C001_00441	81	256	175	0.530303	0.516224
STPN001.0722.00052.C001_00441	81	256	175	0.530303	0.516224
LATE001.0722.00001.C001_01266	7	108	101	0.306061	0.885965
GCA_000182765.2-Fun_HE605205.1_i000_003878	5	67	62	0.187879	0.548673
GCA_014049445.1-Fun_JABWAB010000004.1_i000_002589	5	67	62	0.187879	0.548673
GCA_014049455.1-Fun_JABWAA010000003.1_i000_002254	5	67	62	0.187879	0.548673
GCA_014049495.1-Fun_JABWAC010000003.1_i000_002535	5	67	62	0.187879	0.548673
GCA_014049585.1-Fun_JABVZZ010000002.1_i000_002230	5	67	62	0.187879	0.548673
GCA_903989565.1-Fun_CAJEJE010000003.1_i000_003287	5	67	62	0.187879	0.548673
GCA_005406025.1-Ani_BGZK01004801.1_i000_094009	499	665	166	0.50303	0.174737
GCA_003692655.1-Ani_QRBI01000106.1_i000_009145	84	167	83	0.251515	0.257764
URPA001.0722.00001.C001_00452	8	116	108	0.327273	0.931034
URPA001.0722.00002.C001_00571	8	116	108	0.327273	0.931034
URPA001.0722.00003.C001_00609	8	116	108	0.327273	0.931034
URPA001.0722.00004.C001_00410	8	116	108	0.327273	0.931034
URPA001.0722.00005.C001_00307	8	116	108	0.327273	0.931034
URPA001.0722.00006.C001_00310	8	116	108	0.327273	0.931034
GCA_000803125.3-Ani_CM016642.2_i000_012397	86	226	140	0.424242	0.301075
GCA_017524585.1-Ani_CM029829.1_i000_010583	485	624	139	0.421212	0.118097
GCA_017524585.1-Ani_CM029829.1_i000_010583	812	951	139	0.421212	0.118097
GCA_905146905.1-Ani_CAJHUB010000649.1_i000_000489	87	225	138	0.418182	0.295503
GCA_008782695.1-Ani_CM018501.1_i000_007541	86	226	140	0.424242	0.305011
GCA_008787405.2-Ani_CM018495.1_i000_019708	86	226	140	0.424242	0.305011
GCA_014049915.1-Ani_JABVXQ010000008.1_i000_018595	83	222	139	0.421212	0.302832
GCA_000311805.2-Ani_KB016669.1_i000_005394	87	226	139	0.421212	0.298925
GCA_000210295.1-Pro_FN554971.1_i000_004548	54	120	66	0.2	0.222973
GCA_900617795.1-Ani_CAAALY010022979.1_i000_008402	41	143	102	0.309091	0.377778
GCA_021821965.1-Fun_JACCJH010000007.1_i000_000877	143	255	112	0.339394	0.422642
LYFU001.0722.00002.C001_01341	81	266	185	0.560606	0.454545
LYFU001.0722.00002.C001_02417	81	266	185	0.560606	0.454545
LYFU001.0722.00002.C001_04949	81	266	185	0.560606	0.454545
GCA_013115135.1-Pro_JABANP010000068.1_i000_012398	163	201	38	0.115152	0.171171
GCA_007646595.3-Ani_VBQZ03000217.1_i000_019146	479	617	138	0.418182	0.117949
GCA_007646595.3-Ani_VBQZ03000217.1_i000_019146	805	944	139	0.421212	0.118803
RUBO001.0722.00001.C001_02089	85	292	207	0.627273	0.494033
GCA_004000155.1-Fun_RCSS01000730.1_i000_002575	35	161	126	0.381818	0.59434
GCA_900661375.1-Ani_CAAGRJ010007019.1_i000_005350	90	230	140	0.424242	0.307692
CLSP002.0722.00001.C001_00899	87	266	179	0.542424	0.454315
CLSP002.0722.00001.C001_02840	87	266	179	0.542424	0.454315
MYTE001.0722.00001.C001_00130	192	249	57	0.172727	0.162393
MYTE001.0722.00002.C001_03936	192	249	57	0.172727	0.162393
MYTE001.0722.00001.C001_00251	192	249	57	0.172727	0.162393
MYTE001.0722.00002.C001_03815	192	249	57	0.172727	0.162393
BATH001.0722.00005.C001_02534	90	277	187	0.566667	0.449519
BATH001.0722.00007.C001_05892	90	277	187	0.566667	0.449519
BATH001.0722.00011.C001_00372	90	277	187	0.566667	0.449519
BATH001.0722.00037.C001_04895	90	277	187	0.566667	0.449519
BATH001.0722.00039.C001_04899	90	277	187	0.566667	0.449519
BATH001.0722.00045.C001_00372	90	277	187	0.566667	0.449519
GCA_001675575.1-Ani_LZPO01096977.1_i000_018516	87	225	138	0.418182	0.104943
GCA_001675575.1-Ani_LZPO01096977.1_i000_018516	544	629	85	0.257576	0.0646388
GCA_001594045.1-Ani_KQ976595.1_i000_009821	10	52	42	0.127273	0.114441
GCA_000315875.1-Fun_HE681721.1_i000_002525	2	66	64	0.193939	0.556522
CLBO002.0722.00002.C001_00779	122	211	89	0.269697	0.224181
CLBO002.0722.00002.C001_00779	274	353	79	0.239394	0.198992
GCA_014282345.1-Pla_CM024976.1_i000_025385	2	80	78	0.236364	0.545455
GCA_019455555.1-Ani_JAGFMF010011782.1_i000_012320	591	729	138	0.418182	0.138693
GCA_019924025.1-Fun_JAHFWX010003302.1_i000_014874	71	174	103	0.312121	0.591954
GCA_019924875.1-Fun_JAHFYK010003451.1_i000_016234	71	174	103	0.312121	0.591954
GCA_019924025.1-Fun_JAHFWX010005192.1_i000_018232	72	174	102	0.309091	0.586207
GCA_019924875.1-Fun_JAHFYK010005721.1_i000_019818	72	174	102	0.309091	0.586207
EMBR001.0722.00001.C001_03299	392	474	82	0.248485	0.172996
EMBR001.0722.00002.C001_03078	392	474	82	0.248485	0.172996
EMFA001.0722.00001.C001_00994	393	475	82	0.248485	0.172632
GCA_001420675.1-Ani_LMAW01003038.1_i000_014956	57	156	99	0.3	0.0989011
GCA_001420675.1-Ani_LMAW01003038.1_i000_014956	528	666	138	0.418182	0.137862
GCA_001420675.1-Ani_LMAW01003038.1_i000_014956	838	977	139	0.421212	0.138861
ANPR002.0722.00001.C001_01909	86	288	202	0.612121	0.516624
GCA_020004485.1-Ani_JAATJU010026900.1_i000_020688	85	224	139	0.421212	0.298283
GCA_000710305.1-Ani_KL523411.1_i000_006899	17	154	137	0.415152	0.40413
GCA_905146905.1-Ani_CAJHUB010000649.1_i000_000490	89	230	141	0.427273	0.30989
GCA_905183005.1-Pro_CAJJDO010000118.1_i000_033422	101	149	48	0.145455	0.0672269
GCA_905183005.1-Pro_CAJJDO010000118.1_i000_033422	494	542	48	0.145455	0.0672269
STAL002.0722.00003.C001_01457	12	108	96	0.290909	0.872727
LYFU001.0722.00002.C001_02505	81	266	185	0.560606	0.454545
GCA_000223135.1-Ani_JH001501.1_i000_018297	86	225	139	0.421212	0.297645
STSP041.0722.00001.C001_01406	183	260	77	0.233333	0.190594
STSP041.0722.00001.C001_03611	183	260	77	0.233333	0.190594
STPA006.0722.00001.C001_01179	81	263	182	0.551515	0.47769
GCA_004325045.1-Fun_PITJ01000027.1_i000_000161	149	248	99	0.3	0.392857
GCA_002271885.2-Pla_CM008447.1_i000_012295	21	60	39	0.118182	0.106267
THWI001.0722.00001.C001_01899	106	292	186	0.563636	0.435597
MATI001.0722.00001.C001_02552	85	290	205	0.621212	0.524297
GCA_000383075.1-Fun_KB908911.1_i000_000130	58	153	95	0.287879	0.616883
GCA_001460835.1-Pro_CYKH01001960.1_i000_015101	5	47	42	0.127273	0.149466
GCA_001460835.1-Pro_CYKH01001960.1_i000_015101	107	193	86	0.260606	0.30605
GCA_016808335.1-Pla_CM029040.1_i000_047164	160	330	170	0.515152	0.379464
GCA_000376725.2-Ani_KZ309141.1_i000_015436	52	205	153	0.463636	0.711628
GCA_013634535.1-Ani_JACDTQ010001563.1_i000_002747	86	225	139	0.421212	0.301518
GCF_000001405.40-Hum_NC_000017.11_i000_015498	86	225	139	0.421212	0.297645
GCA_014533835.1-Ani_WJEC01002063.1_i000_007542	82	220	138	0.418182	0.3
EMST001.0722.00001.C001_01424	401	474	73	0.221212	0.154008
HARU001.0722.00001.C001_02085	31	94	63	0.190909	0.670213
GCA_900661375.1-Ani_CAAGRJ010007019.1_i000_005349	37	176	139	0.421212	0.333333
GCA_000004335.1-Ani_GL192892.1_i000_008709	84	222	138	0.418182	0.297414
URUR001.0722.00001.C001_00320	7	116	109	0.330303	0.939655
URUR001.0722.00002.C001_00322	7	116	109	0.330303	0.939655
URUR001.0722.00003.C001_00323	7	116	109	0.330303	0.939655
URUR001.0722.00004.C001_00320	7	116	109	0.330303	0.939655
ZOGA001.0722.00001.C001_00001	322	474	152	0.460606	0.320675
NOSP015.0722.00001.C001_00001	323	475	152	0.460606	0.32
NOSP026.0722.00001.C001_00001	323	475	152	0.460606	0.32
MEMA002.0722.00001.C001_04094	147	312	165	0.5	0.390995
GCA_017655625.1-Fun_JAEOAQ010000001.1_i000_001406	3	63	60	0.181818	0.504202
STSU001.0722.00013.C001_01372	81	269	188	0.569697	0.493438
GCA_014108415.1-Ani_JACASF010000019.1_i000_009319	91	229	138	0.418182	0.303297
COAG001.0722.00001.C001_00075	321	474	153	0.463636	0.322785
MASP044.0722.00001.C001_02901	319	474	155	0.469697	0.327004
EUMA001.0722.00001.C001_02207	313	474	161	0.487879	0.339662
GCA_004325065.1-Fun_PITI01000044.1_i000_000264	149	248	99	0.3	0.392857
MACO001.0722.00001.C001_03573	316	474	158	0.478788	0.333333
GCA_003112345.1-Pla_PKPP01001609.1_i000_017289	2	83	81	0.245455	0.366516
GCA_003112345.1-Pla_PKPP01001609.1_i000_017289	104	188	84	0.254545	0.38009
MUSO001.0722.00001.C001_01520	320	474	154	0.466667	0.324895
GCA_008782695.1-Ani_CM018501.1_i000_007540	90	229	139	0.421212	0.305495
GCA_000004335.1-Ani_GL192892.1_i000_008708	90	230	140	0.424242	0.307692
STPN001.0722.00056.C001_00420	35	207	172	0.521212	0.653992
MELI001.0722.00002.C001_02810	83	297	214	0.648485	0.525799
MELI001.0722.00001.C001_00496	83	297	214	0.648485	0.525799
MELI001.0722.00001.C001_04900	83	297	214	0.648485	0.525799
GCA_000325575.1-Ani_KB031150.1_i000_017816	9	147	138	0.418182	0.479167
GCA_018127125.1-Pla_CM030792.1_i000_015368	37	110	73	0.221212	0.233227
GCA_016858145.1-Pla_JAEHOE010000053.1_i000_010195	89	275	186	0.563636	0.65493
ROBI001.0722.00001.C001_02474	316	474	158	0.478788	0.333333
GCA_014176215.1-Ani_JACASE010000006.1_i000_017593	86	225	139	0.421212	0.301518
GCA_013339685.1-Ani_CM023487.1_i000_019544	3	169	166	0.50303	0.794258
GCA_000334495.1-Ani_KB320933.1_i000_012383	60	200	140	0.424242	0.324826
LASP009.0722.00001.C001_00001	399	474	75	0.227273	0.157895
CLRO001.0722.00001.C001_02841	1	77	76	0.230303	0.655172
CLRO001.0722.00002.C001_03249	1	77	76	0.230303	0.655172
FLSP030.0722.00001.C001_03023	353	473	120	0.363636	0.253165
MUAQ001.0722.00001.C001_00001	363	473	110	0.333333	0.232068
FISU001.0722.00001.C001_00264	610	748	138	0.418182	0.155756
FISU001.0722.00002.C001_00646	610	748	138	0.418182	0.155756
MURU001.0722.00001.C001_00001	353	473	120	0.363636	0.253165
FLSP013.0722.00001.C001_03286	363	473	110	0.333333	0.232068
MUOC001.0722.00001.C001_01766	353	473	120	0.363636	0.253165
CLSP002.0722.00001.C001_01794	86	258	172	0.521212	0.666667
CLSP002.0722.00001.C001_02105	86	258	172	0.521212	0.666667
CLSP002.0722.00001.C001_02226	86	258	172	0.521212	0.666667
CLSP002.0722.00001.C001_02238	86	258	172	0.521212	0.666667
CLSP002.0722.00001.C001_00877	86	258	172	0.521212	0.666667
CLSP002.0722.00001.C001_00935	86	258	172	0.521212	0.666667
CLFE002.0722.00001.C001_01853	1	77	76	0.230303	0.666667
GCA_900618425.1-Ani_UZAN01056107.1_i000_013838	146	227	81	0.245455	0.276451
GCA_000763605.2-Pla_JRKL02001004.1_i000_009223	3	69	66	0.2	0.942857
PSSP093.0722.00001.C001_00001	399	474	75	0.227273	0.157895
OLSP001.0722.00001.C001_02052	401	474	73	0.221212	0.153684
OLSP003.0722.00001.C001_01958	401	474	73	0.221212	0.153684
NASP008.0722.00001.C001_00808	28	92	64	0.193939	0.695652
STCA002.0722.00001.C001_01536	75	254	179	0.542424	0.4475
STCA002.0722.00001.C001_01598	75	254	179	0.542424	0.4475
STCA002.0722.00001.C001_01715	75	254	179	0.542424	0.4475
STCA002.0722.00001.C001_01791	75	254	179	0.542424	0.4475
STCA002.0722.00001.C001_01898	75	254	179	0.542424	0.4475
GCA_014108255.1-Ani_JACAGC010000013.1_i000_003721	42	118	76	0.230303	0.429379
GCA_013401335.1-Ani_VYZX01022869.1_i000_008667	2	132	130	0.393939	0.53719
STCA002.0722.00003.C001_01880	75	254	179	0.542424	0.4475
STCA002.0722.00003.C001_00471	75	254	179	0.542424	0.4475
GCA_000334495.1-Ani_KB320933.1_i000_012384	86	225	139	0.421212	0.297645
GCA_004325075.1-Fun_PITK01000235.1_i000_001441	147	240	93	0.281818	0.373494
OCSP001.0722.00001.C001_00001	389	474	85	0.257576	0.178947
MASP006.0722.00001.C001_00001	312	474	162	0.490909	0.341772
GCA_002966975.2-Pla_PJQY01003872.1_i000_040037	5	82	77	0.233333	0.631148
MAHY001.0722.00001.C001_00001	312	474	162	0.490909	0.341772
POSP032.0722.00001.C001_02368	396	474	78	0.236364	0.164211
POSP033.0722.00001.C001_01481	396	474	78	0.236364	0.164211
POSP034.0722.00001.C001_03616	396	474	78	0.236364	0.164211
STPN001.0722.00044.C001_01412	35	214	179	0.542424	0.619377
STPN001.0722.00050.C001_00449	35	214	179	0.542424	0.619377
STPN001.0722.00078.C001_00440	35	214	179	0.542424	0.619377
STPN001.0722.00089.C001_00494	35	214	179	0.542424	0.619377
STPN001.0722.00093.C001_00477	35	214	179	0.542424	0.619377
STPN001.0722.00010.C001_02097	34	207	173	0.524242	0.657795
GCA_904845875.1-Pla_CAJGYO010000001.1_i000_001691	630	802	172	0.521212	0.149435
POSP026.0722.00001.C001_00001	396	474	78	0.236364	0.164211
STPN001.0722.00029.C001_00461	81	267	186	0.563636	0.54386
STPN001.0722.00055.C001_00427	81	267	186	0.563636	0.54386
MASP018.0722.00001.C001_00747	362	474	112	0.339394	0.236287
LASP004.0722.00001.C001_01449	399	474	75	0.227273	0.157895
LAVE001.0722.00001.C001_02030	401	474	73	0.221212	0.153684
CELY001.0722.00001.C001_00001	399	474	75	0.227273	0.158228
CELY001.0722.00002.C001_00001	399	474	75	0.227273	0.158228
SESP003.0722.00001.C001_01101	333	474	141	0.427273	0.297468
MUAU001.0722.00001.C001_00001	353	473	120	0.363636	0.253165
GCA_013397825.1-Ani_VZRK01000324.1_i000_006724	64	200	136	0.412121	0.676617
VIDO001.0722.00001.C001_03829	61	199	138	0.418182	0.292994
AGSA002.0722.00001.C001_01863	363	474	111	0.336364	0.234177
POSP001.0722.00001.C001_01140	396	474	78	0.236364	0.164211
GCA_000186055.2-Pro_GG665453.1_i000_000811	115	194	79	0.239394	0.401015
GCA_000002165.1-Ani_CM000219.2_i000_020101	103	242	139	0.421212	0.524528
CEBA001.0722.00002.C001_03585	318	474	156	0.472727	0.329114
STPN001.0722.00060.C001_00431	36	214	178	0.539394	0.551084
STPN001.0722.00064.C001_00448	36	214	178	0.539394	0.551084
STPN001.0722.00072.C001_00431	36	214	178	0.539394	0.551084
STPN001.0722.00074.C001_00474	36	214	178	0.539394	0.551084
STPN001.0722.00077.C001_00429	36	214	178	0.539394	0.551084
STPN001.0722.00096.C001_00445	36	214	178	0.539394	0.551084
CEAL001.0722.00001.C001_00001	319	474	155	0.469697	0.327004
CEBA001.0722.00001.C001_03570	319	474	155	0.469697	0.327004
CESP017.0722.00001.C001_01831	319	474	155	0.469697	0.327004
CESP018.0722.00001.C001_01179	319	474	155	0.469697	0.327004
GCA_016881025.1-Ani_JAESOR010000662.1_i000_012923	90	181	91	0.275758	0.491892
GCA_910592245.1-Fun_CAJVQB010116158.1_i000_041614	1	69	68	0.206061	0.591304
STPN001.0722.00018.C001_00437	81	267	186	0.563636	0.492063
GCA_000298355.1-Ani_JH882119.1_i000_012326	84	223	139	0.421212	0.304825
CESP014.0722.00001.C001_00001	316	474	158	0.478788	0.333333
CESP003.0722.00001.C001_01752	317	474	157	0.475758	0.331224
LAJO001.0722.00011.C001_01546	78	264	186	0.563636	0.46384
GCA_013339685.1-Ani_CM023483.1_i000_010297	3	147	144	0.436364	0.941176
GCA_019627755.1-Fun_WSTS01000397.1_i000_008125	3	162	159	0.481818	0.819588
MYPH003.0722.00001.C001_02085	188	248	60	0.181818	0.17192
MYPH003.0722.00001.C001_02558	188	248	60	0.181818	0.17192
MYPH003.0722.00001.C001_03231	188	248	60	0.181818	0.17192
GCA_022453505.1-Fun_JAJLYR010000091.1_i000_012053	86	175	89	0.269697	0.508571
GCA_004325035.1-Fun_PIXR01000023.1_i000_000135	149	248	99	0.3	0.392857
GCA_000690875.1-Ani_KK631572.1_i000_007609	71	211	140	0.424242	0.35443
CNPH001.0722.00001.C001_01617	131	209	78	0.236364	0.369668
GCA_905332335.1-Ani_CAJOBX010014446.1_i000_019395	81	220	139	0.421212	0.301518
WIHE001.0722.00001.C001_02754	399	474	75	0.227273	0.157895
GCA_014108235.1-Ani_JABWUV010000017.1_i000_006582	46	185	139	0.421212	0.355499
GCA_008787405.2-Ani_CM018495.1_i000_019707	90	229	139	0.421212	0.305495
KOAN001.0722.00001.C001_00004	387	474	87	0.263636	0.183158
WISC001.0722.00001.C001_01218	399	474	75	0.227273	0.157895
WISP004.0722.00001.C001_00001	396	474	78	0.236364	0.164211
WISP002.0722.00001.C001_02836	399	474	75	0.227273	0.157895
GCA_014108415.1-Ani_JACASF010000019.1_i000_009320	88	225	137	0.415152	0.301099
WIFO001.0722.00001.C001_02049	399	474	75	0.227273	0.157895
WIFO001.0722.00002.C001_03117	399	474	75	0.227273	0.157895
WIFO001.0722.00003.C001_01048	399	474	75	0.227273	0.157895
GCA_013399675.1-Ani_VXAT01020119.1_i000_012527	2	137	135	0.409091	0.557851
OLAQ001.0722.00001.C001_03166	399	474	75	0.227273	0.157895
AQSP007.0722.00001.C001_00001	351	473	122	0.369697	0.256842
GCA_013396675.1-Ani_VWZE01008603.1_i000_004665	2	138	136	0.412121	0.561983
TESP006.0722.00001.C001_00588	395	473	78	0.236364	0.164557
TESP007.0722.00001.C001_02006	395	473	78	0.236364	0.164557
MEST001.0722.00001.C001_00514	4	95	91	0.275758	0.791304
AQSP003.0722.00001.C001_05063	355	473	118	0.357576	0.248421
ENFA001.0722.00027.C001_02609	76	253	177	0.536364	0.623239
CIFR004.0722.00047.C001_03856	176	252	76	0.230303	0.213483
LASP019.0722.00001.C001_00001	401	474	73	0.221212	0.153684
GCA_009805765.1-Fun_WEHS01000078.1_i000_002842	312	421	109	0.330303	0.232409
GCA_009805785.1-Fun_WEHT01000182.1_i000_002949	312	421	109	0.330303	0.232409
THBR003.0722.00001.C001_02118	105	283	178	0.539394	0.416862
THPS001.0722.00001.C001_01040	105	283	178	0.539394	0.416862
THPS001.0722.00001.C001_02128	105	283	178	0.539394	0.416862
FUNU001.0722.00003.C001_00347	97	297	200	0.606061	0.511509
FUNU001.0722.00003.C001_00497	97	297	200	0.606061	0.511509
FUNU001.0722.00003.C001_01014	97	297	200	0.606061	0.511509
FUNU001.0722.00003.C001_01066	97	297	200	0.606061	0.511509
PRMI001.0722.00056.C001_03505	174	252	78	0.236364	0.220339
ARAL001.0722.00001.C001_04522	330	474	144	0.436364	0.303797
